,id,raw_name,depth_ordering_rank,crop,header_id,num_mask_points,xmin,ymin,xmax,ymax,width,height,coco_label
0,3,person,4,0,7,97,493,5,728,304,235,299,person
1,17,person,18,1,7,25,0,1,187,485,187,484,person
2,18,person,19,0,7,52,255,140,551,485,296,345,person
3,4,person,5,1,1488,30,354,241,439,372,85,131,person
4,6,person,7,1,1488,27,253,234,327,374,74,140,person
5,7,person,8,1,1488,21,120,266,225,374,105,108,person
6,8,person,9,1,1488,26,84,239,162,361,78,122,person
7,9,person,10,1,1488,19,45,247,95,351,50,104,person
8,10,person,11,1,1488,30,0,240,126,374,126,134,person
9,1,person,2,1,1489,32,281,52,493,298,212,246,person
10,5,person,6,0,1490,40,109,130,151,242,42,112,person
11,7,person,8,0,1490,53,208,122,258,272,50,150,person
12,8,person,9,0,1490,50,287,101,374,288,87,187,person
13,9,person,10,0,1490,25,193,145,215,224,22,79,person
14,7,person,8,1,1491,25,390,201,476,379,86,178,person
15,9,person,10,1,1491,52,200,198,420,479,220,281,person
16,10,person,11,1,1491,51,401,143,592,479,191,336,person
17,11,person,12,1,1491,36,523,76,639,478,116,402,person
18,9,person,10,1,1494,19,85,430,144,528,59,98,person
19,10,person,11,1,1494,15,127,446,170,526,43,80,person
20,11,person,12,1,1494,15,159,447,202,527,43,80,person
21,12,person,13,1,1494,22,198,443,251,528,53,85,person
22,13,person,14,1,1494,26,269,408,348,531,79,123,person
23,15,person,16,1,1494,23,452,413,525,527,73,114,person
24,16,person,17,1,1494,20,518,425,555,525,37,100,person
25,17,person,18,1,1494,20,563,423,617,527,54,104,person
26,18,person,19,1,1494,18,613,420,661,527,48,107,person
27,19,person,20,1,1494,17,661,429,709,525,48,96,person
28,20,person,21,1,1494,16,692,430,770,527,78,97,person
29,15,person,16,1,1495,18,204,275,233,318,29,43,person
30,23,person,24,1,1495,18,407,285,449,315,42,30,person
31,3,keyboard,4,0,22633,15,0,616,204,706,204,90,keyboard
32,2,bench,3,0,22634,50,5,558,184,628,179,70,bench
33,3,person,4,0,22634,38,40,500,78,627,38,127,person
34,4,person,5,0,22634,62,293,425,381,678,88,253,person
35,5,person,6,0,22634,75,771,408,877,655,106,247,person
36,6,person,7,0,22634,67,841,404,929,662,88,258,person
37,7,backpack,8,0,22634,28,878,445,936,523,58,78,backpack
38,8,person,9,0,22634,69,921,355,1024,683,103,328,person
39,9,person,10,1,22634,29,998,397,1024,675,26,278,person
40,10,person,11,0,22634,26,392,525,440,612,48,87,person
41,11,person,12,1,22634,31,413,522,450,611,37,89,person
42,13,plant pot,14,0,22634,18,276,561,326,648,50,87,potted plant
43,19,umbrella,20,0,22634,17,1,374,189,513,188,139,umbrella
44,21,umbrella,22,0,22634,15,7,417,286,521,279,104,umbrella
45,25,person,26,0,1523,26,1207,1254,1259,1386,52,132,person
46,26,person,27,0,1523,23,1270,1259,1318,1389,48,130,person
47,27,person,28,0,1523,25,1314,1263,1351,1382,37,119,person
48,12,car,13,1,1524,22,986,1593,1290,1695,304,102,car
49,19,car,15,0,1525,18,1138,1213,1199,1256,61,43,car
50,22,car,18,0,1525,23,925,1230,1053,1280,128,50,car
51,27,person,23,0,1525,17,784,1226,789,1247,5,21,person
52,36,bench,32,0,1525,66,492,1325,603,1449,111,124,bench
53,5,person,6,1,22646,19,141,491,158,558,17,67,person
54,11,person,12,0,22646,22,337,484,351,527,14,43,person
55,13,person,14,0,22646,18,378,487,393,512,15,25,person
56,4,person,5,1,22647,19,465,983,504,1023,39,40,person
57,5,person,6,1,22647,17,444,986,469,1023,25,37,person
58,7,person,8,1,22647,15,305,990,336,1022,31,32,person
59,13,person,14,1,22647,18,55,984,81,1024,26,40,person
60,14,person,15,1,22647,15,114,997,138,1024,24,27,person
61,15,person,16,1,22647,20,84,982,108,1024,24,42,person
62,1,person,2,1,22648,28,202,548,390,1025,188,477,person
63,2,person,3,0,22648,56,0,526,483,1648,483,1122,person
64,5,person,6,1,22648,97,906,316,1580,1648,674,1332,person
65,6,person,7,0,22648,55,1605,542,1841,1224,236,682,person
66,8,person,9,1,22648,24,2053,715,2198,1319,145,604,person
67,12,person,13,0,22648,34,1904,555,2018,1038,114,483,person
68,13,person,14,0,22648,33,1829,574,1919,964,90,390,person
69,14,person,15,1,22648,29,1969,539,2072,1023,103,484,person
70,17,chair,18,1,22649,31,758,470,888,652,130,182,chair
71,18,person,19,1,22649,74,731,342,909,605,178,263,person
72,5,person,6,1,1550,77,97,8,231,242,134,234,person
73,6,person,7,1,1550,52,6,36,107,242,101,206,person
74,1,person,2,1,1551,37,2,349,275,491,273,142,person
75,2,person,3,1,1554,48,544,107,717,468,173,361,person
76,3,person,4,1,1554,52,385,144,590,468,205,324,person
77,9,person,10,1,1558,35,142,187,267,289,125,102,person
78,27,glasses,28,1,1558,19,232,332,284,356,52,24,eye glasses
79,31,book,32,0,1558,18,2,318,232,370,230,52,book
80,1,person,2,1,1562,50,35,32,258,398,223,366,person
81,14,chair,15,1,1564,26,318,172,371,234,53,62,chair
82,20,chair,21,1,1564,15,221,208,275,268,54,60,chair
83,21,chair,22,1,1564,21,162,222,239,297,77,75,chair
84,26,desk,27,1,1564,15,215,167,286,218,71,51,desk
85,30,desk,31,1,1564,21,100,172,220,265,120,93,desk
86,5,table,6,0,1565,23,190,311,581,479,391,168,dining table
87,3,table,4,0,1568,19,177,121,249,156,72,35,dining table
88,4,bench,5,0,1568,19,237,137,279,160,42,23,bench
89,14,book,15,1,1569,15,873,1239,2188,1461,1315,222,book
90,5,person,6,1,1570,68,1288,568,1853,1512,565,944,person
91,14,chair,15,0,1571,35,22,182,79,273,57,91,chair
92,15,chair,16,1,1571,41,75,200,165,274,90,74,chair
93,16,chair,17,1,1571,31,194,205,287,274,93,69,chair
94,16,chair,17,1,1572,16,782,490,851,606,69,116,chair
95,18,desk,19,1,1572,18,311,477,774,666,463,189,desk
96,1,person,2,1,20236,44,22,93,265,355,243,262,person
97,8,chair,9,0,22662,18,808,627,917,746,109,119,chair
98,9,table,10,0,22662,25,360,584,742,686,382,102,dining table
99,11,person,12,0,22662,36,581,490,725,595,144,105,person
100,12,chair,13,0,22662,16,493,599,611,677,118,78,chair
101,17,chair,18,1,22662,16,209,571,309,610,100,39,chair
102,18,table,19,0,22662,18,138,589,278,694,140,105,dining table
103,19,person,20,1,22662,47,0,508,193,703,193,195,person
104,6,person,7,0,22663,76,244,133,488,678,244,545,person
105,40,person,41,0,1634,58,205,174,255,311,50,137,person
106,41,person,42,0,1634,55,160,165,198,298,38,133,person
107,42,backpack,43,0,1634,20,212,194,235,234,23,40,backpack
108,9,person,10,0,1637,35,119,88,145,162,26,74,person
109,10,person,11,0,1637,26,151,96,170,162,19,66,person
110,11,person,12,1,1637,29,226,82,261,192,35,110,person
111,12,person,13,1,1637,33,213,94,244,213,31,119,person
112,6,sofa,7,1,1638,17,159,194,235,246,76,52,couch
113,10,table,11,1,1638,26,29,254,160,319,131,65,dining table
114,9,person,10,1,1640,27,1012,668,1099,1145,87,477,person
115,11,table,12,0,1642,24,189,124,289,212,100,88,dining table
116,11,person,12,0,1644,58,555,238,806,812,251,574,person
117,12,person,13,0,1644,50,390,299,564,868,174,569,person
118,6,person,7,1,1650,17,752,510,806,735,54,225,person
119,7,person,8,0,1650,75,555,474,785,1112,230,638,person
120,16,person,17,1,1652,121,1467,61,1961,1466,494,1405,person
121,17,person,18,1,1652,184,1198,254,1623,1463,425,1209,person
122,5,bench,6,0,1655,22,258,731,459,854,201,123,bench
123,9,bench,10,0,1662,16,180,161,223,206,43,45,bench
124,10,person,11,0,1662,31,188,122,220,169,32,47,person
125,3,person,4,0,1663,44,152,106,177,173,25,67,person
126,4,person,5,0,1663,52,118,104,147,199,29,95,person
127,11,person,12,0,1663,29,74,105,92,170,18,65,person
128,12,person,13,1,1663,25,107,103,121,169,14,66,person
129,13,person,14,0,1663,28,89,101,114,205,25,104,person
130,3,person,4,0,1664,40,126,183,159,296,33,113,person
131,4,person,5,0,1664,45,64,158,104,290,40,132,person
132,5,person,6,0,1664,41,23,133,62,270,39,137,person
133,9,person,10,0,1667,15,300,117,308,143,8,26,person
134,10,person,11,0,1667,22,352,109,366,154,14,45,person
135,15,sofa,16,1,1668,29,2,450,139,516,137,66,couch
136,3,chair,4,0,1673,28,144,172,229,232,85,60,chair
137,7,chair,8,0,1674,22,1113,595,1168,693,55,98,chair
138,3,window,4,0,1678,19,876,346,1084,662,208,316,window
139,4,window,5,0,1678,15,490,342,688,653,198,311,window
140,26,table,27,0,1678,115,79,715,356,1089,277,374,dining table
141,7,sofa,8,0,1682,22,106,188,160,232,54,44,couch
142,7,person,7,0,1684,58,216,244,291,498,75,254,person
143,6,person,7,1,1685,28,275,60,315,213,40,153,person
144,8,person,9,1,1685,46,240,40,296,229,56,189,person
145,18,chair,19,1,1688,44,1793,575,1926,831,133,256,chair
146,20,table,21,1,1688,37,1901,665,2198,987,297,322,dining table
147,0,person,1,0,1689,125,0,103,70,297,70,194,person
148,10,person,11,0,1689,44,160,131,182,227,22,96,person
149,11,person,12,0,1689,46,135,121,161,230,26,109,person
150,12,person,13,0,1689,41,105,133,133,252,28,119,person
151,13,person,14,0,1689,44,82,132,108,261,26,129,person
152,2,person,3,0,1691,50,153,34,199,223,46,189,person
153,11,person,12,1,1692,71,395,478,788,1465,393,987,person
154,12,person,13,1,1692,97,728,405,1140,1465,412,1060,person
155,17,person,18,1,1693,75,915,392,1300,1198,385,806,person
156,4,chair,5,0,1695,17,844,707,948,815,104,108,chair
157,3,person,4,1,1696,134,1381,182,1859,1645,478,1463,person
158,21,bench,22,0,1697,15,194,1233,1180,1645,986,412,bench
159,5,person,6,1,1700,38,1792,857,1952,1318,160,461,person
160,8,person,9,0,1700,31,590,883,651,1108,61,225,person
161,9,person,10,0,1700,26,649,867,720,1110,71,243,person
162,10,person,11,0,1700,33,1340,861,1415,1037,75,176,person
163,1,person,2,1,22676,97,763,3,2192,1463,1429,1460,person
164,2,book,3,0,22676,20,866,990,1490,1367,624,377,book
165,9,table,10,1,22678,42,283,459,563,682,280,223,dining table
166,10,person,11,1,22678,28,947,228,1023,682,76,454,person
167,11,person,12,1,22678,69,350,119,556,682,206,563,person
168,12,person,13,1,22678,50,130,172,301,534,171,362,person
169,13,bottle,14,0,22678,15,129,459,158,541,29,82,bottle
170,1,person,2,1,22679,52,66,234,480,682,414,448,person
171,2,person,3,1,22679,107,225,95,960,680,735,585,person
172,3,person,4,1,22679,52,596,246,1016,679,420,433,person
173,2,person,3,1,22680,57,387,66,1023,682,636,616,person
174,7,person,8,1,22681,70,352,270,727,680,375,410,person
175,8,person,9,1,22681,42,58,356,209,677,151,321,person
176,9,person,10,1,22681,25,2,341,97,681,95,340,person
177,2,bowl,3,0,22682,41,136,94,1136,747,1000,653,bowl
178,2,person,3,1,22683,52,24,300,324,955,300,655,person
179,3,person,4,1,22684,17,960,191,1023,362,63,171,person
180,4,person,5,1,22684,21,742,211,811,317,69,106,person
181,7,person,8,1,22684,28,551,201,625,306,74,105,person
182,8,person,9,1,22684,26,449,164,575,318,126,154,person
183,9,person,10,1,22684,45,307,244,449,685,142,441,person
184,10,person,11,1,22684,51,351,176,558,686,207,510,person
185,11,person,12,1,22684,97,447,116,836,685,389,569,person
186,12,person,13,1,22684,85,547,66,1023,684,476,618,person
187,10,door,11,0,22686,16,35,196,84,495,49,299,door
188,6,person,7,1,22687,59,695,150,1000,698,305,548,person
189,8,person,9,1,22687,37,586,330,739,749,153,419,person
190,10,person,11,1,22687,52,382,331,543,749,161,418,person
191,11,person,12,1,22687,48,279,328,395,748,116,420,person
192,12,person,13,1,22687,48,0,147,204,749,204,602,person
193,13,person,14,1,22687,56,105,283,211,750,106,467,person
194,14,person,15,1,22687,45,151,398,233,748,82,350,person
195,3,person,4,1,22689,105,2,279,963,682,961,403,person
196,4,person,5,1,22689,41,92,398,451,682,359,284,person
197,7,chair,8,1,22690,15,580,386,616,449,36,63,chair
198,8,chair,9,1,22690,34,584,487,702,679,118,192,chair
199,9,person,10,1,22690,44,500,365,608,512,108,147,person
200,10,person,11,1,22690,48,558,355,707,589,149,234,person
201,11,person,12,1,22690,83,328,154,498,463,170,309,person
202,12,person,13,1,22690,49,196,242,304,391,108,149,person
203,13,person,14,1,22690,58,1,154,65,531,64,377,person
204,14,person,15,0,22690,112,24,203,268,690,244,487,person
205,15,table,16,0,22690,51,134,373,582,768,448,395,dining table
206,20,bowl,21,0,22690,20,305,428,380,495,75,67,bowl
207,21,bottle,22,0,22690,23,242,350,282,428,40,78,bottle
208,6,person,7,1,1701,49,2,88,150,338,148,250,person
209,9,person,10,1,1701,43,220,118,265,281,45,163,person
210,10,person,11,0,1701,55,232,129,297,301,65,172,person
211,3,chair,4,0,1702,28,1781,520,2150,1094,369,574,chair
212,6,table,7,0,1702,17,1822,255,2194,612,372,357,dining table
213,13,person,14,1,1702,37,538,787,1434,1466,896,679,person
214,30,vase,31,1,1702,15,2034,184,2092,278,58,94,vase
215,34,bottle,35,1,1702,16,1918,1245,2005,1323,87,78,bottle
216,36,bowl,37,0,1702,23,355,1127,456,1249,101,122,bowl
217,43,bowl,44,0,1702,19,1914,253,1955,302,41,49,bowl
218,3,person,4,1,1703,46,118,105,262,224,144,119,person
219,4,person,5,1,1703,41,80,57,172,223,92,166,person
220,5,person,6,1,1703,37,2,47,85,255,83,208,person
221,6,person,7,1,1703,24,254,129,367,274,113,145,person
222,5,person,6,1,1704,34,113,71,178,240,65,169,person
223,6,person,7,1,1704,30,82,181,162,335,80,154,person
224,7,person,8,1,1704,23,165,190,230,333,65,143,person
225,8,person,9,1,1704,34,65,263,235,402,170,139,person
226,9,person,10,1,1704,35,180,64,243,258,63,194,person
227,10,person,11,0,1704,33,224,81,288,344,64,263,person
228,4,person,5,0,1705,78,19,50,136,344,117,294,person
229,3,person,3,1,1706,56,0,22,350,531,350,509,person
230,6,table,6,1,1706,15,84,0,261,102,177,102,dining table
231,7,person,8,1,1707,39,53,141,183,326,130,185,person
232,9,person,10,1,1707,53,273,55,405,327,132,272,person
233,5,person,6,0,1708,63,72,6,180,322,108,316,person
234,8,person,9,1,1708,46,273,80,435,331,162,251,person
235,10,person,11,1,1708,32,397,56,470,282,73,226,person
236,12,person,13,0,1708,42,539,71,648,326,109,255,person
237,6,person,7,1,1709,34,287,86,372,374,85,288,person
238,7,person,8,1,1709,60,207,32,478,374,271,342,person
239,9,person,10,1,1710,53,372,1,589,423,217,422,person
240,2,person,3,1,1711,28,0,161,142,374,142,213,person
241,5,person,6,1,1711,31,190,0,317,236,127,236,person
242,7,person,8,0,1711,31,312,1,429,194,117,193,person
243,8,person,9,1,1711,28,423,55,500,338,77,283,person
244,11,person,12,1,1711,65,220,73,433,374,213,301,person
245,4,person,5,1,1712,41,46,160,351,749,305,589,person
246,8,chair,9,1,1712,18,81,577,156,749,75,172,chair
247,0,bottle,1,0,1713,20,958,753,1020,941,62,188,bottle
248,2,person,3,1,1713,39,1160,438,1570,1074,410,636,person
249,5,window,6,0,1713,15,973,1,1516,841,543,840,window
250,9,person,10,1,1713,24,196,484,506,836,310,352,person
251,10,person,11,1,1713,46,48,776,942,1647,894,871,person
252,11,person,12,1,1713,29,54,804,657,1519,603,715,person
253,13,person,14,1,1713,30,1467,692,1837,1172,370,480,person
254,14,person,15,1,1713,39,1592,509,2195,1413,603,904,person
255,65,bottle,66,0,1713,20,1180,921,1270,1154,90,233,bottle
256,68,glasses,69,0,1713,33,1207,1202,1311,1246,104,44,eye glasses
257,1,person,2,1,22692,49,2,2,518,773,516,771,person
258,2,person,3,1,22692,51,342,163,658,664,316,501,person
259,4,person,5,1,22692,27,532,2,678,530,146,528,person
260,5,person,6,1,22692,17,334,2,480,188,146,186,person
261,7,bottle,8,0,22692,15,570,388,656,639,86,251,bottle
262,8,scissors,9,0,22692,15,516,682,655,767,139,85,scissors
263,14,person,15,1,22692,22,392,1,579,173,187,172,person
264,0,table,1,0,22693,74,320,409,995,1023,675,614,dining table
265,1,person,2,1,22693,120,0,0,568,1022,568,1022,person
266,2,person,3,1,22693,102,218,33,731,912,513,879,person
267,7,bottle,8,0,22693,20,836,874,942,1023,106,149,bottle
268,9,scissors,10,1,22693,19,703,826,823,929,120,103,scissors
269,4,person,5,0,22694,44,84,599,498,1702,414,1103,person
270,5,person,6,1,22694,36,596,533,998,1887,402,1354,person
271,19,clock,20,1,15,29,82,393,158,499,76,106,clock
272,24,person,25,1,15,111,16,443,146,867,130,424,person
273,71,person,72,1,15,171,334,261,599,998,265,737,person
274,85,glasses,86,0,15,29,452,582,544,648,92,66,eye glasses
275,87,person,88,1,15,91,122,233,394,997,272,764,person
276,1,chair,2,1,16,16,686,416,835,613,149,197,chair
277,2,person,3,0,16,51,508,68,838,612,330,544,person
278,14,person,15,1,16,89,2,36,381,613,379,577,person
279,2,person,3,0,1714,62,72,115,173,273,101,158,person
280,0,person,1,1,1715,59,17,1,223,437,206,436,person
281,13,chair,14,1,1716,20,94,216,176,333,82,117,chair
282,16,person,17,1,1716,57,197,95,316,374,119,279,person
283,19,chair,20,1,1717,19,262,174,299,224,37,50,chair
284,0,person,1,1,1718,53,52,25,168,275,116,250,person
285,2,person,3,1,1719,17,23,25,59,85,36,60,person
286,3,person,4,1,1719,42,0,98,134,270,134,172,person
287,1,person,2,1,1720,35,142,46,195,156,53,110,person
288,7,person,8,1,1721,59,85,44,221,248,136,204,person
289,10,table,11,0,1721,17,277,60,399,207,122,147,dining table
290,3,person,4,0,1723,82,17,34,97,349,80,315,person
291,0,person,1,1,1724,94,10,9,417,492,407,483,person
292,3,table,3,0,1725,19,109,205,181,260,72,55,dining table
293,6,person,6,1,1725,16,145,161,166,197,21,36,person
294,1,person,2,0,1726,63,4,107,147,333,143,226,person
295,1,chair,2,0,1727,22,76,50,135,140,59,90,chair
296,4,person,5,0,1727,67,114,32,268,200,154,168,person
297,5,chair,6,0,1727,28,207,73,294,200,87,127,chair
298,2,person,3,0,1728,37,277,55,309,109,32,54,person
299,5,person,6,1,1728,21,109,93,140,137,31,44,person
300,6,person,7,0,1728,44,134,92,197,199,63,107,person
301,7,person,8,1,1728,39,60,54,115,161,55,107,person
302,8,person,9,0,1728,56,4,58,132,200,128,142,person
303,7,chair,8,0,1729,17,206,168,238,226,32,58,chair
304,1,person,2,1,1730,60,0,18,163,255,163,237,person
305,5,person,6,1,1730,43,30,69,116,131,86,62,person
306,6,person,7,1,1730,28,62,57,92,142,30,85,person
307,15,person,16,1,1731,65,97,58,197,200,100,142,person
308,0,person,1,0,1732,71,203,247,347,694,144,447,person
309,0,person,1,1,1734,103,2,8,279,226,277,218,person
310,0,person,1,1,1735,46,251,58,393,250,142,192,person
311,1,table,2,0,1735,15,251,233,477,324,226,91,dining table
312,4,potters wheel,5,0,1736,24,107,456,410,681,303,225,potted plant
313,5,potters wheel,6,0,1736,28,277,343,495,552,218,209,potted plant
314,6,potters wheel,7,0,1736,21,416,273,549,429,133,156,potted plant
315,8,potters wheel,9,0,1736,26,544,429,862,680,318,251,potted plant
316,9,potters wheel,10,0,1736,21,611,310,760,429,149,119,potted plant
317,17,person,18,0,1736,42,564,147,662,432,98,285,person
318,18,person,19,1,1736,29,2,317,228,582,226,265,person
319,19,person,20,1,1736,32,241,263,460,434,219,171,person
320,20,person,21,1,1736,20,347,204,468,306,121,102,person
321,21,person,22,1,1736,18,436,162,519,255,83,93,person
322,23,person,24,1,1736,15,879,118,921,235,42,117,person
323,31,person,31,1,1736,77,725,188,921,613,196,425,person
324,32,person,32,1,1736,35,727,240,780,367,53,127,person
325,33,person,33,1,1736,33,708,162,774,273,66,111,person
326,34,person,34,1,1736,25,687,186,753,242,66,56,person
327,36,bowl,36,1,1736,21,411,379,483,419,72,40,bowl
328,44,pot,44,1,1736,16,250,183,275,233,25,50,potted plant
329,6,table,7,1,1738,15,2,167,219,354,217,187,dining table
330,7,table,8,1,1738,16,196,177,450,297,254,120,dining table
331,14,chair,15,1,1738,16,373,137,435,187,62,50,chair
332,15,table,16,0,1738,16,236,119,290,168,54,49,dining table
333,15,book,16,0,1739,20,181,263,278,300,97,37,book
334,7,table,8,0,1740,16,677,318,752,403,75,85,dining table
335,12,person,13,0,1740,42,633,143,730,381,97,238,person
336,13,person,14,0,1740,37,471,139,528,333,57,194,person
337,14,person,15,0,1740,43,311,149,380,331,69,182,person
338,15,person,16,0,1740,47,110,141,203,322,93,181,person
339,18,person,17,1,1741,54,951,249,1455,1191,504,942,person
340,0,person,1,1,1742,28,150,163,286,310,136,147,person
341,5,person,6,1,1742,17,142,140,175,187,33,47,person
342,7,person,8,1,1742,29,58,152,120,239,62,87,person
343,9,person,10,1,1742,48,161,85,297,233,136,148,person
344,10,person,11,1,1742,35,304,91,376,235,72,144,person
345,11,person,12,1,1742,35,323,147,477,310,154,163,person
346,0,person,1,1,1743,52,122,33,197,233,75,200,person
347,1,person,2,0,1743,77,34,13,151,225,117,212,person
348,8,sofa,9,1,1744,20,206,166,248,313,42,147,couch
349,0,person,1,1,1745,68,1,12,250,265,249,253,person
350,7,table,8,1,1745,15,113,143,396,264,283,121,dining table
351,15,person,16,1,1746,18,552,116,587,161,35,45,person
352,16,person,17,1,1746,37,129,167,167,408,38,241,person
353,17,person,18,1,1746,51,2,224,141,474,139,250,person
354,18,person,19,1,1746,48,142,253,373,474,231,221,person
355,7,person,8,1,1747,73,0,38,158,232,158,194,person
356,24,table,25,1,1748,18,165,308,276,418,111,110,dining table
357,4,person,5,1,1749,28,74,97,137,169,63,72,person
358,0,person,1,1,1750,76,30,57,287,498,257,441,person
359,0,person,1,1,1751,31,225,53,311,215,86,162,person
360,6,table,7,0,1751,18,123,137,239,213,116,76,dining table
361,4,sofa,5,0,1752,22,144,158,234,219,90,61,couch
362,6,table,7,0,1752,41,18,173,81,255,63,82,dining table
363,1,person,2,1,1753,52,86,0,236,211,150,211,person
364,4,person,5,1,1753,51,257,0,449,300,192,300,person
365,5,person,6,1,1753,34,318,46,434,241,116,195,person
366,8,plate,9,0,1753,19,114,234,299,293,185,59,plate
367,0,person,1,1,1754,66,47,11,248,223,201,212,person
368,1,chair,2,1,1754,33,220,83,284,223,64,140,chair
369,2,chair,3,1,1754,24,223,11,278,93,55,82,chair
370,8,table,9,1,1755,20,191,225,266,294,75,69,dining table
371,9,chair,10,0,1755,21,35,234,123,294,88,60,chair
372,0,person,1,0,1756,44,84,127,162,235,78,108,person
373,1,table,2,0,1756,18,3,214,199,322,196,108,dining table
374,0,person,1,1,1758,57,116,58,265,337,149,279,person
375,9,table,10,1,1759,17,119,228,252,281,133,53,dining table
376,11,chair,12,1,1759,17,43,198,165,281,122,83,chair
377,14,table,15,1,1759,15,80,170,126,223,46,53,dining table
378,0,person,1,0,1760,63,301,8,390,289,89,281,person
379,1,person,2,1,1760,23,48,132,114,220,66,88,person
380,12,chair,13,1,1760,18,114,146,154,199,40,53,chair
381,19,person,20,1,1761,50,504,86,599,333,95,247,person
382,0,person,1,1,1762,66,82,11,199,321,117,310,person
383,0,person,1,1,1763,50,11,139,130,300,119,161,person
384,5,scissors,6,0,1763,25,96,172,110,203,14,31,scissors
385,18,window,19,1,1763,46,0,126,78,228,78,102,window
386,0,person,1,0,1764,72,177,50,510,767,333,717,person
387,1,dog,2,1,1764,37,182,498,449,767,267,269,dog
388,5,table,6,0,1765,17,266,111,385,209,119,98,dining table
389,13,chair,14,0,1765,26,119,116,201,209,82,93,chair
390,4,person,5,1,1766,45,39,141,127,287,88,146,person
391,7,dog,8,0,1766,34,113,342,275,404,162,62,dog
392,0,person,1,1,1767,61,59,22,165,135,106,113,person
393,1,person,2,1,1767,49,189,24,319,240,130,216,person
394,3,table,4,0,1767,17,27,42,200,137,173,95,dining table
395,4,person,5,1,1767,22,0,0,39,115,39,115,person
396,8,chair,9,1,1767,29,167,79,213,126,46,47,chair
397,8,person,9,1,1768,31,1063,296,1204,857,141,561,person
398,9,person,10,1,1768,68,181,150,712,1198,531,1048,person
399,3,person,4,0,1770,35,121,38,137,95,16,57,person
400,5,person,6,0,1770,26,166,37,183,102,17,65,person
401,9,person,10,1,1770,21,177,53,201,103,24,50,person
402,11,person,12,1,1770,35,228,72,261,197,33,125,person
403,14,person,15,1,1770,29,188,110,240,199,52,89,person
404,18,person,19,1,1770,40,69,92,126,208,57,116,person
405,20,person,21,1,1770,42,7,89,86,209,79,120,person
406,21,person,22,1,1770,22,64,43,77,103,13,60,person
407,2,person,3,1,1772,43,61,38,208,234,147,196,person
408,3,chair,4,1,1772,25,58,89,136,351,78,262,chair
409,5,person,6,1,1772,62,129,52,403,359,274,307,person
410,8,hat,9,0,1772,23,72,36,156,80,84,44,hat
411,3,person,4,1,1773,41,4,36,96,227,92,191,person
412,8,person,9,1,1773,70,276,55,418,292,142,237,person
413,8,person,9,0,1774,74,81,7,222,186,141,179,person
414,4,table,5,1,1777,44,203,206,308,304,105,98,dining table
415,7,person,8,0,1777,46,170,127,229,292,59,165,person
416,8,person,9,1,1777,36,72,111,127,240,55,129,person
417,9,person,10,1,1777,32,324,16,450,337,126,321,person
418,10,chair,11,1,1777,33,252,220,344,337,92,117,chair
419,11,chair,12,1,1777,23,150,195,184,277,34,82,chair
420,17,person,18,1,1777,16,31,90,57,208,26,118,person
421,18,table,19,1,1777,31,10,214,144,337,134,123,dining table
422,0,person,1,0,1778,56,129,18,309,251,180,233,person
423,6,sofa,7,1,1780,19,35,132,196,252,161,120,couch
424,7,chair,8,0,1780,31,81,162,167,301,86,139,chair
425,0,table,1,0,1781,25,45,126,210,222,165,96,dining table
426,6,table,7,1,1781,15,0,110,37,148,37,38,dining table
427,16,chair,17,1,1781,21,91,148,136,200,45,52,chair
428,6,person,7,1,1782,32,107,48,177,257,70,209,person
429,20,window,21,1,1782,19,160,0,224,152,64,152,window
430,8,person,9,1,1783,33,2,378,315,647,313,269,person
431,12,bottle,13,0,1783,15,370,486,408,599,38,113,bottle
432,13,person,14,1,1783,20,374,187,484,475,110,288,person
433,17,person,18,1,1783,19,293,119,363,230,70,111,person
434,18,person,19,1,1783,36,115,213,222,397,107,184,person
435,21,person,22,1,1783,39,159,173,270,334,111,161,person
436,25,chair,26,0,1783,20,384,168,428,239,44,71,chair
437,22,person,23,1,1784,40,595,1194,1114,1800,519,606,person
438,12,table,13,1,1785,32,1071,939,1368,1254,297,315,dining table
439,16,table,17,1,1785,17,2087,868,2199,1339,112,471,dining table
440,17,table,18,0,1785,29,156,898,398,1273,242,375,dining table
441,18,table,19,0,1785,37,26,1007,320,1460,294,453,dining table
442,19,table,20,1,1785,17,38,864,227,974,189,110,dining table
443,86,door,85,0,1785,26,1520,424,1824,1244,304,820,door
444,3,table,4,1,1786,44,801,750,1517,1479,716,729,dining table
445,12,table,13,1,1786,28,1068,1024,2042,1534,974,510,dining table
446,16,person,17,1,1786,85,477,367,1324,1532,847,1165,person
447,5,person,6,1,1787,65,161,506,894,1530,733,1024,person
448,6,chair,7,1,1787,41,293,1101,870,1534,577,433,chair
449,8,clock,9,0,1787,15,102,455,231,579,129,124,clock
450,10,person,11,1,1788,50,139,53,170,170,31,117,person
451,11,table,12,1,1788,16,138,119,185,202,47,83,dining table
452,16,person,17,1,1788,53,16,61,89,167,73,106,person
453,17,person,18,1,1788,39,77,112,136,179,59,67,person
454,19,person,20,0,1788,69,201,11,249,141,48,130,person
455,20,person,21,0,1788,62,251,15,305,145,54,130,person
456,30,sofa,31,1,1789,56,143,657,751,970,608,313,couch
457,37,table,38,1,1789,41,1762,780,2080,986,318,206,dining table
458,39,chair,40,1,1789,32,1907,843,2092,1004,185,161,chair
459,51,chair,51,0,1789,64,291,909,726,1647,435,738,chair
460,64,chair,64,0,1789,86,673,927,1114,1645,441,718,chair
461,80,chair,80,1,1789,45,145,836,377,1500,232,664,chair
462,81,chair,81,1,1789,19,1052,655,1172,923,120,268,chair
463,11,table,12,1,1790,62,557,1078,1897,1648,1340,570,dining table
464,14,bowl,15,0,1790,15,960,1059,1072,1173,112,114,bowl
465,17,bottle,18,0,1790,17,1488,907,1595,1158,107,251,bottle
466,21,chair,22,1,1790,24,915,1072,1330,1504,415,432,chair
467,27,bottle,28,0,1790,18,1835,812,1897,1019,62,207,bottle
468,44,person,45,0,1791,45,1087,643,1193,1048,106,405,person
469,45,person,46,0,1791,56,821,630,958,1056,137,426,person
470,46,person,47,1,1791,28,505,658,591,842,86,184,person
471,48,chair,49,0,1791,40,1453,1033,1811,1532,358,499,chair
472,54,person,55,0,1791,53,132,751,326,1350,194,599,person
473,55,person,56,1,1791,26,88,675,197,880,109,205,person
474,56,person,57,1,1791,23,297,672,387,829,90,157,person
475,57,person,58,1,1791,26,402,674,501,822,99,148,person
476,58,person,59,1,1791,30,1365,620,1458,878,93,258,person
477,59,person,60,1,1791,32,1436,610,1529,847,93,237,person
478,4,sofa,5,1,1792,18,571,571,1019,766,448,195,couch
479,13,chair,14,1,1792,27,216,406,313,571,97,165,chair
480,4,window,5,0,1794,79,408,1,2197,1312,1789,1311,window
481,7,table,8,1,1794,63,646,1039,1948,1649,1302,610,dining table
482,26,table,27,1,1794,59,0,940,1029,1302,1029,362,dining table
483,34,window,35,0,1795,17,1034,252,1463,488,429,236,window
484,50,person,51,1,1795,49,1545,363,1728,538,183,175,person
485,51,person,52,0,1795,35,1259,387,1287,489,28,102,person
486,52,person,53,1,1795,17,1222,405,1238,489,16,84,person
487,53,chair,54,1,1795,19,1232,465,1273,549,41,84,chair
488,61,chair,62,1,1795,38,1,637,241,878,240,241,chair
489,3,person,4,0,1796,71,335,159,624,970,289,811,person
490,7,window,8,1,1797,31,731,81,1169,554,438,473,window
491,19,chair,20,1,1797,21,0,522,109,718,109,196,chair
492,20,chair,21,0,1797,29,107,518,228,704,121,186,chair
493,21,table,22,0,1797,16,2,522,214,726,212,204,dining table
494,23,table,24,1,1797,24,386,502,678,651,292,149,dining table
495,28,table,29,0,1797,50,484,529,792,781,308,252,dining table
496,29,table,30,0,1797,38,694,592,1174,799,480,207,dining table
497,12,chair,13,1,1798,15,282,740,383,933,101,193,chair
498,13,window,14,0,1798,20,190,410,614,833,424,423,window
499,21,table,22,1,1798,18,1232,700,1786,1033,554,333,dining table
500,22,table,23,0,1798,39,1344,756,2046,1345,702,589,dining table
501,15,table,16,0,1799,51,1530,577,2021,1482,491,905,dining table
502,4,person,5,0,1800,31,813,489,899,919,86,430,person
503,5,person,6,1,1800,29,36,517,109,801,73,284,person
504,6,person,7,1,1800,18,23,515,75,804,52,289,person
505,7,person,8,1,1800,21,2,461,59,852,57,391,person
506,8,person,9,0,1800,41,388,394,500,890,112,496,person
507,9,person,10,1,1800,21,255,1063,888,1198,633,135,person
508,22,chair,23,0,1801,54,809,513,1298,986,489,473,chair
509,23,person,24,1,1801,109,907,259,1309,1027,402,768,person
510,24,table,25,0,1801,72,961,588,1346,1132,385,544,dining table
511,29,person,30,1,1802,52,512,268,602,503,90,235,person
512,30,person,31,0,1802,81,693,295,860,666,167,371,person
513,31,person,32,0,1802,72,208,279,341,543,133,264,person
514,38,chair,39,1,20243,44,2,685,213,1100,211,415,chair
515,4,table,5,1,20244,24,881,845,1184,1128,303,283,dining table
516,5,chair,6,1,20244,35,816,977,1167,1532,351,555,chair
517,19,person,20,0,20245,43,226,758,325,1089,99,331,person
518,20,bed,21,1,20245,53,602,922,1159,1286,557,364,bed
519,31,hat,32,1,20245,18,1510,409,1698,606,188,197,hat
520,32,table,33,0,20245,34,1151,1155,2200,1623,1049,468,dining table
521,42,pot,43,0,20245,15,1969,1155,2042,1235,73,80,potted plant
522,43,glasses,44,0,20245,26,1418,1135,1510,1196,92,61,eye glasses
523,45,chair,46,1,20245,16,104,923,192,1109,88,186,chair
524,46,chair,47,1,20245,17,4,926,105,1116,101,190,chair
525,10,table,11,0,20246,27,0,471,444,798,444,327,dining table
526,16,bottle,17,1,20246,15,1489,101,1574,421,85,320,bottle
527,18,bottle,19,0,20246,15,1439,139,1511,397,72,258,bottle
528,20,bottle,21,1,20246,16,1369,182,1438,345,69,163,bottle
529,48,chair,49,0,20246,22,888,523,1099,809,211,286,chair
530,50,table,51,1,20246,15,665,549,893,702,228,153,dining table
531,51,clock,52,0,20246,16,805,144,877,215,72,71,clock
532,54,chair,55,1,20246,15,548,557,835,806,287,249,chair
533,23,window,24,0,20247,63,1149,398,1954,640,805,242,window
534,24,vase,25,1,20247,15,1844,488,1953,569,109,81,vase
535,30,table,31,0,20247,15,1211,705,1954,1215,743,510,dining table
536,32,table,33,1,20247,25,1011,684,1354,1241,343,557,dining table
537,33,chair,34,0,20247,37,860,763,1136,1304,276,541,chair
538,36,bowl,37,0,20247,15,1663,619,1788,694,125,75,bowl
539,54,person,55,0,20247,77,466,520,1002,1366,536,846,person
540,55,table,56,0,20247,25,6,845,789,1363,783,518,dining table
541,69,window,70,0,20247,46,225,203,724,776,499,573,window
542,70,window,71,0,20247,21,694,353,981,659,287,306,window
543,4,person,5,1,22695,31,877,398,1016,592,139,194,person
544,3,person,4,1,22697,73,24,30,671,654,647,624,person
545,12,chair,13,1,22697,15,3,3,140,367,137,364,chair
546,13,chair,14,1,22697,26,93,78,363,324,270,246,chair
547,14,chair,15,1,22697,33,430,270,640,518,210,248,chair
548,5,person,6,1,22698,45,294,165,597,681,303,516,person
549,4,person,5,1,22699,69,333,150,626,513,293,363,person
550,5,person,6,0,22699,69,538,44,1023,683,485,639,person
551,6,person,7,0,22699,40,837,2,1023,345,186,343,person
552,9,scissors,10,0,22699,18,185,401,278,421,93,20,scissors
553,12,scissors,13,0,22699,21,582,545,647,592,65,47,scissors
554,2,person,3,0,22700,137,2,113,888,680,886,567,person
555,7,bottle,8,1,22700,28,803,173,901,342,98,169,bottle
556,8,bowl,9,0,22700,16,768,368,842,448,74,80,bowl
557,9,bowl,10,1,22700,16,758,334,846,397,88,63,bowl
558,10,bowl,11,0,22700,15,865,333,952,452,87,119,bowl
559,2,person,3,1,22701,36,321,176,654,683,333,507,person
560,9,chair,10,1,22701,18,655,454,846,681,191,227,chair
561,2,person,3,0,22703,58,1450,818,1648,1403,198,585,person
562,3,chair,4,0,22703,90,1399,1221,1649,1727,250,506,chair
563,7,table,8,0,22704,25,5,550,499,747,494,197,dining table
564,8,person,9,0,22704,111,255,171,444,579,189,408,person
565,1,person,2,1,22706,56,475,5,1022,1022,547,1017,person
566,2,person,3,1,22706,52,0,2,271,1022,271,1020,person
567,3,table,4,0,1806,39,122,462,314,588,192,126,dining table
568,11,person,12,1,1806,20,381,407,418,440,37,33,person
569,12,person,13,1,1806,26,285,415,333,466,48,51,person
570,18,table,19,0,1806,48,416,435,762,647,346,212,dining table
571,26,table,27,1,1806,19,315,435,404,495,89,60,dining table
572,27,chair,28,1,1806,17,391,430,426,492,35,62,chair
573,28,chair,29,1,1806,19,326,439,373,497,47,58,chair
574,2,table,3,0,1808,29,38,177,236,244,198,67,dining table
575,3,table,4,1,1808,18,296,178,398,243,102,65,dining table
576,22,window,23,1,1808,22,14,71,78,176,64,105,window
577,4,chair,5,0,1810,24,560,486,672,669,112,183,chair
578,6,sofa,7,1,1810,27,244,510,512,580,268,70,couch
579,8,sofa,9,1,1810,43,72,546,382,810,310,264,couch
580,9,person,10,1,1810,44,354,464,488,575,134,111,person
581,10,person,11,1,1810,37,83,494,289,599,206,105,person
582,22,bicycle,23,0,1810,28,881,448,933,513,52,65,bicycle
583,23,person,24,1,1810,16,892,427,911,495,19,68,person
584,26,person,27,1,1811,60,0,75,199,379,199,304,person
585,8,sofa,9,0,1813,28,479,192,699,383,220,191,couch
586,13,television,14,0,1813,17,169,160,236,283,67,123,tv
587,20,chair,21,0,1813,43,13,248,199,506,186,258,chair
588,10,window,11,0,1814,18,280,69,383,320,103,251,window
589,10,bed,11,1,1816,45,2,461,779,1197,777,736,bed
590,10,person,11,1,1817,26,74,47,118,173,44,126,person
591,17,chair,18,0,1817,22,166,354,204,397,38,43,chair
592,18,chair,19,0,1817,20,136,353,166,396,30,43,chair
593,12,person,13,0,1819,45,355,430,435,652,80,222,person
594,13,person,14,0,1819,59,249,419,333,654,84,235,person
595,8,sofa,9,0,1820,20,236,195,383,269,147,74,couch
596,23,chair,24,0,1820,18,401,174,439,213,38,39,chair
597,44,chair,45,0,1821,15,203,179,237,229,34,50,chair
598,3,person,4,1,1822,43,211,70,284,319,73,249,person
599,18,chair,19,0,1823,19,252,314,364,404,112,90,chair
600,4,vase,5,0,1824,27,59,187,135,376,76,189,vase
601,13,chair,14,1,1825,16,207,273,227,316,20,43,chair
602,14,table,15,0,1825,21,35,277,219,393,184,116,dining table
603,15,chair,16,1,1825,17,191,283,218,335,27,52,chair
604,16,chair,17,1,1825,20,159,291,197,352,38,61,chair
605,17,chair,18,0,1825,23,112,301,165,381,53,80,chair
606,18,chair,19,0,1825,40,9,318,86,425,77,107,chair
607,12,sofa,13,0,1827,21,140,110,209,148,69,38,couch
608,33,chair,34,0,1828,46,1157,943,1300,1220,143,277,chair
609,34,chair,35,0,1828,58,964,957,1117,1250,153,293,chair
610,107,bowl,108,0,1828,15,1140,873,1160,903,20,30,bowl
611,6,sofa,7,0,1829,42,370,220,575,377,205,157,couch
612,14,window,15,1,1829,15,535,1,603,198,68,197,window
613,22,chair,23,0,1829,38,140,242,274,371,134,129,chair
614,14,chair,15,0,1834,35,382,144,513,273,131,129,chair
615,15,chair,16,0,1834,55,103,147,313,354,210,207,chair
616,23,bed,24,1,1834,22,514,183,619,412,105,229,bed
617,12,chair,13,0,1835,20,117,332,156,374,39,42,chair
618,13,chair,14,0,1835,24,0,328,59,391,59,63,chair
619,3,person,4,1,22708,33,535,240,653,495,118,255,person
620,4,person,5,1,22708,40,420,245,648,686,228,441,person
621,6,person,7,1,22708,17,327,207,359,306,32,99,person
622,7,person,8,1,22708,64,116,166,423,686,307,520,person
623,2,door,3,0,22709,17,0,194,23,509,23,315,door
624,14,window,15,0,22709,18,432,231,453,319,21,88,window
625,20,bed,21,0,22709,46,459,320,799,533,340,213,bed
626,23,table,24,0,22709,21,551,309,639,345,88,36,dining table
627,12,sofa,13,0,22710,25,79,319,718,599,639,280,couch
628,13,sofa,14,1,22710,15,183,280,437,331,254,51,couch
629,17,vase,18,0,22710,23,514,542,623,599,109,57,vase
630,20,vase,21,0,22710,19,123,399,177,466,54,67,vase
631,26,chair,27,1,22710,23,640,293,681,471,41,178,chair
632,27,chair,28,0,22710,44,674,306,734,505,60,199,chair
633,28,chair,29,1,22710,36,714,324,782,569,68,245,chair
634,29,chair,30,1,22710,29,754,354,800,600,46,246,chair
635,16,table,17,0,22712,26,694,352,788,418,94,66,dining table
636,19,chair,20,1,22712,19,808,324,856,369,48,45,chair
637,20,chair,21,1,22712,24,772,355,836,413,64,58,chair
638,21,chair,22,1,22712,21,800,368,868,418,68,50,chair
639,22,chair,23,1,22712,22,679,362,732,424,53,62,chair
640,25,chair,26,1,22712,22,616,312,672,375,56,63,chair
641,27,ball,28,0,22712,20,299,376,383,459,84,83,sports ball
642,29,ball,30,0,22712,19,448,328,516,393,68,65,sports ball
643,30,chair,31,0,22712,23,208,371,260,422,52,51,chair
644,31,ball,32,1,22712,20,588,354,653,404,65,50,sports ball
645,35,chair,36,0,22712,42,1,399,115,494,114,95,chair
646,37,chair,38,1,22712,16,13,335,63,377,50,42,chair
647,38,person,39,1,22712,24,262,307,298,366,36,59,person
648,39,person,40,0,22712,38,202,265,238,379,36,114,person
649,40,person,41,0,22712,26,375,272,401,342,26,70,person
650,43,person,44,1,22712,19,463,306,496,331,33,25,person
651,2,person,3,1,22713,46,705,1,1024,768,319,767,person
652,4,person,5,0,22713,74,133,263,253,599,120,336,person
653,5,person,6,1,22713,55,327,264,404,594,77,330,person
654,6,person,7,0,22713,68,367,228,490,693,123,465,person
655,8,person,9,1,22713,40,471,278,538,621,67,343,person
656,9,person,10,1,22713,56,485,199,639,752,154,553,person
657,10,table,11,0,22714,31,371,284,501,433,130,149,dining table
658,17,chair,18,1,22714,16,370,246,410,292,40,46,chair
659,18,chair,19,1,22714,21,338,258,371,371,33,113,chair
660,19,chair,20,1,22714,45,350,268,436,415,86,147,chair
661,20,chair,21,0,22714,60,436,287,564,465,128,178,chair
662,22,chair,23,1,22714,20,505,257,546,297,41,40,chair
663,23,chair,24,0,22714,38,234,263,273,322,39,59,chair
664,2,sofa,3,0,22715,65,124,169,543,375,419,206,couch
665,9,vase,10,0,22715,18,270,251,311,280,41,29,vase
666,18,window,19,0,22715,43,83,1,484,199,401,198,window
667,19,window,20,0,22715,21,520,0,719,199,199,199,window
668,5,chair,6,0,22717,70,658,552,833,783,175,231,chair
669,12,television,13,0,22717,17,599,415,704,503,105,88,tv
670,15,sofa,16,0,22717,42,325,455,461,612,136,157,couch
671,24,cat,25,1,22717,25,643,609,694,667,51,58,cat
672,29,sofa,30,1,22717,20,94,458,173,569,79,111,couch
673,30,sofa,31,0,22717,30,1,504,194,738,193,234,couch
674,2,window,3,0,1978,25,496,175,799,339,303,164,window
675,6,table,7,0,1978,27,86,303,551,489,465,186,dining table
676,6,desk,7,0,1980,22,1,772,707,1276,706,504,desk
677,13,table,14,0,1980,45,634,888,2129,1400,1495,512,dining table
678,32,table,33,1,1980,57,54,739,2020,996,1966,257,dining table
679,29,table,30,1,1987,15,0,249,207,331,207,82,dining table
680,32,chair,33,1,1987,17,0,298,44,427,44,129,chair
681,11,table,12,0,1989,15,206,132,252,150,46,18,dining table
682,0,chair,1,0,1997,22,175,497,275,705,100,208,chair
683,14,chair,13,0,1997,20,350,487,442,678,92,191,chair
684,22,chair,21,0,1997,25,430,479,525,670,95,191,chair
685,23,chair,22,0,1997,22,577,466,669,644,92,178,chair
686,24,chair,23,0,1997,22,266,491,359,696,93,205,chair
687,25,chair,24,0,1997,24,77,505,178,722,101,217,chair
688,27,chair,26,0,1997,26,846,447,945,601,99,154,chair
689,28,chair,27,1,1997,23,796,416,859,549,63,133,chair
690,29,chair,28,0,1997,25,908,444,993,591,85,147,chair
691,30,chair,29,0,1997,23,954,439,1035,585,81,146,chair
692,31,chair,30,0,1997,25,643,463,732,636,89,173,chair
693,32,chair,31,0,1997,26,504,472,593,661,89,189,chair
694,3,table,4,0,1998,17,669,1182,2198,1466,1529,284,dining table
695,4,desk,5,0,1999,16,146,822,553,960,407,138,desk
696,3,chair,4,0,2001,17,453,569,631,763,178,194,chair
697,8,chair,9,0,2001,15,390,555,515,720,125,165,chair
698,10,chair,11,0,2001,21,318,542,432,716,114,174,chair
699,11,chair,12,0,2001,19,247,537,363,692,116,155,chair
700,12,chair,13,0,2001,15,189,526,295,670,106,144,chair
701,17,chair,18,0,2001,20,142,521,245,655,103,134,chair
702,16,person,17,0,2003,17,220,184,238,220,18,36,person
703,17,person,18,0,2003,20,245,188,257,230,12,42,person
704,18,person,19,0,2003,17,257,184,269,220,12,36,person
705,19,person,20,0,2003,18,269,186,279,220,10,34,person
706,14,table,15,0,2004,19,768,627,1156,741,388,114,dining table
707,15,person,16,1,2004,20,1020,597,1123,690,103,93,person
708,43,person,44,1,2004,18,1316,629,1412,706,96,77,person
709,45,person,46,1,2004,17,1370,612,1440,684,70,72,person
710,46,person,47,1,2004,21,1519,595,1597,687,78,92,person
711,47,person,48,1,2004,30,748,665,886,883,138,218,person
712,48,person,49,1,2004,15,339,659,442,731,103,72,person
713,51,person,52,1,2004,17,975,500,1016,570,41,70,person
714,0,chair,1,0,2006,28,764,770,1337,1461,573,691,chair
715,1,chair,2,0,2006,55,1261,492,1772,1307,511,815,chair
716,3,chair,4,0,2006,26,862,426,1265,773,403,347,chair
717,4,chair,5,0,2006,41,514,675,1032,1395,518,720,chair
718,32,person,33,0,2007,45,3,336,283,685,280,349,person
719,38,person,39,1,2007,22,2,312,83,446,81,134,person
720,39,person,40,1,2007,24,153,312,306,449,153,137,person
721,40,person,41,1,2007,21,288,298,415,447,127,149,person
722,41,person,42,0,2007,21,431,322,591,441,160,119,person
723,42,person,43,0,2007,21,634,326,773,442,139,116,person
724,45,person,46,0,2007,25,825,325,934,476,109,151,person
725,47,person,48,0,2007,20,734,309,816,441,82,132,person
726,49,person,50,1,2007,15,890,297,927,360,37,63,person
727,50,person,51,1,2007,15,832,312,881,377,49,65,person
728,53,person,54,1,2007,19,749,229,814,313,65,84,person
729,56,person,57,0,2007,22,546,211,602,301,56,90,person
730,58,person,59,1,2007,20,441,288,522,370,81,82,person
731,59,person,60,1,2007,18,367,318,454,400,87,82,person
732,60,person,61,1,2007,17,105,295,201,372,96,77,person
733,62,person,62,1,2007,17,1,285,73,379,72,94,person
734,63,person,63,1,2007,15,1,256,54,339,53,83,person
735,64,person,64,1,2007,15,138,244,232,315,94,71,person
736,66,person,66,0,2007,17,253,247,324,325,71,78,person
737,67,person,67,1,2007,22,328,254,410,323,82,69,person
738,69,person,69,1,2007,18,68,238,134,293,66,55,person
739,87,person,87,1,2007,34,444,268,496,338,52,70,person
740,92,bottle,92,0,2007,20,310,375,330,457,20,82,bottle
741,61,person,62,1,22723,33,714,27,780,137,66,110,person
742,62,person,63,1,22723,25,561,52,594,111,33,59,person
743,27,person,28,0,22724,26,558,410,583,461,25,51,person
744,28,person,29,0,22724,25,580,409,600,460,20,51,person
745,29,person,30,0,22724,29,619,409,650,460,31,51,person
746,31,chair,32,0,22724,15,524,425,541,454,17,29,chair
747,32,person,33,0,22724,26,322,392,340,455,18,63,person
748,33,person,34,0,22724,22,306,390,327,432,21,42,person
749,34,person,35,1,22724,18,288,398,303,424,15,26,person
750,35,person,36,1,22724,15,267,394,285,417,18,23,person
751,55,person,56,1,22724,23,725,443,758,513,33,70,person
752,56,person,57,1,22724,83,631,428,765,799,134,371,person
753,57,person,58,1,22724,97,697,372,853,799,156,427,person
754,58,person,59,0,22724,69,794,370,986,800,192,430,person
755,59,person,60,1,22724,48,959,552,1107,694,148,142,person
756,60,person,61,1,22724,64,943,568,1200,799,257,231,person
757,61,person,62,1,22724,16,421,504,447,529,26,25,person
758,62,person,63,1,22724,26,460,499,511,537,51,38,person
759,63,person,64,1,22724,19,512,483,547,519,35,36,person
760,65,person,66,1,22724,25,574,489,620,531,46,42,person
761,66,person,67,1,22724,17,570,481,588,503,18,22,person
762,67,person,68,1,22724,19,606,480,634,517,28,37,person
763,68,person,69,1,22724,15,626,493,658,523,32,30,person
764,69,person,70,1,22724,20,287,479,315,509,28,30,person
765,70,person,71,1,22724,22,217,474,253,509,36,35,person
766,71,person,72,1,22724,16,255,478,283,506,28,28,person
767,72,person,73,1,22724,17,333,474,361,494,28,20,person
768,73,person,74,1,22724,16,366,477,389,498,23,21,person
769,74,person,75,1,22724,18,1,421,37,533,36,112,person
770,5,person,5,1,22725,36,856,499,1024,682,168,183,person
771,6,person,6,1,22725,36,567,404,837,681,270,277,person
772,7,person,7,1,22725,22,735,414,869,682,134,268,person
773,8,person,8,0,22725,29,822,405,920,612,98,207,person
774,9,person,9,1,22725,17,955,465,1023,559,68,94,person
775,11,person,11,1,22725,28,885,418,967,565,82,147,person
776,13,person,13,1,22725,19,875,415,926,477,51,62,person
777,14,person,14,1,22725,20,917,400,992,496,75,96,person
778,16,person,16,1,22725,16,745,368,781,418,36,50,person
779,17,person,17,1,22725,26,590,387,714,568,124,181,person
780,23,person,23,1,22725,18,574,350,651,472,77,122,person
781,24,person,24,1,22725,21,291,396,586,682,295,286,person
782,25,person,25,1,22725,17,505,353,599,432,94,79,person
783,26,person,26,1,22725,17,403,344,507,505,104,161,person
784,33,person,33,1,22725,33,141,330,418,682,277,352,person
785,34,person,34,1,22725,23,246,275,381,439,135,164,person
786,36,person,36,1,22725,38,46,254,240,482,194,228,person
787,37,person,37,1,22725,22,187,250,263,442,76,192,person
788,38,person,38,1,22725,18,151,261,223,396,72,135,person
789,40,person,40,1,22725,18,39,221,122,314,83,93,person
790,43,person,43,1,22725,34,235,165,366,441,131,276,person
791,45,person,45,1,22725,16,489,270,534,316,45,46,person
792,47,person,47,1,22725,26,550,272,627,370,77,98,person
793,48,chair,48,1,22725,19,24,419,214,537,190,118,chair
794,49,chair,49,1,22725,22,68,477,216,680,148,203,chair
795,52,chair,52,1,22725,15,912,561,954,618,42,57,chair
796,8,person,9,1,22727,74,460,277,590,441,130,164,person
797,3,person,4,1,2347,26,208,248,463,477,255,229,person
798,4,person,5,1,2347,38,136,3,465,270,329,267,person
799,4,person,5,1,2351,33,108,40,218,192,110,152,person
800,5,person,6,1,2351,50,226,22,388,188,162,166,person
801,6,person,7,1,2351,30,188,103,285,190,97,87,person
802,6,person,7,1,4247,19,570,424,745,547,175,123,person
803,7,person,8,1,4247,19,484,426,609,603,125,177,person
804,8,person,9,1,4247,27,298,390,480,1035,182,645,person
805,2,table,3,1,4248,17,2,243,158,349,156,106,dining table
806,3,chair,4,1,4248,23,107,255,183,349,76,94,chair
807,2,window,3,1,4249,15,366,57,431,248,65,191,window
808,2,window,3,0,4254,18,188,106,241,353,53,247,window
809,3,window,4,0,4254,22,29,132,123,396,94,264,window
810,4,person,5,1,4369,26,165,119,199,299,34,180,person
811,9,bench,10,0,4370,18,212,138,278,210,66,72,bench
812,11,bench,12,0,4370,15,46,132,110,219,64,87,bench
813,5,person,6,0,66,95,858,398,1159,1062,301,664,person
814,18,person,19,1,66,133,991,425,1289,1062,298,637,person
815,26,person,27,1,66,63,1267,467,1407,1061,140,594,person
816,33,person,34,0,66,74,1135,508,1330,1062,195,554,person
817,43,person,44,0,66,83,1372,445,1546,1062,174,617,person
818,51,person,52,0,66,25,109,825,135,872,26,47,person
819,52,person,53,0,66,26,211,831,235,877,24,46,person
820,53,person,54,0,66,15,199,817,209,844,10,27,person
821,54,person,55,0,66,19,149,826,164,874,15,48,person
822,55,person,56,0,66,26,161,826,179,875,18,49,person
823,8,person,9,0,4840,46,862,456,1220,1318,358,862,person
824,1,person,2,1,20444,49,826,725,1321,1530,495,805,person
825,5,bicycle,6,1,22989,22,435,549,562,599,127,50,bicycle
826,2,scissors,3,0,94,24,278,35,320,54,42,19,scissors
827,3,person,4,0,94,88,304,55,589,229,285,174,person
828,4,person,5,0,94,99,373,172,588,400,215,228,person
829,8,person,9,0,94,93,0,20,188,333,188,313,person
830,13,bench,14,1,5292,38,3,319,367,374,364,55,bench
831,1,window,2,0,5297,15,96,37,157,148,61,111,window
832,9,person,10,0,5298,16,67,281,90,320,23,39,person
833,13,person,14,0,5298,18,165,275,190,308,25,33,person
834,15,person,16,0,5298,15,168,231,186,259,18,28,person
835,17,person,18,1,5298,17,211,249,227,278,16,29,person
836,9,bench,10,1,5308,18,215,166,256,256,41,90,bench
837,10,bench,11,1,5308,21,188,156,256,256,68,100,bench
838,2,person,3,1,5309,19,72,134,105,160,33,26,person
839,3,person,4,1,5309,17,41,132,66,162,25,30,person
840,4,person,5,1,5309,23,0,112,31,157,31,45,person
841,5,person,6,0,5309,29,167,122,184,188,17,66,person
842,6,person,7,0,5309,27,186,127,203,191,17,64,person
843,12,person,13,1,5309,15,139,127,157,144,18,17,person
844,5,person,6,1,5322,28,214,108,276,198,62,90,person
845,7,person,8,1,5322,23,176,123,220,199,44,76,person
846,10,person,11,0,5322,38,144,70,176,175,32,105,person
847,12,person,13,1,5322,34,3,106,58,190,55,84,person
848,20,person,21,1,5322,29,81,99,119,165,38,66,person
849,4,person,5,0,5323,38,483,364,596,753,113,389,person
850,5,person,6,0,5323,54,44,356,174,834,130,478,person
851,6,person,7,0,5323,71,845,343,1111,891,266,548,person
852,7,person,8,0,5323,24,1322,402,1399,623,77,221,person
853,11,person,12,1,5323,18,218,485,305,682,87,197,person
854,5,person,6,0,5324,62,38,33,228,374,190,341,person
855,6,person,7,0,5324,57,222,97,341,374,119,277,person
856,9,chair,10,0,5325,15,254,163,337,272,83,109,chair
857,10,chair,11,0,5325,15,199,201,305,329,106,128,chair
858,12,chair,13,1,5325,17,100,230,216,350,116,120,chair
859,13,chair,14,1,5325,17,98,275,248,461,150,186,chair
860,14,chair,15,0,5325,18,12,299,190,511,178,212,chair
861,17,chair,18,1,5325,15,50,207,119,257,69,50,chair
862,23,chair,24,1,5325,18,737,195,857,331,120,136,chair
863,24,chair,25,1,5325,15,769,211,893,353,124,142,chair
864,25,chair,26,1,5325,17,790,231,938,373,148,142,chair
865,27,chair,28,1,5325,15,846,278,1035,455,189,177,chair
866,4,person,5,0,5326,88,337,64,1081,2149,744,2085,person
867,6,person,7,0,5327,86,648,75,962,1118,314,1043,person
868,12,person,13,1,5327,22,126,503,245,837,119,334,person
869,13,person,14,0,5327,29,224,534,473,983,249,449,person
870,14,person,15,1,5327,36,375,492,601,965,226,473,person
871,15,person,16,1,5327,37,475,489,694,937,219,448,person
872,16,person,17,1,5327,34,571,503,732,925,161,422,person
873,17,person,18,1,5327,19,30,482,147,813,117,331,person
874,18,person,19,1,5327,31,2,485,247,1188,245,703,person
875,2,person,3,0,5328,31,961,166,1128,931,167,765,person
876,3,person,4,0,5328,79,560,320,1051,2132,491,1812,person
877,4,person,5,0,5329,110,304,115,1025,2140,721,2025,person
878,5,person,6,0,5330,103,235,107,1085,2162,850,2055,person
879,6,person,7,1,5330,21,1063,239,1290,658,227,419,person
880,8,person,9,1,5330,16,1081,653,1453,1260,372,607,person
881,9,person,10,1,5330,21,1068,307,1453,1107,385,800,person
882,10,person,11,1,5330,20,987,320,1393,914,406,594,person
883,4,person,5,0,5331,75,474,154,957,2068,483,1914,person
884,4,person,5,0,5388,37,214,102,292,367,78,265,person
885,5,person,6,1,5391,24,494,389,643,650,149,261,person
886,6,person,7,0,5391,44,294,363,496,1158,202,795,person
887,7,person,8,0,5392,25,12,163,28,223,16,60,person
888,9,person,10,1,5392,27,63,151,110,185,47,34,person
889,10,person,11,1,5392,15,164,165,192,207,28,42,person
890,11,person,12,1,5392,43,120,136,173,293,53,157,person
891,12,person,13,1,5392,18,224,150,249,229,25,79,person
892,14,person,15,1,5392,41,176,146,244,280,68,134,person
893,15,person,16,1,5392,24,138,207,194,322,56,115,person
894,16,person,17,1,5392,15,144,205,165,244,21,39,person
895,17,person,18,1,5392,19,190,257,246,323,56,66,person
896,28,table,29,1,5394,22,3,1346,84,1669,81,323,dining table
897,11,chair,12,1,5395,18,791,891,976,1416,185,525,chair
898,12,chair,13,1,5395,18,300,1105,668,1461,368,356,chair
899,21,person,22,1,5533,22,413,399,456,477,43,78,person
900,3,person,4,1,5542,22,227,324,395,511,168,187,person
901,5,person,6,1,5542,24,193,315,297,511,104,196,person
902,6,person,7,1,5542,23,135,275,196,511,61,236,person
903,7,person,8,1,5542,44,69,169,188,509,119,340,person
904,8,person,9,1,5542,19,183,271,261,451,78,180,person
905,10,person,11,1,5542,22,44,266,98,511,54,245,person
906,13,person,14,1,5542,28,552,144,633,326,81,182,person
907,14,person,15,1,5542,29,488,154,585,318,97,164,person
908,15,person,16,1,5542,17,465,147,520,229,55,82,person
909,16,person,17,1,5542,17,419,133,466,197,47,64,person
910,17,person,18,1,5542,24,422,194,496,336,74,142,person
911,18,person,19,1,5542,25,391,184,459,350,68,166,person
912,19,person,20,1,5542,15,364,152,401,214,37,62,person
913,20,person,21,1,5542,19,341,186,390,298,49,112,person
914,21,person,22,1,5542,18,287,189,347,246,60,57,person
915,22,person,23,1,5542,17,258,181,308,251,50,70,person
916,23,person,24,1,5542,19,238,208,293,289,55,81,person
917,24,person,25,1,5542,19,326,251,392,341,66,90,person
918,25,person,26,1,5542,17,270,263,333,334,63,71,person
919,26,person,27,1,5542,18,193,190,244,244,51,54,person
920,9,desk,10,0,5543,19,0,114,91,213,91,99,desk
921,11,person,12,0,5544,16,240,184,258,220,18,36,person
922,16,bench,17,0,5545,24,104,216,277,269,173,53,bench
923,11,window,12,0,5547,22,28,173,123,266,95,93,window
924,4,window,5,0,5557,18,17,27,255,163,238,136,window
925,18,person,19,0,5562,20,124,128,135,167,11,39,person
926,19,person,20,0,5562,23,113,131,124,167,11,36,person
927,23,flowerpot,24,0,5562,16,146,213,177,247,31,34,potted plant
928,58,bench,59,0,24895,23,326,414,344,490,18,76,bench
929,59,bench,60,0,24895,30,304,412,332,501,28,89,bench
930,60,bench,61,0,24895,28,270,406,313,521,43,115,bench
931,61,bench,62,0,24895,36,205,398,285,555,80,157,bench
932,62,bench,63,0,24895,40,16,380,233,566,217,186,bench
933,63,bench,64,0,24895,29,0,329,102,566,102,237,bench
934,64,bench,65,0,24895,24,474,417,491,492,17,75,bench
935,65,bench,66,0,24895,27,485,414,512,504,27,90,bench
936,66,bench,67,0,24895,29,503,409,546,525,43,116,bench
937,67,bench,68,0,24895,36,532,400,614,561,82,161,bench
938,68,bench,69,0,24895,43,586,384,800,566,214,182,bench
939,69,bench,70,0,24895,25,722,343,800,566,78,223,bench
940,4,table,4,1,105,18,158,452,607,552,449,100,dining table
941,8,person,8,1,105,43,484,153,665,472,181,319,person
942,9,person,9,1,105,54,538,3,869,513,331,510,person
943,10,person,10,1,105,85,246,46,466,414,220,368,person
944,18,person,18,1,105,38,136,234,339,448,203,214,person
945,20,person,20,1,105,29,1,1,188,552,187,551,person
946,5,window,6,0,106,15,1733,482,1945,819,212,337,window
947,10,window,11,0,106,21,1553,230,1730,810,177,580,window
948,12,window,13,0,106,31,1953,187,2062,813,109,626,window
949,13,person,14,0,106,60,1858,693,2079,922,221,229,person
950,17,person,18,1,106,66,1634,695,1802,1012,168,317,person
951,20,bottle,21,0,106,16,1591,840,1617,934,26,94,bottle
952,21,table,22,1,106,44,1558,839,2060,918,502,79,dining table
953,24,table,25,1,106,30,1535,908,2043,999,508,91,dining table
954,27,person,28,1,106,38,1616,780,2199,1467,583,687,person
955,33,table,34,1,106,18,1327,988,1967,1180,640,192,dining table
956,34,table,35,1,106,21,890,1142,2199,1467,1309,325,dining table
957,45,window,46,0,106,34,1374,247,1471,911,97,664,window
958,52,table,53,0,106,22,1,900,474,1253,473,353,dining table
959,56,table,57,1,106,27,352,856,821,1122,469,266,dining table
960,59,person,60,1,106,47,467,718,668,1051,201,333,person
961,60,table,61,1,106,21,662,826,1061,1023,399,197,dining table
962,63,chair,64,1,106,25,1051,806,1109,1000,58,194,chair
963,64,person,65,0,106,68,910,703,1069,1007,159,304,person
964,65,person,66,1,106,51,780,690,918,994,138,304,person
965,8,person,9,1,107,32,1107,306,1259,449,152,143,person
966,14,person,15,1,107,22,896,277,1012,429,116,152,person
967,27,person,28,1,107,45,185,330,330,546,145,216,person
968,44,keyboard,45,0,107,17,521,542,654,606,133,64,keyboard
969,47,person,48,1,107,104,300,335,632,886,332,551,person
970,74,person,75,1,107,102,645,368,1099,959,454,591,person
971,93,desk,94,1,107,42,824,622,1102,756,278,134,desk
972,94,desk,95,1,107,51,471,517,647,629,176,112,desk
973,104,clock,105,0,107,17,450,20,502,90,52,70,clock
974,6,table,7,0,5600,16,244,501,632,949,388,448,dining table
975,9,chair,10,0,5600,35,5,563,385,959,380,396,chair
976,10,backpack,11,0,5600,22,187,602,405,840,218,238,backpack
977,11,person,12,1,5600,69,69,348,414,959,345,611,person
978,12,person,13,1,5600,22,2,356,100,586,98,230,person
979,13,person,14,1,5600,16,2,278,60,451,58,173,person
980,15,backpack,16,0,5600,17,247,333,334,440,87,107,backpack
981,17,person,18,1,5600,37,283,330,494,472,211,142,person
982,20,person,21,1,5600,52,484,352,727,821,243,469,person
983,21,person,22,1,5600,22,432,256,536,337,104,81,person
984,22,person,23,1,5600,29,303,256,402,416,99,160,person
985,23,person,24,1,5600,18,329,195,399,298,70,103,person
986,26,person,27,1,5600,26,506,296,629,452,123,156,person
987,35,table,36,0,5600,16,851,388,1079,656,228,268,dining table
988,36,chair,37,1,5600,25,641,452,784,823,143,371,chair
989,37,person,38,1,5600,24,853,214,930,342,77,128,person
990,38,person,39,1,5600,18,997,266,1082,334,85,68,person
991,39,person,40,1,5600,23,1073,274,1193,390,120,116,person
992,40,person,41,1,5600,21,733,218,786,393,53,175,person
993,41,person,42,1,5600,36,659,235,786,494,127,259,person
994,42,person,43,0,5600,48,769,225,894,612,125,387,person
995,43,person,44,1,5600,25,1194,213,1277,470,83,257,person
996,5,desk,6,0,5601,55,141,150,238,256,97,106,desk
997,12,table,13,0,5601,17,0,122,177,236,177,114,dining table
998,13,chair,14,0,5601,17,71,151,122,234,51,83,chair
999,16,chair,17,1,5601,15,3,134,25,202,22,68,chair
1000,3,desk,4,0,5602,18,9,153,137,254,128,101,desk
1001,6,desk,5,0,5603,22,100,165,178,256,78,91,desk
1002,9,chair,8,0,5603,20,112,179,187,255,75,76,chair
1003,13,chair,12,0,5603,28,29,185,105,256,76,71,chair
1004,17,chair,16,0,5603,23,209,153,254,218,45,65,chair
1005,1,chair,2,0,5604,25,38,153,80,225,42,72,chair
1006,2,chair,3,0,5604,21,76,157,135,243,59,86,chair
1007,16,desk,17,1,5604,21,2,127,66,204,64,77,desk
1008,7,chair,8,1,5605,20,48,173,92,234,44,61,chair
1009,8,chair,9,0,5605,25,118,204,166,256,48,52,chair
1010,12,chair,13,0,5605,18,28,157,53,186,25,29,chair
1011,13,chair,14,0,5605,17,55,149,76,176,21,27,chair
1012,18,chair,19,1,5605,20,203,188,250,244,47,56,chair
1013,21,chair,22,1,5605,17,93,147,111,169,18,22,chair
1014,15,desk,16,0,5606,18,54,100,256,135,202,35,desk
1015,13,chair,14,1,5607,19,10,109,46,147,36,38,chair
1016,16,chair,17,0,5607,31,93,134,147,203,54,69,chair
1017,17,chair,18,1,5607,16,140,129,176,157,36,28,chair
1018,18,chair,19,0,5607,22,183,110,219,153,36,43,chair
1019,19,table,20,0,5607,16,146,144,256,255,110,111,dining table
1020,20,table,21,1,5607,15,0,130,48,215,48,85,dining table
1021,21,chair,22,0,5607,37,180,172,255,255,75,83,chair
1022,26,chair,27,1,5607,18,2,151,28,231,26,80,chair
1023,7,chair,8,1,5608,16,204,151,227,210,23,59,chair
1024,8,table,9,1,5608,21,25,180,136,255,111,75,dining table
1025,9,chair,10,1,5608,19,14,183,38,248,24,65,chair
1026,10,chair,11,1,5608,27,31,211,84,256,53,45,chair
1027,11,chair,12,1,5608,19,93,209,140,255,47,46,chair
1028,5,chair,6,1,5609,20,145,193,199,256,54,63,chair
1029,9,table,10,1,5609,15,64,146,172,179,108,33,dining table
1030,32,desk,33,1,5610,22,1799,784,2132,891,333,107,desk
1031,33,chair,34,1,5610,24,1811,788,1963,948,152,160,chair
1032,34,table,35,1,5610,26,1257,823,1568,1097,311,274,dining table
1033,36,table,37,1,5610,18,713,770,966,890,253,120,dining table
1034,37,table,38,1,5610,27,248,1379,1185,1648,937,269,dining table
1035,38,bottle,39,0,5610,37,873,1285,980,1596,107,311,bottle
1036,39,table,40,0,5610,20,1065,1169,1780,1614,715,445,dining table
1037,40,table,41,1,5610,18,1498,1047,2048,1213,550,166,dining table
1038,41,chair,42,1,5610,35,1411,1190,1866,1648,455,458,chair
1039,42,chair,43,1,5610,46,114,1131,561,1639,447,508,chair
1040,43,table,44,1,5610,29,297,998,795,1413,498,415,dining table
1041,89,chair,89,1,5610,27,602,1107,923,1419,321,312,chair
1042,90,chair,90,1,5610,33,907,996,1203,1273,296,277,chair
1043,95,table,95,1,5610,15,5,1113,229,1339,224,226,dining table
1044,5,table,6,0,5611,18,566,632,1111,831,545,199,dining table
1045,25,chair,26,0,5611,15,134,726,235,882,101,156,chair
1046,26,chair,27,0,5611,19,242,738,356,892,114,154,chair
1047,27,chair,28,0,5611,16,348,720,453,870,105,150,chair
1048,28,table,29,1,5611,16,528,792,952,997,424,205,dining table
1049,4,chair,5,0,5612,26,164,196,223,256,59,60,chair
1050,9,chair,10,0,5612,16,3,152,27,197,24,45,chair
1051,10,chair,11,0,5612,19,22,159,62,208,40,49,chair
1052,10,chair,11,0,5613,25,20,193,84,256,64,63,chair
1053,11,chair,12,0,5613,25,86,203,147,256,61,53,chair
1054,1,chair,2,1,5614,31,101,183,187,256,86,73,chair
1055,4,desk,5,1,5614,16,141,167,238,197,97,30,desk
1056,5,desk,6,1,5614,21,162,146,238,182,76,36,desk
1057,6,desk,7,1,5614,33,43,155,162,253,119,98,desk
1058,7,chair,8,1,5614,31,7,195,75,255,68,60,chair
1059,6,chair,7,0,5615,20,325,420,373,503,48,83,chair
1060,8,table,9,0,5615,15,475,456,680,588,205,132,dining table
1061,17,chair,18,0,5615,33,463,476,548,589,85,113,chair
1062,18,chair,19,0,5615,27,630,467,723,591,93,124,chair
1063,25,chair,26,0,5615,21,376,431,425,515,49,84,chair
1064,28,chair,29,0,5615,26,550,486,625,590,75,104,chair
1065,10,chair,11,0,5616,29,139,176,215,255,76,79,chair
1066,11,chair,12,1,5616,30,92,158,145,214,53,56,chair
1067,13,chair,14,1,5616,25,63,144,94,209,31,65,chair
1068,14,chair,15,1,5616,18,38,134,68,183,30,49,chair
1069,16,chair,17,1,5616,17,116,128,146,165,30,37,chair
1070,24,chair,25,1,5616,21,179,145,224,190,45,45,chair
1071,27,chair,28,1,5616,23,17,191,92,255,75,64,chair
1072,8,chair,9,1,5617,15,155,89,190,113,35,24,chair
1073,11,chair,12,1,5617,19,133,147,222,255,89,108,chair
1074,5,desk,6,0,5618,26,38,149,125,243,87,94,desk
1075,6,desk,7,0,5618,31,107,142,174,223,67,81,desk
1076,7,desk,8,0,5618,29,143,136,210,202,67,66,desk
1077,8,desk,9,0,5618,29,189,133,246,191,57,58,desk
1078,9,desk,10,0,5618,28,0,133,52,198,52,65,desk
1079,14,table,15,1,5619,15,1430,711,1669,879,239,168,dining table
1080,21,table,22,1,5619,27,1064,758,1317,879,253,121,dining table
1081,22,table,23,1,5619,42,904,922,1314,1396,410,474,dining table
1082,23,person,24,1,5619,112,882,718,1224,1286,342,568,person
1083,29,chair,30,1,5619,24,840,873,907,1227,67,354,chair
1084,40,table,41,1,5619,17,804,831,924,1028,120,197,dining table
1085,41,person,42,0,5619,68,761,594,963,1036,202,442,person
1086,43,chair,44,1,5619,32,733,792,817,1019,84,227,chair
1087,45,table,46,1,5619,17,561,814,733,1008,172,194,dining table
1088,47,table,48,1,5619,18,574,877,687,965,113,88,dining table
1089,50,person,51,1,5619,71,429,581,623,816,194,235,person
1090,51,person,52,1,5619,33,344,725,492,928,148,203,person
1091,52,person,53,1,5619,33,1,786,129,1073,128,287,person
1092,53,table,54,1,5619,16,1,850,207,1127,206,277,dining table
1093,56,person,57,1,5619,17,1,1063,128,1152,127,89,person
1094,57,table,58,1,5619,35,1,1109,237,1583,236,474,dining table
1095,58,person,59,1,5619,30,1,1253,233,1649,232,396,person
1096,60,chair,61,1,5619,19,237,1316,349,1649,112,333,chair
1097,61,person,62,1,5619,62,427,786,730,1364,303,578,person
1098,63,table,64,1,5619,25,534,1000,899,1399,365,399,dining table
1099,64,person,65,1,5619,97,159,607,712,1616,553,1009,person
1100,65,chair,66,1,5619,19,1301,811,1327,983,26,172,chair
1101,66,table,67,1,5619,44,1317,852,1611,1030,294,178,dining table
1102,67,bottle,68,0,5619,15,1429,799,1467,895,38,96,bottle
1103,68,person,69,1,5619,52,1320,674,1533,882,213,208,person
1104,69,chair,70,1,5619,33,1490,886,1608,1103,118,217,chair
1105,72,chair,73,1,5619,27,1875,772,1987,932,112,160,chair
1106,74,person,75,1,5619,83,1572,734,2004,1193,432,459,person
1107,75,table,76,1,5619,41,1713,968,2132,1371,419,403,dining table
1108,77,chair,78,1,5619,66,1094,1046,1510,1608,416,562,chair
1109,78,table,79,1,5619,66,1301,1154,1919,1644,618,490,dining table
1110,79,person,80,0,5619,101,1179,885,1726,1646,547,761,person
1111,27,table,28,1,5620,72,2,561,345,745,343,184,dining table
1112,29,table,30,1,5620,18,480,542,600,597,120,55,dining table
1113,30,table,31,1,5620,25,394,564,534,646,140,82,dining table
1114,31,table,32,1,5620,23,284,589,450,678,166,89,dining table
1115,32,table,33,1,5620,26,711,519,807,594,96,75,dining table
1116,33,table,34,1,5620,25,651,540,760,650,109,110,dining table
1117,35,chair,36,1,5620,27,511,563,596,718,85,155,chair
1118,38,chair,39,1,5620,17,717,557,779,645,62,88,chair
1119,39,chair,40,1,5620,21,581,563,709,680,128,117,chair
1120,40,table,41,1,5620,15,496,590,663,687,167,97,dining table
1121,41,chair,42,1,5620,28,394,588,515,716,121,128,chair
1122,42,chair,43,1,5620,28,356,636,566,816,210,180,chair
1123,43,table,44,0,5620,21,136,706,421,924,285,218,dining table
1124,44,table,45,1,5620,28,96,635,312,829,216,194,dining table
1125,47,chair,48,1,5620,28,1,697,192,882,191,185,chair
1126,48,chair,49,1,5620,26,634,592,726,718,92,126,chair
1127,49,chair,50,1,5620,27,499,636,656,875,157,239,chair
1128,50,chair,51,1,5620,27,301,706,504,872,203,166,chair
1129,51,table,52,1,5620,17,861,538,979,592,118,54,dining table
1130,52,table,53,1,5620,23,816,559,954,682,138,123,dining table
1131,53,table,54,1,5620,29,755,591,915,796,160,205,dining table
1132,54,chair,55,1,5620,21,981,521,1059,592,78,71,chair
1133,55,chair,56,1,5620,25,946,542,1033,650,87,108,chair
1134,56,chair,57,1,5620,29,910,564,1015,655,105,91,chair
1135,57,chair,58,1,5620,35,865,597,986,731,121,134,chair
1136,58,chair,59,1,5620,38,790,661,952,893,162,232,chair
1137,59,table,60,1,5620,20,649,643,854,834,205,191,dining table
1138,60,table,61,0,5620,33,505,713,775,1063,270,350,dining table
1139,61,table,62,1,5620,26,176,866,611,1200,435,334,dining table
1140,63,chair,64,1,5620,43,3,847,276,1199,273,352,chair
1141,64,chair,65,1,5620,40,682,724,875,981,193,257,chair
1142,65,chair,66,0,5620,45,462,875,760,1199,298,324,chair
1143,66,table,67,0,5620,32,790,886,1167,1198,377,312,dining table
1144,67,chair,68,1,5620,24,1077,918,1399,1197,322,279,chair
1145,68,chair,69,0,5620,48,1099,735,1308,1097,209,362,chair
1146,69,table,70,0,5620,25,915,731,1152,892,237,161,dining table
1147,70,chair,71,1,5620,30,1118,643,1275,859,157,216,chair
1148,71,table,72,1,5620,15,971,650,1158,744,187,94,dining table
1149,72,chair,73,1,5620,26,1132,588,1261,740,129,152,chair
1150,73,chair,74,1,5620,26,1145,562,1254,664,109,102,chair
1151,74,table,75,1,5620,18,1019,596,1171,671,152,75,dining table
1152,76,chair,77,1,5620,19,1165,533,1251,620,86,87,chair
1153,78,chair,79,1,5620,18,1166,513,1241,597,75,84,chair
1154,83,table,84,1,5620,18,1379,656,1499,958,120,302,dining table
1155,84,table,85,1,5620,29,1352,598,1499,835,147,237,dining table
1156,85,table,86,1,5620,27,1331,565,1458,759,127,194,dining table
1157,86,chair,87,1,5620,15,1432,512,1483,598,51,86,chair
1158,87,person,88,1,5620,32,46,454,159,595,113,141,person
1159,28,table,29,1,5621,48,1211,950,1518,1619,307,669,dining table
1160,32,chair,32,0,5621,44,1355,1064,1948,1650,593,586,chair
1161,33,person,33,0,5621,103,1331,683,1865,1612,534,929,person
1162,34,chair,34,1,5621,30,1798,953,2003,1539,205,586,chair
1163,35,table,35,1,5621,29,1825,880,2199,1369,374,489,dining table
1164,40,person,40,1,5621,36,2023,1021,2199,1289,176,268,person
1165,44,table,44,1,5621,21,1750,780,2197,889,447,109,dining table
1166,49,table,49,1,5621,17,1935,729,2195,793,260,64,dining table
1167,65,chair,65,0,5621,33,40,981,470,1608,430,627,chair
1168,66,person,66,0,5621,72,2,630,430,1383,428,753,person
1169,68,chair,68,1,5621,43,415,907,768,1357,353,450,chair
1170,69,table,69,1,5621,37,417,885,705,1275,288,390,dining table
1171,72,table,72,1,5621,29,725,831,1221,1250,496,419,dining table
1172,73,person,73,0,5621,83,824,636,1064,1237,240,601,person
1173,74,chair,74,0,5621,43,835,864,1172,1314,337,450,chair
1174,75,chair,75,1,5621,36,1101,832,1317,1227,216,395,chair
1175,76,table,76,1,5621,21,1243,805,1403,895,160,90,dining table
1176,77,person,77,1,5621,50,1260,632,1549,936,289,304,person
1177,78,chair,78,1,5621,16,1159,758,1283,843,124,85,chair
1178,79,person,79,1,5621,28,1053,614,1223,834,170,220,person
1179,83,chair,83,1,5621,18,629,782,791,913,162,131,chair
1180,84,table,84,1,5621,15,505,770,625,892,120,122,dining table
1181,85,person,85,1,5621,36,590,654,782,904,192,250,person
1182,89,person,89,1,5621,25,1231,645,1356,767,125,122,person
1183,96,person,96,1,5621,29,851,619,934,767,83,148,person
1184,97,table,97,1,5621,21,778,710,863,808,85,98,dining table
1185,101,person,101,1,5621,43,625,617,745,750,120,133,person
1186,104,chair,104,1,5621,22,324,808,489,886,165,78,chair
1187,105,person,105,1,5621,46,312,623,522,858,210,235,person
1188,110,person,110,1,5621,33,413,628,516,746,103,118,person
1189,111,person,111,1,5621,39,7,677,208,855,201,178,person
1190,112,chair,112,1,5621,20,129,627,228,792,99,165,chair
1191,126,window,126,1,5621,18,1120,546,1331,608,211,62,window
1192,132,person,132,1,5621,28,1009,601,1090,722,81,121,person
1193,134,person,134,1,5621,55,656,489,771,706,115,217,person
1194,6,desk,7,0,5622,17,21,123,156,214,135,91,desk
1195,7,desk,8,0,5622,22,49,145,228,255,179,110,desk
1196,23,chair,24,1,5622,15,220,94,251,118,31,24,chair
1197,24,chair,25,1,5622,22,206,117,256,164,50,47,chair
1198,25,chair,26,1,5622,22,155,105,198,145,43,40,chair
1199,1,desk,2,0,5623,16,3,115,97,197,94,82,desk
1200,2,desk,3,0,5623,23,26,131,141,225,115,94,desk
1201,3,desk,4,0,5623,26,54,135,197,256,143,121,desk
1202,4,desk,5,0,5623,37,92,145,255,255,163,110,desk
1203,12,table,13,0,5625,16,2,157,107,211,105,54,dining table
1204,4,table,5,0,5626,16,7,63,153,111,146,48,dining table
1205,5,chair,6,1,5626,15,22,62,46,109,24,47,chair
1206,9,table,10,0,5626,17,96,119,256,239,160,120,dining table
1207,11,chair,12,1,5626,21,111,115,167,216,56,101,chair
1208,4,chair,5,1,5627,16,157,119,195,168,38,49,chair
1209,10,chair,11,1,5627,16,67,176,117,255,50,79,chair
1210,66,table,67,1,5628,31,1,732,455,1128,454,396,dining table
1211,71,chair,72,1,5628,25,1,806,179,1136,178,330,chair
1212,72,chair,73,0,5628,28,178,792,406,1135,228,343,chair
1213,73,chair,74,1,5628,28,372,758,517,1018,145,260,chair
1214,74,table,75,1,5628,37,522,671,1115,860,593,189,dining table
1215,75,chair,76,1,5628,24,515,687,683,864,168,177,chair
1216,76,chair,77,1,5628,22,703,703,879,857,176,154,chair
1217,77,chair,78,1,5628,17,1045,662,1153,792,108,130,chair
1218,78,chair,79,1,5628,22,1028,687,1154,795,126,108,chair
1219,80,table,81,1,5628,56,599,807,1698,1401,1099,594,dining table
1220,81,chair,82,1,5628,49,467,804,775,1222,308,418,chair
1221,82,chair,83,0,5628,38,677,873,1024,1317,347,444,chair
1222,83,chair,84,0,5628,38,925,896,1282,1374,357,478,chair
1223,85,chair,86,1,5628,41,1329,806,1617,1200,288,394,chair
1224,87,table,88,0,5628,48,1294,718,2038,1088,744,370,dining table
1225,89,chair,90,1,5628,39,1626,772,1847,1091,221,319,chair
1226,90,chair,91,1,5628,18,1400,753,1564,837,164,84,chair
1227,20,table,21,1,5629,21,59,789,369,899,310,110,dining table
1228,23,table,24,1,5629,27,297,743,783,895,486,152,dining table
1229,26,table,27,1,5629,16,710,712,1000,830,290,118,dining table
1230,29,table,30,1,5629,19,1058,696,1191,778,133,82,dining table
1231,31,table,32,1,5629,24,1177,675,1403,724,226,49,dining table
1232,36,table,37,1,5629,17,1370,666,1508,705,138,39,dining table
1233,40,table,41,1,5629,25,267,856,768,1137,501,281,dining table
1234,41,table,42,1,5629,48,681,785,1184,1127,503,342,dining table
1235,45,table,46,1,5629,37,1169,722,1424,995,255,273,dining table
1236,48,table,49,1,5629,25,1411,697,1598,906,187,209,dining table
1237,61,table,62,1,5629,40,436,954,1605,1534,1169,580,dining table
1238,64,table,65,1,5629,36,1295,832,1818,1410,523,578,dining table
1239,17,table,18,1,5630,19,1288,896,1473,1008,185,112,dining table
1240,21,person,22,0,5630,40,1968,717,2159,982,191,265,person
1241,23,table,24,1,5630,24,1544,977,1982,1054,438,77,dining table
1242,30,table,31,1,5630,25,1575,1032,2141,1413,566,381,dining table
1243,31,chair,32,1,5630,18,1880,1066,2080,1432,200,366,chair
1244,32,table,33,1,5630,32,1315,1092,2015,1320,700,228,dining table
1245,33,chair,34,1,5630,15,1606,1150,1843,1301,237,151,chair
1246,34,chair,35,1,5630,18,1360,1109,1609,1271,249,162,chair
1247,35,table,36,1,5630,23,1174,990,1664,1080,490,90,dining table
1248,39,table,40,1,5630,31,939,920,1292,999,353,79,dining table
1249,40,chair,41,1,5630,24,1090,930,1191,1050,101,120,chair
1250,41,chair,42,1,5630,27,959,922,1097,1048,138,126,chair
1251,42,table,43,1,5630,42,509,918,1049,1047,540,129,dining table
1252,43,table,44,1,5630,16,790,902,960,957,170,55,dining table
1253,49,chair,50,1,5630,34,665,946,805,1134,140,188,chair
1254,50,chair,51,1,5630,32,764,959,920,1147,156,188,chair
1255,52,table,53,1,5630,29,959,1036,1453,1228,494,192,dining table
1256,54,table,55,1,5630,39,1034,1218,2021,1648,987,430,dining table
1257,55,chair,56,1,5630,22,1533,1359,1908,1647,375,288,chair
1258,56,chair,57,1,5630,53,1110,1250,1518,1648,408,398,chair
1259,57,table,58,1,5630,54,461,1127,1230,1645,769,518,dining table
1260,58,chair,59,0,5630,46,711,1213,1124,1649,413,436,chair
1261,59,chair,60,1,5630,42,430,1154,842,1645,412,491,chair
1262,60,table,61,1,5630,31,362,973,798,1218,436,245,dining table
1263,61,table,62,1,5630,23,164,939,527,1020,363,81,dining table
1264,64,chair,65,1,5630,36,349,977,511,1241,162,264,chair
1265,65,chair,66,1,5630,21,477,993,602,1152,125,159,chair
1266,66,table,67,1,5630,24,3,1017,438,1428,435,411,dining table
1267,67,chair,68,1,5630,46,29,1022,326,1428,297,406,chair
1268,68,chair,69,1,5630,21,1,1036,85,1384,84,348,chair
1269,14,chair,15,1,5633,15,38,347,97,388,59,41,chair
1270,16,chair,17,1,5633,17,72,393,141,442,69,49,chair
1271,20,chair,21,1,5633,21,244,300,305,396,61,96,chair
1272,23,chair,24,1,5633,24,288,322,354,435,66,113,chair
1273,26,chair,27,0,5633,26,334,357,421,473,87,116,chair
1274,28,chair,29,1,5633,17,436,340,508,387,72,47,chair
1275,29,chair,30,1,5633,21,530,381,627,444,97,63,chair
1276,30,chair,31,1,5633,27,414,398,515,479,101,81,chair
1277,35,chair,36,0,5633,22,516,268,564,343,48,75,chair
1278,23,table,24,1,5634,17,1220,530,1419,716,199,186,dining table
1279,24,table,25,1,5634,24,1221,537,1393,739,172,202,dining table
1280,25,table,26,1,5634,26,968,512,1193,580,225,68,dining table
1281,26,table,27,1,5634,20,831,504,1007,563,176,59,dining table
1282,27,table,28,1,5634,28,660,494,893,546,233,52,dining table
1283,28,table,29,1,5634,29,594,488,745,536,151,48,dining table
1284,29,table,30,1,5634,49,943,571,1294,859,351,288,dining table
1285,31,chair,32,0,5634,23,1170,526,1248,571,78,45,chair
1286,33,chair,34,1,5634,21,984,512,1041,564,57,52,chair
1287,34,chair,35,1,5634,19,1011,526,1090,573,79,47,chair
1288,35,chair,36,1,5634,18,794,504,854,549,60,45,chair
1289,36,chair,37,1,5634,20,679,495,733,540,54,45,chair
1290,38,table,39,1,5634,15,775,551,1056,662,281,111,dining table
1291,39,table,40,1,5634,23,541,535,847,623,306,88,dining table
1292,40,chair,41,1,5634,20,981,587,1085,636,104,49,chair
1293,41,chair,42,1,5634,40,987,609,1146,939,159,330,chair
1294,43,chair,44,1,5634,20,723,562,813,640,90,78,chair
1295,44,table,45,1,5634,32,354,521,653,607,299,86,dining table
1296,53,table,54,1,5634,17,10,570,330,831,320,261,dining table
1297,54,table,55,1,5634,49,101,582,542,921,441,339,dining table
1298,55,chair,56,1,5634,53,42,603,232,917,190,314,chair
1299,56,chair,57,1,5634,15,111,542,199,586,88,44,chair
1300,57,table,58,1,5634,25,351,630,682,996,331,366,dining table
1301,59,table,60,1,5634,53,557,664,1010,1095,453,431,dining table
1302,60,table,61,1,5634,27,706,643,1101,1018,395,375,dining table
1303,61,chair,62,1,5634,58,546,687,764,1091,218,404,chair
1304,67,chair,68,1,5634,59,244,623,456,991,212,368,chair
1305,26,chair,27,1,5635,19,26,217,94,256,68,39,chair
1306,6,table,7,0,5636,18,72,122,176,207,104,85,dining table
1307,7,table,8,0,5636,19,157,111,228,167,71,56,dining table
1308,9,chair,10,0,5636,20,200,117,236,166,36,49,chair
1309,10,chair,11,0,5636,28,121,135,170,203,49,68,chair
1310,11,chair,12,0,5636,33,0,167,73,256,73,89,chair
1311,12,table,13,1,5636,16,0,114,85,147,85,33,dining table
1312,14,chair,15,1,5636,16,9,113,43,149,34,36,chair
1313,27,table,28,0,5636,17,0,142,68,226,68,84,dining table
1314,5,desk,6,0,5637,48,152,154,240,252,88,98,desk
1315,6,desk,7,0,5637,44,114,141,185,213,71,72,desk
1316,7,desk,8,0,5637,37,12,165,102,255,90,90,desk
1317,12,desk,13,0,5637,25,27,122,72,164,45,42,desk
1318,13,desk,14,1,5637,20,182,131,250,194,68,63,desk
1319,9,table,10,0,5638,20,0,140,255,253,255,113,dining table
1320,10,chair,11,1,5638,15,108,146,186,251,78,105,chair
1321,22,chair,23,1,5638,15,178,146,255,254,77,108,chair
1322,1,desk,2,0,5639,24,418,311,565,479,147,168,desk
1323,2,desk,3,0,5639,27,330,281,458,447,128,166,desk
1324,3,desk,4,1,5639,29,274,254,356,357,82,103,desk
1325,4,desk,5,1,5639,24,255,358,406,479,151,121,desk
1326,5,desk,6,1,5639,27,184,311,303,474,119,163,desk
1327,6,desk,7,1,5639,19,210,235,281,307,71,72,desk
1328,14,chair,15,0,5640,24,99,157,140,226,41,69,chair
1329,22,chair,23,1,5640,16,198,142,220,164,22,22,chair
1330,6,table,7,0,5641,18,0,126,229,255,229,129,dining table
1331,11,chair,12,0,5641,29,140,173,184,255,44,82,chair
1332,12,chair,13,0,5641,21,176,160,204,235,28,75,chair
1333,13,chair,14,0,5641,18,201,150,215,195,14,45,chair
1334,61,table,62,1,5642,92,143,785,1342,943,1199,158,dining table
1335,62,chair,63,1,5642,19,79,789,247,903,168,114,chair
1336,64,chair,65,1,5642,16,416,799,542,905,126,106,chair
1337,68,table,69,1,5642,30,1291,807,1627,944,336,137,dining table
1338,71,chair,72,1,5642,27,1753,719,1936,1155,183,436,chair
1339,72,chair,73,0,5642,35,1610,755,1906,1187,296,432,chair
1340,73,chair,74,1,5642,25,1634,1103,1904,1323,270,220,chair
1341,74,chair,75,1,5642,17,2049,697,2168,896,119,199,chair
1342,75,chair,76,1,5642,18,1953,727,2134,928,181,201,chair
1343,76,chair,77,1,5642,23,1933,850,2099,1075,166,225,chair
1344,77,chair,78,1,5642,32,1923,886,2193,1281,270,395,chair
1345,78,chair,79,1,5642,16,1694,1258,2199,1648,505,390,chair
1346,79,table,80,1,5642,26,1382,882,1714,989,332,107,dining table
1347,81,chair,82,1,5642,25,1134,845,1289,1036,155,191,chair
1348,82,chair,83,1,5642,30,1408,904,1615,1138,207,234,chair
1349,83,table,84,1,5642,15,1242,941,1623,1118,381,177,dining table
1350,84,chair,85,1,5642,49,1108,973,1420,1405,312,432,chair
1351,85,table,86,1,5642,33,893,1024,1408,1627,515,603,dining table
1352,86,table,87,1,5642,19,926,870,1258,1027,332,157,dining table
1353,88,table,89,1,5642,18,593,846,904,932,311,86,dining table
1354,89,chair,90,1,5642,15,828,828,954,932,126,104,chair
1355,90,table,91,1,5642,15,305,840,587,901,282,61,dining table
1356,92,chair,93,1,5642,26,233,862,423,1095,190,233,chair
1357,93,chair,94,1,5642,16,603,866,743,1008,140,142,chair
1358,94,chair,95,1,5642,17,328,900,680,993,352,93,chair
1359,96,chair,97,1,5642,29,5,905,201,1250,196,345,chair
1360,97,table,98,0,5642,30,5,954,420,1435,415,481,dining table
1361,98,chair,99,1,5642,41,227,920,571,1279,344,359,chair
1362,99,table,100,0,5642,31,351,993,952,1543,601,550,dining table
1363,100,chair,101,1,5642,41,596,951,954,1354,358,403,chair
1364,103,window,104,1,5642,20,1361,535,1726,798,365,263,window
1365,1,desk,2,0,5643,15,40,163,122,256,82,93,desk
1366,3,chair,4,0,5643,22,32,175,112,256,80,81,chair
1367,5,chair,6,1,5643,23,104,166,179,254,75,88,chair
1368,6,chair,7,1,5643,19,174,149,213,234,39,85,chair
1369,13,person,14,1,5643,27,176,63,209,126,33,63,person
1370,20,desk,21,1,5643,17,63,118,111,159,48,41,desk
1371,26,chair,27,1,5643,15,157,114,175,141,18,27,chair
1372,28,chair,29,1,5643,18,211,138,255,207,44,69,chair
1373,22,table,22,1,5644,29,95,604,728,720,633,116,dining table
1374,42,table,42,1,5644,32,3,722,289,1131,286,409,dining table
1375,43,chair,43,1,5644,32,3,824,183,1062,180,238,chair
1376,44,chair,44,0,5644,87,39,818,357,1210,318,392,chair
1377,45,chair,45,0,5644,52,281,705,503,975,222,270,chair
1378,46,chair,46,0,5644,65,519,720,751,1000,232,280,chair
1379,47,chair,47,0,5644,33,725,737,888,968,163,231,chair
1380,48,table,48,0,5644,50,295,664,931,1003,636,339,dining table
1381,49,table,49,0,5644,36,627,645,1106,913,479,268,dining table
1382,50,table,50,0,5644,45,1425,721,2199,1170,774,449,dining table
1383,52,backpack,52,0,5644,51,1853,688,2068,803,215,115,backpack
1384,54,chair,54,1,5644,29,1467,806,1617,1057,150,251,chair
1385,55,chair,55,1,5644,33,1676,831,1930,1076,254,245,chair
1386,56,chair,56,1,5644,41,1823,960,2016,1409,193,449,chair
1387,57,chair,57,1,5644,61,1869,843,2091,1143,222,300,chair
1388,58,chair,58,1,5644,25,2030,951,2199,1126,169,175,chair
1389,59,chair,59,1,5644,39,2020,755,2199,963,179,208,chair
1390,60,chair,60,1,5644,28,1263,899,1611,1038,348,139,chair
1391,61,chair,61,1,5644,18,991,869,1208,963,217,94,chair
1392,62,chair,62,1,5644,29,1055,957,1443,1306,388,349,chair
1393,63,chair,63,1,5644,42,1417,1035,1825,1572,408,537,chair
1394,64,chair,64,1,5644,52,1169,1224,1689,1648,520,424,chair
1395,65,chair,65,1,5644,78,746,1101,1208,1648,462,547,chair
1396,68,table,68,0,5644,32,998,788,1979,1100,981,312,dining table
1397,69,table,69,1,5644,18,692,935,2050,1649,1358,714,dining table
1398,33,table,34,1,5645,20,918,682,1597,832,679,150,dining table
1399,34,table,35,1,5645,21,861,717,1328,873,467,156,dining table
1400,50,table,51,1,5645,30,408,747,1206,1015,798,268,dining table
1401,51,chair,52,1,5645,16,470,836,584,1007,114,171,chair
1402,57,table,58,1,5645,18,427,950,1467,1199,1040,249,dining table
1403,20,chair,21,1,20477,18,1246,945,1459,1177,213,232,chair
1404,21,chair,22,1,20477,40,292,864,737,1507,445,643,chair
1405,24,chair,25,1,20477,27,1895,923,2196,1650,301,727,chair
1406,32,table,33,0,20477,32,1569,579,2080,719,511,140,dining table
1407,36,chair,37,1,20477,19,1867,595,1978,752,111,157,chair
1408,37,chair,38,1,20477,17,1802,635,1919,784,117,149,chair
1409,47,chair,48,1,20477,28,648,737,941,1106,293,369,chair
1410,48,chair,49,1,20477,26,1146,740,1317,1104,171,364,chair
1411,60,chair,61,1,20477,17,1179,536,1258,693,79,157,chair
1412,17,door,18,0,20478,28,1905,424,2199,950,294,526,door
1413,23,door,24,0,20478,21,1289,473,1523,840,234,367,door
1414,25,table,26,0,20478,36,1701,933,2199,1405,498,472,dining table
1415,27,table,28,0,20478,21,913,982,1606,1378,693,396,dining table
1416,28,table,29,0,20478,23,1384,892,1838,1185,454,293,dining table
1417,38,chair,39,0,20478,15,805,872,901,994,96,122,chair
1418,16,chair,17,0,20479,27,1238,704,1460,1026,222,322,chair
1419,19,chair,20,1,20479,20,1158,673,1297,865,139,192,chair
1420,22,table,23,0,20479,20,920,592,1289,769,369,177,dining table
1421,26,table,27,0,20479,26,303,627,727,676,424,49,dining table
1422,27,chair,28,0,20479,21,305,639,429,807,124,168,chair
1423,28,chair,29,0,20479,17,417,667,522,818,105,151,chair
1424,29,chair,30,0,20479,21,582,659,710,808,128,149,chair
1425,31,table,32,0,20479,15,3,659,149,884,146,225,dining table
1426,17,desk,18,0,20480,23,1,727,392,1297,391,570,desk
1427,25,chair,26,1,20480,37,699,938,1052,1442,353,504,chair
1428,26,chair,27,1,20480,39,905,949,1269,1531,364,582,chair
1429,27,chair,28,1,20480,28,383,890,562,1199,179,309,chair
1430,29,chair,30,1,20480,18,1231,824,1391,1163,160,339,chair
1431,30,chair,31,1,20480,28,1339,957,1613,1264,274,307,chair
1432,34,chair,35,1,20480,18,547,846,743,976,196,130,chair
1433,37,chair,38,1,20480,15,837,789,976,941,139,152,chair
1434,38,chair,39,1,20480,15,924,808,1057,951,133,143,chair
1435,40,chair,41,1,20480,17,1597,871,1732,1112,135,241,chair
1436,45,chair,46,1,20480,33,689,778,873,947,184,169,chair
1437,46,chair,47,1,20480,23,1169,707,1300,843,131,136,chair
1438,48,chair,49,1,20480,16,1081,750,1185,853,104,103,chair
1439,14,table,15,0,20481,17,308,962,1013,1128,705,166,dining table
1440,16,chair,17,1,20481,15,995,1001,1110,1245,115,244,chair
1441,21,chair,22,0,20481,27,1684,1191,2008,1493,324,302,chair
1442,22,chair,23,1,20481,15,1341,1196,1714,1442,373,246,chair
1443,27,table,28,1,20481,38,249,1274,1005,1647,756,373,dining table
1444,28,chair,29,1,20481,23,166,1277,535,1650,369,373,chair
1445,29,chair,30,1,20481,17,520,1398,897,1649,377,251,chair
1446,18,table,19,0,20482,28,930,935,1598,1200,668,265,dining table
1447,21,chair,22,1,20482,22,920,926,1094,1180,174,254,chair
1448,28,chair,29,0,20482,35,192,540,453,853,261,313,chair
1449,29,chair,30,0,20482,26,344,536,532,812,188,276,chair
1450,31,chair,32,0,20482,34,4,532,232,816,228,284,chair
1451,32,chair,33,1,20482,28,134,500,335,643,201,143,chair
1452,34,table,35,0,20482,31,529,659,850,864,321,205,dining table
1453,41,chair,42,0,20482,27,765,532,965,761,200,229,chair
1454,42,chair,43,0,20482,27,952,524,1162,769,210,245,chair
1455,43,chair,44,0,20482,31,1232,531,1438,774,206,243,chair
1456,44,chair,45,1,20482,19,1070,531,1194,681,124,150,chair
1457,46,chair,47,1,20482,15,1169,818,1288,937,119,119,chair
1458,48,chair,49,1,20482,23,1435,523,1574,711,139,188,chair
1459,59,chair,60,1,20482,17,725,597,824,656,99,59,chair
1460,62,chair,63,1,20482,23,1015,492,1099,605,84,113,chair
1461,63,chair,64,1,20482,20,1326,524,1436,696,110,172,chair
1462,17,door,18,0,20483,34,740,417,976,828,236,411,door
1463,20,person,21,1,20483,67,0,832,670,1648,670,816,person
1464,22,person,23,1,20483,50,3,622,163,1041,160,419,person
1465,27,person,28,1,20483,40,384,622,566,845,182,223,person
1466,30,person,31,1,20483,33,745,633,872,832,127,199,person
1467,32,chair,33,1,20483,38,693,799,867,1062,174,263,chair
1468,33,person,34,1,20483,27,84,961,200,1259,116,298,person
1469,34,chair,35,1,20483,26,559,931,734,1362,175,431,chair
1470,36,person,37,1,20483,78,878,836,1307,1564,429,728,person
1471,37,chair,38,1,20483,25,1149,1068,1345,1579,196,511,chair
1472,39,person,40,1,20483,58,971,722,1159,1114,188,392,person
1473,41,person,42,1,20483,87,1333,756,1663,1350,330,594,person
1474,42,chair,43,1,20483,24,1611,943,1735,1321,124,378,chair
1475,44,person,45,1,20483,64,1721,745,1965,1184,244,439,person
1476,46,chair,47,1,20483,19,2007,838,2057,1046,50,208,chair
1477,47,person,48,1,20483,25,1925,722,2051,851,126,129,person
1478,49,person,50,1,20483,41,1304,708,1456,970,152,262,person
1479,51,person,52,1,20483,20,1318,654,1405,763,87,109,person
1480,54,person,55,1,20483,29,1574,693,1680,899,106,206,person
1481,57,person,58,1,20483,32,917,680,1092,808,175,128,person
1482,60,person,61,1,20483,30,1004,619,1134,767,130,148,person
1483,64,window,65,0,20483,17,205,378,569,673,364,295,window
1484,13,table,14,0,23082,16,300,343,549,400,249,57,dining table
1485,14,table,15,0,23082,15,131,383,355,450,224,67,dining table
1486,16,table,17,0,23082,27,367,364,731,625,364,261,dining table
1487,23,person,24,0,23082,58,0,322,144,690,144,368,person
1488,24,person,25,1,23082,53,732,261,874,496,142,235,person
1489,25,person,26,0,23082,16,971,251,1022,315,51,64,person
1490,26,chair,27,0,23082,40,70,550,268,768,198,218,chair
1491,27,chair,28,0,23082,52,254,492,495,768,241,276,chair
1492,28,chair,29,0,23082,36,492,410,642,628,150,218,chair
1493,29,chair,30,0,23082,34,619,385,759,564,140,179,chair
1494,30,chair,31,1,23082,28,746,357,880,494,134,137,chair
1495,39,chair,40,1,23082,17,584,275,642,320,58,45,chair
1496,40,table,41,0,23082,21,458,290,566,342,108,52,dining table
1497,5,table,6,0,23083,50,347,293,594,600,247,307,dining table
1498,6,chair,7,0,23083,63,363,336,561,600,198,264,chair
1499,7,table,8,0,23083,31,581,299,800,599,219,300,dining table
1500,8,chair,9,0,23083,58,597,345,783,599,186,254,chair
1501,13,table,14,0,23083,38,53,274,267,530,214,256,dining table
1502,14,chair,15,0,23083,52,67,310,258,542,191,232,chair
1503,17,table,18,1,23083,21,0,268,133,495,133,227,dining table
1504,19,chair,20,1,23083,34,1,299,59,510,58,211,chair
1505,21,table,22,1,23083,16,479,237,626,301,147,64,dining table
1506,31,table,32,0,23083,17,111,220,219,280,108,60,dining table
1507,32,table,33,1,23083,21,189,221,297,386,108,165,dining table
1508,33,table,34,1,23083,36,280,222,418,386,138,164,dining table
1509,34,chair,35,1,23083,44,278,241,391,391,113,150,chair
1510,35,chair,36,1,23083,27,193,241,271,392,78,151,chair
1511,37,table,38,1,23083,28,383,194,488,291,105,97,dining table
1512,42,chair,43,1,23083,31,388,203,472,292,84,89,chair
1513,9,desk,10,0,23084,33,59,316,206,476,147,160,desk
1514,10,desk,11,0,23084,26,296,315,429,479,133,164,desk
1515,11,desk,12,0,23084,36,413,312,567,480,154,168,desk
1516,12,desk,13,1,23084,18,598,295,640,426,42,131,desk
1517,13,desk,14,1,23084,23,556,283,640,395,84,112,desk
1518,14,desk,15,1,23084,24,1,317,99,478,98,161,desk
1519,4,person,5,0,23085,69,4,215,305,679,301,464,person
1520,5,person,6,0,23085,48,762,195,853,443,91,248,person
1521,6,person,7,0,23085,33,544,237,640,391,96,154,person
1522,7,person,8,0,23085,29,468,239,541,391,73,152,person
1523,8,person,9,1,23085,18,653,302,710,363,57,61,person
1524,9,person,10,1,23085,16,712,290,753,333,41,43,person
1525,10,person,11,1,23085,32,663,214,757,295,94,81,person
1526,11,person,12,1,23085,20,598,218,639,286,41,68,person
1527,12,chair,13,1,23085,23,657,324,746,439,89,115,chair
1528,13,chair,14,1,23085,23,537,314,631,426,94,112,chair
1529,14,person,15,1,23085,43,853,234,979,370,126,136,person
1530,15,chair,16,1,23085,20,912,295,989,384,77,89,chair
1531,16,person,17,1,23085,22,944,202,1000,269,56,67,person
1532,17,person,18,1,23085,26,907,182,973,235,66,53,person
1533,18,person,19,1,23085,18,915,184,949,222,34,38,person
1534,19,person,20,1,23085,26,853,212,913,299,60,87,person
1535,21,person,22,1,23085,17,741,231,791,312,50,81,person
1536,22,person,23,1,23085,16,744,199,770,253,26,54,person
1537,24,person,25,1,23085,21,530,213,569,284,39,71,person
1538,25,table,26,1,23085,30,515,277,715,319,200,42,dining table
1539,26,person,27,1,23085,21,508,170,549,249,41,79,person
1540,28,person,28,1,23085,32,434,210,518,283,84,73,person
1541,30,chair,30,1,23085,16,398,259,449,299,51,40,chair
1542,32,chair,32,0,23085,20,443,309,524,416,81,107,chair
1543,36,table,36,1,23085,31,170,382,359,583,189,201,dining table
1544,37,person,37,1,23085,37,250,181,331,398,81,217,person
1545,38,person,38,1,23085,29,125,198,196,371,71,173,person
1546,39,person,39,1,23085,38,146,179,215,370,69,191,person
1547,40,person,40,1,23085,28,192,177,240,342,48,165,person
1548,43,person,43,1,23085,26,233,188,266,284,33,96,person
1549,2,clock,3,1,5673,22,403,71,638,365,235,294,clock
1550,3,clock,4,1,5673,22,3,76,246,370,243,294,clock
1551,1,clock,2,1,5674,18,153,80,448,371,295,291,clock
1552,5,clock,6,1,5675,19,2,2,233,253,231,251,clock
1553,6,clock,7,1,5675,16,381,12,598,260,217,248,clock
1554,4,clock,5,1,5676,19,1226,126,1598,960,372,834,clock
1555,5,clock,6,1,5676,16,0,119,263,1051,263,932,clock
1556,2,clock,3,1,20486,31,84,23,364,284,280,261,clock
1557,6,window,7,0,5685,26,50,128,130,406,80,278,window
1558,7,person,8,0,5685,34,110,362,151,492,41,130,person
1559,8,window,9,0,5685,23,163,207,197,403,34,196,window
1560,11,person,12,1,5690,16,117,127,128,162,11,35,person
1561,12,person,13,0,5690,21,153,128,167,161,14,33,person
1562,3,flowerpot,4,0,120,20,1699,1103,1825,1226,126,123,potted plant
1563,7,sofa,8,1,120,97,243,957,847,1288,604,331,couch
1564,18,sofa,19,1,120,170,1061,962,1633,1293,572,331,couch
1565,34,bottle,35,0,120,21,1240,1097,1261,1174,21,77,bottle
1566,40,person,41,1,120,98,589,880,835,1227,246,347,person
1567,51,person,52,0,120,103,1151,889,1329,1159,178,270,person
1568,64,person,65,0,120,141,1332,885,1628,1307,296,422,person
1569,8,person,9,1,5959,17,53,161,80,188,27,27,person
1570,9,person,10,1,5959,22,77,159,105,191,28,32,person
1571,11,person,12,1,5959,17,139,156,157,172,18,16,person
1572,12,person,13,1,5959,16,157,154,171,171,14,17,person
1573,13,person,14,1,5959,18,196,160,217,180,21,20,person
1574,14,person,15,1,5959,18,230,165,256,192,26,27,person
1575,15,person,16,1,5959,19,280,167,304,195,24,28,person
1576,16,person,17,1,5959,18,330,162,354,190,24,28,person
1577,19,chair,20,1,5959,23,253,207,306,265,53,58,chair
1578,26,chair,27,0,5959,33,207,203,259,265,52,62,chair
1579,4,chair,5,0,5960,20,462,351,554,491,92,140,chair
1580,18,chair,19,0,5962,28,719,384,834,552,115,168,chair
1581,19,chair,20,0,5962,29,626,374,732,534,106,160,chair
1582,20,chair,21,0,5962,32,542,362,644,514,102,152,chair
1583,21,chair,22,0,5962,32,463,354,562,497,99,143,chair
1584,22,chair,23,0,5962,33,396,343,488,479,92,136,chair
1585,24,chair,25,0,5962,28,250,325,341,445,91,120,chair
1586,25,chair,26,0,5962,26,195,318,278,434,83,116,chair
1587,26,chair,27,0,5962,26,149,312,224,417,75,105,chair
1588,27,chair,28,0,5962,28,104,308,177,411,73,103,chair
1589,28,chair,29,0,5962,23,69,301,137,394,68,93,chair
1590,10,chair,11,1,5963,17,117,166,138,206,21,40,chair
1591,13,chair,14,1,5963,21,97,174,126,234,29,60,chair
1592,14,chair,15,1,5963,18,71,174,96,195,25,21,chair
1593,17,chair,18,1,5963,15,36,169,55,187,19,18,chair
1594,18,chair,19,1,5963,16,43,174,65,198,22,24,chair
1595,22,chair,23,1,5963,15,16,184,44,210,28,26,chair
1596,25,chair,26,1,5963,17,54,183,81,210,27,27,chair
1597,26,chair,27,1,5963,20,89,183,120,257,31,74,chair
1598,27,chair,28,1,5963,24,72,194,115,273,43,79,chair
1599,28,chair,29,1,5963,30,26,193,73,264,47,71,chair
1600,32,chair,33,1,5963,28,46,211,108,298,62,87,chair
1601,33,chair,34,1,5963,20,2,256,90,299,88,43,chair
1602,38,chair,39,1,5963,18,175,169,198,216,23,47,chair
1603,39,chair,40,1,5963,17,183,173,208,233,25,60,chair
1604,46,chair,47,1,5963,16,242,173,265,196,23,23,chair
1605,48,chair,49,1,5963,15,261,181,290,205,29,24,chair
1606,49,chair,50,1,5963,20,188,181,221,257,33,76,chair
1607,50,chair,51,1,5963,25,192,194,239,275,47,81,chair
1608,51,chair,52,1,5963,15,214,173,235,196,21,23,chair
1609,52,chair,53,1,5963,19,227,182,255,221,28,39,chair
1610,53,chair,54,1,5963,19,244,193,285,235,41,42,chair
1611,56,chair,57,1,5963,33,201,219,279,298,78,79,chair
1612,13,chair,14,0,5967,36,214,922,677,1463,463,541,chair
1613,14,chair,15,1,5967,33,639,869,901,1425,262,556,chair
1614,15,chair,16,1,5967,24,640,1008,1180,1465,540,457,chair
1615,16,chair,17,1,5967,31,0,870,347,1466,347,596,chair
1616,20,chair,21,1,5968,15,1349,876,1494,992,145,116,chair
1617,27,chair,28,1,5968,18,949,913,1114,1048,165,135,chair
1618,28,chair,29,1,5968,17,831,906,932,1031,101,125,chair
1619,29,chair,30,1,5968,17,723,898,818,1012,95,114,chair
1620,31,chair,32,1,5968,17,523,918,630,1042,107,124,chair
1621,32,chair,33,1,5968,24,750,932,921,1115,171,183,chair
1622,33,chair,34,1,5968,17,228,942,376,1099,148,157,chair
1623,34,chair,35,1,5968,15,338,950,505,1127,167,177,chair
1624,35,chair,36,1,5968,27,465,959,648,1238,183,279,chair
1625,36,chair,37,1,5968,66,476,976,900,1363,424,387,chair
1626,37,chair,38,1,5968,18,0,1012,108,1278,108,266,chair
1627,38,chair,39,1,5968,38,2,1008,264,1397,262,389,chair
1628,39,chair,40,0,5968,75,69,1031,583,1530,514,499,chair
1629,40,chair,41,1,5968,25,896,934,1135,1172,239,238,chair
1630,41,chair,42,1,5968,26,1090,915,1293,1145,203,230,chair
1631,42,chair,43,1,5968,26,1242,896,1418,1053,176,157,chair
1632,54,chair,55,1,5968,17,1904,1096,2199,1365,295,269,chair
1633,55,chair,56,1,5968,17,1742,1285,2199,1640,457,355,chair
1634,56,chair,57,1,5968,19,1834,911,2026,1023,192,112,chair
1635,57,chair,58,1,5968,17,1651,909,1815,987,164,78,chair
1636,58,chair,59,1,5968,21,1771,943,1994,1082,223,139,chair
1637,59,chair,60,1,5968,23,1555,940,1737,1063,182,123,chair
1638,60,chair,61,1,5968,30,1422,973,1648,1156,226,183,chair
1639,61,chair,62,1,5968,35,1648,985,1989,1205,341,220,chair
1640,62,chair,63,1,5968,47,1503,1057,1917,1445,414,388,chair
1641,63,chair,64,1,5968,30,1213,1033,1542,1240,329,207,chair
1642,64,chair,65,1,5968,41,825,1133,1251,1536,426,403,chair
1643,65,chair,66,1,5968,38,1202,1187,1788,1642,586,455,chair
1644,66,chair,67,1,5968,27,4,1375,512,1640,508,265,chair
1645,11,chair,12,0,5969,23,859,475,943,624,84,149,chair
1646,12,chair,13,1,5969,22,767,484,866,652,99,168,chair
1647,13,chair,14,1,5969,20,789,468,860,556,71,88,chair
1648,14,chair,15,1,5969,15,722,463,779,514,57,51,chair
1649,15,chair,16,1,5969,16,664,457,718,510,54,53,chair
1650,16,chair,17,1,5969,17,606,453,652,517,46,64,chair
1651,17,chair,18,1,5969,20,691,480,756,565,65,85,chair
1652,18,chair,19,1,5969,15,557,450,600,489,43,39,chair
1653,22,chair,23,1,5969,21,311,443,364,495,53,52,chair
1654,24,chair,25,1,5969,17,403,451,442,500,39,49,chair
1655,26,chair,27,1,5969,20,504,463,561,542,57,79,chair
1656,27,chair,28,1,5969,16,563,468,616,514,53,46,chair
1657,28,chair,29,1,5969,16,627,475,683,525,56,50,chair
1658,29,chair,30,1,5969,31,633,504,727,699,94,195,chair
1659,30,chair,31,0,5969,39,709,515,842,722,133,207,chair
1660,31,chair,32,1,5969,19,559,496,643,595,84,99,chair
1661,32,chair,33,1,5969,20,488,485,560,585,72,100,chair
1662,33,chair,34,1,5969,19,423,477,487,564,64,87,chair
1663,34,chair,35,1,5969,18,366,472,428,543,62,71,chair
1664,35,chair,36,1,5969,20,314,467,370,553,56,86,chair
1665,38,chair,39,1,5969,15,236,421,268,479,32,58,chair
1666,48,chair,49,1,5969,15,193,429,226,496,33,67,chair
1667,50,chair,51,1,5969,19,266,459,310,541,44,82,chair
1668,60,chair,61,1,5969,15,103,439,138,504,35,65,chair
1669,61,chair,62,1,5969,21,48,464,113,623,65,159,chair
1670,62,chair,63,1,5969,21,87,472,155,640,68,168,chair
1671,63,chair,64,1,5969,24,135,477,205,657,70,180,chair
1672,64,chair,65,1,5969,24,179,488,259,675,80,187,chair
1673,65,chair,66,1,5969,28,236,500,319,697,83,197,chair
1674,66,chair,67,1,5969,28,297,509,387,723,90,214,chair
1675,67,chair,68,1,5969,25,363,523,467,746,104,223,chair
1676,68,chair,69,1,5969,25,447,534,557,760,110,226,chair
1677,69,chair,70,0,5969,36,540,549,700,762,160,213,chair
1678,70,chair,71,1,5969,28,2,551,80,674,78,123,chair
1679,16,chair,17,0,5970,30,574,505,805,869,231,364,chair
1680,17,chair,18,0,5970,34,397,481,587,787,190,306,chair
1681,3,person,4,1,23133,65,366,110,743,681,377,571,person
1682,5,person,6,1,23134,27,504,340,557,416,53,76,person
1683,9,chair,10,0,23134,15,421,432,482,470,61,38,chair
1684,13,person,14,1,23134,26,614,396,641,460,27,64,person
1685,14,person,15,1,23134,45,607,395,728,525,121,130,person
1686,16,table,17,1,23134,21,677,482,778,542,101,60,dining table
1687,18,person,19,1,23134,39,948,391,1021,503,73,112,person
1688,20,person,21,1,23134,62,738,375,1011,602,273,227,person
1689,21,person,22,1,23134,77,516,393,743,680,227,287,person
1690,22,person,23,1,23134,23,274,364,312,416,38,52,person
1691,23,person,24,1,23134,66,216,375,396,611,180,236,person
1692,24,person,25,1,23134,38,136,376,214,544,78,168,person
1693,26,person,27,1,23134,36,107,384,152,441,45,57,person
1694,27,person,28,1,23134,27,66,373,112,435,46,62,person
1695,28,person,29,1,23134,29,5,369,44,468,39,99,person
1696,29,person,30,1,23134,66,20,371,140,545,120,174,person
1697,30,chair,31,1,23134,37,2,438,121,550,119,112,chair
1698,31,chair,32,1,23134,45,114,459,188,657,74,198,chair
1699,35,bottle,36,0,23134,15,655,473,675,521,20,48,bottle
1700,37,chair,38,1,23134,31,713,549,1008,682,295,133,chair
1701,10,person,11,1,23135,22,192,198,248,268,56,70,person
1702,14,person,15,0,23135,63,177,326,375,599,198,273,person
1703,15,chair,16,0,23135,38,242,418,390,641,148,223,chair
1704,16,person,17,1,23135,32,379,328,467,530,88,202,person
1705,17,chair,18,1,23135,24,377,414,468,608,91,194,chair
1706,18,person,19,1,23135,31,463,321,541,425,78,104,person
1707,19,person,20,1,23135,42,402,340,536,594,134,254,person
1708,20,chair,21,1,23135,39,399,443,566,682,167,239,chair
1709,21,person,22,1,23135,20,535,317,567,406,32,89,person
1710,22,person,23,1,23135,42,530,323,644,579,114,256,person
1711,23,chair,24,1,23135,21,543,431,665,594,122,163,chair
1712,24,person,25,1,23135,27,640,323,711,409,71,86,person
1713,25,person,26,1,23135,26,644,336,707,460,63,124,person
1714,26,person,27,1,23135,66,485,357,785,682,300,325,person
1715,27,chair,28,1,23135,35,586,472,810,683,224,211,chair
1716,28,person,29,1,23135,26,722,330,805,430,83,100,person
1717,29,person,30,1,23135,23,774,323,816,394,42,71,person
1718,32,person,33,1,23135,16,811,324,847,379,36,55,person
1719,33,person,34,1,23135,21,803,337,866,429,63,92,person
1720,35,person,36,1,23135,24,872,368,929,569,57,201,person
1721,36,person,37,1,23135,22,891,316,928,390,37,74,person
1722,37,person,38,1,23135,20,920,312,955,374,35,62,person
1723,39,person,40,1,23135,24,916,336,974,443,58,107,person
1724,40,person,41,1,23135,32,925,352,985,468,60,116,person
1725,41,person,42,1,23135,20,974,349,1022,548,48,199,person
1726,42,person,43,1,23135,15,987,338,1022,390,35,52,person
1727,43,chair,44,1,23135,21,788,459,898,641,110,182,chair
1728,44,chair,45,1,23135,18,872,446,964,586,92,140,chair
1729,45,chair,46,1,23135,16,936,435,1007,577,71,142,chair
1730,47,person,48,1,23135,17,842,577,1023,682,181,105,person
1731,51,person,52,1,23135,18,719,297,746,337,27,40,person
1732,52,person,53,1,23135,17,665,284,698,328,33,44,person
1733,2,person,3,1,23136,55,626,77,926,479,300,402,person
1734,3,person,4,1,23136,42,473,97,716,393,243,296,person
1735,4,person,5,1,23136,68,244,185,457,680,213,495,person
1736,5,person,6,1,23136,62,49,129,264,680,215,551,person
1737,6,person,7,1,23136,16,0,226,40,628,40,402,person
1738,2,person,3,1,23137,16,936,428,1023,626,87,198,person
1739,3,person,4,1,23137,75,448,194,1023,675,575,481,person
1740,4,person,5,1,23137,64,1,165,448,683,447,518,person
1741,9,table,10,0,23138,16,551,167,623,197,72,30,dining table
1742,11,chair,12,0,23138,25,509,308,664,554,155,246,chair
1743,12,chair,13,1,23138,25,425,288,537,492,112,204,chair
1744,13,chair,14,1,23138,29,355,272,437,445,82,173,chair
1745,14,chair,15,0,23138,28,299,262,370,416,71,154,chair
1746,1,table,2,0,23139,40,0,235,312,571,312,336,dining table
1747,2,table,3,0,23139,18,2,166,114,219,112,53,dining table
1748,3,table,4,0,23139,44,420,168,658,243,238,75,dining table
1749,5,chair,6,0,23139,30,697,232,800,462,103,230,chair
1750,6,chair,7,0,23139,21,675,189,732,371,57,182,chair
1751,8,chair,9,0,23139,25,534,187,638,322,104,135,chair
1752,9,chair,10,0,23139,25,619,151,722,310,103,159,chair
1753,10,chair,11,0,23139,24,437,178,523,319,86,141,chair
1754,14,chair,15,0,23139,30,371,150,440,287,69,137,chair
1755,15,chair,16,0,23139,37,295,228,425,467,130,239,chair
1756,16,chair,17,1,23139,21,304,191,366,328,62,137,chair
1757,27,fork,28,0,23139,15,118,338,137,366,19,28,fork
1758,37,chair,38,0,23139,34,104,333,316,599,212,266,chair
1759,5,bench,6,0,6146,15,6,1165,593,1597,587,432,bench
1760,7,bench,8,0,6146,20,0,1081,298,1476,298,395,bench
1761,3,door,4,0,6148,19,388,532,747,1400,359,868,door
1762,5,door,6,0,6148,19,1262,519,1503,1355,241,836,door
1763,4,person,5,0,6150,25,45,122,93,224,48,102,person
1764,5,person,6,1,6150,21,131,129,160,222,29,93,person
1765,1,person,2,1,6405,48,19,22,197,161,178,139,person
1766,3,person,4,1,6405,44,207,82,294,348,87,266,person
1767,4,person,5,1,6405,40,299,90,440,349,141,259,person
1768,5,person,6,1,6405,51,433,98,541,348,108,250,person
1769,7,chair,8,1,6406,15,366,79,439,128,73,49,chair
1770,3,chair,4,1,6408,18,28,68,122,151,94,83,chair
1771,5,person,6,0,6409,48,139,63,200,228,61,165,person
1772,6,person,7,1,6409,16,33,95,64,121,31,26,person
1773,18,bench,19,1,6410,17,2,337,133,426,131,89,bench
1774,19,bench,20,0,6410,30,397,277,639,397,242,120,bench
1775,16,desk,17,1,6411,17,0,458,167,584,167,126,desk
1776,31,person,31,0,6416,61,1379,754,1524,1194,145,440,person
1777,33,person,33,0,6416,36,1181,785,1286,1137,105,352,person
1778,35,person,35,0,6416,60,997,755,1156,1127,159,372,person
1779,36,person,36,1,6416,32,1124,732,1210,931,86,199,person
1780,37,person,37,0,6416,56,837,767,956,1095,119,328,person
1781,43,person,42,1,6416,15,1019,751,1081,828,62,77,person
1782,44,person,43,1,6416,54,595,948,862,1085,267,137,person
1783,46,person,45,1,6416,49,171,956,527,1139,356,183,person
1784,49,person,48,1,6416,49,213,889,410,1021,197,132,person
1785,52,person,51,1,6416,24,162,882,225,953,63,71,person
1786,53,person,52,1,6416,32,75,865,175,937,100,72,person
1787,57,person,56,1,6416,31,441,775,524,883,83,108,person
1788,59,person,58,1,6416,35,502,751,568,885,66,134,person
1789,60,person,59,1,6416,24,576,772,626,885,50,113,person
1790,61,person,60,1,6416,22,601,781,669,895,68,114,person
1791,63,chair,62,1,6416,16,731,894,801,1010,70,116,chair
1792,64,chair,63,1,6416,17,655,887,734,984,79,97,chair
1793,74,desk,72,1,6416,22,1268,828,1407,901,139,73,desk
1794,3,table,4,0,6417,15,302,259,506,344,204,85,dining table
1795,7,person,8,1,6417,28,210,173,266,268,56,95,person
1796,8,person,9,1,6417,22,323,218,389,290,66,72,person
1797,9,person,10,1,6417,17,431,244,486,334,55,90,person
1798,10,person,11,1,6417,21,370,265,430,343,60,78,person
1799,13,person,14,1,6417,45,369,271,516,408,147,137,person
1800,14,person,15,1,6417,19,343,310,499,407,156,97,person
1801,15,chair,16,1,6417,16,269,338,369,406,100,68,chair
1802,18,person,19,1,6417,24,49,242,131,335,82,93,person
1803,19,person,20,1,6417,28,200,227,301,334,101,107,person
1804,22,person,23,1,6417,28,81,250,200,381,119,131,person
1805,23,person,24,1,6417,22,142,296,296,406,154,110,person
1806,9,chair,10,1,6418,15,58,122,90,148,32,26,chair
1807,11,chair,12,0,6418,15,231,139,261,191,30,52,chair
1808,15,chair,16,1,6418,15,28,186,90,205,62,19,chair
1809,20,person,21,1,6420,19,301,69,313,112,12,43,person
1810,0,person,1,1,20588,23,59,132,114,204,55,72,person
1811,3,person,4,1,20588,22,1,95,46,138,45,43,person
1812,4,person,5,1,20588,28,49,101,95,138,46,37,person
1813,5,person,6,1,20588,25,101,96,149,139,48,43,person
1814,8,person,9,1,20588,30,59,131,114,204,55,73,person
1815,9,person,10,1,20588,27,120,132,163,193,43,61,person
1816,11,person,12,1,20588,80,153,53,243,274,90,221,person
1817,2,chair,3,0,20589,16,252,97,335,148,83,51,chair
1818,9,person,10,1,20589,19,0,213,85,300,85,87,person
1819,10,person,11,1,20589,38,98,168,294,300,196,132,person
1820,10,door,11,0,576,19,1150,225,1244,743,94,518,door
1821,16,chair,17,0,576,34,1096,570,1286,790,190,220,chair
1822,4,person,5,0,6609,34,34,159,81,236,47,77,person
1823,5,person,6,1,6609,33,93,145,138,215,45,70,person
1824,6,person,7,1,6609,33,151,185,200,276,49,91,person
1825,7,person,8,0,6609,48,95,185,165,279,70,94,person
1826,10,chair,11,1,6609,25,165,155,208,209,43,54,chair
1827,3,table,4,0,6610,24,2,188,185,288,183,100,dining table
1828,9,table,10,0,6610,22,323,167,491,262,168,95,dining table
1829,10,chair,11,1,6610,15,438,175,483,230,45,55,chair
1830,11,chair,12,0,6610,25,274,188,327,265,53,77,chair
1831,12,chair,13,0,6610,24,320,222,390,290,70,68,chair
1832,17,person,18,1,6610,19,212,81,247,136,35,55,person
1833,2,person,3,0,6612,75,91,51,240,219,149,168,person
1834,4,table,5,1,6613,16,967,677,1242,898,275,221,dining table
1835,6,chair,7,1,6613,25,789,628,1013,901,224,273,chair
1836,7,chair,8,1,6613,16,829,708,1049,899,220,191,chair
1837,13,person,14,0,6613,46,260,284,371,547,111,263,person
1838,9,chair,10,1,6615,25,718,1069,1018,1531,300,462,chair
1839,2,person,3,1,6616,54,289,125,1214,1195,925,1070,person
1840,3,person,4,1,6616,46,0,29,681,892,681,863,person
1841,5,person,6,1,6616,30,1174,0,1594,392,420,392,person
1842,6,person,7,1,6616,20,539,2,1053,185,514,183,person
1843,7,person,8,1,6616,38,2,0,368,556,366,556,person
1844,4,table,5,0,6617,23,660,436,1367,990,707,554,dining table
1845,5,chair,6,0,6618,25,792,691,1052,999,260,308,chair
1846,8,chair,9,1,6618,16,457,601,601,807,144,206,chair
1847,10,book,11,1,6618,15,254,673,487,995,233,322,book
1848,3,person,4,1,6619,42,3,119,92,210,89,91,person
1849,4,person,5,1,6619,43,19,182,96,281,77,99,person
1850,5,person,6,1,6619,41,176,160,230,247,54,87,person
1851,6,person,7,0,6619,51,116,173,179,319,63,146,person
1852,8,chair,9,1,6619,25,21,242,97,341,76,99,chair
1853,9,chair,10,0,6619,27,116,236,206,344,90,108,chair
1854,10,chair,11,1,6619,24,195,211,242,307,47,96,chair
1855,5,table,6,0,6620,22,3,1194,909,1634,906,440,dining table
1856,7,chair,8,0,6620,21,555,1313,813,1647,258,334,chair
1857,8,chair,9,1,6620,20,129,1359,377,1640,248,281,chair
1858,9,chair,10,1,6620,17,784,1277,945,1597,161,320,chair
1859,11,chair,12,0,6620,19,1286,1309,1495,1634,209,325,chair
1860,12,chair,13,0,6620,24,1491,1366,1739,1640,248,274,chair
1861,13,chair,14,0,6620,25,1872,1342,2133,1637,261,295,chair
1862,7,person,8,1,6621,20,273,6,389,123,116,117,person
1863,9,table,10,0,6621,23,751,848,1756,1649,1005,801,dining table
1864,10,person,11,1,6621,38,661,639,906,1018,245,379,person
1865,11,person,12,1,6621,42,1373,620,1690,975,317,355,person
1866,12,person,13,1,6621,56,1289,1003,1977,1561,688,558,person
1867,13,chair,14,1,6621,32,1405,1205,1959,1649,554,444,chair
1868,15,person,16,1,6621,62,502,1006,1231,1635,729,629,person
1869,16,chair,17,1,6621,36,592,1326,1156,1649,564,323,chair
1870,18,plate,19,0,6621,15,805,1106,1098,1270,293,164,plate
1871,5,person,6,1,6622,33,207,384,300,617,93,233,person
1872,6,person,7,1,6622,42,286,339,415,568,129,229,person
1873,11,chair,12,1,6622,17,78,564,199,763,121,199,chair
1874,15,table,16,1,6622,15,137,575,776,767,639,192,dining table
1875,16,chair,17,1,6622,17,749,572,845,747,96,175,chair
1876,18,chair,19,1,6622,29,811,507,956,737,145,230,chair
1877,11,chair,12,0,6623,37,1521,635,1780,1009,259,374,chair
1878,22,bottle,23,0,6623,20,1914,1345,1994,1505,80,160,bottle
1879,8,table,9,1,6624,18,2,866,671,1195,669,329,dining table
1880,9,chair,10,1,6624,31,563,945,818,1193,255,248,chair
1881,20,bench,21,1,6624,19,41,744,297,890,256,146,bench
1882,32,chair,32,1,6624,31,415,868,632,1200,217,332,chair
1883,13,chair,14,0,8291,19,329,187,382,258,53,71,chair
1884,18,chair,19,0,8291,19,60,186,107,250,47,64,chair
1885,24,chair,25,1,8291,15,7,179,46,238,39,59,chair
1886,4,window,5,0,8295,19,252,40,314,101,62,61,window
1887,8,sofa,9,1,8300,15,1077,558,1274,722,197,164,couch
1888,20,person,21,1,8782,25,256,197,297,288,41,91,person
1889,22,table,23,0,8782,17,3,283,307,375,304,92,dining table
1890,8,window,9,1,8785,15,876,350,1245,689,369,339,window
1891,5,person,6,0,8786,22,562,78,588,160,26,82,person
1892,8,person,9,1,8786,17,568,0,611,88,43,88,person
1893,9,person,10,0,8786,22,538,7,575,88,37,81,person
1894,11,person,12,1,8786,25,690,1,789,264,99,263,person
1895,8,person,9,0,9968,16,155,116,160,131,5,15,person
1896,24,table,23,0,9975,19,216,149,256,173,40,24,dining table
1897,22,chair,23,0,9976,19,385,536,501,716,116,180,chair
1898,13,chair,14,0,9989,20,96,134,125,177,29,43,chair
1899,5,bed,6,0,9998,21,3,112,212,445,209,333,bed
1900,2,sink,3,0,10004,23,66,100,184,206,118,106,sink
1901,1,desk,2,1,10062,18,3,325,490,849,487,524,desk
1902,2,desk,3,1,10062,15,772,423,1276,849,504,426,desk
1903,3,person,4,1,10062,42,139,218,560,712,421,494,person
1904,5,chair,6,1,10062,18,248,590,490,848,242,258,chair
1905,6,person,7,1,10062,33,459,256,772,760,313,504,person
1906,7,person,8,1,10062,46,469,280,839,849,370,569,person
1907,8,person,9,1,10062,30,493,464,927,848,434,384,person
1908,10,bottle,11,0,10062,15,982,579,1045,774,63,195,bottle
1909,11,bottle,12,0,10062,20,1121,622,1191,829,70,207,bottle
1910,11,chair,10,1,10063,26,0,350,96,430,96,80,chair
1911,13,chair,11,1,10063,24,447,154,543,253,96,99,chair
1912,14,chair,12,1,10063,23,531,167,640,305,109,138,chair
1913,15,chair,13,1,10063,26,371,145,468,248,97,103,chair
1914,16,chair,14,1,10063,22,300,138,399,229,99,91,chair
1915,17,chair,15,1,10063,24,243,131,333,213,90,82,chair
1916,18,chair,16,1,10063,27,182,126,274,215,92,89,chair
1917,19,chair,17,1,10063,23,131,120,224,203,93,83,chair
1918,20,chair,18,1,10063,21,109,113,175,195,66,82,chair
1919,21,chair,19,1,10063,20,438,214,551,368,113,154,chair
1920,22,chair,20,1,10063,15,356,202,463,273,107,71,chair
1921,23,chair,21,1,10063,15,282,192,380,256,98,64,chair
1922,24,chair,22,1,10063,16,216,178,303,240,87,62,chair
1923,25,chair,23,1,10063,17,157,168,241,225,84,57,chair
1924,26,chair,24,1,10063,16,105,160,181,213,76,53,chair
1925,27,chair,25,1,10063,16,55,150,129,202,74,52,chair
1926,10,chair,9,1,10065,15,88,340,376,474,288,134,chair
1927,11,chair,10,0,10065,27,248,293,496,483,248,190,chair
1928,12,chair,11,0,10065,21,357,262,557,418,200,156,chair
1929,13,chair,12,0,10065,22,439,238,601,369,162,131,chair
1930,14,chair,13,0,10065,26,485,224,632,331,147,107,chair
1931,15,chair,14,0,10065,18,533,211,659,305,126,94,chair
1932,16,chair,15,1,10065,48,447,162,534,223,87,61,chair
1933,17,chair,16,1,10065,56,407,164,506,240,99,76,chair
1934,18,chair,17,1,10065,54,352,175,466,261,114,86,chair
1935,19,chair,18,1,10065,60,291,185,437,282,146,97,chair
1936,20,chair,19,1,10065,67,217,196,367,312,150,116,chair
1937,21,chair,20,1,10065,65,125,211,294,340,169,129,chair
1938,22,chair,21,1,10065,58,3,232,218,375,215,143,chair
1939,23,chair,22,1,10065,29,0,315,91,438,91,123,chair
1940,8,person,9,1,10066,49,103,154,277,548,174,394,person
1941,10,person,11,1,10066,33,717,198,823,438,106,240,person
1942,11,person,12,1,10066,35,883,192,1030,498,147,306,person
1943,12,person,13,1,10066,41,498,275,967,718,469,443,person
1944,13,person,14,1,10066,50,390,244,758,718,368,474,person
1945,14,person,15,1,10066,59,330,258,641,721,311,463,person
1946,15,person,16,1,10066,55,240,257,524,684,284,427,person
1947,23,chair,24,1,10066,21,950,361,1046,665,96,304,chair
1948,6,chair,7,0,10067,31,170,94,237,155,67,61,chair
1949,7,chair,8,0,10067,18,121,86,181,137,60,51,chair
1950,8,chair,9,0,10067,18,86,79,138,121,52,42,chair
1951,9,chair,10,0,10067,17,57,73,102,112,45,39,chair
1952,10,chair,11,0,10067,16,234,69,281,119,47,50,chair
1953,11,chair,12,0,10067,19,180,65,231,106,51,41,chair
1954,12,chair,13,0,10067,19,147,60,191,94,44,34,chair
1955,13,chair,14,1,10067,18,121,57,158,95,37,38,chair
1956,14,chair,15,1,10067,16,96,54,129,86,33,32,chair
1957,15,chair,16,1,10067,16,76,54,106,77,30,23,chair
1958,16,chair,17,1,10067,16,34,69,78,104,44,35,chair
1959,4,person,5,1,10068,72,2,1,140,267,138,266,person
1960,5,person,6,1,10068,34,109,88,168,199,59,111,person
1961,6,person,7,1,10068,38,130,94,201,221,71,127,person
1962,7,person,8,1,10068,28,215,63,260,159,45,96,person
1963,8,person,9,1,10068,45,149,95,253,231,104,136,person
1964,9,person,10,1,10068,22,275,72,315,138,40,66,person
1965,10,person,11,1,10068,16,328,88,369,141,41,53,person
1966,11,person,12,1,10068,27,353,87,399,180,46,93,person
1967,12,person,13,1,10068,53,187,104,311,246,124,142,person
1968,13,person,14,1,10068,54,231,113,370,266,139,153,person
1969,14,person,15,1,10068,26,289,123,399,266,110,143,person
1970,2,person,3,1,190,76,478,253,691,417,213,164,person
1971,10,person,11,1,190,58,61,332,159,633,98,301,person
1972,20,person,21,1,190,99,164,339,329,580,165,241,person
1973,32,person,33,1,190,82,322,340,424,600,102,260,person
1974,44,person,45,1,190,55,421,358,517,601,96,243,person
1975,56,person,57,1,190,46,503,349,571,588,68,239,person
1976,67,person,68,1,190,73,564,343,654,637,90,294,person
1977,78,person,79,1,190,59,642,355,743,640,101,285,person
1978,88,person,89,1,190,89,731,330,838,613,107,283,person
1979,101,person,102,1,190,86,793,354,946,627,153,273,person
1980,114,person,115,0,190,84,68,527,198,767,130,240,person
1981,131,person,132,0,190,97,183,514,311,760,128,246,person
1982,146,person,147,0,190,75,298,528,417,772,119,244,person
1983,163,person,164,0,190,71,407,527,516,741,109,214,person
1984,179,person,180,0,190,67,494,556,616,772,122,216,person
1985,195,person,196,0,190,56,608,539,727,768,119,229,person
1986,211,person,212,0,190,52,729,547,829,770,100,223,person
1987,227,person,228,0,190,48,800,558,930,787,130,229,person
1988,242,person,243,0,190,57,925,538,1042,792,117,254,person
1989,257,vase,258,0,190,15,257,243,294,295,37,52,vase
1990,272,table,273,1,190,16,1,627,50,808,49,181,dining table
1991,3,person,4,0,191,98,3,256,621,1020,618,764,person
1992,13,person,14,0,191,71,127,259,464,980,337,721,person
1993,6,table,7,1,192,16,259,674,2195,1648,1936,974,dining table
1994,7,person,8,1,192,29,1714,1052,2193,1648,479,596,person
1995,8,chair,9,1,192,18,773,516,1042,968,269,452,chair
1996,9,chair,10,1,192,15,2,908,276,1650,274,742,chair
1997,10,person,11,1,192,63,929,146,1642,912,713,766,person
1998,15,plate,16,0,192,26,1420,791,1796,1033,376,242,plate
1999,17,person,18,1,192,99,8,290,1001,1607,993,1317,person
2000,26,plate,27,0,192,39,655,1111,1138,1510,483,399,plate
2001,8,desk,9,0,10106,16,128,131,183,167,55,36,desk
2002,10,table,11,0,10106,18,55,176,132,228,77,52,dining table
2003,11,table,12,0,10106,21,121,180,269,227,148,47,dining table
2004,12,chair,13,0,10106,20,182,184,215,227,33,43,chair
2005,13,chair,14,1,10106,15,152,171,184,216,32,45,chair
2006,14,chair,15,1,10106,20,221,173,252,218,31,45,chair
2007,3,chair,4,0,10108,27,763,860,1076,1267,313,407,chair
2008,5,chair,6,0,10108,25,460,1003,804,1421,344,418,chair
2009,6,chair,7,0,10108,30,111,1057,511,1543,400,486,chair
2010,9,table,10,0,10108,16,1255,736,1707,1021,452,285,dining table
2011,74,chair,75,1,10108,51,1260,719,1482,988,222,269,chair
2012,82,chair,83,1,10108,19,1251,836,1480,1023,229,187,chair
2013,6,table,7,0,10109,17,30,324,126,415,96,91,dining table
2014,0,table,1,0,10110,21,469,312,707,424,238,112,dining table
2015,19,table,20,1,10111,23,250,912,1663,1653,1413,741,dining table
2016,20,chair,21,0,10111,27,110,1238,595,1653,485,415,chair
2017,21,person,22,1,10111,29,180,848,610,1452,430,604,person
2018,22,chair,23,1,10111,18,519,1345,976,1653,457,308,chair
2019,23,person,24,1,10111,44,580,909,1126,1650,546,741,person
2020,24,person,25,1,10111,28,955,692,1263,1006,308,314,person
2021,25,person,26,1,10111,39,1205,714,1613,1559,408,845,person
2022,27,table,28,0,10111,21,247,628,891,973,644,345,dining table
2023,28,chair,29,0,10111,18,119,714,253,958,134,244,chair
2024,29,person,30,1,10111,17,101,534,274,726,173,192,person
2025,31,person,32,1,10111,26,622,533,866,891,244,358,person
2026,55,chair,56,1,10111,25,1504,1008,1666,1509,162,501,chair
2027,6,table,7,0,10112,17,325,285,514,346,189,61,dining table
2028,7,table,8,0,10113,32,716,760,1309,1199,593,439,dining table
2029,8,chair,9,0,10113,17,1243,601,1354,753,111,152,chair
2030,10,chair,11,1,10113,18,1201,819,1333,1072,132,253,chair
2031,11,chair,12,1,10113,20,1130,852,1244,1128,114,276,chair
2032,12,chair,13,1,10113,22,1015,904,1187,1197,172,293,chair
2033,13,chair,14,1,10113,27,704,918,981,1199,277,281,chair
2034,15,chair,16,1,10113,16,556,735,688,932,132,197,chair
2035,16,table,17,0,10113,31,178,616,518,741,340,125,dining table
2036,4,table,5,0,10114,18,0,169,74,225,74,56,dining table
2037,15,table,16,0,10117,19,303,234,414,304,111,70,dining table
2038,16,chair,17,0,10117,19,318,258,359,311,41,53,chair
2039,17,table,18,0,10117,26,470,336,699,466,229,130,dining table
2040,18,chair,19,1,10117,23,435,372,511,467,76,95,chair
2041,38,chair,39,1,10117,16,290,243,318,286,28,43,chair
2042,6,desk,7,0,10119,20,568,626,835,876,267,250,desk
2043,15,table,16,1,10119,15,1122,621,1446,936,324,315,dining table
2044,16,chair,17,1,10119,20,1221,716,1454,949,233,233,chair
2045,17,chair,18,1,10119,19,1094,676,1300,880,206,204,chair
2046,2,person,3,1,10120,18,30,77,68,156,38,79,person
2047,3,person,4,1,10120,27,194,77,249,164,55,87,person
2048,4,person,5,1,10120,32,244,68,300,171,56,103,person
2049,6,person,7,0,10120,54,93,136,158,304,65,168,person
2050,10,person,11,1,10120,29,315,85,362,235,47,150,person
2051,12,person,13,1,10120,18,349,113,380,199,31,86,person
2052,13,person,14,0,10120,41,326,158,404,365,78,207,person
2053,35,chair,36,1,10121,15,604,384,696,466,92,82,chair
2054,46,chair,47,1,10121,32,417,220,455,263,38,43,chair
2055,7,chair,8,0,10123,15,247,258,327,342,80,84,chair
2056,9,chair,10,0,10123,17,439,229,483,293,44,64,chair
2057,0,table,1,0,10124,23,166,205,731,599,565,394,dining table
2058,7,book,8,0,10124,15,80,50,147,147,67,97,book
2059,10,chair,11,1,10124,42,420,429,714,599,294,170,chair
2060,11,chair,12,1,10124,18,648,212,747,471,99,259,chair
2061,13,backpack,14,0,23668,25,167,211,232,259,65,48,backpack
2062,14,backpack,15,0,23668,17,111,185,165,208,54,23,backpack
2063,16,backpack,17,0,23668,16,64,149,97,167,33,18,backpack
2064,19,backpack,20,0,23668,18,266,161,311,186,45,25,backpack
2065,5,person,6,1,23669,41,235,1,385,312,150,311,person
2066,6,person,7,1,23669,31,834,2,957,329,123,327,person
2067,7,table,8,0,23669,21,3,0,337,250,334,250,dining table
2068,8,person,9,0,23669,51,0,227,432,719,432,492,person
2069,9,person,10,0,23669,32,456,145,650,410,194,265,person
2070,10,person,11,1,23669,65,478,239,959,678,481,439,person
2071,11,person,12,1,23669,17,701,440,957,717,256,277,person
2072,3,person,4,0,23670,60,1115,398,1356,1007,241,609,person
2073,4,person,5,1,23670,70,958,348,1200,1001,242,653,person
2074,5,person,6,1,23670,58,877,337,1057,957,180,620,person
2075,6,person,7,1,23670,63,706,340,886,926,180,586,person
2076,7,person,8,0,23670,65,2,478,383,1199,381,721,person
2077,8,person,9,1,23670,54,417,519,635,1198,218,679,person
2078,9,person,10,1,23670,43,563,507,805,1123,242,616,person
2079,3,person,4,0,23671,38,607,270,700,535,93,265,person
2080,5,person,6,1,23671,48,548,196,632,300,84,104,person
2081,7,chair,8,1,23671,29,531,244,639,299,108,55,chair
2082,9,person,10,0,23671,68,503,322,624,536,121,214,person
2083,12,person,13,1,23671,51,452,196,534,341,82,145,person
2084,15,person,16,0,23671,73,419,268,522,536,103,268,person
2085,17,chair,18,1,23671,47,329,250,435,429,106,179,chair
2086,18,person,19,1,23671,34,333,186,427,291,94,105,person
2087,21,person,22,0,23671,74,329,265,428,536,99,271,person
2088,23,chair,24,1,23671,46,220,244,324,427,104,183,chair
2089,24,person,25,1,23671,31,240,228,319,297,79,69,person
2090,27,person,28,0,23671,59,222,276,335,527,113,251,person
2091,29,chair,30,1,23671,47,114,242,225,426,111,184,chair
2092,30,person,31,1,23671,25,128,196,211,296,83,100,person
2093,33,person,34,0,23671,59,97,276,222,536,125,260,person
2094,36,person,37,0,23671,66,3,272,123,523,120,251,person
2095,4,person,5,1,23672,17,726,301,800,600,74,299,person
2096,10,pot,11,0,23673,16,98,217,140,283,42,66,potted plant
2097,24,person,25,0,23673,63,848,293,993,767,145,474,person
2098,25,person,26,0,23673,92,716,303,875,767,159,464,person
2099,26,person,27,1,23673,71,579,269,732,720,153,451,person
2100,27,person,28,1,23673,74,569,336,756,767,187,431,person
2101,28,person,29,1,23673,62,500,283,612,739,112,456,person
2102,29,person,30,0,23673,69,396,320,552,767,156,447,person
2103,30,person,31,1,23673,55,363,312,461,721,98,409,person
2104,31,person,32,0,23673,72,204,303,383,766,179,463,person
2105,32,person,33,1,23673,59,146,309,293,744,147,435,person
2106,34,table,35,1,23673,21,2,467,152,647,150,180,dining table
2107,15,desk,16,0,10761,23,68,194,209,317,141,123,desk
2108,17,desk,18,0,10761,21,163,201,377,351,214,150,desk
2109,22,desk,23,1,10761,15,290,181,394,214,104,33,desk
2110,25,desk,26,1,10761,20,394,191,528,295,134,104,desk
2111,6,desk,7,0,10762,16,101,171,317,319,216,148,desk
2112,8,desk,9,0,10762,15,428,165,581,272,153,107,desk
2113,5,desk,6,0,10763,20,326,219,637,479,311,260,desk
2114,6,person,7,1,10763,20,515,167,611,240,96,73,person
2115,9,person,10,0,10763,53,45,158,166,434,121,276,person
2116,15,person,16,1,10765,16,826,328,900,399,74,71,person
2117,17,person,18,1,10765,20,978,333,1076,497,98,164,person
2118,20,person,21,1,10765,34,849,358,1002,540,153,182,person
2119,21,person,22,1,10765,28,715,358,831,545,116,187,person
2120,22,desk,23,0,10765,27,502,472,911,728,409,256,desk
2121,24,desk,25,0,10765,16,689,396,1279,959,590,563,desk
2122,28,person,29,1,10765,18,699,378,756,483,57,105,person
2123,29,person,30,0,10765,75,360,366,527,672,167,306,person
2124,30,person,31,1,10765,71,14,277,253,958,239,681,person
2125,12,person,13,1,10766,27,101,585,240,769,139,184,person
2126,13,person,14,1,10766,35,30,596,209,827,179,231,person
2127,14,person,15,1,10766,17,0,676,146,957,146,281,person
2128,15,person,16,1,10766,41,587,518,741,757,154,239,person
2129,16,person,17,1,10766,25,612,659,730,813,118,154,person
2130,17,person,18,1,10766,76,657,429,927,885,270,456,person
2131,18,person,19,1,10766,70,811,464,1299,1039,488,575,person
2132,58,glasses,59,0,10766,32,756,499,841,530,85,31,eye glasses
2133,74,person,75,1,10766,21,1372,594,1484,724,112,130,person
2134,13,person,14,1,10767,71,1583,544,1847,1241,264,697,person
2135,14,person,15,0,10767,69,1086,585,1290,1227,204,642,person
2136,16,chair,17,1,10767,19,1117,812,1180,1042,63,230,chair
2137,17,person,18,1,10767,131,280,398,1152,1529,872,1131,person
2138,19,cell phone,20,0,10767,15,169,1268,414,1341,245,73,cell phone
2139,22,bottle,23,1,10767,18,226,934,307,1117,81,183,bottle
2140,12,person,13,1,10768,44,3,454,714,1319,711,865,person
2141,13,person,14,1,10768,38,599,457,1189,1049,590,592,person
2142,14,person,15,1,10768,37,1088,441,1474,897,386,456,person
2143,15,person,16,1,10768,26,1340,439,1622,774,282,335,person
2144,16,person,17,1,10768,29,1589,415,1820,694,231,279,person
2145,18,person,19,1,10768,16,1764,414,1856,640,92,226,person
2146,19,person,20,1,10768,21,1840,415,2040,621,200,206,person
2147,20,person,21,1,10768,28,1854,400,2100,580,246,180,person
2148,7,desk,8,1,10938,22,710,474,1210,729,500,255,desk
2149,9,chair,10,1,10938,15,896,572,1116,748,220,176,chair
2150,10,person,11,1,10938,32,1060,441,1400,835,340,394,person
2151,13,person,14,1,10938,24,532,394,764,682,232,288,person
2152,14,person,15,1,10938,19,302,387,567,624,265,237,person
2153,15,person,16,1,10938,20,300,361,438,567,138,206,person
2154,16,person,17,1,10938,17,162,312,321,431,159,119,person
2155,18,person,19,1,10938,19,411,306,463,384,52,78,person
2156,19,person,20,1,10938,21,438,318,534,388,96,70,person
2157,20,person,21,1,10938,21,515,312,616,471,101,159,person
2158,21,person,22,1,10938,22,636,317,768,474,132,157,person
2159,22,person,23,1,10938,24,721,342,895,503,174,161,person
2160,23,person,24,1,10938,25,894,338,1042,521,148,183,person
2161,24,person,25,1,10938,30,1088,352,1242,535,154,183,person
2162,25,person,26,1,10938,25,1250,316,1376,468,126,152,person
2163,26,person,27,1,10938,38,1350,324,1553,588,203,264,person
2164,27,person,28,1,10938,20,1438,304,1543,449,105,145,person
2165,29,person,30,1,10938,16,1336,312,1401,419,65,107,person
2166,30,person,31,1,10938,18,1232,286,1302,382,70,96,person
2167,32,person,33,1,10938,20,1136,288,1223,371,87,83,person
2168,34,person,35,1,10938,19,1372,277,1429,384,57,107,person
2169,35,person,36,1,10938,15,1355,275,1399,356,44,81,person
2170,36,person,37,1,10938,20,1487,282,1563,399,76,117,person
2171,37,person,38,1,10938,15,1541,281,1585,369,44,88,person
2172,40,person,41,1,10938,18,1118,265,1180,340,62,75,person
2173,41,person,42,1,10938,19,970,264,1026,325,56,61,person
2174,43,person,44,1,10938,19,812,275,876,351,64,76,person
2175,44,person,45,1,10938,16,773,266,841,333,68,67,person
2176,45,person,46,1,10938,17,861,260,918,335,57,75,person
2177,47,person,48,1,10938,21,916,267,968,340,52,73,person
2178,48,person,49,1,10938,18,575,282,636,365,61,83,person
2179,5,desk,6,0,10939,52,0,144,127,246,127,102,desk
2180,6,desk,7,1,10939,23,82,167,255,256,173,89,desk
2181,17,desk,18,1,10941,16,396,517,605,581,209,64,desk
2182,23,desk,24,1,10941,18,437,477,610,532,173,55,desk
2183,24,desk,25,1,10941,17,461,441,612,476,151,35,desk
2184,25,desk,26,1,10941,15,481,416,616,442,135,26,desk
2185,26,desk,27,1,10941,19,497,395,614,417,117,22,desk
2186,27,chair,28,1,10941,20,98,478,230,692,132,214,chair
2187,28,chair,29,1,10941,24,174,445,296,631,122,186,chair
2188,29,chair,30,1,10941,20,223,419,329,576,106,157,chair
2189,31,desk,32,1,10941,28,71,455,269,691,198,236,desk
2190,32,desk,33,1,10941,19,149,425,313,626,164,201,desk
2191,33,desk,34,1,10941,25,200,402,349,580,149,178,desk
2192,34,desk,35,1,10941,20,240,368,392,543,152,175,desk
2193,43,desk,44,1,10941,16,835,689,1148,857,313,168,desk
2194,44,desk,45,1,10941,23,778,590,1057,859,279,269,desk
2195,45,desk,46,1,10941,19,750,528,984,756,234,228,desk
2196,46,desk,47,1,10941,18,733,485,926,645,193,160,desk
2197,49,desk,50,1,10941,15,705,401,826,538,121,137,desk
2198,50,chair,51,1,10941,23,1039,473,1149,660,110,187,chair
2199,8,desk,9,0,10942,15,0,186,226,256,226,70,desk
2200,9,chair,10,1,10942,15,13,203,72,239,59,36,chair
2201,10,chair,11,1,10942,15,70,217,128,253,58,36,chair
2202,20,chair,21,1,10943,19,117,129,146,159,29,30,chair
2203,27,chair,28,1,10943,15,226,146,255,187,29,41,chair
2204,28,chair,29,1,10943,16,177,141,204,167,27,26,chair
2205,3,desk,4,0,10944,17,0,116,171,176,171,60,desk
2206,13,desk,14,1,10944,15,43,176,256,256,213,80,desk
2207,6,desk,7,0,10945,35,19,169,202,256,183,87,desk
2208,7,desk,8,1,10945,46,155,149,255,256,100,107,desk
2209,8,desk,9,1,10945,27,0,147,84,253,84,106,desk
2210,9,desk,10,1,10945,33,50,134,158,221,108,87,desk
2211,13,desk,14,1,10945,29,121,124,206,174,85,50,desk
2212,14,desk,15,1,10945,26,186,115,249,155,63,40,desk
2213,16,desk,17,1,10945,19,2,111,67,140,65,29,desk
2214,0,chair,1,0,10946,29,53,150,134,255,81,105,chair
2215,1,chair,2,0,10946,30,172,162,245,256,73,94,chair
2216,5,chair,6,1,10946,15,207,90,239,132,32,42,chair
2217,6,chair,7,1,10946,17,183,110,230,161,47,51,chair
2218,8,chair,9,1,10946,24,101,121,155,208,54,87,chair
2219,9,chair,10,1,10946,20,0,143,41,249,41,106,chair
2220,10,chair,11,1,10946,34,19,116,78,195,59,79,chair
2221,11,chair,12,1,10946,23,72,102,113,150,41,48,chair
2222,12,chair,13,1,10946,15,16,99,53,150,37,51,chair
2223,13,chair,14,1,10946,24,128,106,169,174,41,68,chair
2224,14,chair,15,1,10946,17,151,97,186,155,35,58,chair
2225,4,desk,5,0,10947,65,50,153,179,256,129,103,desk
2226,5,desk,6,0,10947,36,158,119,243,203,85,84,desk
2227,6,desk,7,0,10947,47,99,110,166,187,67,77,desk
2228,7,desk,8,0,10947,40,30,103,101,151,71,48,desk
2229,8,desk,9,0,10947,23,151,186,255,256,104,70,desk
2230,7,table,8,0,10948,17,247,379,603,464,356,85,dining table
2231,9,table,10,0,10948,20,100,403,524,567,424,164,dining table
2232,10,chair,11,1,10948,20,352,428,490,590,138,162,chair
2233,13,table,14,0,10948,20,2,441,416,659,414,218,dining table
2234,14,chair,15,1,10948,26,92,489,300,712,208,223,chair
2235,16,table,17,0,10948,15,692,380,1002,424,310,44,dining table
2236,24,table,25,0,10948,16,540,456,1035,714,495,258,dining table
2237,25,chair,26,0,10948,31,516,502,686,741,170,239,chair
2238,26,chair,27,0,10948,25,698,511,871,765,173,254,chair
2239,27,chair,28,1,10948,15,891,516,1034,769,143,253,chair
2240,4,desk,5,0,10949,32,141,159,197,212,56,53,desk
2241,5,desk,6,1,10949,24,201,166,255,212,54,46,desk
2242,6,chair,7,1,10949,16,133,134,165,165,32,31,chair
2243,8,desk,9,0,10949,46,0,172,150,255,150,83,desk
2244,9,desk,10,1,10949,18,148,194,216,255,68,61,desk
2245,10,desk,11,0,10950,16,74,173,165,220,91,47,desk
2246,7,person,8,1,10951,21,315,117,350,155,35,38,person
2247,11,person,12,1,10951,18,3,222,116,270,113,48,person
2248,12,person,13,1,10951,24,207,179,295,267,88,88,person
2249,13,person,14,1,10951,18,155,174,206,224,51,50,person
2250,15,person,16,1,10951,29,308,176,393,302,85,126,person
2251,16,person,17,1,10951,17,257,171,307,216,50,45,person
2252,19,person,20,1,10951,15,2,150,44,195,42,45,person
2253,22,person,23,1,10951,16,47,150,76,182,29,32,person
2254,25,person,26,1,10951,22,379,176,433,257,54,81,person
2255,28,person,29,1,10951,21,419,170,475,223,56,53,person
2256,30,person,31,1,10951,21,383,259,485,336,102,77,person
2257,8,desk,9,0,10952,30,796,527,1021,767,225,240,desk
2258,7,chair,8,1,10953,17,542,390,646,504,104,114,chair
2259,25,chair,26,1,10953,16,295,511,529,733,234,222,chair
2260,26,chair,27,1,10953,31,413,562,733,839,320,277,chair
2261,27,chair,28,1,10953,26,739,627,1030,862,291,235,chair
2262,10,person,10,1,21164,46,909,513,1010,668,101,155,person
2263,12,table,12,1,21164,52,749,569,1231,666,482,97,dining table
2264,13,person,13,1,21164,29,941,386,1050,512,109,126,person
2265,14,table,14,1,21164,40,268,625,696,722,428,97,dining table
2266,20,table,20,1,21164,44,1061,585,1588,731,527,146,dining table
2267,23,table,23,1,21164,37,0,714,475,843,475,129,dining table
2268,24,table,24,1,21164,40,610,663,915,752,305,89,dining table
2269,26,person,26,1,21164,66,84,592,357,1086,273,494,person
2270,27,chair,27,1,21164,15,179,825,375,893,196,68,chair
2271,29,person,29,1,21164,55,463,578,664,821,201,243,person
2272,30,person,30,1,21164,41,679,603,864,812,185,209,person
2273,33,person,33,1,21164,33,967,557,1074,738,107,181,person
2274,42,person,42,1,21164,51,1161,541,1305,741,144,200,person
2275,45,person,45,1,21164,50,1347,529,1560,802,213,273,person
2276,48,table,48,1,21164,66,0,769,933,1198,933,429,dining table
2277,49,table,49,1,21164,20,1021,725,1254,849,233,124,dining table
2278,50,chair,50,1,21164,21,1325,776,1401,936,76,160,chair
2279,51,chair,51,1,21164,22,1130,864,1334,1006,204,142,chair
2280,52,chair,52,1,21164,26,896,883,1148,1085,252,202,chair
2281,53,chair,53,1,21164,28,651,901,852,1123,201,222,chair
2282,54,chair,54,1,21164,22,333,1008,745,1199,412,191,chair
2283,57,person,57,1,21164,86,329,733,632,1189,303,456,person
2284,58,person,58,1,21164,81,816,653,1104,1113,288,460,person
2285,59,person,59,1,21164,72,1102,610,1377,993,275,383,person
2286,60,person,60,1,21164,20,1460,750,1599,890,139,140,person
2287,3,person,4,0,21165,83,225,28,308,243,83,215,person
2288,4,table,5,1,21165,15,82,157,177,183,95,26,dining table
2289,5,table,6,0,21165,26,96,177,246,266,150,89,dining table
2290,6,chair,7,1,21165,39,128,191,206,281,78,90,chair
2291,7,table,8,1,21165,21,94,191,184,282,90,91,dining table
2292,8,chair,9,1,21165,30,7,208,103,334,96,126,chair
2293,9,person,10,1,21165,60,10,119,115,317,105,198,person
2294,12,table,13,1,21165,22,479,207,554,257,75,50,dining table
2295,13,table,14,1,21165,30,266,230,390,282,124,52,dining table
2296,14,person,15,1,21165,42,289,145,388,254,99,109,person
2297,15,person,16,1,21165,66,385,150,528,251,143,101,person
2298,16,person,17,1,21165,29,526,164,600,274,74,110,person
2299,17,person,18,1,21165,71,347,193,570,443,223,250,person
2300,19,chair,20,1,21165,17,532,269,600,302,68,33,chair
2301,20,table,21,1,21165,51,100,263,408,375,308,112,dining table
2302,21,chair,22,1,21165,25,122,286,251,390,129,104,chair
2303,25,chair,26,1,21165,23,314,318,374,396,60,78,chair
2304,26,person,27,1,21165,49,144,277,450,480,306,203,person
2305,27,table,28,1,21165,23,1,363,600,480,599,117,dining table
2306,4,person,5,1,21166,65,745,176,1034,483,289,307,person
2307,7,chair,8,1,21166,15,63,668,287,810,224,142,chair
2308,8,chair,9,1,21166,22,0,614,157,810,157,196,chair
2309,10,person,11,1,21166,22,13,376,125,449,112,73,person
2310,11,person,12,1,21166,26,0,417,119,570,119,153,person
2311,12,person,13,1,21166,32,42,417,204,634,162,217,person
2312,13,person,14,1,21166,62,107,403,483,811,376,408,person
2313,14,person,15,1,21166,41,385,488,799,810,414,322,person
2314,15,person,16,1,21166,42,1051,409,1589,811,538,402,person
2315,16,table,17,1,21166,21,317,537,519,702,202,165,dining table
2316,30,chair,31,1,21166,32,753,450,932,655,179,205,chair
2317,31,chair,32,1,21166,40,901,467,1136,703,235,236,chair
2318,32,chair,33,1,21166,21,1153,489,1249,622,96,133,chair
2319,33,table,34,1,21166,41,763,463,1253,617,490,154,dining table
2320,34,chair,35,1,21166,36,1419,518,1661,793,242,275,chair
2321,42,table,43,1,21166,33,631,607,1075,810,444,203,dining table
2322,46,person,47,1,21166,34,1482,298,1624,450,142,152,person
2323,13,table,14,1,23740,26,591,366,1022,482,431,116,dining table
2324,17,chair,18,0,23740,47,559,512,829,767,270,255,chair
2325,18,chair,19,0,23740,61,756,478,980,718,224,240,chair
2326,19,chair,20,0,23740,38,271,562,593,768,322,206,chair
2327,20,chair,21,1,23740,43,902,461,1024,663,122,202,chair
2328,19,person,20,1,23741,20,1,660,123,996,122,336,person
2329,20,person,21,1,23741,39,980,540,1125,896,145,356,person
2330,21,table,22,0,23741,33,0,1059,1070,1172,1070,113,dining table
2331,22,person,23,1,23741,23,444,1047,737,1161,293,114,person
2332,23,table,24,0,23741,15,1154,863,1518,1001,364,138,dining table
2333,24,table,25,0,23741,61,1174,725,1763,1130,589,405,dining table
2334,25,person,26,1,23741,25,1484,660,1595,765,111,105,person
2335,26,person,27,1,23741,24,1695,708,1823,875,128,167,person
2336,27,person,28,1,23741,22,1756,774,1941,932,185,158,person
2337,28,person,29,1,23741,26,1561,803,1736,1034,175,231,person
2338,29,person,30,1,23741,25,1310,872,1542,1128,232,256,person
2339,30,person,31,1,23741,18,1184,1030,1306,1132,122,102,person
2340,31,table,32,0,23741,96,2,682,2175,1437,2173,755,dining table
2341,32,person,33,1,23741,22,1865,624,1984,753,119,129,person
2342,33,person,34,1,23741,25,1994,638,2173,805,179,167,person
2343,34,person,35,1,23741,25,2023,842,2198,1050,175,208,person
2344,35,person,36,1,23741,26,1892,980,2198,1208,306,228,person
2345,36,person,37,1,23741,27,1729,1080,2199,1353,470,273,person
2346,37,person,38,1,23741,58,891,934,1395,1404,504,470,person
2347,86,table,87,0,23741,15,2011,636,2196,739,185,103,dining table
2348,3,person,4,1,205,23,371,128,415,179,44,51,person
2349,6,table,7,0,205,82,15,211,338,309,323,98,dining table
2350,8,person,9,1,205,21,246,164,308,209,62,45,person
2351,9,person,10,1,205,20,134,155,202,208,68,53,person
2352,10,person,11,1,205,19,26,154,102,211,76,57,person
2353,14,chair,15,1,205,15,392,288,435,326,43,38,chair
2354,15,chair,16,1,205,20,296,291,394,326,98,35,chair
2355,16,person,17,1,205,26,265,248,357,312,92,64,person
2356,17,chair,18,0,205,15,246,310,379,326,133,16,chair
2357,18,person,19,1,205,52,130,213,269,316,139,103,person
2358,19,chair,20,1,205,21,169,297,266,326,97,29,chair
2359,20,person,21,1,205,42,0,212,128,326,128,114,person
2360,6,table,7,0,10954,24,38,81,193,133,155,52,dining table
2361,8,desk,9,0,10954,29,0,83,300,184,300,101,desk
2362,9,desk,10,1,10954,17,0,143,299,203,299,60,desk
2363,10,table,11,0,10955,21,93,190,217,275,124,85,dining table
2364,12,table,13,0,10955,17,261,244,344,294,83,50,dining table
2365,14,table,15,0,10955,25,211,279,361,349,150,70,dining table
2366,16,table,17,0,10955,18,382,241,447,300,65,59,dining table
2367,19,table,20,0,10955,18,394,150,447,197,53,47,dining table
2368,20,table,21,0,10955,22,275,128,381,178,106,50,dining table
2369,31,table,32,0,10955,15,494,161,558,211,64,50,dining table
2370,34,table,35,0,10955,17,545,146,630,223,85,77,dining table
2371,36,table,37,0,10955,19,519,212,566,298,47,86,dining table
2372,39,table,40,0,10955,23,400,272,526,357,126,85,dining table
2373,43,table,44,0,10955,15,615,214,639,335,24,121,dining table
2374,45,table,46,0,10955,23,423,308,624,420,201,112,dining table
2375,47,table,48,0,10955,28,134,326,377,420,243,94,dining table
2376,48,table,49,0,10955,20,23,212,164,305,141,93,dining table
2377,0,table,1,0,10957,38,14,127,276,198,262,71,dining table
2378,1,tables,2,0,10958,15,46,136,178,196,132,60,dining table
2379,12,table,13,0,10958,15,80,183,113,207,33,24,dining table
2380,22,person,23,0,10958,24,138,219,163,276,25,57,person
2381,25,person,26,0,10958,22,212,146,228,175,16,29,person
2382,28,person,29,0,10958,20,374,192,394,240,20,48,person
2383,29,person,30,0,10958,17,358,182,373,229,15,47,person
2384,30,person,31,1,10958,16,387,165,404,203,17,38,person
2385,41,person,42,1,10958,17,271,203,300,230,29,27,person
2386,42,person,43,1,10958,16,284,157,302,182,18,25,person
2387,3,person,4,1,23742,25,636,372,750,485,114,113,person
2388,4,person,5,1,23742,30,484,372,596,492,112,120,person
2389,5,person,6,1,23742,39,267,361,398,507,131,146,person
2390,6,person,7,1,23742,46,140,363,299,533,159,170,person
2391,8,chair,9,1,23742,26,392,387,516,495,124,108,chair
2392,6,person,7,1,23743,27,304,233,421,483,117,250,person
2393,7,table,8,0,23743,43,549,411,1022,587,473,176,dining table
2394,8,person,9,1,23743,27,124,475,419,682,295,207,person
2395,9,person,10,1,23743,74,499,426,1001,683,502,257,person
2396,12,person,13,1,23743,49,518,359,764,595,246,236,person
2397,13,table,14,0,23743,53,0,542,675,682,675,140,dining table
2398,44,person,45,1,649,28,664,516,717,565,53,49,person
2399,54,desk,55,1,649,16,602,564,768,703,166,139,desk
2400,58,person,59,1,649,24,902,476,961,512,59,36,person
2401,60,chair,61,1,649,16,998,547,1037,587,39,40,chair
2402,61,person,62,1,649,24,1054,509,1106,585,52,76,person
2403,64,table,65,1,649,16,1121,543,1215,599,94,56,dining table
2404,65,chair,66,0,649,20,1152,538,1201,605,49,67,chair
2405,76,desk,77,1,649,57,271,563,605,750,334,187,desk
2406,78,chair,79,1,649,24,301,597,367,722,66,125,chair
2407,79,chair,80,0,649,52,390,600,498,753,108,153,chair
2408,90,chair,91,1,649,36,170,615,295,793,125,178,chair
2409,103,chair,104,1,649,38,254,636,403,842,149,206,chair
2410,104,chair,105,1,649,33,0,623,76,847,76,224,chair
2411,105,chair,106,0,649,54,55,650,205,867,150,217,chair
2412,106,table,107,1,649,24,0,646,350,869,350,223,dining table
2413,107,chair,108,1,649,17,813,619,902,743,89,124,chair
2414,108,chair,109,1,649,28,594,641,732,832,138,191,chair
2415,109,chair,110,1,649,40,883,641,1024,878,141,237,chair
2416,110,chair,111,1,649,27,746,673,885,841,139,168,chair
2417,111,table,112,1,649,27,643,662,983,842,340,180,dining table
2418,112,chair,113,1,649,17,642,755,825,838,183,83,chair
2419,113,chair,114,1,649,16,1021,817,1114,912,93,95,chair
2420,115,chair,116,1,649,19,274,793,398,912,124,119,chair
2421,3,desk,4,0,10967,15,99,107,237,193,138,86,desk
2422,2,desk,3,0,10969,18,66,113,119,172,53,59,desk
2423,3,desk,4,0,10969,26,110,125,209,210,99,85,desk
2424,12,chair,13,0,10969,21,145,166,199,210,54,44,chair
2425,15,chair,16,0,10971,15,289,301,313,332,24,31,chair
2426,12,chair,13,1,10972,18,148,122,171,157,23,35,chair
2427,5,table,6,0,10974,29,79,126,128,199,49,73,dining table
2428,7,chair,8,0,10974,23,142,115,218,194,76,79,chair
2429,8,chair,9,1,10974,15,0,132,63,230,63,98,chair
2430,6,table,7,1,10975,23,116,149,217,230,101,81,dining table
2431,7,chair,8,0,10975,25,106,160,169,244,63,84,chair
2432,8,chair,9,1,10975,16,178,156,229,220,51,64,chair
2433,21,person,22,0,10978,43,70,105,139,198,69,93,person
2434,22,person,23,1,10978,41,151,49,219,199,68,150,person
2435,8,table,9,0,10979,15,0,200,231,256,231,56,dining table
2436,10,chair,11,1,10979,15,207,205,233,256,26,51,chair
2437,11,person,12,1,10979,18,194,182,225,220,31,38,person
2438,29,person,30,1,10979,18,81,167,109,189,28,22,person
2439,46,chair,47,1,10979,17,35,213,78,254,43,41,chair
2440,13,chair,14,0,10984,15,158,142,181,174,23,32,chair
2441,14,chair,15,0,10984,18,185,159,210,198,25,39,chair
2442,15,chair,16,0,10984,17,223,182,251,228,28,46,chair
2443,20,table,21,0,10984,19,38,123,106,158,68,35,dining table
2444,21,table,22,0,10984,20,51,145,139,192,88,47,dining table
2445,22,table,23,0,10984,17,74,185,192,252,118,67,dining table
2446,25,chair,26,0,10984,18,75,155,93,191,18,36,chair
2447,26,chair,27,0,10984,18,101,152,123,187,22,35,chair
2448,29,chair,30,0,10984,21,146,200,178,249,32,49,chair
2449,30,chair,31,0,10984,22,113,209,144,254,31,45,chair
2450,7,table,8,0,10985,35,33,140,115,204,82,64,dining table
2451,10,table,11,1,10985,19,26,201,171,256,145,55,dining table
2452,38,chair,38,0,10987,15,195,217,232,240,37,23,chair
2453,42,desk,42,1,10987,18,1,184,75,217,74,33,desk
2454,48,person,48,0,10987,30,108,200,144,233,36,33,person
2455,50,person,50,1,10987,16,112,197,134,216,22,19,person
2456,54,person,54,1,10987,17,167,193,195,227,28,34,person
2457,58,person,58,0,10987,17,154,185,175,207,21,22,person
2458,59,person,59,0,10987,18,165,174,181,195,16,21,person
2459,66,desk,66,0,10987,50,93,169,173,206,80,37,desk
2460,75,person,75,1,10987,24,50,182,69,216,19,34,person
2461,9,table,10,1,21167,22,1,192,159,293,158,101,dining table
2462,10,chair,11,1,21167,18,1,201,38,295,37,94,chair
2463,17,chair,18,1,21167,37,104,197,189,288,85,91,chair
2464,18,table,19,1,21167,34,168,219,315,288,147,69,dining table
2465,20,chair,21,1,21167,15,641,309,732,361,91,52,chair
2466,21,backpack,22,0,21167,25,174,248,286,299,112,51,backpack
2467,23,person,24,1,21167,20,242,141,317,239,75,98,person
2468,26,chair,27,1,21167,16,1,312,60,340,59,28,chair
2469,27,chair,28,1,21167,65,0,334,158,590,158,256,chair
2470,30,chair,31,1,21167,66,110,375,284,712,174,337,chair
2471,31,table,32,0,21167,34,0,285,379,376,379,91,dining table
2472,32,table,33,1,21167,85,184,332,793,650,609,318,dining table
2473,34,chair,34,0,21167,131,180,418,482,814,302,396,chair
2474,35,person,35,0,21167,127,248,238,619,762,371,524,person
2475,36,person,36,0,21167,112,611,225,961,783,350,558,person
2476,37,chair,37,1,21167,113,776,427,1075,817,299,390,chair
2477,1,person,2,1,21168,73,35,271,685,1168,650,897,person
2478,2,person,3,1,21168,91,955,177,1502,1167,547,990,person
2479,3,book,4,1,21168,23,458,718,753,861,295,143,book
2480,4,chair,5,1,25110,24,977,212,1023,423,46,211,chair
2481,11,table,12,0,25110,21,142,333,510,679,368,346,dining table
2482,19,person,20,0,25110,120,582,142,1003,740,421,598,person
2483,14,chair,15,1,25111,22,704,440,817,544,113,104,chair
2484,15,chair,16,1,25111,28,674,407,708,534,34,127,chair
2485,16,table,17,0,25111,40,558,348,683,443,125,95,dining table
2486,17,chair,18,0,25111,34,572,356,646,450,74,94,chair
2487,18,chair,19,1,25111,34,633,352,701,437,68,85,chair
2488,19,chair,20,1,25111,16,621,344,661,388,40,44,chair
2489,20,table,21,0,25111,50,325,383,517,537,192,154,dining table
2490,21,chair,22,1,25111,34,337,400,436,536,99,136,chair
2491,22,chair,23,1,25111,31,416,393,520,533,104,140,chair
2492,23,chair,24,1,25111,25,422,375,505,444,83,69,chair
2493,25,table,26,1,25111,15,0,480,80,543,80,63,dining table
2494,26,chair,27,1,25111,27,0,453,94,543,94,90,chair
2495,2,clock,3,0,25113,18,390,61,439,112,49,51,clock
2496,8,table,9,0,25113,18,228,362,353,387,125,25,dining table
2497,9,table,10,0,25113,21,796,393,929,420,133,27,dining table
2498,10,person,11,1,25113,25,0,439,157,682,157,243,person
2499,11,person,12,1,25113,64,1,326,209,677,208,351,person
2500,12,person,13,1,25113,61,52,336,178,586,126,250,person
2501,13,person,14,1,25113,70,219,376,436,652,217,276,person
2502,14,chair,15,1,25113,44,32,562,230,683,198,121,chair
2503,15,chair,16,1,25113,27,74,446,178,574,104,128,chair
2504,16,chair,17,0,25113,40,161,443,274,587,113,144,chair
2505,17,chair,18,1,25113,50,345,449,482,641,137,192,chair
2506,18,chair,19,0,25113,49,206,548,456,683,250,135,chair
2507,19,chair,20,1,25113,46,532,424,667,625,135,201,chair
2508,20,person,21,0,25113,81,531,333,671,574,140,241,person
2509,21,person,22,1,25113,17,728,351,792,411,64,60,person
2510,22,person,23,1,25113,43,604,368,742,624,138,256,person
2511,23,chair,24,1,25113,19,605,556,701,656,96,100,chair
2512,24,chair,25,1,25113,20,809,405,883,472,74,67,chair
2513,25,person,26,1,25113,58,557,403,951,682,394,279,person
2514,26,chair,27,1,25113,28,813,464,950,605,137,141,chair
2515,27,person,28,1,25113,36,899,328,1023,583,124,255,person
2516,29,chair,30,1,25113,26,841,566,1023,682,182,116,chair
2517,2,window,3,0,25114,18,1320,429,1600,879,280,450,window
2518,7,chair,8,1,25114,16,1219,693,1323,767,104,74,chair
2519,8,chair,9,1,25114,27,1219,730,1457,985,238,255,chair
2520,12,chair,13,1,25114,19,0,919,364,1200,364,281,chair
2521,13,sofa,14,0,25114,44,154,818,1398,1200,1244,382,couch
2522,5,person,6,1,25115,48,302,114,465,443,163,329,person
2523,29,table,30,0,25116,135,164,440,699,697,535,257,dining table
2524,30,chair,31,0,25116,35,568,467,739,681,171,214,chair
2525,33,chair,34,1,25116,26,553,442,686,589,133,147,chair
2526,35,chair,36,1,25116,19,140,454,188,619,48,165,chair
2527,36,chair,37,1,25116,31,158,461,273,652,115,191,chair
2528,37,chair,38,1,25116,45,177,477,355,697,178,220,chair
2529,38,sofa,39,1,25116,29,48,412,318,504,270,92,couch
2530,39,sofa,40,1,25116,17,46,401,239,463,193,62,couch
2531,51,chair,52,0,25116,29,354,482,545,741,191,259,chair
2532,33,table,34,1,25117,22,970,535,1151,579,181,44,dining table
2533,34,chair,35,1,25117,20,990,555,1048,593,58,38,chair
2534,35,chair,36,1,25117,19,949,526,992,590,43,64,chair
2535,36,desk,37,0,25117,23,821,577,1151,855,330,278,desk
2536,40,book,41,0,25117,15,896,612,1003,644,107,32,book
2537,45,table,46,0,25117,24,547,492,842,638,295,146,dining table
2538,46,chair,47,1,25117,28,755,508,835,625,80,117,chair
2539,48,chair,49,1,25117,22,695,492,773,595,78,103,chair
2540,49,chair,50,1,25117,31,522,502,594,614,72,112,chair
2541,50,chair,51,1,25117,31,598,512,686,637,88,125,chair
2542,51,table,52,0,25117,17,406,465,589,539,183,74,dining table
2543,52,chair,53,1,25117,24,393,465,449,537,56,72,chair
2544,53,table,54,1,25117,17,137,457,257,535,120,78,dining table
2545,54,person,55,1,25117,29,158,418,237,475,79,57,person
2546,60,table,61,0,25117,17,183,498,320,662,137,164,dining table
2547,61,table,62,0,25117,65,297,549,557,751,260,202,dining table
2548,62,chair,63,0,25117,31,228,556,358,733,130,177,chair
2549,63,chair,64,0,25117,30,498,557,609,738,111,181,chair
2550,64,chair,65,0,25117,33,368,595,503,798,135,203,chair
2551,65,chair,66,1,25117,17,291,500,340,574,49,74,chair
2552,66,chair,67,0,25117,31,150,512,243,645,93,133,chair
2553,6,table,7,0,25118,17,728,951,1330,1200,602,249,dining table
2554,7,person,8,1,25118,82,256,532,893,1199,637,667,person
2555,8,person,9,1,25118,69,577,169,861,966,284,797,person
2556,11,person,12,1,25118,56,848,173,1149,958,301,785,person
2557,13,person,14,0,25118,77,1136,261,1406,1044,270,783,person
2558,14,person,15,1,25118,67,1306,313,1489,959,183,646,person
2559,16,person,17,1,25118,17,1565,412,1600,949,35,537,person
2560,17,book,18,1,25118,34,733,892,1036,1135,303,243,book
2561,20,book,21,1,25118,15,1325,434,1400,571,75,137,book
2562,7,person,8,1,25119,33,388,65,436,203,48,138,person
2563,8,person,9,1,25119,29,349,80,404,178,55,98,person
2564,9,person,10,0,25119,48,328,132,416,251,88,119,person
2565,12,chair,13,1,25119,16,556,172,625,207,69,35,chair
2566,16,chair,17,1,25119,19,413,202,529,242,116,40,chair
2567,17,table,18,1,25119,27,375,195,639,245,264,50,dining table
2568,18,chair,19,1,25119,33,523,210,639,382,116,172,chair
2569,22,table,23,0,25119,29,92,236,597,479,505,243,dining table
2570,23,chair,24,1,25119,25,413,231,532,444,119,213,chair
2571,24,chair,25,1,25119,24,118,264,239,479,121,215,chair
2572,25,chair,26,0,25119,28,218,286,456,480,238,194,chair
2573,10,plant pots,11,0,11863,16,279,1880,534,2044,255,164,potted plant
2574,13,window,14,0,11865,15,255,42,289,131,34,89,window
2575,23,person,24,1,11904,37,41,101,135,225,94,124,person
2576,3,door,4,0,11907,17,46,756,343,1164,297,408,door
2577,11,door,12,0,11907,15,1866,790,2092,1161,226,371,door
2578,15,person,16,0,11907,17,1207,1024,1225,1074,18,50,person
2579,17,person,18,0,11907,16,1257,1025,1271,1077,14,52,person
2580,2,person,3,0,11908,22,274,461,332,514,58,53,person
2581,3,person,4,0,11908,42,80,383,138,566,58,183,person
2582,4,person,5,0,11908,36,337,591,474,776,137,185,person
2583,6,person,7,0,11908,46,0,364,73,704,73,340,person
2584,12,person,13,1,11908,15,224,453,249,504,25,51,person
2585,1,person,2,0,11909,33,101,226,126,317,25,91,person
2586,2,person,3,0,11909,38,386,227,418,341,32,114,person
2587,3,person,4,0,11909,26,333,278,374,343,41,65,person
2588,4,person,5,0,11909,25,427,272,477,340,50,68,person
2589,5,person,6,0,11909,15,128,288,159,317,31,29,person
2590,7,person,8,0,11909,17,187,282,215,317,28,35,person
2591,8,person,9,0,11909,17,212,287,240,316,28,29,person
2592,11,person,12,0,11909,16,299,289,325,314,26,25,person
2593,40,person,41,0,11911,15,649,796,666,852,17,56,person
2594,8,person,9,0,11912,22,1100,624,1121,696,21,72,person
2595,0,person,1,0,11914,18,217,1465,633,2046,416,581,person
2596,1,person,2,0,11914,17,1327,1669,1533,2046,206,377,person
2597,13,person,14,0,11914,24,304,1530,352,1672,48,142,person
2598,7,person,8,0,11915,26,218,626,256,755,38,129,person
2599,5,person,6,1,12191,16,175,175,207,198,32,23,person
2600,7,person,8,1,12191,15,89,164,115,180,26,16,person
2601,11,person,12,1,12197,40,140,293,315,479,175,186,person
2602,12,person,13,1,12197,30,282,301,397,419,115,118,person
2603,13,person,14,1,12197,30,424,279,511,382,87,103,person
2604,14,person,15,1,12197,24,490,274,576,358,86,84,person
2605,15,person,16,1,12197,24,347,265,415,341,68,76,person
2606,17,person,18,1,12197,22,275,262,324,339,49,77,person
2607,18,person,19,1,12197,28,113,277,194,393,81,116,person
2608,19,person,20,1,12197,29,70,260,136,384,66,124,person
2609,20,person,21,1,12197,26,55,247,104,319,49,72,person
2610,21,person,22,1,12197,20,158,261,204,327,46,66,person
2611,22,person,23,1,12197,17,407,253,448,317,41,64,person
2612,23,person,24,1,12197,17,304,244,340,295,36,51,person
2613,24,person,25,1,12197,26,234,246,279,337,45,91,person
2614,27,person,28,1,12197,18,189,242,229,291,40,49,person
2615,28,person,29,1,12197,16,374,248,409,288,35,40,person
2616,29,person,30,1,12197,22,529,265,596,339,67,74,person
2617,31,person,32,1,12197,17,41,238,78,300,37,62,person
2618,4,person,5,1,12198,18,51,211,108,254,57,43,person
2619,5,person,6,1,12198,20,110,208,181,255,71,47,person
2620,6,person,7,1,12198,19,163,191,207,226,44,35,person
2621,7,person,8,1,12198,19,79,180,114,214,35,34,person
2622,8,person,9,1,12198,17,38,173,62,196,24,23,person
2623,9,person,10,1,12198,16,113,174,134,198,21,24,person
2624,11,person,12,1,12198,36,128,171,171,213,43,42,person
2625,12,person,13,1,12198,16,107,166,121,182,14,16,person
2626,13,person,14,1,12198,16,160,171,174,193,14,22,person
2627,5,person,6,1,25154,59,768,226,865,492,97,266,person
2628,8,chair,9,1,25154,15,93,634,496,719,403,85,chair
2629,9,chair,10,1,25154,15,493,634,662,702,169,68,chair
2630,10,person,11,0,25154,37,484,436,960,719,476,283,person
2631,13,chair,14,1,25154,17,600,551,677,635,77,84,chair
2632,14,person,15,1,25154,32,597,400,746,557,149,157,person
2633,15,person,16,1,25154,40,406,384,690,522,284,138,person
2634,16,chair,17,1,25154,24,368,546,607,659,239,113,chair
2635,17,chair,18,0,25154,19,277,498,432,557,155,59,chair
2636,19,person,20,0,25154,27,140,410,290,515,150,105,person
2637,20,chair,21,1,25154,24,136,541,373,638,237,97,chair
2638,21,chair,22,1,25154,18,0,568,215,673,215,105,chair
2639,22,person,23,1,25154,22,1,351,141,573,140,222,person
2640,23,chair,24,0,25154,21,433,511,649,554,216,43,chair
2641,3,person,4,0,12215,78,3,70,88,237,85,167,person
2642,4,bench,5,0,12215,24,130,197,284,274,154,77,bench
2643,5,bench,6,0,12215,15,274,195,423,278,149,83,bench
2644,6,person,7,0,12215,47,80,166,269,230,189,64,person
2645,4,person,5,1,12216,20,483,139,499,202,16,63,person
2646,5,person,6,0,12216,30,341,146,363,212,22,66,person
2647,6,bench,7,0,12216,21,370,216,500,290,130,74,bench
2648,7,person,8,0,12216,46,364,171,419,292,55,121,person
2649,5,person,6,0,12217,37,125,366,203,473,78,107,person
2650,4,person,5,0,12218,48,339,127,409,350,70,223,person
2651,5,person,6,1,12218,66,352,112,422,354,70,242,person
2652,1,person,2,0,12219,52,150,107,228,471,78,364,person
2653,3,backpack,4,0,12219,23,128,163,198,278,70,115,backpack
2654,4,person,5,0,12220,64,75,186,217,342,142,156,person
2655,5,person,6,0,12220,55,216,198,299,365,83,167,person
2656,6,person,7,0,12220,48,297,188,372,358,75,170,person
2657,0,airplane,1,0,12221,33,129,2,618,351,489,349,airplane
2658,1,person,2,0,12223,16,180,209,186,232,6,23,person
2659,4,person,5,0,12223,21,124,205,135,246,11,41,person
2660,5,person,6,1,12223,16,133,208,142,245,9,37,person
2661,6,person,7,0,12223,19,142,213,157,235,15,22,person
2662,8,person,9,0,12223,24,160,207,170,248,10,41,person
2663,22,person,23,0,12223,50,362,200,412,315,50,115,person
2664,3,person,4,0,12226,50,262,236,306,428,44,192,person
2665,4,person,5,0,12226,55,51,166,158,457,107,291,person
2666,3,chair,4,0,12227,19,313,444,511,690,198,246,chair
2667,17,bench,18,0,12227,26,538,493,720,561,182,68,bench
2668,5,person,6,0,12228,34,108,224,152,354,44,130,person
2669,2,person,3,0,12229,69,85,179,261,498,176,319,person
2670,3,bench,4,0,12229,30,2,381,328,498,326,117,bench
2671,0,airplane,1,0,12231,97,2,23,576,398,574,375,airplane
2672,1,person,2,1,12232,37,2,216,69,332,67,116,person
2673,11,person,12,1,12232,38,143,123,347,331,204,208,person
2674,12,person,13,1,12232,19,333,224,387,332,54,108,person
2675,14,person,15,1,12232,31,440,229,484,331,44,102,person
2676,15,person,16,1,12232,23,135,229,161,332,26,103,person
2677,16,person,17,1,12232,26,95,233,132,332,37,99,person
2678,17,person,18,1,12232,23,51,217,78,330,27,113,person
2679,19,person,20,1,12232,15,476,220,497,332,21,112,person
2680,2,person,3,0,12233,49,341,154,387,282,46,128,person
2681,3,person,4,0,12233,51,400,156,441,285,41,129,person
2682,5,person,6,0,12234,42,344,153,418,241,74,88,person
2683,7,person,8,0,12234,48,64,192,140,325,76,133,person
2684,9,person,10,0,12234,45,188,85,231,197,43,112,person
2685,3,person,4,0,12236,58,323,133,468,310,145,177,person
2686,8,person,9,0,12237,58,38,240,82,387,44,147,person
2687,9,person,10,0,12237,27,333,247,361,330,28,83,person
2688,1,person,2,0,12239,43,182,240,240,358,58,118,person
2689,2,bench,3,0,12239,19,97,317,269,362,172,45,bench
2690,15,chair,16,0,12240,17,280,238,326,308,46,70,chair
2691,16,chair,17,1,12240,15,276,231,319,290,43,59,chair
2692,18,person,19,0,12240,20,273,171,285,228,12,57,person
2693,3,person,4,0,12241,73,307,85,394,317,87,232,person
2694,10,person,11,0,12243,51,150,221,189,333,39,112,person
2695,11,person,12,1,12243,31,286,225,308,306,22,81,person
2696,12,person,13,1,12243,21,346,233,369,280,23,47,person
2697,13,person,14,1,12243,16,374,226,396,253,22,27,person
2698,14,person,15,0,12243,32,412,222,436,279,24,57,person
2699,15,person,16,1,12243,16,467,221,478,254,11,33,person
2700,16,person,17,1,12243,17,477,220,490,253,13,33,person
2701,3,person,4,0,12246,25,171,150,236,249,65,99,person
2702,4,bench,5,0,12246,16,0,241,241,331,241,90,bench
2703,6,person,7,0,12247,44,52,240,114,487,62,247,person
2704,1,person,2,0,12248,46,92,225,159,360,67,135,person
2705,5,person,6,0,12250,58,99,305,157,486,58,181,person
2706,6,person,7,0,12250,58,168,294,225,489,57,195,person
2707,7,person,8,1,12250,19,0,318,24,457,24,139,person
2708,13,person,14,0,12251,44,132,180,212,292,80,112,person
2709,0,airplane,1,1,12254,55,0,1,1022,325,1022,324,airplane
2710,1,airplane,2,1,12254,64,0,173,691,408,691,235,airplane
2711,2,airplane,3,0,12254,62,2,359,595,582,593,223,airplane
2712,3,airplane,4,0,12254,44,591,401,923,551,332,150,airplane
2713,4,airplane,5,1,12254,20,829,306,1022,419,193,113,airplane
2714,5,airplane,6,1,12254,23,784,602,1023,767,239,165,airplane
2715,25,person,24,1,12254,15,371,658,391,723,20,65,person
2716,28,person,27,0,12254,16,441,680,469,753,28,73,person
2717,29,person,28,0,12254,16,492,693,522,759,30,66,person
2718,30,person,29,0,12254,15,529,681,550,755,21,74,person
2719,31,airplane,30,1,12254,16,449,529,662,661,213,132,airplane
2720,43,window,41,1,12254,20,463,108,1023,667,560,559,window
2721,4,person,5,0,21739,90,201,168,240,299,39,131,person
2722,5,backpack,6,0,21739,45,202,191,235,243,33,52,backpack
2723,6,sofa,7,0,21740,206,67,348,448,446,381,98,couch
2724,7,person,8,0,21740,153,287,221,377,452,90,231,person
2725,9,person,10,0,21740,126,198,225,291,450,93,225,person
2726,10,shoe,11,0,21740,19,218,433,256,449,38,16,shoe
2727,11,person,12,1,21740,228,82,198,200,463,118,265,person
2728,12,person,13,1,21740,155,83,197,183,453,100,256,person
2729,3,person,4,0,21741,94,100,306,156,485,56,179,person
2730,4,person,5,0,21741,117,167,295,225,489,58,194,person
2731,5,person,6,1,21741,47,0,318,21,455,21,137,person
2732,3,bench,4,0,21742,99,79,306,408,373,329,67,bench
2733,4,person,5,0,21742,77,297,191,373,357,76,166,person
2734,5,person,6,1,21742,99,219,197,301,365,82,168,person
2735,6,person,7,1,21742,131,75,186,216,360,141,174,person
2736,12,door,13,0,21743,25,108,128,177,265,69,137,door
2737,13,person,14,0,21743,107,193,140,264,328,71,188,person
2738,15,person,16,0,21743,61,58,153,113,342,55,189,person
2739,17,chair,18,0,21743,29,113,233,176,330,63,97,chair
2740,11,person,12,1,21744,80,70,216,140,315,70,99,person
2741,12,person,13,1,21744,65,111,211,145,281,34,70,person
2742,13,bench,14,0,21744,46,71,257,251,330,180,73,bench
2743,14,person,15,0,21744,54,474,187,492,232,18,45,person
2744,16,person,17,0,21744,66,446,177,477,260,31,83,person
2745,17,person,18,0,21744,59,410,184,432,253,22,69,person
2746,19,person,20,1,21744,56,392,175,419,245,27,70,person
2747,20,person,21,0,21744,52,386,184,401,239,15,55,person
2748,21,person,22,0,21744,41,370,179,383,236,13,57,person
2749,22,person,23,0,21744,59,375,186,392,239,17,53,person
2750,23,person,24,0,21744,72,353,179,373,238,20,59,person
2751,24,person,25,0,21744,71,317,202,351,260,34,58,person
2752,25,person,26,1,21744,39,312,196,327,228,15,32,person
2753,27,person,28,0,21744,73,289,201,310,267,21,66,person
2754,31,person,32,0,21744,94,265,187,290,295,25,108,person
2755,32,bench,33,1,21744,43,307,230,354,266,47,36,bench
2756,33,person,34,0,21744,93,139,179,167,253,28,74,person
2757,8,person,9,0,21745,128,229,197,362,444,133,247,person
2758,2,person,3,0,21746,50,279,160,337,325,58,165,person
2759,1,person,2,0,21747,91,168,192,463,960,295,768,person
2760,2,person,3,0,219,83,152,120,380,930,228,810,person
2761,6,person,7,0,12270,46,240,367,665,1103,425,736,person
2762,5,desk,6,0,12271,30,228,350,1023,740,795,390,desk
2763,10,chair,11,1,12271,19,0,394,219,759,219,365,chair
2764,10,desk,11,0,12273,25,364,783,1932,1536,1568,753,desk
2765,11,desk,12,1,12277,17,0,157,131,369,131,212,desk
2766,6,desk,7,0,12279,21,168,273,407,425,239,152,desk
2767,0,chair,1,1,12280,19,209,367,368,576,159,209,chair
2768,7,desk,8,0,12280,19,123,345,1115,802,992,457,desk
2769,11,person,11,0,12281,58,330,130,443,278,113,148,person
2770,12,chair,13,0,12282,17,192,159,209,185,17,26,chair
2771,21,chair,22,0,12282,15,126,154,143,179,17,25,chair
2772,3,desk,4,0,12283,24,2,52,498,373,496,321,desk
2773,8,window,9,0,12287,16,274,35,324,85,50,50,window
2774,1,table,2,0,23923,26,0,394,1279,960,1279,566,dining table
2775,5,chair,6,1,23923,20,8,783,801,959,793,176,chair
2776,5,person,6,1,23924,122,133,209,605,981,472,772,person
2777,5,desk,6,0,23925,46,266,407,679,784,413,377,desk
2778,8,chair,9,1,23925,19,1,460,677,1023,676,563,chair
2779,9,person,10,1,23925,119,34,212,677,935,643,723,person
2780,6,person,7,1,13807,57,692,854,1456,2195,764,1341,person
2781,4,person,5,1,13808,50,2,979,1057,2042,1055,1063,person
2782,11,person,12,1,13808,23,718,1085,808,1236,90,151,person
2783,6,person,7,1,13809,25,0,231,109,841,109,610,person
2784,8,person,9,0,13809,37,10,503,302,964,292,461,person
2785,1,elephant,2,0,13811,115,311,0,1996,1496,1685,1496,elephant
2786,5,person,6,1,13812,19,163,251,216,299,53,48,person
2787,8,person,9,0,13812,23,150,244,165,299,15,55,person
2788,9,person,10,1,13812,17,144,246,155,287,11,41,person
2789,11,person,12,0,13812,19,131,241,148,290,17,49,person
2790,14,bench,15,1,13812,17,0,234,34,278,34,44,bench
2791,1,person,2,1,13813,46,732,197,942,842,210,645,person
2792,2,person,3,1,13813,49,98,194,392,843,294,649,person
2793,4,person,5,1,13814,39,280,690,420,1324,140,634,person
2794,5,person,6,0,13814,42,189,731,563,1426,374,695,person
2795,2,person,3,1,23926,65,619,101,1023,767,404,666,person
2796,12,chair,13,0,14174,26,1126,800,1363,1142,237,342,chair
2797,14,chair,15,1,14174,15,842,813,1015,1012,173,199,chair
2798,15,chair,16,0,14174,25,735,831,961,1122,226,291,chair
2799,18,chair,19,0,14174,17,400,869,590,1113,190,244,chair
2800,2,person,3,1,14180,59,348,373,870,1270,522,897,person
2801,2,person,3,0,15453,50,104,441,281,824,177,383,person
2802,3,chair,4,0,15453,19,285,541,430,795,145,254,chair
2803,4,person,5,0,15453,47,519,331,718,833,199,502,person
2804,5,person,6,1,15453,34,811,441,1039,826,228,385,person
2805,6,person,7,0,15453,47,922,446,1184,887,262,441,person
2806,15,person,16,1,15453,17,283,840,421,958,138,118,person
2807,3,person,4,1,15454,54,14,81,254,291,240,210,person
2808,4,person,5,1,15454,54,149,54,329,280,180,226,person
2809,3,person,4,0,15455,57,104,80,157,213,53,133,person
2810,4,person,5,0,15455,47,165,50,219,192,54,142,person
2811,5,person,6,0,15455,58,213,91,271,229,58,138,person
2812,7,person,8,1,15455,16,0,124,42,298,42,174,person
2813,8,person,9,1,15455,20,3,109,35,174,32,65,person
2814,9,person,10,0,15455,32,36,110,73,212,37,102,person
2815,10,person,11,1,15455,23,276,188,400,299,124,111,person
2816,11,bicycle,12,0,15455,35,321,136,363,163,42,27,bicycle
2817,3,person,4,1,15457,24,2,189,72,598,70,409,person
2818,5,person,6,1,15457,17,66,486,222,552,156,66,person
2819,6,person,7,1,15457,15,138,198,399,598,261,400,person
2820,7,person,8,1,15457,38,139,53,350,335,211,282,person
2821,0,table,1,0,15458,22,41,241,208,373,167,132,dining table
2822,6,vase,7,0,15458,17,355,216,433,267,78,51,vase
2823,8,chair,9,0,15458,18,426,259,494,373,68,114,chair
2824,10,cake,11,0,15458,29,90,157,150,244,60,87,cake
2825,2,person,3,1,15459,72,83,27,341,739,258,712,person
2826,3,person,4,0,15459,68,272,20,533,761,261,741,person
2827,4,person,5,0,15460,57,47,36,161,484,114,448,person
2828,5,person,6,1,15460,42,146,20,205,456,59,436,person
2829,6,person,7,0,15460,64,157,28,281,476,124,448,person
2830,7,person,8,1,15460,42,240,16,334,465,94,449,person
2831,2,person,3,0,15461,45,65,81,177,496,112,415,person
2832,3,person,4,0,15461,56,160,92,264,481,104,389,person
2833,4,person,5,0,15461,47,247,91,329,485,82,394,person
2834,5,person,6,0,15461,53,314,86,413,478,99,392,person
2835,8,person,9,1,15461,25,0,48,91,288,91,240,person
2836,9,person,10,1,15461,34,78,31,190,167,112,136,person
2837,10,person,11,1,15461,35,213,25,336,156,123,131,person
2838,11,person,12,1,15461,21,395,124,481,252,86,128,person
2839,12,person,13,1,15461,20,372,78,459,179,87,101,person
2840,15,person,16,1,15461,16,283,17,337,112,54,95,person
2841,16,person,17,1,15461,22,0,1,94,108,94,107,person
2842,17,person,18,1,15461,17,179,6,242,93,63,87,person
2843,18,person,19,1,15461,16,435,1,490,197,55,196,person
2844,19,person,20,1,15461,29,329,0,460,155,131,155,person
2845,2,person,3,1,15462,65,209,141,406,479,197,338,person
2846,2,person,3,1,15463,53,35,71,212,406,177,335,person
2847,3,person,4,1,15463,26,187,243,284,381,97,138,person
2848,2,person,3,1,22041,61,9,44,286,410,277,366,person
2849,3,person,4,1,22041,32,261,151,357,410,96,259,person
2850,10,table,11,1,15622,18,2,517,282,599,280,82,dining table
2851,32,person,33,0,15622,37,288,409,370,598,82,189,person
2852,33,person,34,1,15622,21,635,427,674,596,39,169,person
2853,34,person,35,1,15622,33,653,421,753,599,100,178,person
2854,35,person,36,1,15622,23,719,414,798,599,79,185,person
2855,2,person,3,1,15623,42,60,68,201,226,141,158,person
2856,2,bench,3,0,15624,25,563,208,742,357,179,149,bench
2857,3,bench,4,1,15624,35,549,163,766,432,217,269,bench
2858,9,bench,10,0,15625,17,234,311,389,499,155,188,bench
2859,20,door,21,0,15626,15,72,44,124,252,52,208,door
2860,1,window,2,0,15627,15,91,878,296,1468,205,590,window
2861,1,window,2,0,15628,34,582,197,1235,770,653,573,window
2862,21,bench,22,1,15629,20,163,1461,2066,1648,1903,187,bench
2863,1,window,2,0,15630,22,4,127,281,1076,277,949,window
2864,9,person,10,1,15630,47,239,150,684,517,445,367,person
2865,17,bench,18,1,15631,22,0,894,203,1023,203,129,bench
2866,1,window,2,0,15632,47,2,0,350,852,348,852,window
2867,4,bench,5,0,16054,23,5,235,92,300,87,65,bench
2868,3,table,4,1,255,28,278,175,1408,885,1130,710,dining table
2869,8,person,9,0,255,103,938,231,2140,1266,1202,1035,person
2870,21,person,22,0,255,87,636,648,1192,1647,556,999,person
2871,5,person,6,1,16147,19,269,212,384,462,115,250,person
2872,7,person,8,1,16147,20,855,280,970,581,115,301,person
2873,9,person,10,0,16147,21,1815,194,1892,505,77,311,person
2874,10,person,11,1,16147,17,1887,97,1992,866,105,769,person
2875,13,person,14,1,16147,36,239,94,758,849,519,755,person
2876,14,person,15,1,16147,57,723,5,1368,798,645,793,person
2877,15,person,16,1,16147,62,766,218,1879,1304,1113,1086,person
2878,2,person,3,1,16148,17,233,95,255,143,22,48,person
2879,3,person,4,1,16148,17,192,86,226,146,34,60,person
2880,4,person,5,1,16148,16,181,123,211,173,30,50,person
2881,11,person,12,1,16148,56,5,7,233,249,228,242,person
2882,7,person,8,0,16149,23,328,651,375,765,47,114,person
2883,8,person,9,0,16149,23,242,623,295,744,53,121,person
2884,5,person,6,0,24362,109,688,167,917,643,229,476,person
2885,6,person,7,0,24362,82,495,312,616,676,121,364,person
2886,7,person,8,0,24362,70,285,315,403,641,118,326,person
2887,8,person,9,0,24362,88,170,350,341,683,171,333,person
2888,9,person,10,1,24362,61,489,212,599,385,110,173,person
2889,10,person,11,0,24362,65,599,192,679,426,80,234,person
2890,11,person,12,1,24362,44,789,201,839,494,50,293,person
2891,47,chair,48,0,24363,34,621,394,697,474,76,80,chair
2892,48,chair,49,0,24363,31,570,375,624,450,54,75,chair
2893,49,chair,50,0,24363,19,536,343,560,378,24,35,chair
2894,50,person,51,0,24363,32,443,306,463,363,20,57,person
2895,51,person,52,1,24363,30,441,299,455,361,14,62,person
2896,52,person,53,0,24363,36,420,304,441,368,21,64,person
2897,53,person,54,1,24363,21,408,301,420,367,12,66,person
2898,54,person,55,0,24363,36,387,304,418,376,31,72,person
2899,8,person,9,0,16151,21,127,220,144,275,17,55,person
2900,9,person,10,1,16151,16,137,232,160,268,23,36,person
2901,13,person,14,0,16151,20,220,222,234,274,14,52,person
2902,14,person,15,0,16151,33,232,223,250,293,18,70,person
2903,15,person,16,0,16151,20,247,225,269,272,22,47,person
2904,16,table,17,0,16151,32,60,250,228,420,168,170,dining table
2905,3,person,4,1,16152,28,99,56,156,161,57,105,person
2906,6,chair,7,1,16152,15,24,198,85,318,61,120,chair
2907,7,person,8,1,16152,44,68,120,190,285,122,165,person
2908,3,table,4,0,16153,50,41,107,201,201,160,94,dining table
2909,7,person,8,1,16761,30,138,657,199,940,61,283,person
2910,8,person,9,1,16761,20,199,652,254,746,55,94,person
2911,9,person,10,1,16761,20,256,650,310,748,54,98,person
2912,10,person,11,1,16761,22,240,697,277,862,37,165,person
2913,11,person,12,0,16761,34,175,703,255,984,80,281,person
2914,12,person,13,1,16761,24,323,639,379,729,56,90,person
2915,13,person,14,1,16761,17,277,687,330,791,53,104,person
2916,14,person,15,1,16761,19,328,687,371,771,43,84,person
2917,15,person,16,1,16761,42,248,744,326,1011,78,267,person
2918,16,person,17,1,16761,30,384,632,451,743,67,111,person
2919,17,person,18,1,16761,27,446,626,511,709,65,83,person
2920,18,person,19,1,16761,28,507,621,570,707,63,86,person
2921,19,person,20,1,16761,20,581,620,637,702,56,82,person
2922,20,person,21,1,16761,22,644,611,709,693,65,82,person
2923,21,person,22,1,16761,25,717,609,779,720,62,111,person
2924,22,person,23,1,16761,23,803,600,852,694,49,94,person
2925,23,person,24,1,16761,21,875,595,936,684,61,89,person
2926,24,person,25,1,16761,24,951,592,1001,683,50,91,person
2927,25,person,26,1,16761,23,1024,596,1079,682,55,86,person
2928,26,person,27,1,16761,20,1099,602,1152,687,53,85,person
2929,27,person,28,1,16761,22,1177,603,1243,692,66,89,person
2930,28,person,29,1,16761,23,1238,604,1287,701,49,97,person
2931,29,person,30,1,16761,25,1316,606,1370,733,54,127,person
2932,30,person,31,1,16761,23,1385,618,1436,746,51,128,person
2933,31,person,32,1,16761,23,1452,617,1501,747,49,130,person
2934,32,person,33,1,16761,24,1531,623,1600,722,69,99,person
2935,33,person,34,1,16761,26,1619,633,1678,746,59,113,person
2936,34,person,35,1,16761,38,1684,638,1748,919,64,281,person
2937,35,person,36,0,16761,32,1728,643,1806,928,78,285,person
2938,36,person,37,1,16761,32,1654,687,1726,966,72,279,person
2939,37,person,38,1,16761,20,1600,683,1653,767,53,84,person
2940,38,person,39,1,16761,22,1538,666,1602,769,64,103,person
2941,39,person,40,1,16761,21,1483,658,1535,751,52,93,person
2942,40,person,41,1,16761,21,1413,658,1468,754,55,96,person
2943,41,person,42,1,16761,25,1340,651,1386,737,46,86,person
2944,42,person,43,1,16761,21,1260,647,1321,731,61,84,person
2945,43,person,44,1,16761,21,1201,647,1252,738,51,91,person
2946,44,person,45,1,16761,29,1127,645,1202,724,75,79,person
2947,45,person,46,1,16761,22,1059,645,1109,721,50,76,person
2948,46,person,47,1,16761,18,990,643,1037,721,47,78,person
2949,47,person,48,1,16761,24,920,643,970,727,50,84,person
2950,48,person,49,1,16761,22,839,642,899,735,60,93,person
2951,49,person,50,1,16761,21,779,650,827,729,48,79,person
2952,50,person,51,1,16761,22,707,649,756,738,49,89,person
2953,51,person,52,1,16761,21,638,655,697,736,59,81,person
2954,52,person,53,1,16761,27,564,657,634,748,70,91,person
2955,53,person,54,1,16761,34,500,665,565,760,65,95,person
2956,54,person,55,1,16761,21,449,666,506,762,57,96,person
2957,55,person,56,1,16761,32,381,675,449,768,68,93,person
2958,56,person,57,1,16761,25,308,735,366,832,58,97,person
2959,57,person,58,1,16761,20,356,721,390,821,34,100,person
2960,58,person,59,1,16761,22,390,720,433,809,43,89,person
2961,59,person,60,1,16761,25,435,713,494,808,59,95,person
2962,60,person,61,1,16761,34,497,707,563,797,66,90,person
2963,61,person,62,1,16761,26,557,701,618,783,61,82,person
2964,62,person,63,1,16761,24,617,695,677,779,60,84,person
2965,63,person,64,1,16761,33,674,684,749,781,75,97,person
2966,64,person,65,1,16761,29,745,685,811,768,66,83,person
2967,65,person,66,1,16761,32,812,689,871,766,59,77,person
2968,66,person,67,1,16761,25,866,683,936,766,70,83,person
2969,67,person,68,1,16761,23,937,681,1003,763,66,82,person
2970,68,person,69,1,16761,20,1021,678,1067,767,46,89,person
2971,69,person,70,1,16761,21,1083,682,1135,762,52,80,person
2972,70,person,71,1,16761,27,1143,683,1208,763,65,80,person
2973,71,person,72,1,16761,27,1207,687,1277,770,70,83,person
2974,72,person,73,1,16761,29,1274,690,1333,777,59,87,person
2975,73,person,74,1,16761,19,1331,695,1392,784,61,89,person
2976,74,person,75,1,16761,20,1392,701,1459,787,67,86,person
2977,75,person,76,1,16761,23,1465,705,1524,794,59,89,person
2978,76,person,77,1,16761,17,1515,722,1568,805,53,83,person
2979,77,person,78,1,16761,17,1568,727,1621,820,53,93,person
2980,78,person,79,1,16761,27,1612,740,1674,1011,62,271,person
2981,79,person,80,0,16761,28,1564,794,1642,1065,78,271,person
2982,80,person,81,0,16761,27,1520,778,1584,1040,64,262,person
2983,81,person,82,0,16761,29,1464,768,1530,1025,66,257,person
2984,82,person,83,0,16761,28,1425,756,1484,1007,59,251,person
2985,83,person,84,0,16761,24,1382,750,1441,1000,59,250,person
2986,84,person,85,0,16761,26,1320,741,1394,984,74,243,person
2987,85,person,86,0,16761,24,1267,738,1329,973,62,235,person
2988,86,person,87,0,16761,27,1207,732,1279,965,72,233,person
2989,87,person,88,0,16761,25,1154,725,1216,956,62,231,person
2990,88,person,89,0,16761,20,1098,719,1162,952,64,233,person
2991,89,person,90,0,16761,21,1040,720,1102,951,62,231,person
2992,90,person,91,0,16761,24,975,719,1044,952,69,233,person
2993,91,person,92,0,16761,22,917,724,979,947,62,223,person
2994,92,person,93,0,16761,23,859,727,919,952,60,225,person
2995,93,person,94,0,16761,25,801,725,862,956,61,231,person
2996,94,person,95,0,16761,26,745,725,808,958,63,233,person
2997,95,person,96,0,16761,28,676,732,748,964,72,232,person
2998,96,person,97,0,16761,23,611,738,681,972,70,234,person
2999,97,person,98,0,16761,25,566,742,620,977,54,235,person
3000,98,person,99,0,16761,24,516,751,578,992,62,241,person
3001,99,person,100,0,16761,22,451,762,528,1009,77,247,person
3002,100,person,101,0,16761,23,407,769,468,1020,61,251,person
3003,101,person,102,0,16761,24,357,775,431,1035,74,260,person
3004,102,person,103,0,16761,26,311,796,379,1052,68,256,person
3005,103,person,104,0,16761,26,263,808,337,1082,74,274,person
3006,3,person,4,0,16766,26,82,115,104,177,22,62,person
3007,4,person,5,0,16766,23,126,115,151,174,25,59,person
3008,5,person,6,0,16766,23,62,149,83,231,21,82,person
3009,6,person,7,0,16766,26,24,136,44,211,20,75,person
3010,8,person,9,1,16766,23,172,185,211,240,39,55,person
3011,9,person,10,0,16766,21,242,157,266,209,24,52,person
3012,10,chair,11,0,16766,17,248,177,272,214,24,37,chair
3013,11,person,12,0,16766,20,276,155,307,201,31,46,person
3014,12,person,13,0,16766,16,211,131,230,180,19,49,person
3015,13,person,14,1,16766,19,179,133,198,185,19,52,person
3016,14,person,15,1,16766,28,83,212,120,279,37,67,person
3017,15,person,16,1,16766,15,202,116,217,146,15,30,person
3018,6,person,7,0,16772,20,257,167,274,221,17,54,person
3019,7,person,8,0,16772,18,300,193,325,246,25,53,person
3020,8,person,9,0,16772,18,381,188,402,238,21,50,person
3021,9,person,10,0,16772,24,180,303,217,377,37,74,person
3022,10,person,11,0,16772,21,101,184,117,236,16,52,person
3023,11,person,12,0,16772,19,341,181,357,227,16,46,person
3024,12,person,13,0,16772,17,358,183,373,234,15,51,person
3025,13,person,14,0,16772,16,262,349,281,411,19,62,person
3026,14,person,15,0,16772,19,341,300,377,352,36,52,person
3027,15,person,16,0,16772,22,396,287,421,345,25,58,person
3028,16,person,17,0,16772,21,448,264,475,320,27,56,person
3029,17,person,18,0,16772,18,299,163,317,208,18,45,person
3030,1,person,2,1,25186,124,88,20,952,766,864,746,person
3031,1,person,2,1,25187,76,6,28,584,526,578,498,person
3032,1,person,2,1,25188,125,245,19,844,676,599,657,person
3033,23,person,24,1,19056,31,241,359,307,448,66,89,person
3034,26,person,27,1,19056,17,335,381,401,448,66,67,person
3035,27,person,28,1,19056,20,387,371,448,448,61,77,person
3036,15,chair,16,0,19057,15,67,256,116,322,49,66,chair
3037,16,chair,17,0,19057,17,138,241,184,293,46,52,chair
3038,23,person,24,1,19057,18,383,217,431,263,48,46,person
3039,25,bench,26,0,19057,17,130,317,204,422,74,105,bench
3040,26,bench,27,0,19057,23,186,291,263,409,77,118,bench
3041,27,bench,28,0,19057,15,232,276,306,373,74,97,bench
3042,1,person,2,1,961,57,67,80,160,159,93,79,person
3043,2,person,3,1,961,43,162,84,247,155,85,71,person
3044,5,table,6,0,961,107,32,149,296,265,264,116,dining table
3045,6,person,7,1,961,71,0,155,128,265,128,110,person
3046,7,person,8,1,961,61,288,0,400,265,112,265,person
3047,7,person,8,1,19094,15,443,111,461,149,18,38,person
3048,8,person,9,1,19094,18,419,125,450,183,31,58,person
3049,9,person,10,1,19094,37,345,113,415,184,70,71,person
3050,10,person,11,1,19094,32,292,122,349,177,57,55,person
3051,11,person,12,0,19094,39,447,120,503,293,56,173,person
3052,12,person,13,1,19094,28,249,125,281,247,32,122,person
3053,13,person,14,0,19094,39,187,121,221,242,34,121,person
3054,14,person,15,1,19094,24,103,134,136,222,33,88,person
3055,15,person,16,1,19094,27,30,118,66,220,36,102,person
3056,16,person,17,1,19094,21,56,174,107,227,51,53,person
3057,19,chair,20,1,19094,16,154,187,174,250,20,63,chair
3058,20,person,21,1,19094,19,122,174,166,227,44,53,person
3059,21,person,22,0,19094,28,103,199,161,285,58,86,person
3060,1,person,2,0,19096,52,133,70,163,161,30,91,person
3061,5,person,6,1,19096,28,150,147,249,224,99,77,person
3062,11,person,12,1,19096,19,236,58,255,81,19,23,person
3063,15,person,16,1,19096,21,277,58,299,182,22,124,person
3064,0,desk,1,0,19098,22,47,116,190,193,143,77,desk
3065,1,person,2,1,19098,31,62,75,108,128,46,53,person
3066,2,person,3,1,19098,26,123,76,156,121,33,45,person
3067,3,desk,4,1,19099,17,146,272,349,363,203,91,desk
3068,19,chair,20,1,19099,16,546,269,589,334,43,65,chair
3069,2,person,3,1,19101,32,99,75,123,144,24,69,person
3070,5,person,6,0,19101,53,138,64,180,200,42,136,person
3071,6,person,7,0,19101,50,40,74,81,213,41,139,person
3072,10,person,11,0,19101,30,277,67,309,203,32,136,person
3073,3,person,4,0,19102,68,219,69,314,245,95,176,person
3074,4,person,5,1,19102,20,0,67,18,202,18,135,person
3075,4,sofa,5,1,19103,19,77,111,246,162,169,51,couch
3076,1,person,2,0,19104,81,146,61,271,223,125,162,person
3077,2,person,3,0,19104,54,240,72,328,223,88,151,person
3078,0,person,1,1,19105,19,14,70,31,95,17,25,person
3079,1,person,2,1,19105,21,59,72,81,97,22,25,person
3080,2,desk,3,0,19105,17,0,86,92,131,92,45,desk
3081,3,person,4,0,19105,58,25,62,60,165,35,103,person
3082,5,person,6,0,19105,41,129,48,166,188,37,140,person
3083,8,person,9,0,19105,55,205,69,239,168,34,99,person
3084,3,person,4,0,19106,29,70,109,141,249,71,140,person
3085,4,person,5,0,19106,33,121,100,200,239,79,139,person
3086,5,person,6,0,19106,34,174,100,233,221,59,121,person
3087,6,person,7,0,19106,34,245,110,324,230,79,120,person
3088,12,person,13,1,19106,18,356,303,525,475,169,172,person
3089,14,person,15,1,19106,28,501,119,583,255,82,136,person
3090,3,person,4,1,19107,19,139,161,169,230,30,69,person
3091,4,person,5,1,19107,25,3,99,40,214,37,115,person
3092,7,person,8,0,19107,45,205,145,274,276,69,131,person
3093,9,chair,10,1,19107,22,187,205,236,277,49,72,chair
3094,10,person,11,1,19107,23,253,138,305,188,52,50,person
3095,11,person,12,1,19107,34,282,135,342,269,60,134,person
3096,12,person,13,1,19107,23,380,51,448,287,68,236,person
3097,1,chair,2,1,24547,18,515,332,634,425,119,93,chair
3098,2,chair,3,1,24547,15,391,321,488,400,97,79,chair
3099,5,television,6,0,24547,29,257,231,377,333,120,102,tv
3100,6,person,7,1,24547,71,355,154,492,332,137,178,person
3101,7,person,8,1,24547,53,302,147,398,319,96,172,person
3102,8,person,9,1,24547,51,175,159,313,375,138,216,person
3103,4,person,5,0,24548,30,13,574,511,2057,498,1483,person
3104,5,person,6,1,24548,54,864,905,2121,2057,1257,1152,person
3105,6,table,7,0,24548,16,489,1226,2152,1556,1663,330,dining table
3106,0,person,1,1,24549,92,1,103,232,593,231,490,person
3107,1,person,2,1,24549,74,136,190,396,593,260,403,person
3108,2,person,3,1,24549,83,412,118,640,593,228,475,person
3109,3,person,4,1,24549,40,635,194,869,592,234,398,person
3110,4,person,5,1,24549,45,844,171,1023,474,179,303,person
3111,9,person,10,0,19155,16,116,128,122,149,6,21,person
3112,11,person,12,0,19155,15,103,126,109,149,6,23,person
3113,9,person,10,1,19160,20,2,128,16,163,14,35,person
3114,10,person,11,1,19160,18,109,171,133,189,24,18,person
3115,5,person,6,0,19172,32,133,49,182,137,49,88,person
3116,6,person,7,0,19172,25,241,60,263,138,22,78,person
3117,7,person,8,0,19172,19,267,90,299,143,32,53,person
3118,8,person,9,1,19172,57,327,105,539,431,212,326,person
3119,9,person,10,1,19172,36,124,300,297,464,173,164,person
3120,42,chair,43,0,19179,17,181,447,215,491,34,44,chair
3121,43,chair,44,0,19179,15,273,445,301,493,28,48,chair
3122,44,chair,45,0,19179,15,323,447,351,491,28,44,chair
3123,5,person,6,0,19183,48,298,125,404,455,106,330,person
3124,5,person,6,0,19191,45,69,583,270,1268,201,685,person
3125,15,person,16,0,19192,31,1952,878,2114,1257,162,379,person
3126,16,person,17,0,19192,24,1708,869,1761,1033,53,164,person
3127,17,person,18,0,19192,45,53,864,150,1130,97,266,person
3128,18,chair,19,0,19195,17,730,360,792,461,62,101,chair
3129,20,chair,21,0,19195,18,126,352,200,463,74,111,chair
3130,21,chair,22,1,19195,18,701,363,760,451,59,88,chair
3131,5,bench,6,1,19196,19,1407,917,2037,1398,630,481,bench
3132,8,chair,9,0,19197,15,115,178,141,210,26,32,chair
3133,2,person,3,1,24550,74,305,215,491,750,186,535,person
3134,3,person,4,1,24550,83,530,220,733,750,203,530,person
3135,9,table,10,0,24551,48,647,449,761,645,114,196,dining table
3136,10,table,11,0,24551,63,709,483,907,680,198,197,dining table
3137,11,table,12,0,24551,72,2,493,286,680,284,187,dining table
3138,11,person,12,0,291,36,362,296,383,363,21,67,person
3139,12,person,13,0,291,37,396,293,421,366,25,73,person
3140,13,person,14,0,291,27,418,297,435,367,17,70,person
3141,14,person,15,0,291,27,431,313,450,370,19,57,person
3142,15,person,16,0,291,29,447,296,468,368,21,72,person
3143,16,person,17,0,291,46,471,303,498,370,27,67,person
3144,17,person,18,1,291,32,486,297,503,367,17,70,person
3145,18,person,19,1,291,21,496,295,508,351,12,56,person
3146,19,person,20,0,291,23,510,301,523,361,13,60,person
3147,20,person,21,0,291,27,524,312,542,364,18,52,person
3148,21,person,22,0,291,32,547,300,567,357,20,57,person
3149,22,person,23,0,291,28,577,293,596,359,19,66,person
3150,23,person,24,0,291,29,601,291,622,360,21,69,person
3151,24,person,25,0,291,30,639,297,663,362,24,65,person
3152,25,person,26,1,291,31,629,293,641,352,12,59,person
3153,39,person,40,1,292,23,7,271,59,336,52,65,person
3154,40,person,41,0,292,21,92,275,139,336,47,61,person
3155,41,person,42,1,292,30,131,256,187,335,56,79,person
3156,42,person,43,1,292,30,191,233,246,336,55,103,person
3157,43,person,44,1,292,32,228,218,277,335,49,117,person
3158,44,person,45,1,292,29,290,212,340,314,50,102,person
3159,45,backpack,46,0,292,31,271,239,331,324,60,85,backpack
3160,46,person,47,1,292,39,327,189,380,305,53,116,person
3161,47,backpack,48,0,292,26,330,217,365,303,35,86,backpack
3162,48,person,49,1,292,34,387,192,452,281,65,89,person
3163,49,person,50,1,292,33,438,155,488,269,50,114,person
3164,50,backpack,51,1,292,22,427,181,472,246,45,65,backpack
3165,51,person,52,1,292,34,469,147,532,255,63,108,person
3166,52,person,53,1,292,19,500,136,528,192,28,56,person
3167,53,person,54,1,292,41,510,124,565,242,55,118,person
3168,54,person,55,1,292,36,564,113,630,218,66,105,person
3169,55,backpack,56,0,292,16,565,138,600,202,35,64,backpack
3170,56,person,57,1,292,30,580,104,630,159,50,55,person
3171,57,person,58,1,292,25,557,95,596,160,39,65,person
3172,58,person,59,1,292,27,534,79,572,130,38,51,person
3173,59,backpack,60,0,292,22,547,102,572,152,25,50,backpack
3174,60,person,61,1,292,27,560,56,585,102,25,46,person
3175,61,person,62,1,292,38,512,62,551,161,39,99,person
3176,62,backpack,63,0,292,22,532,65,549,114,17,49,backpack
3177,64,person,65,0,292,57,463,39,503,160,40,121,person
3178,65,person,66,0,292,61,401,18,456,158,55,140,person
3179,66,backpack,67,0,292,25,416,39,445,91,29,52,backpack
3180,67,person,68,1,292,38,390,46,416,151,26,105,person
3181,68,person,69,1,292,29,342,94,391,168,49,74,person
3182,69,person,70,0,292,31,315,73,345,170,30,97,person
3183,70,backpack,71,0,292,18,327,91,350,139,23,48,backpack
3184,71,backpack,72,0,292,15,345,97,374,139,29,42,backpack
3185,73,person,74,1,292,27,274,76,301,166,27,90,person
3186,74,backpack,75,0,292,19,285,86,315,125,30,39,backpack
3187,75,person,76,1,292,42,261,58,295,153,34,95,person
3188,77,person,78,1,292,17,187,54,206,101,19,47,person
3189,78,person,79,1,292,17,189,106,208,171,19,65,person
3190,79,person,80,1,292,23,214,79,239,163,25,84,person
3191,80,person,81,1,292,25,233,73,260,158,27,85,person
3192,10,chair,11,1,19203,21,0,190,51,240,51,50,chair
3193,2,person,3,0,19205,47,37,128,175,287,138,159,person
3194,3,chair,4,0,19205,34,52,182,177,285,125,103,chair
3195,6,person,7,1,19207,20,234,208,257,316,23,108,person
3196,7,person,8,0,19207,32,250,202,309,327,59,125,person
3197,4,chair,5,0,24553,34,158,392,302,582,144,190,chair
3198,10,person,11,1,24553,23,14,239,60,316,46,77,person
3199,4,car,5,1,24554,19,619,253,653,287,34,34,car
3200,5,bench,6,0,19507,33,2,128,130,213,128,85,bench
3201,8,table,9,0,19507,19,159,140,296,189,137,49,dining table
3202,2,window,3,0,19509,15,246,171,323,270,77,99,window
3203,6,person,7,1,19509,17,149,204,235,303,86,99,person
3204,7,person,8,0,19509,39,156,227,263,530,107,303,person
3205,8,person,9,1,19509,32,249,218,301,508,52,290,person
3206,14,chair,15,0,19510,20,95,198,164,305,69,107,chair
3207,9,chair,10,0,19511,19,61,164,109,244,48,80,chair
3208,11,chair,12,0,19511,16,144,160,186,231,42,71,chair
3209,24,chair,24,1,19511,15,432,175,502,264,70,89,chair
3210,28,chair,28,1,19511,16,15,149,61,235,46,86,chair
3211,11,person,12,1,19512,49,9,109,210,402,201,293,person
3212,12,person,13,1,19512,34,93,175,272,403,179,228,person
3213,13,person,14,0,19512,41,420,161,540,402,120,241,person
3214,13,table,14,0,19513,19,9,225,133,280,124,55,dining table
3215,7,chair,8,1,19514,21,78,234,157,323,79,89,chair
3216,8,chair,9,1,19514,25,197,221,276,323,79,102,chair
3217,9,chair,10,0,19514,29,279,200,374,322,95,122,chair
3218,10,chair,11,0,19514,20,362,181,421,305,59,124,chair
3219,7,person,8,1,19597,16,101,143,118,213,17,70,person
3220,8,person,9,0,19597,18,148,141,164,207,16,66,person
3221,9,person,10,0,19597,15,121,147,131,178,10,31,person
3222,13,person,14,1,19597,16,360,69,498,372,138,303,person
3223,5,person,6,0,19598,32,24,43,93,226,69,183,person
3224,7,person,8,0,19598,31,122,51,191,223,69,172,person
3225,9,person,10,0,19598,33,208,58,273,218,65,160,person
3226,10,person,11,0,19598,25,285,75,320,192,35,117,person
3227,11,person,12,0,19598,77,211,107,471,447,260,340,person
3228,12,chair,13,0,19598,24,169,172,317,429,148,257,chair
3229,14,person,15,1,19598,15,362,68,411,127,49,59,person
3230,15,person,16,1,19598,36,411,26,495,254,84,228,person
3231,16,person,17,0,19598,41,483,16,574,275,91,259,person
3232,19,person,20,0,19598,28,593,60,647,248,54,188,person
3233,5,person,6,0,19600,73,314,31,401,251,87,220,person
3234,6,person,7,0,19600,61,380,57,499,276,119,219,person
3235,7,chair,8,0,19600,16,500,93,534,147,34,54,chair
3236,2,person,3,1,19601,30,35,143,89,228,54,85,person
3237,4,person,5,1,19601,39,116,143,177,233,61,90,person
3238,6,person,7,1,19601,35,204,146,247,232,43,86,person
3239,9,person,10,1,19601,30,281,148,336,235,55,87,person
3240,10,person,11,1,19601,30,367,146,406,235,39,89,person
3241,5,person,6,1,19602,32,422,66,500,373,78,307,person
3242,2,chair,3,0,19603,22,111,140,167,201,56,61,chair
3243,6,chair,7,1,19603,16,190,167,243,200,53,33,chair
3244,9,chair,10,1,19603,18,17,176,75,200,58,24,chair
3245,19,person,20,0,19969,16,683,384,697,427,14,43,person
3246,21,person,22,0,19969,15,725,386,734,426,9,40,person
3247,3,person,4,1,20082,42,141,47,362,263,221,216,person
3248,5,chair,6,1,20083,18,25,57,57,114,32,57,chair
3249,6,person,7,1,20083,23,40,41,81,99,41,58,person
3250,13,person,14,1,20083,16,225,69,256,98,31,29,person
3251,3,person,4,1,20084,42,0,31,236,288,236,257,person
3252,5,person,6,0,20084,21,233,72,315,140,82,68,person
3253,6,person,7,1,20084,15,372,70,404,134,32,64,person
3254,7,chair,8,1,20085,25,259,223,379,452,120,229,chair
3255,3,person,4,1,20086,59,42,38,368,205,326,167,person
3256,2,person,3,1,20087,55,239,96,491,340,252,244,person
3257,3,person,4,1,20087,33,0,19,207,289,207,270,person
3258,2,person,3,1,20088,45,116,28,244,201,128,173,person
3259,4,person,5,1,20089,32,27,34,75,135,48,101,person
3260,6,person,7,0,20089,21,169,98,217,136,48,38,person
3261,7,person,8,1,20089,48,136,56,269,169,133,113,person
3262,5,bed,6,0,1207,15,106,364,430,619,324,255,bed
3263,12,chair,13,1,1207,21,428,455,528,728,100,273,chair
3264,10,bed,11,0,1208,25,154,246,370,359,216,113,bed
3265,10,chair,11,0,1209,41,203,126,287,225,84,99,chair
3266,19,bed,20,1,1212,29,134,235,450,300,316,65,bed
3267,5,sofa,6,0,1213,23,22,522,735,828,713,306,couch
3268,12,bed,13,1,1214,25,0,176,406,411,406,235,bed
3269,7,table,8,0,1215,19,166,185,239,254,73,69,dining table
3270,8,chair,9,0,1215,23,106,181,161,254,55,73,chair
3271,9,chair,10,0,1215,21,234,182,278,253,44,71,chair
3272,10,sofa,11,0,1216,16,2,237,210,359,208,122,couch
3273,6,sofa,7,0,1218,29,560,204,825,555,265,351,couch
3274,7,sofa,8,0,1218,37,121,212,407,598,286,386,couch
3275,10,table,11,0,1218,19,459,287,608,460,149,173,dining table
3276,6,table,7,1,1221,16,129,180,186,211,57,31,dining table
3277,7,bed,8,0,1221,26,57,199,293,333,236,134,bed
3278,2,bed,3,0,1223,18,161,224,371,328,210,104,bed
3279,9,clock,10,0,1223,25,233,92,264,160,31,68,clock
3280,10,bed,11,0,1224,56,543,634,1685,1446,1142,812,bed
3281,15,chair,16,1,1225,25,431,452,528,730,97,278,chair
3282,5,table,6,0,1226,15,250,319,344,420,94,101,dining table
3283,6,chair,7,1,1228,22,46,439,198,578,152,139,chair
3284,8,bed,9,1,1229,61,509,244,1279,959,770,715,bed
3285,17,bed,18,0,1230,51,259,894,1388,1300,1129,406,bed
3286,21,mirror,22,1,1230,51,1976,0,2197,746,221,746,mirror
3287,7,sofa,8,1,22606,29,1,191,208,483,207,292,couch
3288,5,bed,6,1,22609,19,965,432,1012,761,47,329,bed
3289,14,table,15,0,22609,25,260,412,490,573,230,161,dining table
3290,2,plant pot,3,0,22611,18,287,447,369,530,82,83,potted plant
3291,6,bench,7,0,22611,31,363,402,474,493,111,91,bench
3292,3,bed,4,0,22612,31,356,233,950,627,594,394,bed
3293,13,vase,14,0,22612,24,584,480,691,634,107,154,vase
3294,4,window,5,0,22613,17,1135,293,1428,898,293,605,window
3295,14,flowerpot,15,0,1860,18,254,532,360,627,106,95,potted plant
3296,22,flowerpot,23,1,1860,15,606,355,719,487,113,132,potted plant
3297,24,sofa,25,0,1860,26,715,285,997,553,282,268,couch
3298,25,bird,26,0,1860,25,825,43,886,205,61,162,bird
3299,10,chair,11,1,1861,17,129,387,230,458,101,71,chair
3300,11,chair,12,1,1861,16,235,370,311,431,76,61,chair
3301,14,chair,15,1,1861,21,557,399,633,683,76,284,chair
3302,15,chair,16,1,1861,22,479,429,582,684,103,255,chair
3303,16,chair,17,1,1861,18,362,479,504,683,142,204,chair
3304,8,chair,9,0,1863,21,153,181,198,251,45,70,chair
3305,14,table,15,1,1866,16,572,198,660,304,88,106,dining table
3306,9,bed,10,0,1885,66,2,331,885,856,883,525,bed
3307,3,door,4,1,1886,16,0,76,48,164,48,88,door
3308,9,bed,10,0,1886,27,127,133,300,225,173,92,bed
3309,10,sofa,11,0,1886,65,126,143,233,233,107,90,couch
3310,14,bed,15,1,1888,19,1,1157,1043,1649,1042,492,bed
3311,4,sofa,5,1,1889,22,176,89,247,127,71,38,couch
3312,7,desk,8,0,1889,20,62,94,149,147,87,53,desk
3313,11,sofa,12,1,1889,15,0,92,90,187,90,95,couch
3314,8,person,9,1,1890,52,223,409,555,1196,332,787,person
3315,11,person,12,1,1890,58,1005,382,1360,1195,355,813,person
3316,17,shoe,18,0,1892,15,223,200,257,214,34,14,shoe
3317,20,chair,21,1,1892,16,0,169,94,311,94,142,chair
3318,0,person,1,0,1896,53,328,349,625,1391,297,1042,person
3319,2,suitcase,3,0,1896,17,137,1114,416,1552,279,438,suitcase
3320,3,window,4,1,1897,66,10,115,190,231,180,116,window
3321,4,bed,5,1,1897,21,152,195,266,320,114,125,bed
3322,6,table,7,1,1897,20,8,219,112,283,104,64,dining table
3323,7,chair,8,1,1897,33,85,206,154,295,69,89,chair
3324,9,chair,10,1,1897,18,0,266,99,330,99,64,chair
3325,16,window,17,1,1898,16,1055,556,1340,806,285,250,window
3326,19,chair,20,0,1898,22,1099,726,1181,888,82,162,chair
3327,20,chair,21,0,1898,22,1204,717,1310,871,106,154,chair
3328,15,person,16,0,1900,135,781,315,1230,1160,449,845,person
3329,6,bed,7,1,1903,43,759,424,1465,751,706,327,bed
3330,9,bed,10,1,1903,39,444,463,1599,1198,1155,735,bed
3331,16,bed,17,0,1905,63,1023,644,2197,1648,1174,1004,bed
3332,19,sofa,20,1,1905,27,2,815,366,1500,364,685,couch
3333,20,sofa,20,1,1907,32,0,116,206,316,206,200,couch
3334,28,sofa,28,0,1907,53,153,93,292,182,139,89,couch
3335,4,bed,5,0,1912,33,1013,831,2198,1474,1185,643,bed
3336,5,bed,6,0,1912,39,259,817,1396,1608,1137,791,bed
3337,5,bed,6,0,1915,15,47,132,242,237,195,105,bed
3338,3,bed,4,0,1916,21,0,60,272,449,272,389,bed
3339,8,bed,9,1,1918,26,227,442,388,563,161,121,bed
3340,6,bed,7,1,1919,35,1346,903,2199,1648,853,745,bed
3341,7,bed,8,1,1919,30,0,871,1224,1647,1224,776,bed
3342,7,bed,8,1,1920,33,616,371,1279,959,663,588,bed
3343,9,bed,10,0,1920,44,2,372,498,947,496,575,bed
3344,2,window,3,0,1921,22,915,182,1294,562,379,380,window
3345,3,bed,4,0,1921,82,129,465,1545,1143,1416,678,bed
3346,4,bed,5,1,1922,20,70,117,138,166,68,49,bed
3347,5,bed,6,1,1922,19,177,109,242,164,65,55,bed
3348,7,bed,8,1,1922,24,216,140,265,235,49,95,bed
3349,9,chair,10,1,1922,20,76,144,138,224,62,80,chair
3350,10,chair,11,0,1922,18,149,120,167,158,18,38,chair
3351,10,bed,11,0,1923,18,8,178,164,251,156,73,bed
3352,4,desk,5,0,1924,28,896,538,1276,894,380,356,desk
3353,5,chair,6,0,1924,33,1039,565,1279,992,240,427,chair
3354,12,bed,13,0,1924,78,331,442,904,915,573,473,bed
3355,19,bed,20,1,1924,27,0,525,492,1023,492,498,bed
3356,30,television,31,0,1924,24,786,65,949,235,163,170,tv
3357,10,bed,11,0,1925,87,102,356,1041,959,939,603,bed
3358,14,sofa,15,1,1926,46,68,148,226,266,158,118,couch
3359,13,bed,14,1,1928,15,587,1753,1532,2047,945,294,bed
3360,6,bed,7,0,1929,30,25,83,271,231,246,148,bed
3361,11,sofa,12,0,1930,23,0,493,277,864,277,371,couch
3362,1,bed,2,1,1933,20,0,691,322,1146,322,455,bed
3363,7,bed,8,1,1933,24,524,689,959,1149,435,460,bed
3364,9,bed,10,1,1937,20,0,171,166,246,166,75,bed
3365,4,bed,5,0,1940,58,855,865,1942,1407,1087,542,bed
3366,5,bicycle,6,1,1940,131,1288,885,2199,1621,911,736,bicycle
3367,8,television,9,1,1941,69,83,883,500,1374,417,491,tv
3368,10,table,11,1,1941,32,269,793,670,982,401,189,dining table
3369,11,chair,12,1,1941,26,332,678,642,826,310,148,chair
3370,12,chair,13,1,1941,58,222,882,692,1374,470,492,chair
3371,13,bed,14,0,1941,51,990,676,2189,1374,1199,698,bed
3372,17,bed,18,0,1942,71,0,410,637,829,637,419,bed
3373,19,table,20,0,1943,34,270,202,409,295,139,93,dining table
3374,6,sofa,7,0,1944,35,2,160,152,286,150,126,couch
3375,7,table,8,1,1944,23,106,135,174,213,68,78,dining table
3376,5,chair,6,0,1945,21,144,73,199,158,55,85,chair
3377,3,bed,4,0,1946,53,58,110,265,236,207,126,bed
3378,9,bed,10,1,1947,30,82,149,330,247,248,98,bed
3379,3,desk,4,0,1948,26,65,291,348,495,283,204,desk
3380,9,bed,10,1,1949,26,1101,491,1872,1409,771,918,bed
3381,13,bed,14,0,1949,25,74,489,1015,1378,941,889,bed
3382,10,bed,11,1,1950,47,767,510,1596,1195,829,685,bed
3383,24,table,25,1,1950,22,1013,587,1209,624,196,37,dining table
3384,4,bed,5,0,1951,16,379,458,806,654,427,196,bed
3385,3,bed,4,1,1952,34,1321,764,2015,1511,694,747,bed
3386,13,bed,14,1,1953,33,288,812,844,1352,556,540,bed
3387,18,table,19,1,1954,23,300,458,450,634,150,176,dining table
3388,21,chair,22,0,1954,41,199,445,377,675,178,230,chair
3389,15,chair,16,0,1956,18,1203,716,1310,871,107,155,chair
3390,16,chair,17,0,1956,15,1102,723,1180,880,78,157,chair
3391,8,person,9,0,1961,109,1186,326,1452,1367,266,1041,person
3392,6,bed,7,0,1962,44,755,420,1526,750,771,330,bed
3393,10,bed,11,0,1962,45,443,464,1598,1198,1155,734,bed
3394,7,table,8,0,1963,30,1552,1151,2197,1647,645,496,dining table
3395,6,bed,7,1,1964,52,1087,704,1790,1311,703,607,bed
3396,3,bed,4,1,1966,34,298,949,550,1534,252,585,bed
3397,9,bed,10,1,1966,26,1296,894,1675,1534,379,640,bed
3398,4,bed,5,0,1967,19,26,146,238,399,212,253,bed
3399,8,desk,9,0,1967,22,467,227,599,399,132,172,desk
3400,13,chair,14,0,1967,46,406,210,517,399,111,189,chair
3401,3,bed,4,1,1971,34,0,814,1124,1647,1124,833,bed
3402,5,bed,6,1,1971,36,1136,752,2198,1647,1062,895,bed
3403,8,pot,9,0,20249,17,407,1375,543,1518,136,143,potted plant
3404,12,window,13,0,20249,28,611,671,1209,1212,598,541,window
3405,6,bed,7,0,22719,71,257,367,695,545,438,178,bed
3406,4,bed,5,0,22721,130,132,329,874,800,742,471,bed
3407,5,window,6,0,22721,34,696,194,903,408,207,214,window
3408,11,table,12,0,22721,36,1136,602,1512,1016,376,414,dining table
3409,12,table,13,1,22721,16,1069,444,1315,615,246,171,dining table
3410,17,television,18,0,22721,20,1079,334,1200,463,121,129,tv
3411,18,chair,19,0,22721,34,1057,449,1163,745,106,296,chair
3412,4,bed,5,0,2461,21,214,71,321,228,107,157,bed
3413,6,bed,7,0,2461,16,133,99,168,182,35,83,bed
3414,8,person,9,1,2462,16,1414,722,1473,1045,59,323,person
3415,10,person,11,1,2462,17,1199,715,1237,1085,38,370,person
3416,7,television,8,1,2475,16,267,155,295,194,28,39,tv
3417,21,chair,22,1,2481,22,332,555,716,958,384,403,chair
3418,12,chair,13,0,2484,22,273,152,316,202,43,50,chair
3419,13,chair,14,1,2484,26,134,146,197,207,63,61,chair
3420,15,chair,16,1,2484,31,78,165,144,303,66,138,chair
3421,16,table,17,1,2484,19,61,183,103,242,42,59,dining table
3422,17,chair,18,0,2484,37,2,184,96,317,94,133,chair
3423,18,chair,19,0,2484,34,300,170,395,268,95,98,chair
3424,9,table,10,1,2487,15,350,409,510,669,160,260,dining table
3425,9,sofa,10,1,2492,29,24,116,103,180,79,64,couch
3426,10,chair,11,1,2492,18,0,125,52,194,52,69,chair
3427,13,sofa,14,1,2493,47,0,184,316,404,316,220,couch
3428,13,sofa,14,0,2495,57,807,788,1888,1337,1081,549,couch
3429,13,table,14,1,2496,23,194,689,732,1115,538,426,dining table
3430,14,chair,15,1,2496,32,173,683,398,1099,225,416,chair
3431,15,chair,16,1,2496,33,357,643,624,1056,267,413,chair
3432,11,sofa,12,1,2497,26,0,150,172,240,172,90,couch
3433,11,door,12,0,22817,26,447,1,920,837,473,836,door
3434,4,bed,5,0,22818,33,183,405,678,768,495,363,bed
3435,9,hair dryer,10,0,22818,31,815,546,1023,764,208,218,hair drier
3436,14,tele vision,15,0,22818,20,663,147,909,342,246,195,tv
3437,12,table,13,0,22821,30,57,373,345,639,288,266,dining table
3438,13,table,14,0,22821,20,274,352,404,490,130,138,dining table
3439,17,car,18,1,22821,40,553,308,1022,445,469,137,car
3440,18,car,19,1,22821,32,573,352,1023,648,450,296,car
3441,6,sink,7,0,2530,15,373,788,641,924,268,136,sink
3442,8,person,9,0,2532,49,441,48,503,301,62,253,person
3443,31,person,32,1,2533,16,561,900,618,942,57,42,person
3444,32,person,33,1,2533,16,739,858,775,904,36,46,person
3445,34,person,35,0,2533,17,965,892,1027,942,62,50,person
3446,35,person,36,1,2533,18,864,1106,916,1165,52,59,person
3447,36,person,37,1,2533,21,1026,1049,1099,1106,73,57,person
3448,37,person,38,1,2533,17,480,1072,544,1116,64,44,person
3449,39,person,40,0,2533,19,913,688,948,775,35,87,person
3450,40,chair,41,1,2533,15,1387,940,1455,1030,68,90,chair
3451,43,chair,44,1,2533,16,190,894,249,973,59,79,chair
3452,2,sink,3,0,40,54,0,261,996,670,996,409,sink
3453,5,person,6,1,40,51,320,3,999,610,679,607,person
3454,3,sink,4,0,6,33,531,901,929,1452,398,551,sink
3455,7,toilet,8,0,7,29,337,593,509,894,172,301,toilet
3456,11,mirror,12,1,7,16,0,123,211,579,211,456,mirror
3457,25,bowl,26,0,7,23,338,694,507,894,169,200,bowl
3458,1,toilet,2,1,9,31,253,1182,1013,1649,760,467,toilet
3459,5,sink,6,0,10,22,287,682,400,771,113,89,sink
3460,9,mirror,10,0,10,19,241,160,438,623,197,463,mirror
3461,3,sink,4,0,11,18,8,207,86,239,78,32,sink
3462,2,toilet,3,1,12,41,107,327,643,1144,536,817,toilet
3463,7,door,8,0,12,17,1369,1,1650,2135,281,2134,door
3464,14,sink,14,0,13,33,191,1356,745,1643,554,287,sink
3465,19,flowerpot,20,0,14,16,259,490,413,671,154,181,potted plant
3466,9,toilet,10,1,15,39,1465,1042,2191,1765,726,723,toilet
3467,13,sink,14,0,15,54,365,780,818,1393,453,613,sink
3468,8,toilet,9,1,16,37,96,779,553,1199,457,420,toilet
3469,3,sink,4,0,17,68,460,1109,1417,1560,957,451,sink
3470,6,toilet,7,0,18,39,633,821,1243,1461,610,640,toilet
3471,6,toilet,7,1,19,17,613,270,639,387,26,117,toilet
3472,17,sink,18,0,19,21,19,255,155,279,136,24,sink
3473,8,pot,9,0,20,17,26,1605,202,1811,176,206,potted plant
3474,3,sink,4,0,24,24,530,1297,917,1521,387,224,sink
3475,15,toilet,16,0,25,18,295,1201,532,1382,237,181,toilet
3476,5,vase,6,0,27,19,1304,1491,1383,1653,79,162,vase
3477,10,hat,11,0,27,23,934,194,1159,919,225,725,hat
3478,11,hat,12,0,27,36,451,475,645,1188,194,713,hat
3479,12,hat,13,0,27,24,215,114,424,1000,209,886,hat
3480,16,toilet,17,0,27,37,645,1465,1188,2194,543,729,toilet
3481,7,toilet,8,0,28,24,583,745,1148,1630,565,885,toilet
3482,12,bottle,13,0,28,16,382,1300,505,1616,123,316,bottle
3483,13,pot,14,1,28,15,326,1304,380,1424,54,120,potted plant
3484,14,pot,15,1,28,23,277,1318,336,1569,59,251,potted plant
3485,16,sink,17,1,28,29,160,686,559,988,399,302,sink
3486,13,sink,13,0,30,27,464,760,749,954,285,194,sink
3487,7,chair,8,1,31,22,664,847,866,999,202,152,chair
3488,7,chair,8,0,32,35,22,670,466,1149,444,479,chair
3489,10,bottle,11,0,32,15,537,656,587,792,50,136,bottle
3490,8,sink,9,0,33,23,328,456,596,806,268,350,sink
3491,13,toilet,14,0,33,26,51,500,271,950,220,450,toilet
3492,22,bowl,23,0,33,26,77,672,272,950,195,278,bowl
3493,9,toilet,10,0,35,42,537,668,753,934,216,266,toilet
3494,3,window,4,0,36,19,137,49,217,124,80,75,window
3495,8,toilet,9,1,36,30,234,108,307,190,73,82,toilet
3496,9,sink,10,0,36,15,240,117,335,179,95,62,sink
3497,12,chair,13,1,36,26,68,67,105,110,37,43,chair
3498,20,chair,21,1,37,16,573,370,600,436,27,66,chair
3499,5,window,6,1,39,24,70,62,188,387,118,325,window
3500,6,vase,7,0,39,26,74,332,171,502,97,170,vase
3501,8,toilet,9,0,40,17,457,1567,856,2096,399,529,toilet
3502,12,mirror,13,0,40,24,136,585,476,749,340,164,mirror
3503,6,sink,7,0,42,29,144,269,361,388,217,119,sink
3504,2,sink,3,0,43,29,935,1146,1267,1210,332,64,sink
3505,12,chair,13,1,43,45,0,1458,767,2199,767,741,chair
3506,14,mirror,15,0,43,27,689,308,1343,1047,654,739,mirror
3507,13,toilet,14,1,44,15,29,440,174,509,145,69,toilet
3508,8,sink,9,0,45,37,32,170,181,326,149,156,sink
3509,11,toilet,12,0,45,35,175,188,264,296,89,108,toilet
3510,16,pot,17,0,47,17,842,529,908,652,66,123,potted plant
3511,17,mirror,18,0,47,15,849,0,1018,663,169,663,mirror
3512,20,sink,21,0,47,15,617,1041,965,1300,348,259,sink
3513,23,toilet,24,1,47,34,252,950,633,1534,381,584,toilet
3514,35,bowl,36,0,47,20,249,1268,469,1535,220,267,bowl
3515,12,mirror,13,0,48,28,0,427,615,1387,615,960,mirror
3516,15,sink,16,0,48,22,331,1282,691,1423,360,141,sink
3517,3,toilet,4,0,49,42,472,780,664,1146,192,366,toilet
3518,5,sink,6,0,49,17,50,743,250,785,200,42,sink
3519,3,window,4,0,50,18,457,325,671,603,214,278,window
3520,11,chair,12,0,50,44,374,647,555,941,181,294,chair
3521,2,window,3,0,51,19,296,1,661,126,365,125,window
3522,9,chair,10,1,51,40,837,469,1017,798,180,329,chair
3523,2,mirror,3,0,53,16,78,36,230,424,152,388,mirror
3524,7,sink,8,0,53,33,5,662,389,960,384,298,sink
3525,6,toilet,7,0,54,65,799,881,1318,1648,519,767,toilet
3526,13,table,14,1,54,15,1522,1360,2082,1648,560,288,dining table
3527,14,chair,15,0,54,43,442,1043,865,1648,423,605,chair
3528,5,vase,6,0,55,17,315,565,369,751,54,186,vase
3529,10,pot,11,0,55,57,376,691,480,933,104,242,potted plant
3530,14,bottle,15,1,55,15,1114,739,1149,874,35,135,bottle
3531,16,bottle,17,0,55,16,892,644,928,749,36,105,bottle
3532,9,toilet,10,0,56,42,558,403,738,634,180,231,toilet
3533,10,sink,11,0,56,35,151,359,585,528,434,169,sink
3534,32,bowl,33,0,56,37,561,466,739,634,178,168,bowl
3535,5,window,5,0,57,18,566,248,796,404,230,156,window
3536,7,vase,7,0,57,17,493,298,534,409,41,111,vase
3537,27,door,27,0,57,18,960,0,1198,801,238,801,door
3538,20,sink,21,0,58,30,285,556,583,701,298,145,sink
3539,25,sink,26,0,58,23,767,539,1058,671,291,132,sink
3540,30,toilet,31,1,58,19,1266,867,1502,1048,236,181,toilet
3541,6,sink,7,0,60,17,513,369,665,407,152,38,sink
3542,12,toilet,13,0,60,35,269,321,357,488,88,167,toilet
3543,15,mirror,16,0,60,29,526,1,788,307,262,306,mirror
3544,16,pot,17,1,60,18,696,336,730,394,34,58,potted plant
3545,16,mirror,15,0,61,22,995,249,1211,434,216,185,mirror
3546,23,mirror,21,0,61,32,2,154,224,473,222,319,mirror
3547,44,sink,41,0,61,16,1,484,229,546,228,62,sink
3548,12,window,10,1,62,21,807,174,936,620,129,446,window
3549,23,toilet,21,0,62,27,256,624,437,811,181,187,toilet
3550,35,bowl,33,0,62,26,268,725,437,812,169,87,bowl
3551,41,bowl,39,0,62,18,142,858,409,997,267,139,bowl
3552,8,sink,9,0,63,20,680,1160,1095,1245,415,85,sink
3553,11,toilet,12,0,63,35,111,1224,556,2199,445,975,toilet
3554,3,toilet,4,1,64,30,2,622,404,1112,402,490,toilet
3555,5,pot,6,0,64,27,776,434,892,737,116,303,potted plant
3556,6,pot,7,0,64,39,959,446,1094,786,135,340,potted plant
3557,10,mirror,11,0,64,77,555,4,943,578,388,574,mirror
3558,11,mirror,12,1,64,34,1087,3,1210,602,123,599,mirror
3559,1,vase,2,1,65,15,299,312,329,486,30,174,vase
3560,10,sink,11,0,65,17,420,395,560,448,140,53,sink
3561,12,chair,13,0,65,29,59,340,236,587,177,247,chair
3562,11,sink,11,1,66,31,846,722,1196,996,350,274,sink
3563,3,toilet,4,0,67,30,777,840,1148,1324,371,484,toilet
3564,11,sink,12,0,67,53,5,883,582,1221,577,338,sink
3565,37,bowl,38,0,67,26,814,1036,1147,1326,333,290,bowl
3566,8,sink,9,0,69,37,873,541,1132,959,259,418,sink
3567,10,sink,11,0,70,17,929,681,1231,814,302,133,sink
3568,11,toilet,12,0,71,52,990,851,1322,1414,332,563,toilet
3569,27,bowl,28,0,71,26,1075,1156,1313,1410,238,254,bowl
3570,10,bottle,11,0,72,16,716,442,763,509,47,67,bottle
3571,14,sink,15,0,72,20,446,507,692,593,246,86,sink
3572,22,toilet,23,0,72,16,341,797,623,1047,282,250,toilet
3573,10,sink,11,0,73,21,52,275,243,323,191,48,sink
3574,11,sink,12,0,73,25,241,312,449,371,208,59,sink
3575,12,sink,13,0,73,27,478,354,725,436,247,82,sink
3576,13,sink,14,0,73,20,809,419,1023,532,214,113,sink
3577,13,pot,14,0,74,15,964,1084,1042,1170,78,86,potted plant
3578,6,sink,7,0,75,17,830,822,1353,949,523,127,sink
3579,8,bottle,9,0,75,15,749,981,793,1149,44,168,bottle
3580,8,sink,9,0,76,18,380,656,676,743,296,87,sink
3581,15,toilet,16,0,76,22,599,739,767,1024,168,285,toilet
3582,8,toilet,9,1,77,17,1023,730,1157,1002,134,272,toilet
3583,12,sink,13,0,77,25,233,649,675,903,442,254,sink
3584,13,sink,14,1,77,17,13,861,576,1139,563,278,sink
3585,11,toilet,12,1,78,53,123,1424,1009,2196,886,772,toilet
3586,13,sink,14,1,78,21,38,1430,531,2104,493,674,sink
3587,14,bowl,15,0,80,17,837,701,951,793,114,92,bowl
3588,16,vase,17,1,80,30,962,580,1089,823,127,243,vase
3589,29,bottle,30,0,80,15,286,759,315,798,29,39,bottle
3590,30,bottle,31,0,80,16,315,757,339,794,24,37,bottle
3591,31,bottle,32,0,80,17,338,749,364,787,26,38,bottle
3592,3,window,4,1,81,19,1,224,178,1277,177,1053,window
3593,6,toilet,7,0,81,51,512,1394,1134,2201,622,807,toilet
3594,7,sink,8,1,81,18,1061,1402,1465,2201,404,799,sink
3595,7,sink,8,0,82,25,446,452,718,785,272,333,sink
3596,8,toilet,9,0,82,22,606,511,883,882,277,371,toilet
3597,30,bowl,31,0,82,16,608,692,873,884,265,192,bowl
3598,9,sink,10,0,83,37,886,1138,1433,1286,547,148,sink
3599,16,vase,17,0,83,19,261,884,407,1132,146,248,vase
3600,3,mirror,4,0,84,17,1630,1,2199,1038,569,1037,mirror
3601,7,pot,8,0,84,17,1786,958,1885,1100,99,142,potted plant
3602,9,sink,10,0,84,22,1484,1137,2091,1332,607,195,sink
3603,12,toilet,13,0,84,35,325,964,1095,1651,770,687,toilet
3604,5,toilet,6,0,85,28,573,537,820,916,247,379,toilet
3605,9,sink,10,0,85,36,855,573,1112,917,257,344,sink
3606,14,mirror,15,0,86,17,363,1,917,846,554,845,mirror
3607,1,mirror,2,0,88,37,58,4,1010,1257,952,1253,mirror
3608,4,toilet,4,0,88,56,746,1309,1346,2095,600,786,toilet
3609,15,sink,15,0,88,28,63,1307,620,1461,557,154,sink
3610,35,bowl,35,0,88,32,865,1627,1344,2092,479,465,bowl
3611,12,toilet,13,1,89,19,1751,1019,1900,1263,149,244,toilet
3612,4,sink,5,0,90,15,211,1068,709,1555,498,487,sink
3613,2,window,3,0,91,30,708,112,1427,1360,719,1248,window
3614,4,flowerpot,5,0,91,38,1597,1123,1797,1333,200,210,potted plant
3615,23,sink,23,0,91,16,1627,1381,2165,1480,538,99,sink
3616,3,mirror,4,0,92,18,0,1,739,710,739,709,mirror
3617,14,sink,15,1,92,52,0,714,400,879,400,165,sink
3618,17,sink,18,1,92,35,663,546,847,602,184,56,sink
3619,18,vase,19,0,92,20,743,361,796,428,53,67,vase
3620,1,mirror,2,0,93,24,239,201,533,783,294,582,mirror
3621,12,sink,13,0,93,26,383,725,626,799,243,74,sink
3622,9,window,10,1,94,36,180,0,387,594,207,594,window
3623,21,bowl,22,0,95,17,744,497,795,530,51,33,bowl
3624,3,toilet,4,0,96,29,823,1335,1492,2047,669,712,toilet
3625,2,toilet,3,0,98,46,88,141,673,686,585,545,toilet
3626,3,sink,4,0,98,41,1172,74,1580,612,408,538,sink
3627,19,bowl,20,0,98,37,306,391,674,687,368,296,bowl
3628,8,toilet,9,0,100,32,471,977,791,1469,320,492,toilet
3629,13,mirror,11,0,100,26,2,154,230,1026,228,872,mirror
3630,16,pot,14,1,100,15,179,933,241,1023,62,90,potted plant
3631,19,sink,17,0,100,26,41,1028,389,1210,348,182,sink
3632,20,mirror,18,0,100,25,90,493,307,705,217,212,mirror
3633,2,toilet,3,1,102,55,377,536,1162,1441,785,905,toilet
3634,10,toothbrush,11,0,102,16,1441,420,1494,687,53,267,toothbrush
3635,11,sink,12,0,102,49,1165,719,2012,1045,847,326,sink
3636,7,pot,8,1,103,15,958,959,1037,1070,79,111,potted plant
3637,10,sink,11,0,103,39,812,1095,1373,1406,561,311,sink
3638,21,mirror,20,0,103,49,580,4,1009,1085,429,1081,mirror
3639,3,toilet,4,0,105,36,393,614,766,1022,373,408,toilet
3640,13,bowl,14,0,105,33,393,812,760,1021,367,209,bowl
3641,13,bench,14,0,106,17,1897,906,2199,1133,302,227,bench
3642,20,chair,21,1,106,74,1332,1187,2112,1650,780,463,chair
3643,26,chair,27,1,106,39,838,887,1051,1330,213,443,chair
3644,29,vase,30,0,106,15,466,802,521,919,55,117,vase
3645,32,chair,33,1,106,58,5,989,355,1649,350,660,chair
3646,2,mirror,3,0,107,20,2,0,276,431,274,431,mirror
3647,23,flowerpot,24,0,107,35,844,403,935,511,91,108,potted plant
3648,17,sink,18,0,108,20,420,356,586,396,166,40,sink
3649,2,toilet,3,0,109,53,515,323,1191,1023,676,700,toilet
3650,3,sink,4,0,109,23,0,317,635,802,635,485,sink
3651,5,window,5,1,110,26,298,443,764,1003,466,560,window
3652,10,toilet,10,1,110,29,502,1206,830,1739,328,533,toilet
3653,21,sink,21,0,110,23,905,1278,1335,1428,430,150,sink
3654,12,sink,11,0,111,23,306,378,409,420,103,42,sink
3655,15,sink,14,1,111,38,441,497,691,554,250,57,sink
3656,3,window,4,0,112,20,281,1,672,622,391,621,window
3657,4,window,5,0,112,24,671,0,1024,573,353,573,window
3658,10,sink,11,0,112,25,94,437,271,491,177,54,sink
3659,1,sink,2,0,113,30,59,472,400,1140,341,668,sink
3660,2,toilet,3,1,113,57,231,433,643,893,412,460,toilet
3661,16,bowl,17,0,113,27,298,650,646,893,348,243,bowl
3662,6,sink,7,0,114,54,155,575,381,882,226,307,sink
3663,2,window,3,0,115,20,46,51,793,552,747,501,window
3664,10,chair,11,0,115,56,509,513,723,933,214,420,chair
3665,13,table,14,1,115,31,75,566,251,720,176,154,dining table
3666,14,toilet,15,0,116,27,606,899,711,1144,105,245,toilet
3667,15,sink,16,0,116,27,457,883,589,1094,132,211,sink
3668,7,window,8,1,117,19,135,137,371,289,236,152,window
3669,10,window,11,0,117,16,669,1,959,299,290,298,window
3670,13,toilet,14,1,117,40,104,342,191,558,87,216,toilet
3671,14,sink,15,0,117,29,2,384,176,684,174,300,sink
3672,24,bowl,25,0,117,27,114,470,189,558,75,88,bowl
3673,9,sink,10,0,118,28,791,1227,1590,1976,799,749,sink
3674,12,toilet,13,0,118,16,190,1199,599,1788,409,589,toilet
3675,9,flowerpot,10,0,119,16,68,615,200,734,132,119,potted plant
3676,12,sink,13,0,119,22,474,357,607,534,133,177,sink
3677,13,sink,14,0,119,22,619,339,724,481,105,142,sink
3678,3,sink,4,0,120,37,605,1026,1062,1569,457,543,sink
3679,11,toilet,12,1,120,19,1026,1119,1176,1569,150,450,toilet
3680,5,toilet,6,0,122,46,728,858,1307,1534,579,676,toilet
3681,15,bowl,16,0,122,34,796,1162,1303,1533,507,371,bowl
3682,1,mirror,2,0,123,21,2,4,408,396,406,392,mirror
3683,3,sink,4,0,123,19,313,385,436,416,123,31,sink
3684,6,pot,7,1,123,34,157,321,224,422,67,101,potted plant
3685,9,mirror,10,0,123,27,545,351,582,427,37,76,mirror
3686,19,ball,20,0,123,15,906,483,959,525,53,42,sports ball
3687,20,pot,21,1,123,33,869,395,947,511,78,116,potted plant
3688,4,vase,5,0,124,19,543,260,570,312,27,52,vase
3689,8,toilet,9,0,124,33,669,480,817,670,148,190,toilet
3690,6,chair,6,1,125,48,296,808,551,1217,255,409,chair
3691,10,sink,10,0,125,39,92,895,468,1139,376,244,sink
3692,7,toilet,8,0,126,40,457,617,904,1188,447,571,toilet
3693,6,mirror,7,0,127,59,887,1,1599,588,712,587,mirror
3694,7,sink,8,0,127,22,952,623,1372,710,420,87,sink
3695,6,toilet,7,0,128,33,69,1439,335,2015,266,576,toilet
3696,6,toilet,7,0,129,49,504,1216,981,1962,477,746,toilet
3697,8,sink,9,0,129,15,7,1243,384,1439,377,196,sink
3698,14,toilet,15,0,131,37,177,407,329,702,152,295,toilet
3699,2,mirror,3,0,132,22,2,0,284,338,282,338,mirror
3700,10,sink,11,0,132,19,210,337,356,370,146,33,sink
3701,13,toilet,14,1,132,26,356,327,491,517,135,190,toilet
3702,16,door,17,1,132,22,680,1,726,529,46,528,door
3703,7,mirror,8,0,133,24,779,0,1799,864,1020,864,mirror
3704,11,sink,11,0,133,18,768,862,1158,995,390,133,sink
3705,23,bowl,24,0,134,15,957,1017,1085,1082,128,65,bowl
3706,24,toilet,25,1,134,19,466,1210,728,1330,262,120,toilet
3707,26,mirror,27,0,134,98,1054,2,1780,949,726,947,mirror
3708,29,sink,30,0,134,16,962,1125,1382,1212,420,87,sink
3709,10,sink,11,0,136,35,1647,1028,2193,1466,546,438,sink
3710,14,sink,14,0,138,18,223,545,394,593,171,48,sink
3711,22,mirror,22,0,138,20,327,416,407,498,80,82,mirror
3712,4,toilet,5,0,139,37,426,559,682,1023,256,464,toilet
3713,6,sink,7,0,139,23,29,567,385,696,356,129,sink
3714,13,toilet,14,0,140,53,613,838,956,1440,343,602,toilet
3715,26,bowl,27,0,140,26,619,1196,882,1441,263,245,bowl
3716,22,sink,23,0,141,15,362,1291,778,1426,416,135,sink
3717,24,mirror,25,0,141,33,0,1146,206,1613,206,467,mirror
3718,9,mirror,10,0,142,22,892,1,1430,661,538,660,mirror
3719,17,sink,16,0,142,17,773,697,1121,821,348,124,sink
3720,1,toilet,2,1,143,60,388,955,1318,1649,930,694,toilet
3721,6,door,7,1,143,15,2029,172,2198,1648,169,1476,door
3722,7,toilet,8,1,144,36,0,635,403,1066,403,431,toilet
3723,2,sink,3,0,146,18,446,474,715,611,269,137,sink
3724,11,toilet,12,0,146,24,2,745,267,1023,265,278,toilet
3725,20,sink,21,0,147,22,177,1234,668,1433,491,199,sink
3726,8,sink,9,0,148,40,0,469,394,632,394,163,sink
3727,6,flowerpot,5,0,150,22,696,392,765,456,69,64,potted plant
3728,7,window,6,0,150,35,471,88,721,363,250,275,window
3729,8,mirror,7,0,150,29,349,197,413,313,64,116,mirror
3730,14,window,12,0,150,23,2,174,243,352,241,178,window
3731,4,toilet,5,0,151,39,1063,1048,1433,1702,370,654,toilet
3732,6,toilet,7,1,152,36,343,757,666,1074,323,317,toilet
3733,8,sink,9,0,152,27,525,639,748,1202,223,563,sink
3734,13,toilet,14,1,153,30,574,915,998,1417,424,502,toilet
3735,19,door,20,1,153,18,0,930,97,1599,97,669,door
3736,31,bowl,32,0,153,15,575,1161,750,1417,175,256,bowl
3737,2,toilet,3,1,155,33,984,422,1324,842,340,420,toilet
3738,6,sink,7,0,155,27,27,516,425,648,398,132,sink
3739,2,sink,3,0,156,15,55,628,228,747,173,119,sink
3740,6,window,7,0,156,15,456,127,692,572,236,445,window
3741,9,door,10,1,156,18,597,102,767,1023,170,921,door
3742,10,toilet,11,1,156,33,397,673,651,1023,254,350,toilet
3743,14,toilet,15,1,157,32,759,610,1033,895,274,285,toilet
3744,17,sink,18,0,157,17,991,715,1185,854,194,139,sink
3745,7,sink,7,0,158,33,5,571,263,941,258,370,sink
3746,10,mirror,10,0,158,22,16,489,79,581,63,92,mirror
3747,6,toilet,7,1,159,27,2,812,358,1649,356,837,toilet
3748,10,chair,11,0,159,57,1503,809,1891,1368,388,559,chair
3749,10,sink,10,0,160,37,1285,904,1788,1174,503,270,sink
3750,6,door,7,0,161,16,560,362,929,1109,369,747,door
3751,9,window,10,1,161,33,1435,233,1750,837,315,604,window
3752,12,toilet,13,1,161,24,1657,949,1910,1390,253,441,toilet
3753,19,chair,20,1,161,28,492,976,702,1528,210,552,chair
3754,2,mirror,3,0,163,37,0,1,380,502,380,501,mirror
3755,24,mirror,22,0,163,18,380,223,425,273,45,50,mirror
3756,8,sink,6,0,164,18,154,497,317,564,163,67,sink
3757,7,sink,8,0,165,17,52,1283,809,1677,757,394,sink
3758,8,toilet,9,1,167,57,157,1110,789,1854,632,744,toilet
3759,7,toilet,8,0,168,48,650,1283,1413,2198,763,915,toilet
3760,7,sink,8,0,169,51,3,775,284,1048,281,273,sink
3761,11,mirror,12,0,169,23,53,618,113,725,60,107,mirror
3762,14,toilet,15,1,170,29,1026,1085,1530,1466,504,381,toilet
3763,19,toilet,20,0,172,21,1231,1260,1467,1612,236,352,toilet
3764,22,bottle,23,0,172,15,556,238,693,386,137,148,bottle
3765,3,vase,4,0,174,15,0,383,78,538,78,155,vase
3766,15,mirror,16,0,174,17,609,47,882,349,273,302,mirror
3767,7,sink,8,0,175,19,776,1488,1434,1638,658,150,sink
3768,4,sink,5,0,176,23,44,948,358,1180,314,232,sink
3769,7,toilet,8,0,177,31,388,839,678,1247,290,408,toilet
3770,21,bowl,22,0,177,17,389,1068,532,1248,143,180,bowl
3771,3,toilet,4,0,178,51,662,624,1122,1199,460,575,toilet
3772,5,sink,6,0,178,18,1224,635,1596,748,372,113,sink
3773,9,bottle,10,0,178,18,990,452,1056,598,66,146,bottle
3774,10,bottle,11,0,178,18,863,403,935,597,72,194,bottle
3775,15,mirror,16,0,178,51,749,0,1599,563,850,563,mirror
3776,5,sink,6,0,179,20,1125,725,1413,1066,288,341,sink
3777,10,door,11,1,179,19,2065,0,2198,1066,133,1066,door
3778,6,toilet,7,1,180,17,535,788,768,1008,233,220,toilet
3779,3,window,4,0,181,35,1498,596,1918,892,420,296,window
3780,11,sink,12,0,181,21,1110,1138,1478,1210,368,72,sink
3781,4,toilet,5,0,183,36,231,496,398,868,167,372,toilet
3782,1,window,2,0,184,25,460,1,1179,715,719,714,window
3783,12,sink,13,0,184,28,718,960,1156,1167,438,207,sink
3784,2,sink,3,0,185,58,1511,876,2045,1534,534,658,sink
3785,9,toilet,10,0,185,56,786,690,1233,1377,447,687,toilet
3786,10,window,11,1,185,54,237,3,720,647,483,644,window
3787,17,vase,18,0,185,16,411,501,491,632,80,131,vase
3788,6,toilet,7,1,186,49,984,571,1916,1423,932,852,toilet
3789,8,sink,9,0,186,15,1823,935,2200,1329,377,394,sink
3790,15,bowl,16,0,186,24,985,944,1471,1424,486,480,bowl
3791,2,toilet,3,0,187,55,4,574,648,1524,644,950,toilet
3792,3,sink,4,0,187,43,578,476,1483,959,905,483,sink
3793,11,toilet,12,1,188,24,839,915,1232,1199,393,284,toilet
3794,17,sink,18,1,188,34,51,978,656,1199,605,221,sink
3795,16,sink,17,0,189,20,332,1524,864,1668,532,144,sink
3796,18,door,19,1,189,22,0,1287,182,2199,182,912,door
3797,10,sink,11,0,190,45,346,476,827,664,481,188,sink
3798,0,toilet,1,0,2534,32,970,548,1699,1533,729,985,toilet
3799,3,toilet,4,0,2535,37,1102,603,1602,1526,500,923,toilet
3800,16,bowl,16,0,2535,32,1099,1118,1482,1530,383,412,bowl
3801,0,sink,1,0,2539,17,344,495,1789,1251,1445,756,sink
3802,1,sink,2,0,2540,20,722,885,1196,1094,474,209,sink
3803,2,sink,3,0,2540,23,1143,1074,1859,1448,716,374,sink
3804,4,toilet,5,0,2541,28,548,859,991,1493,443,634,toilet
3805,5,sink,6,0,2541,28,1335,450,2049,1341,714,891,sink
3806,7,sink,8,0,2542,18,601,825,1044,1031,443,206,sink
3807,10,bottle,11,0,2542,23,553,548,615,725,62,177,bottle
3808,0,toilet,1,0,2543,64,1043,1187,1646,2025,603,838,toilet
3809,8,toilet,8,0,2544,30,855,1209,1201,1864,346,655,toilet
3810,0,sink,1,0,2546,18,210,332,507,412,297,80,sink
3811,2,sink,3,0,2547,21,24,1075,865,1435,841,360,sink
3812,0,mirror,1,0,2548,31,121,60,202,163,81,103,mirror
3813,0,toilet,1,1,2549,27,1292,692,1797,1349,505,657,toilet
3814,0,sink,1,0,2550,30,389,1022,1046,1905,657,883,sink
3815,11,chair,12,1,2550,15,1056,1284,1525,2048,469,764,chair
3816,24,bottle,24,0,2550,15,340,1388,391,1561,51,173,bottle
3817,20,toilet,15,0,2552,36,492,340,714,598,222,258,toilet
3818,8,toilet,9,0,2553,30,696,839,1179,1543,483,704,toilet
3819,9,sink,10,1,2553,21,1853,603,2187,1076,334,473,sink
3820,1,toilet,2,1,2554,40,286,1255,1056,2049,770,794,toilet
3821,10,toilet,11,0,2558,29,154,723,955,1998,801,1275,toilet
3822,18,sink,14,0,2559,25,1066,1267,1579,1404,513,137,sink
3823,1,toilet,2,0,2560,32,1321,674,2121,1651,800,977,toilet
3824,1,toilet,2,0,2561,18,946,661,1488,1535,542,874,toilet
3825,7,sink,7,0,2561,18,161,655,616,773,455,118,sink
3826,1,toilet,2,0,2563,36,348,390,1363,1870,1015,1480,toilet
3827,5,toilet,6,0,2564,24,483,1241,859,1773,376,532,toilet
3828,7,sink,7,0,2564,32,656,1059,1292,1398,636,339,sink
3829,9,sink,9,0,2565,20,88,340,225,394,137,54,sink
3830,10,sink,10,0,2565,16,2,396,111,493,109,97,sink
3831,19,mirror,19,0,2565,15,127,274,159,338,32,64,mirror
3832,27,bowl,27,0,2565,24,245,401,320,468,75,67,bowl
3833,6,sink,7,0,2567,48,621,1297,1000,1825,379,528,sink
3834,0,sink,1,0,2568,18,1436,812,2179,1652,743,840,sink
3835,2,toilet,3,0,2568,35,747,665,1778,1650,1031,985,toilet
3836,8,pot,9,0,2568,19,1200,76,1437,350,237,274,potted plant
3837,11,bowl,12,0,2568,21,1468,311,1696,464,228,153,bowl
3838,6,chair,7,1,2569,18,604,744,792,1051,188,307,chair
3839,12,toilet,13,0,2570,16,2,233,35,280,33,47,toilet
3840,18,sink,19,0,2570,16,181,230,223,265,42,35,sink
3841,2,sink,3,0,2572,45,214,1031,914,1367,700,336,sink
3842,8,toilet,9,1,2572,16,2,1553,586,2198,584,645,toilet
3843,0,toilet,1,0,2574,43,173,56,256,220,83,164,toilet
3844,2,sink,3,0,2574,47,0,47,91,208,91,161,sink
3845,13,bowl,12,0,2574,39,172,137,247,220,75,83,bowl
3846,14,bowl,13,0,2574,36,83,115,170,198,87,83,bowl
3847,3,toilet,4,0,2575,22,75,105,152,235,77,130,toilet
3848,0,chair,1,0,2577,24,276,225,413,428,137,203,chair
3849,25,vase,26,0,2577,36,74,102,132,205,58,103,vase
3850,15,toilet,15,0,2578,22,284,1500,644,2075,360,575,toilet
3851,9,sink,10,0,2579,15,101,153,154,174,53,21,sink
3852,3,vase,4,0,2580,15,230,988,363,1091,133,103,vase
3853,5,sink,6,0,2580,17,637,944,995,1061,358,117,sink
3854,9,toilet,10,0,2580,27,1055,925,1436,1456,381,531,toilet
3855,12,window,13,0,2580,18,1590,389,1864,653,274,264,window
3856,19,mirror,20,0,2580,39,4,13,920,988,916,975,mirror
3857,3,sink,4,0,2581,21,24,87,99,196,75,109,sink
3858,7,toilet,8,0,2581,51,117,83,199,190,82,107,toilet
3859,27,bowl,28,0,2581,28,143,128,199,190,56,62,bowl
3860,29,bowl,30,0,2581,24,188,118,248,169,60,51,bowl
3861,14,sink,14,0,2582,26,800,1010,1195,1170,395,160,sink
3862,7,toilet,8,1,2583,33,640,770,1008,1223,368,453,toilet
3863,5,toilet,6,1,2584,20,131,408,232,512,101,104,toilet
3864,19,chair,20,1,2585,19,803,448,860,575,57,127,chair
3865,6,sink,7,0,2586,21,477,604,660,688,183,84,sink
3866,10,toilet,11,0,2586,27,142,636,388,1004,246,368,toilet
3867,14,bowl,15,0,2586,23,143,804,384,1006,241,202,bowl
3868,2,mirror,2,0,2587,23,771,264,1152,855,381,591,mirror
3869,4,sink,4,0,2587,27,783,1273,1323,2045,540,772,sink
3870,7,toilet,7,1,2587,36,144,1432,721,2047,577,615,toilet
3871,5,sink,6,1,2590,19,31,220,127,300,96,80,sink
3872,9,mirror,10,0,2590,18,35,103,70,183,35,80,mirror
3873,2,toilet,3,0,2591,30,210,561,338,877,128,316,toilet
3874,3,toilet,4,0,2592,18,267,483,398,600,131,117,toilet
3875,13,bowl,14,0,2592,21,267,512,400,598,133,86,bowl
3876,1,mirror,2,0,2593,29,474,74,1205,1054,731,980,mirror
3877,4,pot,3,0,2593,15,333,1445,473,1627,140,182,potted plant
3878,7,sink,6,0,2593,41,503,1470,1406,1856,903,386,sink
3879,8,mirror,8,0,2594,29,1318,1,2198,1172,880,1171,mirror
3880,9,vase,9,0,2594,40,1530,795,1751,1218,221,423,vase
3881,17,pot,17,0,2594,16,1435,1023,1500,1136,65,113,potted plant
3882,18,pot,18,0,2594,24,1969,1169,2076,1332,107,163,potted plant
3883,21,sink,21,0,2594,16,1786,1345,2198,1662,412,317,sink
3884,22,sink,22,0,2594,15,1066,1037,1397,1131,331,94,sink
3885,25,window,25,0,2594,22,982,354,1210,909,228,555,window
3886,11,chair,12,0,2596,25,79,139,154,192,75,53,chair
3887,5,sink,6,0,2597,22,0,581,281,788,281,207,sink
3888,25,bowl,26,0,2597,15,790,850,959,1100,169,250,bowl
3889,5,pot,6,0,2598,17,413,811,519,851,106,40,potted plant
3890,15,toilet,16,0,2598,44,888,601,1182,1129,294,528,toilet
3891,21,mirror,22,1,2598,15,2037,1,2198,796,161,795,mirror
3892,1,toilet,2,0,2599,30,1,135,165,290,164,155,toilet
3893,14,bowl,15,0,2599,32,52,206,163,290,111,84,bowl
3894,5,sink,6,0,2600,15,46,207,109,232,63,25,sink
3895,16,toilet,17,0,2600,19,189,244,273,300,84,56,toilet
3896,2,sink,3,0,2601,26,154,295,332,509,178,214,sink
3897,5,toilet,6,0,2602,42,466,877,1243,1767,777,890,toilet
3898,6,sink,7,1,2602,29,60,754,393,1050,333,296,sink
3899,27,bowl,28,0,2602,20,680,1316,1221,1759,541,443,bowl
3900,5,toilet,6,1,2604,16,174,290,236,382,62,92,toilet
3901,15,bowl,15,0,2604,18,176,319,232,383,56,64,bowl
3902,6,toilet,7,0,2605,23,145,400,276,512,131,112,toilet
3903,0,sink,1,0,2606,29,63,137,99,154,36,17,sink
3904,9,bowl,10,0,2607,15,1415,836,1598,1191,183,355,bowl
3905,18,toilet,18,1,2608,31,0,1602,402,2197,402,595,toilet
3906,26,bowl,26,0,2608,27,1,1751,405,2198,404,447,bowl
3907,2,toilet,3,0,2609,46,159,413,652,1385,493,972,toilet
3908,3,sink,4,0,2609,24,669,303,1278,1131,609,828,sink
3909,15,bowl,16,0,2609,25,243,963,655,1381,412,418,bowl
3910,3,sink,4,0,2610,22,5,192,173,270,168,78,sink
3911,13,sink,13,0,2611,39,413,1355,1432,2198,1019,843,sink
3912,7,mirror,8,0,2612,20,21,94,42,138,21,44,mirror
3913,8,toilet,9,0,2613,21,725,1450,1253,1850,528,400,toilet
3914,15,bowl,16,0,2613,28,726,1503,1252,1859,526,356,bowl
3915,1,door,2,0,2614,24,567,47,671,622,104,575,door
3916,8,sink,9,0,2614,33,567,399,772,689,205,290,sink
3917,14,toilet,15,0,2614,42,18,356,224,761,206,405,toilet
3918,21,bowl,22,0,2614,31,21,567,167,762,146,195,bowl
3919,6,sink,7,0,2615,25,239,1044,619,1407,380,363,sink
3920,20,sink,21,0,2616,48,671,383,933,769,262,386,sink
3921,23,bottle,24,0,2616,17,615,508,659,560,44,52,bottle
3922,30,toilet,31,0,2616,39,220,391,453,707,233,316,toilet
3923,40,bowl,41,0,2616,30,672,382,933,509,261,127,bowl
3924,42,bowl,43,0,2616,17,337,547,452,707,115,160,bowl
3925,15,sink,15,0,2617,15,183,829,452,906,269,77,sink
3926,7,toilet,8,0,2618,21,508,378,621,530,113,152,toilet
3927,19,bowl,20,0,2618,27,513,443,621,530,108,87,bowl
3928,13,sink,14,0,2619,28,176,273,467,479,291,206,sink
3929,5,sink,5,0,2620,24,75,1551,1354,2199,1279,648,sink
3930,2,toilet,3,0,2621,21,2,234,56,306,54,72,toilet
3931,4,sink,5,0,2621,19,144,210,229,264,85,54,sink
3932,9,toilet,10,0,2622,31,1265,553,1570,1123,305,570,toilet
3933,5,mirror,6,0,2623,17,173,121,420,302,247,181,mirror
3934,16,flowerpot,17,0,2623,15,511,69,547,152,36,83,potted plant
3935,6,sink,7,0,2624,16,117,189,174,213,57,24,sink
3936,6,toilet,7,0,2625,32,544,1157,1245,2112,701,955,toilet
3937,7,sink,8,0,2626,28,708,413,1027,915,319,502,sink
3938,11,toilet,12,0,2626,32,33,246,231,714,198,468,toilet
3939,15,bowl,16,0,2626,31,35,549,227,714,192,165,bowl
3940,1,sink,2,0,2629,30,7,48,130,258,123,210,sink
3941,2,toilet,3,0,2629,39,185,72,289,263,104,191,toilet
3942,13,bowl,14,0,2629,31,199,175,272,262,73,87,bowl
3943,14,bowl,15,0,2629,40,373,170,459,267,86,97,bowl
3944,3,toilet,4,0,2630,32,143,337,295,584,152,247,toilet
3945,5,mirror,6,1,2630,17,2,47,62,218,60,171,mirror
3946,6,toilet,7,1,2631,17,1238,1339,1522,1649,284,310,toilet
3947,9,sink,10,0,2631,19,1733,1138,2106,1462,373,324,sink
3948,6,mirror,7,0,2632,22,537,1,620,211,83,210,mirror
3949,0,sink,1,0,2633,19,58,229,1475,1408,1417,1179,sink
3950,1,toilet,2,0,2633,30,1123,282,2049,1471,926,1189,toilet
3951,4,mirror,4,0,2635,17,1020,372,1316,1310,296,938,mirror
3952,9,sink,8,0,2635,20,811,1376,1266,1539,455,163,sink
3953,14,toilet,13,1,2635,19,344,1479,461,1799,117,320,toilet
3954,6,sink,7,0,2636,17,88,261,174,307,86,46,sink
3955,3,toilet,4,0,2637,20,115,193,153,242,38,49,toilet
3956,5,sink,5,0,2637,26,187,164,241,250,54,86,sink
3957,15,bowl,15,0,2637,22,115,204,152,242,37,38,bowl
3958,2,sink,3,0,2638,20,107,156,198,212,91,56,sink
3959,6,toilet,7,0,2639,19,172,311,305,510,133,199,toilet
3960,10,sink,11,0,2640,28,551,561,765,638,214,77,sink
3961,17,toilet,18,0,2640,31,47,512,206,838,159,326,toilet
3962,36,bowl,36,0,2640,27,55,702,201,836,146,134,bowl
3963,2,toilet,3,0,2642,29,890,1004,1501,1534,611,530,toilet
3964,0,sink,1,0,2643,30,21,101,233,255,212,154,sink
3965,2,toilet,3,0,2644,18,216,1176,633,1653,417,477,toilet
3966,12,sink,13,0,2644,27,1613,1104,2199,1396,586,292,sink
3967,9,bottle,9,0,2646,23,57,380,89,445,32,65,bottle
3968,4,toilet,5,0,2647,56,823,325,1208,1249,385,924,toilet
3969,7,sink,8,0,2651,17,632,1525,1071,1635,439,110,sink
3970,4,sink,5,0,2652,18,1229,1475,1573,1700,344,225,sink
3971,6,toilet,7,0,2652,46,369,1313,1145,2199,776,886,toilet
3972,5,toilet,6,0,2653,35,579,975,1143,1598,564,623,toilet
3973,9,toilet,10,0,2654,33,501,377,725,666,224,289,toilet
3974,14,sink,15,0,2654,32,175,369,472,597,297,228,sink
3975,22,bowl,23,0,2654,22,531,512,709,666,178,154,bowl
3976,14,toilet,15,0,2655,35,0,920,313,1365,313,445,toilet
3977,34,bowl,34,0,2655,22,22,1126,312,1362,290,236,bowl
3978,2,mirror,3,0,2656,21,2,15,94,124,92,109,mirror
3979,3,sink,4,0,2656,23,12,177,109,287,97,110,sink
3980,2,bench,3,0,2657,21,93,184,157,248,64,64,bench
3981,38,mirror,39,0,2658,16,201,391,318,590,117,199,mirror
3982,40,chair,41,0,2658,28,331,666,434,785,103,119,chair
3983,5,toilet,6,0,2659,18,2,396,94,511,92,115,toilet
3984,1,sink,2,0,2660,24,79,175,168,255,89,80,sink
3985,6,sink,7,0,2662,21,1021,1099,1485,1219,464,120,sink
3986,9,toilet,10,0,2662,49,304,1196,783,1987,479,791,toilet
3987,11,toilet,11,1,2663,21,148,1591,510,1989,362,398,toilet
3988,12,sink,12,0,2663,30,2,1397,413,2199,411,802,sink
3989,9,chair,10,0,2665,22,2,1530,250,1991,248,461,chair
3990,11,sink,11,0,2666,16,2,1171,383,1324,381,153,sink
3991,13,bowl,13,0,2666,18,222,1030,411,1144,189,114,bowl
3992,2,toilet,3,0,2667,42,1295,787,1825,1437,530,650,toilet
3993,7,sink,8,0,2668,15,253,831,445,902,192,71,sink
3994,15,toilet,15,1,2669,18,328,1861,881,2198,553,337,toilet
3995,8,bottle,9,0,2670,18,1447,700,1537,975,90,275,bottle
3996,10,toilet,11,0,2670,56,632,1403,1485,2198,853,795,toilet
3997,15,vase,16,0,2670,23,1292,1344,1389,1495,97,151,vase
3998,19,window,20,1,2670,15,239,69,319,959,80,890,window
3999,11,toilet,12,0,2672,33,473,348,557,493,84,145,toilet
4000,12,sink,13,0,2672,30,585,381,751,599,166,218,sink
4001,15,mirror,16,0,2672,17,683,93,747,307,64,214,mirror
4002,24,sink,25,0,2672,16,32,416,150,446,118,30,sink
4003,49,bowl,49,0,2672,21,489,421,555,492,66,71,bowl
4004,4,sink,5,0,2673,26,36,125,159,222,123,97,sink
4005,7,toilet,8,1,2673,19,190,136,305,223,115,87,toilet
4006,14,sink,15,0,2674,33,715,990,1167,1625,452,635,sink
4007,17,toilet,18,1,2674,39,1255,1093,1622,1649,367,556,toilet
4008,25,bowl,25,0,2675,33,430,1055,724,1276,294,221,bowl
4009,26,bowl,26,0,2675,17,21,1045,173,1260,152,215,bowl
4010,17,mirror,16,0,2677,20,0,0,211,374,211,374,mirror
4011,8,toilet,9,1,2678,32,135,720,802,1378,667,658,toilet
4012,13,sink,14,1,2678,15,0,1215,797,1647,797,432,sink
4013,3,sink,4,0,2680,55,76,95,255,309,179,214,sink
4014,4,toilet,5,0,2683,19,49,344,111,448,62,104,toilet
4015,0,toilet,1,0,2684,63,935,1319,1406,2200,471,881,toilet
4016,3,toilet,4,1,2686,22,85,159,130,201,45,42,toilet
4017,7,sink,8,0,2686,19,140,155,222,253,82,98,sink
4018,13,bowl,14,0,2686,25,86,163,129,201,43,38,bowl
4019,14,bowl,15,0,2686,21,102,175,153,223,51,48,bowl
4020,9,sink,10,0,2687,24,380,485,699,764,319,279,sink
4021,15,bed,16,1,2688,15,2,169,508,338,506,169,bed
4022,7,mirror,8,0,2689,21,530,138,567,202,37,64,mirror
4023,16,sink,17,0,2689,16,461,305,665,349,204,44,sink
4024,5,toilet,6,1,2690,19,353,1573,705,2006,352,433,toilet
4025,4,toilet,5,0,2692,25,76,112,154,194,78,82,toilet
4026,6,sink,7,0,2692,16,212,140,276,174,64,34,sink
4027,8,toilet,9,1,2693,32,864,1010,1596,1648,732,638,toilet
4028,11,sink,11,1,2693,17,1505,1175,1918,1450,413,275,sink
4029,4,toilet,5,0,2695,18,37,186,80,240,43,54,toilet
4030,6,sink,7,1,2695,16,144,177,204,258,60,81,sink
4031,11,bowl,12,0,2696,20,74,116,145,223,71,107,bowl
4032,1,window,2,0,2697,17,31,66,160,144,129,78,window
4033,2,mirror,3,1,2697,22,217,12,255,140,38,128,mirror
4034,0,mirror,1,0,2698,25,107,54,170,161,63,107,mirror
4035,1,sink,2,0,2698,16,336,116,520,159,184,43,sink
4036,4,sink,5,0,2698,17,41,177,302,299,261,122,sink
4037,19,sink,20,0,2700,16,443,1372,787,1479,344,107,sink
4038,3,toilet,4,1,2704,25,360,1275,646,1649,286,374,toilet
4039,9,toilet,10,0,2706,28,821,924,1537,1952,716,1028,toilet
4040,11,toilet,10,0,2707,26,639,1496,1223,2199,584,703,toilet
4041,12,sink,11,0,2707,23,3,1576,554,1816,551,240,sink
4042,2,sink,3,0,2711,20,311,1270,1144,2198,833,928,sink
4043,5,sink,6,0,2713,33,55,190,141,306,86,116,sink
4044,1,toilet,2,0,2714,42,10,291,215,504,205,213,toilet
4045,26,sink,26,0,2715,17,131,718,369,833,238,115,sink
4046,7,toilet,8,0,2716,35,765,893,1367,2102,602,1209,toilet
4047,4,mirror,5,0,2717,27,500,2,1023,431,523,429,mirror
4048,9,toilet,10,0,2718,44,1134,1179,1447,1875,313,696,toilet
4049,26,bowl,27,0,2718,25,1135,1531,1428,1876,293,345,bowl
4050,5,sink,6,0,2720,26,119,162,174,281,55,119,sink
4051,2,toilet,3,0,2721,76,82,687,955,1466,873,779,toilet
4052,5,sink,6,0,2721,49,628,392,990,946,362,554,sink
4053,27,bowl,28,0,2721,30,460,1188,959,1464,499,276,bowl
4054,2,sink,3,0,2722,36,60,176,174,332,114,156,sink
4055,14,toilet,15,0,2723,37,377,698,676,1135,299,437,toilet
4056,0,sink,1,0,2724,19,102,138,213,193,111,55,sink
4057,6,toothbrush,7,0,2724,16,125,54,145,96,20,42,toothbrush
4058,12,sink,13,0,2725,16,622,387,802,418,180,31,sink
4059,7,sink,8,0,2728,28,102,166,231,300,129,134,sink
4060,4,sink,5,0,2729,15,1304,1079,1911,1230,607,151,sink
4061,5,sink,6,0,2729,15,344,983,797,1096,453,113,sink
4062,0,toilet,1,0,2730,20,147,156,230,256,83,100,toilet
4063,4,sink,5,0,2730,44,12,159,134,254,122,95,sink
4064,2,sink,3,0,2732,15,15,163,114,243,99,80,sink
4065,17,sink,18,0,2733,18,35,1088,580,1336,545,248,sink
4066,9,sink,10,0,2734,15,19,557,257,725,238,168,sink
4067,1,mirror,2,0,2735,16,2,0,172,192,170,192,mirror
4068,6,sink,7,0,2735,15,148,174,227,195,79,21,sink
4069,30,window,31,1,2737,33,507,250,618,417,111,167,window
4070,36,mirror,37,0,2737,82,122,202,386,420,264,218,mirror
4071,39,mirror,40,0,2737,20,391,352,422,410,31,58,mirror
4072,73,sofa,74,1,2737,16,0,589,417,680,417,91,couch
4073,1,sink,2,0,2738,48,196,124,357,325,161,201,sink
4074,1,window,2,1,2739,17,119,0,487,801,368,801,window
4075,16,door,17,0,2739,17,366,804,425,968,59,164,door
4076,5,toilet,6,0,2740,20,313,486,434,650,121,164,toilet
4077,18,mirror,19,0,2740,56,0,13,193,224,193,211,mirror
4078,22,bowl,23,0,2740,29,314,535,430,649,116,114,bowl
4079,4,window,4,0,2741,15,441,431,738,1222,297,791,window
4080,8,sink,8,1,2741,17,740,1078,976,1157,236,79,sink
4081,9,sink,9,0,2741,28,687,1152,1139,1409,452,257,sink
4082,3,toilet,4,0,2743,30,481,1476,1362,2198,881,722,toilet
4083,5,sink,6,0,2743,33,215,1305,730,2079,515,774,sink
4084,9,toilet,10,1,2744,15,16,257,64,300,48,43,toilet
4085,9,mirror,10,0,2747,24,922,206,1022,356,100,150,mirror
4086,6,sink,7,0,2748,17,200,146,263,169,63,23,sink
4087,0,toilet,1,0,2749,41,60,121,145,243,85,122,toilet
4088,4,sink,5,1,2749,16,209,140,255,254,46,114,sink
4089,10,toilet,11,1,2751,21,399,499,725,798,326,299,toilet
4090,13,sink,14,0,2751,16,843,510,1194,578,351,68,sink
4091,0,toilet,1,0,2752,19,45,127,146,252,101,125,toilet
4092,8,toilet,9,1,2753,23,0,760,304,1198,304,438,toilet
4093,14,toilet,15,1,2754,25,288,1323,568,1735,280,412,toilet
4094,10,sink,11,0,2755,28,2,1329,572,1618,570,289,sink
4095,20,window,21,0,2755,18,908,38,1745,1040,837,1002,window
4096,4,toilet,5,0,2757,39,1009,471,1277,958,268,487,toilet
4097,19,bowl,20,0,2757,28,1011,752,1237,957,226,205,bowl
4098,6,sink,7,1,2759,19,17,224,138,318,121,94,sink
4099,4,toilet,5,1,2760,23,596,316,798,532,202,216,toilet
4100,8,bottle,9,0,2760,15,338,227,379,306,41,79,bottle
4101,5,vase,6,0,2761,20,109,122,127,169,18,47,vase
4102,37,mirror,38,0,2762,31,835,479,1175,912,340,433,mirror
4103,38,mirror,39,0,2762,24,955,797,1062,957,107,160,mirror
4104,44,chair,45,0,2762,52,823,918,1112,1332,289,414,chair
4105,4,sink,5,0,2763,19,769,1346,1183,1562,414,216,sink
4106,12,toilet,13,0,2763,21,0,1414,614,2197,614,783,toilet
4107,1,mirror,2,0,2764,21,52,9,135,86,83,77,mirror
4108,2,toilet,3,0,2764,16,155,154,230,255,75,101,toilet
4109,3,sink,4,0,2764,31,40,132,135,256,95,124,sink
4110,4,bottle,5,0,2765,20,1622,174,1681,417,59,243,bottle
4111,10,toothbrush,11,0,2765,15,1023,247,1061,424,38,177,toothbrush
4112,13,bottle,14,0,2765,21,719,306,785,519,66,213,bottle
4113,16,bottle,17,1,2765,20,610,236,704,523,94,287,bottle
4114,17,sink,18,0,2765,21,606,597,1386,1468,780,871,sink
4115,19,bottle,20,1,2765,17,1776,597,1870,820,94,223,bottle
4116,34,toilet,35,1,2765,30,2,738,646,1470,644,732,toilet
4117,25,window,25,0,2767,18,274,110,362,276,88,166,window
4118,3,sink,4,0,2768,19,107,240,221,348,114,108,sink
4119,4,mirror,5,0,2768,20,151,46,230,194,79,148,mirror
4120,8,sink,9,0,2769,18,0,205,76,311,76,106,sink
4121,0,toilet,1,0,2770,33,275,587,1152,1914,877,1327,toilet
4122,14,vase,15,0,2772,17,33,67,54,98,21,31,vase
4123,15,chair,16,1,2775,23,350,296,453,524,103,228,chair
4124,7,toilet,8,0,2776,25,90,226,168,299,78,73,toilet
4125,0,sink,1,0,2778,23,114,406,237,616,123,210,sink
4126,1,toilet,2,0,2778,18,276,489,371,632,95,143,toilet
4127,14,bowl,15,0,2778,22,277,525,371,632,94,107,bowl
4128,3,toilet,4,0,2779,30,154,106,257,212,103,106,toilet
4129,2,sink,3,0,2780,35,665,990,1640,2191,975,1201,sink
4130,8,toilet,9,0,2780,49,2,967,824,2198,822,1231,toilet
4131,1,toilet,2,0,2783,17,801,1555,1215,2139,414,584,toilet
4132,5,sink,6,0,2783,16,4,1058,584,1581,580,523,sink
4133,22,bowl,22,0,2783,32,794,1563,1214,2140,420,577,bowl
4134,7,toilet,8,0,2784,21,201,117,256,207,55,90,toilet
4135,19,bowl,20,0,2784,27,202,156,256,208,54,52,bowl
4136,6,sink,7,0,2785,24,628,516,823,669,195,153,sink
4137,15,mirror,16,0,2786,22,857,340,890,408,33,68,mirror
4138,4,sink,5,0,2787,17,61,162,148,201,87,39,sink
4139,1,window,2,0,2788,15,300,3,1078,681,778,678,window
4140,9,sink,10,0,2788,21,653,794,1135,858,482,64,sink
4141,4,sink,5,0,2789,22,1618,1009,2189,1647,571,638,sink
4142,7,toilet,8,1,2789,47,772,907,1675,1649,903,742,toilet
4143,7,sink,8,0,2794,15,1526,1103,1806,1229,280,126,sink
4144,3,mirror,4,0,2795,21,113,33,238,105,125,72,mirror
4145,4,sink,5,0,2795,25,111,200,228,358,117,158,sink
4146,10,toilet,11,0,2797,23,1000,1105,1373,1509,373,404,toilet
4147,13,mirror,14,1,2797,15,298,0,909,313,611,313,mirror
4148,15,sink,16,0,2797,31,430,779,869,1302,439,523,sink
4149,4,toilet,5,0,2799,34,350,349,871,1447,521,1098,toilet
4150,12,bowl,13,0,2799,32,406,1013,872,1450,466,437,bowl
4151,14,bowl,15,0,2799,31,1089,670,1591,1290,502,620,bowl
4152,2,sink,1,0,2800,15,588,891,1250,1185,662,294,sink
4153,1,mirror,2,0,2801,16,63,2,133,59,70,57,mirror
4154,3,chair,4,0,2801,31,188,68,236,168,48,100,chair
4155,9,sink,9,0,2801,31,33,109,142,224,109,115,sink
4156,10,sink,10,0,2801,28,110,101,195,199,85,98,sink
4157,12,toilet,13,1,2802,19,0,757,305,1066,305,309,toilet
4158,26,bowl,27,0,2802,19,1,928,298,1065,297,137,bowl
4159,27,bowl,28,0,2802,20,536,834,705,1065,169,231,bowl
4160,7,toilet,8,1,2803,18,131,166,205,225,74,59,toilet
4161,5,sink,6,0,2804,30,65,793,381,1019,316,226,sink
4162,7,toilet,8,1,2804,20,299,865,483,1092,184,227,toilet
4163,17,bowl,18,0,2804,17,300,936,484,1092,184,156,bowl
4164,6,sink,7,0,2805,20,636,541,993,737,357,196,sink
4165,7,sink,8,0,2805,22,1219,613,1668,875,449,262,sink
4166,5,toilet,6,0,2806,27,2,97,67,172,65,75,toilet
4167,7,sink,8,0,2806,22,222,97,269,175,47,78,sink
4168,18,bowl,19,0,2806,37,6,127,67,172,61,45,bowl
4169,4,bed,5,1,2807,17,493,280,558,368,65,88,bed
4170,3,toilet,4,1,2808,30,150,604,429,959,279,355,toilet
4171,15,bowl,16,0,2808,24,150,786,418,959,268,173,bowl
4172,20,vase,21,0,2809,16,93,136,119,165,26,29,vase
4173,20,plate,21,0,2810,16,347,385,400,404,53,19,plate
4174,31,mirror,32,0,2810,20,412,213,512,333,100,120,mirror
4175,12,toilet,13,1,2815,26,82,501,360,767,278,266,toilet
4176,2,toilet,3,1,2816,39,517,511,879,898,362,387,toilet
4177,10,sink,11,0,2816,16,110,613,386,722,276,109,sink
4178,23,bowl,24,0,2816,27,596,729,879,897,283,168,bowl
4179,15,toilet,15,0,2817,23,27,525,181,771,154,246,toilet
4180,2,mirror,3,0,2818,29,195,1,1131,498,936,497,mirror
4181,11,sink,12,0,2818,28,373,577,879,771,506,194,sink
4182,6,mirror,7,0,2819,20,130,98,330,387,200,289,mirror
4183,9,sink,10,0,2819,25,96,603,443,784,347,181,sink
4184,15,toilet,16,0,2819,47,613,616,999,1280,386,664,toilet
4185,4,toilet,5,1,2820,37,143,343,353,496,210,153,toilet
4186,4,window,5,0,2821,27,62,20,176,190,114,170,window
4187,9,toilet,10,1,2822,57,685,1323,1273,1924,588,601,toilet
4188,13,mirror,14,0,2823,60,43,172,228,449,185,277,mirror
4189,8,mirror,9,1,2824,21,2,53,65,154,63,101,mirror
4190,5,sink,6,0,2825,19,0,147,79,189,79,42,sink
4191,5,toilet,6,0,2826,19,103,243,167,305,64,62,toilet
4192,9,sink,10,0,2826,16,153,213,219,266,66,53,sink
4193,30,bowl,31,0,2826,20,104,249,167,307,63,58,bowl
4194,1,toilet,2,0,2827,40,565,432,685,692,120,260,toilet
4195,26,sink,27,1,2827,30,6,693,298,767,292,74,sink
4196,30,bowl,31,0,2827,25,580,568,685,692,105,124,bowl
4197,2,mirror,3,0,2829,46,2,1,593,578,591,577,mirror
4198,11,flowerpot,11,0,2829,18,427,407,520,502,93,95,potted plant
4199,14,sink,14,0,2829,20,501,440,655,493,154,53,sink
4200,15,sink,15,0,2829,29,191,508,514,677,323,169,sink
4201,37,bowl,37,0,2829,16,721,514,794,591,73,77,bowl
4202,2,sink,3,0,2830,20,158,446,378,600,220,154,sink
4203,4,toilet,5,0,2831,17,163,384,257,512,94,128,toilet
4204,3,sink,4,0,2833,40,259,272,417,350,158,78,sink
4205,6,toilet,7,1,2834,15,1138,787,1279,958,141,171,toilet
4206,14,sink,15,0,2834,15,3,609,161,673,158,64,sink
4207,3,toilet,4,1,2837,51,46,1067,695,1597,649,530,toilet
4208,13,toilet,14,1,2838,49,1015,936,1801,1534,786,598,toilet
4209,16,bottle,17,0,2838,15,1507,503,1571,663,64,160,bottle
4210,1,window,2,0,2839,21,2,7,419,489,417,482,window
4211,10,toilet,11,1,2839,28,627,498,797,767,170,269,toilet
4212,3,sink,4,0,2840,16,116,90,169,156,53,66,sink
4213,5,toilet,6,0,2840,22,166,105,219,179,53,74,toilet
4214,13,bowl,14,0,2840,17,166,140,214,179,48,39,bowl
4215,8,sink,9,0,2841,21,182,146,292,289,110,143,sink
4216,10,toilet,11,1,2841,19,2,197,70,271,68,74,toilet
4217,14,bowl,15,0,2841,15,201,154,273,174,72,20,bowl
4218,18,bowl,19,0,2841,22,1,205,69,271,68,66,bowl
4219,2,toilet,3,0,2842,24,426,1221,1217,1999,791,778,toilet
4220,8,toilet,8,0,2843,21,163,228,320,414,157,186,toilet
4221,9,sink,9,0,2843,16,336,299,508,386,172,87,sink
4222,10,sink,10,0,2843,16,312,290,558,432,246,142,sink
4223,28,bowl,28,0,2843,22,162,323,287,415,125,92,bowl
4224,6,toilet,7,1,2845,24,452,668,784,957,332,289,toilet
4225,9,sink,10,0,2845,19,909,628,1276,959,367,331,sink
4226,11,bowl,8,0,2846,49,785,515,1655,1374,870,859,bowl
4227,0,toilet,1,0,2847,18,421,966,886,1880,465,914,toilet
4228,19,bowl,20,0,2847,26,522,1479,879,1872,357,393,bowl
4229,2,sink,3,0,2848,27,403,249,712,652,309,403,sink
4230,18,toilet,19,1,2848,17,647,463,1020,767,373,304,toilet
4231,10,sink,11,0,2851,18,37,198,174,255,137,57,sink
4232,11,sink,12,0,2851,23,166,185,255,254,89,69,sink
4233,18,sink,19,0,2852,25,1312,1711,1646,2068,334,357,sink
4234,0,sink,1,0,2854,18,32,122,217,255,185,133,sink
4235,0,mirror,1,0,2855,17,56,29,125,98,69,69,mirror
4236,4,toilet,5,0,2855,34,60,154,115,234,55,80,toilet
4237,0,sink,1,0,2856,18,177,122,250,162,73,40,sink
4238,1,toilet,2,0,2857,20,190,207,320,381,130,174,toilet
4239,1,sink,2,0,2859,16,2,174,108,241,106,67,sink
4240,0,chair,1,0,2860,33,9,172,92,298,83,126,chair
4241,8,toilet,9,1,2861,16,190,218,256,256,66,38,toilet
4242,15,sink,16,0,2861,25,1,212,132,255,131,43,sink
4243,4,sink,5,0,2862,26,1332,1106,2045,1492,713,386,sink
4244,11,mirror,12,0,2862,39,2,2,271,1337,269,1335,mirror
4245,0,toilet,1,0,2864,21,330,103,600,456,270,353,toilet
4246,24,sink,24,0,2866,33,293,1197,927,1485,634,288,sink
4247,33,bottle,33,1,2866,15,463,1585,531,1800,68,215,bottle
4248,34,bottle,34,0,2866,16,490,1642,571,1838,81,196,bottle
4249,40,mirror,40,0,2866,25,407,130,1118,1227,711,1097,mirror
4250,7,window,8,0,2868,15,140,0,215,112,75,112,window
4251,10,toilet,11,0,2868,52,12,83,92,188,80,105,toilet
4252,23,bowl,24,0,2868,26,83,112,141,166,58,54,bowl
4253,26,bowl,27,0,2868,26,35,127,92,188,57,61,bowl
4254,0,sink,1,0,2870,15,60,134,205,256,145,122,sink
4255,11,sink,12,0,2871,22,52,268,234,354,182,86,sink
4256,9,sink,9,1,2872,17,1262,1356,1533,1760,271,404,sink
4257,13,hair dryer,13,0,2872,97,846,566,1118,1175,272,609,hair drier
4258,4,sink,5,0,2873,19,663,321,992,391,329,70,sink
4259,5,sink,6,0,2873,21,1254,340,1597,419,343,79,sink
4260,3,toilet,4,1,2874,30,306,733,678,1023,372,290,toilet
4261,1,toilet,2,0,2876,18,161,106,210,151,49,45,toilet
4262,4,bowl,5,0,2876,20,176,214,248,256,72,42,bowl
4263,28,bowl,29,0,2876,19,164,119,208,151,44,32,bowl
4264,4,sink,5,0,2877,16,87,162,175,239,88,77,sink
4265,7,mirror,8,0,2877,15,132,48,184,101,52,53,mirror
4266,2,sink,3,0,2878,19,761,304,1023,555,262,251,sink
4267,4,window,5,0,2878,26,449,2,933,308,484,306,window
4268,5,vase,6,0,2878,24,609,211,674,295,65,84,vase
4269,1,sink,2,0,2879,31,197,772,1268,1534,1071,762,sink
4270,4,chair,5,0,2880,16,522,301,639,425,117,124,chair
4271,20,bed,20,0,2880,24,2,178,385,426,383,248,bed
4272,9,toilet,10,0,2882,20,114,154,163,221,49,67,toilet
4273,14,sink,15,0,2882,15,173,136,225,157,52,21,sink
4274,0,toilet,1,0,2883,19,211,126,255,223,44,97,toilet
4275,21,bowl,22,0,2883,29,142,161,194,217,52,56,bowl
4276,2,sink,3,0,2884,49,351,1087,845,1811,494,724,sink
4277,7,toilet,8,0,2884,42,903,1123,1300,2016,397,893,toilet
4278,11,mirror,12,0,2884,51,873,506,1052,719,179,213,mirror
4279,4,toilet,3,0,2886,23,1172,1708,1645,2175,473,467,toilet
4280,6,sink,5,0,2886,24,63,1383,935,1695,872,312,sink
4281,2,toilet,3,1,2887,30,142,150,221,270,79,120,toilet
4282,7,sink,8,0,2888,20,61,227,148,263,87,36,sink
4283,4,sink,4,0,2889,16,22,148,92,192,70,44,sink
4284,8,chair,8,0,2889,20,148,174,251,255,103,81,chair
4285,6,toilet,7,0,2891,56,34,601,556,1210,522,609,toilet
4286,19,bowl,20,0,2891,32,161,844,550,1207,389,363,bowl
4287,7,sink,8,0,2893,33,114,654,386,1023,272,369,sink
4288,14,toilet,15,1,2893,32,0,680,220,1219,220,539,toilet
4289,2,toilet,3,0,2894,33,1141,886,1423,1264,282,378,toilet
4290,3,sink,4,0,2894,35,1654,1069,2198,1464,544,395,sink
4291,10,toilet,11,0,2895,20,146,416,263,512,117,96,toilet
4292,4,sink,5,0,2896,24,403,338,788,783,385,445,sink
4293,5,toilet,6,1,2896,20,783,416,1094,821,311,405,toilet
4294,11,sink,12,0,2898,15,876,1060,1608,1391,732,331,sink
4295,3,sink,4,0,2899,39,464,420,988,680,524,260,sink
4296,8,toilet,9,1,2899,30,2,333,499,766,497,433,toilet
4297,11,toilet,12,0,2901,30,66,106,157,184,91,78,toilet
4298,3,toilet,4,0,2902,31,113,120,210,245,97,125,toilet
4299,1,mirror,2,1,2903,23,2,156,322,848,320,692,mirror
4300,9,toilet,10,1,2903,18,2080,774,2198,1460,118,686,toilet
4301,33,bowl,34,0,2903,21,1693,890,1953,1269,260,379,bowl
4302,4,table,5,0,2904,26,437,958,1054,1786,617,828,dining table
4303,0,toilet,1,0,2905,41,300,251,1421,1490,1121,1239,toilet
4304,2,toilet,3,0,2907,27,912,547,1698,1546,786,999,toilet
4305,4,sink,5,0,2907,17,0,769,769,1153,769,384,sink
4306,27,bowl,28,0,2907,20,1177,971,1688,1545,511,574,bowl
4307,0,sink,1,0,2908,19,798,394,1560,1038,762,644,sink
4308,2,chair,3,0,2909,26,11,148,124,255,113,107,chair
4309,1,toilet,2,0,2912,17,422,1036,951,1928,529,892,toilet
4310,10,toilet,11,1,2913,16,1299,1269,1705,1468,406,199,toilet
4311,22,bowl,23,0,2914,15,17,424,78,511,61,87,bowl
4312,1,toilet,2,0,2915,24,104,152,179,293,75,141,toilet
4313,6,sink,7,0,2915,16,19,122,96,204,77,82,sink
4314,4,toilet,4,0,2916,21,249,311,437,459,188,148,toilet
4315,26,bowl,26,0,2916,29,250,316,437,459,187,143,bowl
4316,27,bowl,27,0,2916,16,243,428,389,523,146,95,bowl
4317,2,sink,3,0,2918,16,200,733,503,878,303,145,sink
4318,3,sink,4,0,2918,15,509,712,763,833,254,121,sink
4319,3,sink,3,0,2920,37,84,1255,949,1666,865,411,sink
4320,6,toilet,6,0,2920,38,766,1443,1254,1841,488,398,toilet
4321,11,mirror,11,0,2920,31,245,229,557,1119,312,890,mirror
4322,21,bowl,19,0,2920,34,774,1467,1250,1839,476,372,bowl
4323,0,toilet,1,0,2921,24,160,298,371,480,211,182,toilet
4324,0,toilet,1,0,2922,26,83,200,125,256,42,56,toilet
4325,4,sink,5,0,2923,19,504,358,606,412,102,54,sink
4326,5,sink,6,0,2923,19,286,431,458,529,172,98,sink
4327,5,sink,6,0,2925,44,268,546,777,1646,509,1100,sink
4328,13,toilet,14,0,2925,59,1470,476,2173,1649,703,1173,toilet
4329,24,bowl,25,0,2925,30,1472,1086,1982,1650,510,564,bowl
4330,11,chair,12,0,2926,28,1,148,110,256,109,108,chair
4331,1,mirror,2,0,2928,27,48,61,158,212,110,151,mirror
4332,7,bed,8,1,2932,15,2,183,461,341,459,158,bed
4333,0,chair,1,0,2933,16,0,86,69,207,69,121,chair
4334,1,toilet,2,0,2933,19,146,73,236,185,90,112,toilet
4335,16,bowl,17,0,2933,18,146,140,198,183,52,43,bowl
4336,17,bowl,18,0,2933,26,162,154,241,228,79,74,bowl
4337,15,sink,16,0,2934,16,137,173,190,187,53,14,sink
4338,1,toilet,1,0,2936,43,464,1057,953,1888,489,831,toilet
4339,23,bowl,23,0,2936,24,600,1431,959,1887,359,456,bowl
4340,3,toilet,4,0,2937,25,49,68,141,239,92,171,toilet
4341,4,sink,5,0,2937,23,186,58,317,215,131,157,sink
4342,13,sink,14,0,2938,25,425,1081,911,1354,486,273,sink
4343,2,toilet,3,1,2939,19,768,862,959,1179,191,317,toilet
4344,9,sink,10,0,2939,30,2,903,377,1279,375,376,sink
4345,19,bowl,20,0,2939,17,765,1008,959,1181,194,173,bowl
4346,0,toilet,1,0,2941,16,626,586,1302,1840,676,1254,toilet
4347,0,toilet,1,0,2942,24,181,83,255,202,74,119,toilet
4348,3,sink,4,0,2942,29,0,44,101,202,101,158,sink
4349,9,bowl,10,0,2942,23,180,137,255,200,75,63,bowl
4350,11,bowl,12,0,2942,23,103,109,177,171,74,62,bowl
4351,2,sink,3,0,2943,23,424,742,1309,1130,885,388,sink
4352,4,sink,5,0,2945,27,579,974,1592,1541,1013,567,sink
4353,11,hair dryer,12,0,2945,15,410,44,723,710,313,666,hair drier
4354,4,sink,5,0,2947,27,97,353,336,530,239,177,sink
4355,34,bowl,34,0,2947,21,387,427,519,531,132,104,bowl
4356,4,sink,5,0,2948,29,0,683,540,1644,540,961,sink
4357,10,hair dryer,11,0,2948,22,1565,875,1735,967,170,92,hair drier
4358,1,toilet,2,0,2949,16,103,841,379,1274,276,433,toilet
4359,7,person,8,0,2952,50,545,401,738,958,193,557,person
4360,3,sink,4,0,2953,22,142,266,254,296,112,30,sink
4361,0,toilet,1,0,2954,20,381,154,535,419,154,265,toilet
4362,0,toilet,1,0,2955,40,480,608,822,1198,342,590,toilet
4363,2,sink,3,0,2955,44,759,671,1240,1198,481,527,sink
4364,5,toilet,6,0,2957,28,66,367,149,471,83,104,toilet
4365,0,toilet,1,0,2959,44,1185,607,1689,1609,504,1002,toilet
4366,8,sink,9,0,2959,19,162,556,680,692,518,136,sink
4367,13,window,14,0,2961,15,574,325,1165,639,591,314,window
4368,14,toilet,15,0,2961,15,181,1490,479,1860,298,370,toilet
4369,15,sink,16,0,2962,18,150,759,375,959,225,200,sink
4370,1,toilet,2,0,2963,24,147,148,244,256,97,108,toilet
4371,12,sink,13,0,2963,23,25,149,89,194,64,45,sink
4372,3,sink,4,0,2964,38,39,407,383,515,344,108,sink
4373,7,mirror,8,0,2964,18,494,296,546,380,52,84,mirror
4374,6,sink,7,0,2965,42,1006,946,1873,1534,867,588,sink
4375,9,mirror,10,1,2965,15,1300,5,1827,251,527,246,mirror
4376,1,toilet,2,0,2967,21,4,153,63,220,59,67,toilet
4377,17,bowl,18,0,2967,29,4,166,63,220,59,54,bowl
4378,2,sink,3,0,2968,15,100,165,153,180,53,15,sink
4379,6,toilet,7,0,2968,19,20,230,75,299,55,69,toilet
4380,8,toilet,9,0,2969,17,152,427,227,512,75,85,toilet
4381,0,sink,1,0,2971,41,0,30,118,151,118,121,sink
4382,1,toilet,2,0,2971,20,133,79,200,152,67,73,toilet
4383,8,vase,9,0,2971,24,39,172,87,227,48,55,vase
4384,12,vase,13,0,2971,16,226,19,246,61,20,42,vase
4385,15,bowl,16,0,2971,26,133,89,198,152,65,63,bowl
4386,8,toilet,9,0,2972,32,109,385,191,493,82,108,toilet
4387,4,toilet,5,0,2973,22,344,310,549,480,205,170,toilet
4388,5,bowl,6,0,2974,31,511,311,810,543,299,232,bowl
4389,8,sink,9,0,2974,25,952,791,2194,1649,1242,858,sink
4390,10,toilet,10,1,2974,15,97,1357,842,1649,745,292,toilet
4391,5,toilet,6,0,2975,18,96,202,143,256,47,54,toilet
4392,0,mirror,1,0,2977,19,517,3,1379,954,862,951,mirror
4393,2,toilet,3,0,2978,18,40,210,92,303,52,93,toilet
4394,8,sink,9,1,2979,27,229,1205,1000,1481,771,276,sink
4395,1,mirror,2,0,2980,24,310,52,499,317,189,265,mirror
4396,4,sink,5,0,2980,22,299,484,558,576,259,92,sink
4397,10,toilet,11,0,2980,29,107,721,327,1021,220,300,toilet
4398,13,bowl,14,0,2980,20,122,807,328,1023,206,216,bowl
4399,4,sink,5,0,2981,17,1091,1030,1594,1205,503,175,sink
4400,2,sink,3,0,2982,17,205,154,256,254,51,100,sink
4401,8,toilet,9,0,2983,24,55,107,110,190,55,83,toilet
4402,3,mirror,4,0,2984,16,980,1,1198,737,218,736,mirror
4403,5,toilet,6,0,2984,29,264,980,843,1597,579,617,toilet
4404,7,sink,8,1,2984,15,880,1056,1198,1218,318,162,sink
4405,2,sink,3,0,2986,16,91,153,142,209,51,56,sink
4406,6,toilet,7,0,2986,30,181,159,231,250,50,91,toilet
4407,0,toilet,1,0,2987,22,184,117,243,237,59,120,toilet
4408,12,sink,13,0,2988,46,1371,1073,2046,1651,675,578,sink
4409,14,mirror,15,0,2988,31,1546,179,2034,905,488,726,mirror
4410,2,toilet,3,0,2989,18,164,173,222,256,58,83,toilet
4411,4,mirror,5,0,2989,16,173,66,255,164,82,98,mirror
4412,12,sink,12,0,2990,45,1241,779,1970,1224,729,445,sink
4413,1,toilet,2,0,2991,24,102,354,256,533,154,179,toilet
4414,19,bowl,20,0,2991,33,102,430,243,533,141,103,bowl
4415,3,sink,4,0,2992,19,100,157,175,194,75,37,sink
4416,4,toilet,5,0,2993,29,61,117,178,251,117,134,toilet
4417,13,flowerpot,14,0,2994,15,127,1189,283,1335,156,146,potted plant
4418,0,mirror,1,0,2995,22,55,18,136,115,81,97,mirror
4419,1,sink,2,0,2996,62,29,1026,993,1648,964,622,sink
4420,14,toilet,15,1,2996,33,985,947,1656,1649,671,702,toilet
4421,15,sink,15,0,2998,48,722,1145,1465,1339,743,194,sink
4422,0,mirror,1,0,2999,51,2,153,872,1146,870,993,mirror
4423,3,sink,4,0,2999,21,640,997,916,1141,276,144,sink
4424,14,bottle,15,0,2999,19,357,932,402,1108,45,176,bottle
4425,13,vase,14,0,3000,19,689,154,751,246,62,92,vase
4426,2,flowerpot,3,0,3001,21,289,490,393,571,104,81,potted plant
4427,6,toilet,7,1,3001,22,2,590,284,959,282,369,toilet
4428,6,sink,7,0,3002,16,106,557,297,630,191,73,sink
4429,5,toilet,5,1,3003,41,230,484,367,722,137,238,toilet
4430,6,sink,6,0,3003,15,38,507,184,555,146,48,sink
4431,21,bowl,20,0,3003,40,230,581,365,723,135,142,bowl
4432,5,toilet,6,1,3004,47,330,1356,914,2106,584,750,toilet
4433,8,sink,9,0,3004,32,8,1375,590,2197,582,822,sink
4434,9,sink,10,0,3005,16,59,138,171,187,112,49,sink
4435,13,toothbrush,14,0,3005,16,205,148,245,180,40,32,toothbrush
4436,26,sink,27,0,3006,17,537,693,763,790,226,97,sink
4437,27,bottle,28,1,3006,15,601,681,647,798,46,117,bottle
4438,30,toilet,31,1,3006,23,2,664,273,1023,271,359,toilet
4439,17,table,18,0,3007,30,1594,1035,2051,1459,457,424,dining table
4440,20,sink,21,0,3009,17,192,193,255,232,63,39,sink
4441,8,toilet,9,0,3010,40,667,930,967,1443,300,513,toilet
4442,11,sink,12,0,3010,16,1127,1217,1948,1641,821,424,sink
4443,10,sink,11,0,3011,35,863,794,1382,957,519,163,sink
4444,13,toilet,14,0,3011,30,552,843,874,1301,322,458,toilet
4445,10,sink,10,0,3012,25,1036,1207,1418,1291,382,84,sink
4446,2,toilet,3,0,3013,36,326,1341,1103,2025,777,684,toilet
4447,7,sink,8,0,3014,39,794,1319,1462,2197,668,878,sink
4448,11,mirror,10,0,3017,36,6,28,351,452,345,424,mirror
4449,8,sink,9,0,3019,17,27,213,186,273,159,60,sink
4450,20,bowl,21,0,3019,19,285,305,435,366,150,61,bowl
4451,1,sink,2,0,20294,29,162,1141,697,1406,535,265,sink
4452,6,toilet,7,0,20294,35,882,1158,1316,2046,434,888,toilet
4453,16,sink,16,0,20295,18,556,946,827,1061,271,115,sink
4454,11,sink,12,0,20298,21,240,1313,658,1441,418,128,sink
4455,12,sink,13,0,20298,22,861,1388,1312,1556,451,168,sink
4456,5,toilet,6,1,20301,23,490,1624,1374,2200,884,576,toilet
4457,2,sink,3,0,20302,24,252,239,1655,1536,1403,1297,sink
4458,6,toilet,7,1,20302,18,1847,1143,2046,1536,199,393,toilet
4459,11,door,11,0,20303,15,0,0,107,1280,107,1280,door
4460,12,mirror,12,0,20303,16,54,358,296,710,242,352,mirror
4461,13,sink,13,0,20303,16,76,706,303,804,227,98,sink
4462,15,toilet,15,0,20303,29,411,700,635,1044,224,344,toilet
4463,10,toilet,11,0,20305,38,182,1238,730,2200,548,962,toilet
4464,13,sink,14,0,20305,17,810,1381,1393,2200,583,819,sink
4465,10,sink,11,0,20307,19,366,1354,913,1598,547,244,sink
4466,13,mirror,14,0,20307,31,891,602,1091,920,200,318,mirror
4467,7,toilet,8,1,20308,24,822,586,1242,960,420,374,toilet
4468,10,sink,11,0,20308,29,599,657,987,817,388,160,sink
4469,22,toothbrush,23,0,20308,21,14,921,271,950,257,29,toothbrush
4470,10,sink,11,0,20309,16,625,1388,989,1523,364,135,sink
4471,7,person,8,1,22823,93,46,117,511,997,465,880,person
4472,5,sink,6,0,22826,15,2,496,136,568,134,72,sink
4473,6,sink,7,0,22826,15,0,639,184,806,184,167,sink
4474,13,sink,14,0,22827,16,278,481,446,524,168,43,sink
4475,15,mirror,16,0,22827,26,372,213,526,318,154,105,mirror
4476,5,sink,6,0,22828,20,2,664,288,1020,286,356,sink
4477,6,toilet,7,0,22828,32,263,705,426,890,163,185,toilet
4478,5,toilet,6,0,22829,16,907,851,1235,1085,328,234,toilet
4479,11,toilet,11,1,22830,25,7,583,461,1024,454,441,toilet
4480,17,vase,17,0,22830,18,90,385,180,519,90,134,vase
4481,3,person,4,1,22832,25,776,494,1023,637,247,143,person
4482,23,clock,24,0,22833,16,261,81,293,120,32,39,clock
4483,4,sink,5,0,22834,34,121,395,345,666,224,271,sink
4484,11,mirror,12,0,22834,23,168,18,380,323,212,305,mirror
4485,7,toilet,8,0,22837,39,408,218,534,484,126,266,toilet
4486,6,sink,7,0,22838,24,509,331,684,414,175,83,sink
4487,4,mirror,5,0,22839,18,267,8,394,237,127,229,mirror
4488,9,vase,10,0,22839,16,100,108,139,161,39,53,vase
4489,10,vase,11,0,22839,18,68,89,109,161,41,72,vase
4490,10,table,11,0,3194,21,194,168,250,208,56,40,dining table
4491,0,bed,1,0,3195,39,137,283,1476,1198,1339,915,bed
4492,7,chair,8,0,3197,28,244,113,284,182,40,69,chair
4493,8,chair,9,1,3197,21,94,111,122,172,28,61,chair
4494,9,chair,10,0,3197,25,67,113,99,180,32,67,chair
4495,10,table,11,0,3197,25,2,131,71,192,69,61,dining table
4496,9,bed,10,0,3198,30,28,148,190,288,162,140,bed
4497,3,bed,4,0,3199,85,81,331,1249,1198,1168,867,bed
4498,7,chair,8,0,3199,35,1234,472,1410,869,176,397,chair
4499,4,bed,5,0,3200,97,120,90,244,188,124,98,bed
4500,9,chair,10,0,3200,17,53,114,77,154,24,40,chair
4501,10,chair,11,1,3200,15,134,110,154,139,20,29,chair
4502,3,bed,4,0,3201,29,331,845,979,1451,648,606,bed
4503,3,bed,4,0,22871,18,88,91,1023,768,935,677,bed
4504,4,person,5,1,22871,54,907,172,1023,555,116,383,person
4505,3,bed,4,0,22872,40,142,543,2197,1650,2055,1107,bed
4506,2,bed,3,0,22873,62,21,16,887,1116,866,1100,bed
4507,1,bed,2,1,46,46,142,111,619,463,477,352,bed
4508,2,person,3,1,46,64,0,63,490,465,490,402,person
4509,1,window,2,0,192,23,0,58,184,191,184,133,window
4510,5,table,6,1,192,22,184,181,256,254,72,73,dining table
4511,10,chair,11,1,193,24,20,173,56,254,36,81,chair
4512,11,bed,12,1,193,26,112,175,256,256,144,81,bed
4513,10,bed,11,0,194,40,4,130,183,240,179,110,bed
4514,14,chair,15,1,194,36,137,169,206,240,69,71,chair
4515,7,bed,8,1,195,17,0,171,139,256,139,85,bed
4516,3,window,4,1,196,40,2,213,136,565,134,352,window
4517,8,bed,8,0,196,97,204,217,802,678,598,461,bed
4518,17,window,17,1,196,19,529,221,587,439,58,218,window
4519,21,mirror,20,0,196,34,791,225,966,408,175,183,mirror
4520,22,vase,21,0,196,16,778,358,806,412,28,54,vase
4521,4,bed,5,1,197,47,418,372,1288,860,870,488,bed
4522,6,bed,7,1,198,28,121,79,256,209,135,130,bed
4523,11,mirror,12,0,198,16,23,39,66,106,43,67,mirror
4524,5,window,6,0,199,22,213,124,259,334,46,210,window
4525,12,chair,13,1,199,21,407,301,469,363,62,62,chair
4526,14,window,15,0,199,52,501,95,667,338,166,243,window
4527,17,chair,18,0,199,40,708,308,785,456,77,148,chair
4528,20,bed,21,1,199,72,0,246,396,533,396,287,bed
4529,8,bed,9,1,200,17,178,169,255,256,77,87,bed
4530,5,desk,6,0,201,18,839,400,1062,565,223,165,desk
4531,8,bed,9,0,201,34,105,384,900,743,795,359,bed
4532,10,vase,11,0,201,18,923,533,1009,579,86,46,vase
4533,4,bed,5,0,202,80,90,101,249,232,159,131,bed
4534,5,desk,6,0,202,18,33,94,89,144,56,50,desk
4535,10,bed,11,1,202,30,0,132,35,256,35,124,bed
4536,4,door,5,1,203,16,1254,150,1384,743,130,593,door
4537,5,door,6,1,203,16,1187,1,1502,997,315,996,door
4538,13,desk,14,1,203,30,765,390,888,494,123,104,desk
4539,29,bed,30,0,203,46,206,530,923,999,717,469,bed
4540,2,window,3,0,204,16,923,26,1249,421,326,395,window
4541,6,bed,7,0,204,43,532,451,1252,813,720,362,bed
4542,11,desk,12,0,204,20,88,455,474,728,386,273,desk
4543,2,window,3,0,205,24,98,16,476,1011,378,995,window
4544,8,bed,9,0,205,47,135,735,1879,1648,1744,913,bed
4545,5,window,6,0,206,20,41,91,77,145,36,54,window
4546,7,chair,8,0,206,25,89,122,127,171,38,49,chair
4547,13,bed,14,1,206,67,108,111,256,251,148,140,bed
4548,8,bed,8,1,207,30,229,868,2046,1534,1817,666,bed
4549,5,bed,6,1,208,42,86,135,300,253,214,118,bed
4550,6,bed,7,1,208,22,0,230,300,300,300,70,bed
4551,13,chair,14,0,208,25,70,137,116,230,46,93,chair
4552,15,window,16,0,209,16,101,26,127,102,26,76,window
4553,19,bed,20,1,209,54,0,67,124,236,124,169,bed
4554,8,bed,9,1,210,32,0,107,203,228,203,121,bed
4555,5,bed,6,1,211,42,0,0,121,205,121,205,bed
4556,11,mirror,12,0,212,16,71,93,117,155,46,62,mirror
4557,12,window,13,1,212,22,50,54,121,155,71,101,window
4558,16,chair,17,0,212,26,15,142,60,232,45,90,chair
4559,4,bed,5,1,213,19,0,103,108,157,108,54,bed
4560,5,bed,6,1,213,31,3,113,175,199,172,86,bed
4561,6,bed,7,1,213,20,94,104,299,200,205,96,bed
4562,12,bed,13,1,214,27,214,150,255,211,41,61,bed
4563,2,bed,3,0,215,46,124,74,255,171,131,97,bed
4564,6,table,7,1,215,20,0,99,88,145,88,46,dining table
4565,0,bed,1,0,216,41,0,2,1822,1648,1822,1646,bed
4566,3,window,4,0,217,37,121,36,337,190,216,154,window
4567,6,bed,7,1,217,32,0,125,147,240,147,115,bed
4568,10,bowl,11,0,217,26,234,192,329,247,95,55,bowl
4569,8,window,6,0,218,24,712,227,888,376,176,149,window
4570,21,bed,18,0,218,68,240,344,699,659,459,315,bed
4571,31,vase,27,0,218,15,34,505,76,604,42,99,vase
4572,9,bed,10,0,219,42,116,68,224,151,108,83,bed
4573,3,bed,4,0,220,135,53,94,255,233,202,139,bed
4574,3,bed,4,0,221,47,65,93,277,225,212,132,bed
4575,6,sofa,7,1,222,15,0,122,70,178,70,56,couch
4576,8,bed,9,0,222,29,38,133,256,256,218,123,bed
4577,3,window,4,0,223,16,28,32,94,112,66,80,window
4578,10,bed,11,0,223,38,65,104,212,235,147,131,bed
4579,3,bed,4,1,224,73,626,882,2197,1649,1571,767,bed
4580,5,window,6,1,225,26,0,16,90,153,90,137,window
4581,7,sofa,8,1,225,24,0,142,163,229,163,87,couch
4582,3,window,4,1,226,15,643,135,1313,433,670,298,window
4583,4,bed,5,0,226,99,130,71,2199,1648,2069,1577,bed
4584,6,mirror,7,0,227,46,0,1,84,101,84,100,mirror
4585,7,bed,8,1,227,34,0,105,256,256,256,151,bed
4586,4,chair,5,1,228,30,725,298,1055,631,330,333,chair
4587,8,window,8,1,228,20,524,2,998,463,474,461,window
4588,7,bed,8,1,229,34,0,140,310,225,310,85,bed
4589,3,bed,4,0,230,37,2,438,637,1292,635,854,bed
4590,5,bed,6,0,230,63,287,625,1472,1465,1185,840,bed
4591,6,bed,7,0,231,80,696,426,1441,823,745,397,bed
4592,14,chair,14,1,231,29,1114,642,1499,1000,385,358,chair
4593,15,table,15,1,231,15,1230,763,1498,998,268,235,dining table
4594,22,table,22,0,231,42,359,530,549,719,190,189,dining table
4595,23,chair,23,0,231,19,462,529,586,705,124,176,chair
4596,27,sofa,27,1,231,26,2,581,280,902,278,321,couch
4597,3,window,4,0,232,28,347,58,590,287,243,229,window
4598,9,bed,10,0,232,72,127,135,467,414,340,279,bed
4599,31,bed,29,0,233,71,226,332,879,686,653,354,bed
4600,3,bed,4,0,234,101,2,39,207,290,205,251,bed
4601,4,bed,5,0,235,40,0,1082,1343,1865,1343,783,bed
4602,18,bed,19,0,236,54,194,231,432,384,238,153,bed
4603,22,chair,23,1,236,16,420,262,482,332,62,70,chair
4604,8,bed,9,0,237,25,300,481,1270,958,970,477,bed
4605,10,bed,11,1,238,16,71,565,428,768,357,203,bed
4606,6,bed,7,0,239,83,341,262,921,669,580,407,bed
4607,8,bed,9,1,239,38,0,145,447,767,447,622,bed
4608,12,mirror,13,0,240,31,627,259,722,419,95,160,mirror
4609,13,mirror,14,0,240,41,196,236,320,422,124,186,mirror
4610,14,bed,15,0,240,106,331,291,802,616,471,325,bed
4611,19,mirror,20,1,240,17,934,154,1022,381,88,227,mirror
4612,7,bed,7,0,241,80,223,349,665,659,442,310,bed
4613,14,television,15,0,242,17,448,914,649,1178,201,264,tv
4614,23,window,24,0,242,32,0,203,290,1017,290,814,window
4615,27,clock,28,0,242,15,273,1133,321,1197,48,64,clock
4616,29,bed,30,1,242,15,0,1282,797,1649,797,367,bed
4617,2,window,3,0,243,29,701,305,866,1137,165,832,window
4618,5,bed,6,1,243,79,177,916,1465,1649,1288,733,bed
4619,17,window,18,0,243,15,1068,266,2198,1455,1130,1189,window
4620,5,bed,5,0,244,58,2,475,736,1150,734,675,bed
4621,7,bed,8,1,245,20,787,425,1023,768,236,343,bed
4622,22,bed,23,0,246,68,406,204,865,614,459,410,bed
4623,41,chair,39,1,246,24,85,631,384,793,299,162,chair
4624,42,table,40,1,246,40,432,608,1140,793,708,185,dining table
4625,45,chair,42,1,246,36,896,496,1154,788,258,292,chair
4626,30,bed,31,1,247,38,572,770,1087,1199,515,429,bed
4627,11,bowl,12,0,248,18,412,342,456,366,44,24,bowl
4628,17,sofa,18,1,248,16,2,479,166,666,164,187,couch
4629,22,bed,23,1,248,18,392,465,999,665,607,200,bed
4630,24,flowerpot,25,0,248,26,782,381,954,487,172,106,potted plant
4631,4,bed,4,1,249,18,346,253,1023,768,677,515,bed
4632,6,bed,7,1,250,39,2,816,2082,1648,2080,832,bed
4633,3,chair,4,1,251,20,297,699,466,788,169,89,chair
4634,9,table,10,1,251,42,454,731,779,844,325,113,dining table
4635,11,vase,12,0,251,17,551,657,595,742,44,85,vase
4636,14,chair,15,1,251,30,667,695,844,875,177,180,chair
4637,19,sofa,20,1,251,53,0,729,528,1208,528,479,couch
4638,28,plate,29,0,251,15,46,1031,155,1072,109,41,plate
4639,37,bed,38,1,251,74,1092,494,1552,1075,460,581,bed
4640,48,vase,49,0,251,15,1593,739,1686,796,93,57,vase
4641,8,bed,9,0,252,136,3,434,2199,1464,2196,1030,bed
4642,19,bed,18,1,253,24,0,515,731,768,731,253,bed
4643,2,mirror,3,0,254,16,192,44,344,392,152,348,mirror
4644,8,bed,9,1,254,34,649,280,1023,767,374,487,bed
4645,6,bed,6,1,255,49,10,346,1152,959,1142,613,bed
4646,7,window,7,0,255,18,847,1,1111,355,264,354,window
4647,11,bed,11,0,256,41,91,161,573,590,482,429,bed
4648,12,sofa,12,1,256,29,394,339,800,590,406,251,couch
4649,25,window,25,1,256,28,0,23,36,297,36,274,window
4650,7,bed,6,0,257,61,44,982,1454,2003,1410,1021,bed
4651,2,bed,3,0,258,31,0,685,1014,1470,1014,785,bed
4652,4,bed,5,1,258,43,1173,686,2185,1471,1012,785,bed
4653,5,chair,6,1,258,15,1512,851,1989,1471,477,620,chair
4654,6,toilet,7,0,259,27,672,373,801,534,129,161,toilet
4655,6,bed,7,0,260,28,77,106,300,224,223,118,bed
4656,3,chair,4,1,261,18,377,678,988,1273,611,595,chair
4657,9,mirror,10,1,261,51,1944,4,2181,542,237,538,mirror
4658,10,bed,11,1,261,22,0,976,2196,1649,2196,673,bed
4659,3,window,4,0,262,21,631,64,748,375,117,311,window
4660,10,window,11,1,262,43,254,93,320,289,66,196,window
4661,18,mirror,19,0,262,36,47,109,128,236,81,127,mirror
4662,21,bed,22,0,262,93,115,218,555,486,440,268,bed
4663,4,window,5,0,263,16,1197,358,1665,928,468,570,window
4664,6,pot,7,0,263,21,1806,145,1926,295,120,150,potted plant
4665,13,bed,13,1,263,45,0,668,1553,1462,1553,794,bed
4666,13,bed,13,1,264,47,2,824,1221,1067,1219,243,bed
4667,15,bed,15,1,264,46,4,928,1869,1465,1865,537,bed
4668,3,mirror,4,0,265,104,993,393,1254,1041,261,648,mirror
4669,5,bed,6,1,265,34,799,910,2199,1444,1400,534,bed
4670,3,window,4,1,266,15,1029,235,1099,630,70,395,window
4671,11,pot,12,0,266,16,1513,718,1578,794,65,76,potted plant
4672,13,bed,13,0,266,76,0,857,1153,1637,1153,780,bed
4673,14,bed,14,0,266,42,1477,852,2198,1628,721,776,bed
4674,11,bed,10,1,267,65,2,488,1051,898,1049,410,bed
4675,9,bed,10,0,268,40,714,586,1541,1091,827,505,bed
4676,10,chair,11,0,268,20,553,679,733,843,180,164,chair
4677,11,chair,12,0,268,17,391,681,588,869,197,188,chair
4678,12,chair,13,0,268,50,106,753,324,992,218,239,chair
4679,6,bed,7,0,269,47,182,400,1022,768,840,368,bed
4680,9,bed,10,1,270,96,67,91,1534,1023,1467,932,bed
4681,7,bed,7,0,271,46,932,669,2199,1461,1267,792,bed
4682,8,bed,8,0,271,47,1,665,952,1461,951,796,bed
4683,2,chair,3,1,272,31,851,1096,1216,1334,365,238,chair
4684,9,bed,9,0,272,39,0,1097,1645,2198,1645,1101,bed
4685,5,pot,6,0,273,16,670,410,781,535,111,125,potted plant
4686,9,pot,10,0,273,22,659,3,752,154,93,151,potted plant
4687,10,sofa,11,0,273,65,686,633,2092,1644,1406,1011,couch
4688,17,window,18,0,273,18,1293,67,2090,798,797,731,window
4689,2,bed,3,0,274,124,91,343,913,847,822,504,bed
4690,7,bed,7,0,275,87,130,424,1011,850,881,426,bed
4691,14,mirror,13,0,275,22,1035,138,1213,322,178,184,mirror
4692,16,chair,15,1,275,30,2,657,136,854,134,197,chair
4693,5,mirror,4,1,276,64,538,208,653,319,115,111,mirror
4694,6,mirror,5,1,276,52,188,208,300,322,112,114,mirror
4695,9,bed,8,0,276,31,136,250,707,533,571,283,bed
4696,16,flowerpot,15,0,276,56,13,346,123,474,110,128,potted plant
4697,15,bed,14,0,277,19,116,310,548,515,432,205,bed
4698,8,flowerpot,9,0,278,16,249,315,282,351,33,36,potted plant
4699,10,bed,11,1,278,49,295,229,591,439,296,210,bed
4700,3,door,4,1,279,15,223,94,267,218,44,124,door
4701,12,bed,13,0,279,45,127,142,458,338,331,196,bed
4702,14,mirror,15,1,279,30,33,80,153,174,120,94,mirror
4703,9,mirror,10,0,280,25,534,119,689,401,155,282,mirror
4704,2,window,3,0,281,36,29,77,351,748,322,671,window
4705,9,bed,9,0,281,73,272,347,1349,896,1077,549,bed
4706,6,bed,7,1,282,58,0,928,1130,1596,1130,668,bed
4707,3,vase,4,0,283,15,1240,641,1315,739,75,98,vase
4708,6,chair,7,0,283,40,548,544,811,914,263,370,chair
4709,9,bed,10,1,283,16,555,911,1599,1200,1044,289,bed
4710,10,bed,11,1,283,20,0,811,801,1199,801,388,bed
4711,7,bed,8,1,284,37,497,433,957,768,460,335,bed
4712,8,bed,9,1,284,41,2,440,396,768,394,328,bed
4713,1,window,2,1,285,15,235,378,371,801,136,423,window
4714,4,window,5,1,285,153,600,102,1475,1163,875,1061,window
4715,8,window,9,1,285,72,1720,116,2198,1366,478,1250,window
4716,10,flowerpot,11,1,285,27,1234,1372,1550,1463,316,91,potted plant
4717,12,chair,13,0,285,53,237,840,697,1338,460,498,chair
4718,14,bed,15,1,285,30,1,1009,508,1464,507,455,bed
4719,13,window,13,1,286,17,93,40,187,401,94,361,window
4720,28,bed,26,0,286,74,325,266,760,683,435,417,bed
4721,5,bed,5,1,287,64,2,282,975,866,973,584,bed
4722,6,bed,5,0,288,18,0,374,1690,1511,1690,1137,bed
4723,6,window,6,1,289,28,791,235,873,349,82,114,window
4724,7,sofa,7,0,289,24,561,333,721,392,160,59,couch
4725,14,vase,14,0,289,16,834,319,871,367,37,48,vase
4726,18,bed,17,0,289,125,371,197,915,611,544,414,bed
4727,37,vase,33,1,289,15,850,311,917,572,67,261,vase
4728,1,bed,2,0,290,48,88,326,1055,866,967,540,bed
4729,13,chair,14,1,290,32,760,385,907,577,147,192,chair
4730,14,table,15,0,290,41,800,434,1126,654,326,220,dining table
4731,15,chair,16,1,290,27,1082,577,1156,723,74,146,chair
4732,7,bed,8,0,291,40,672,261,1973,1307,1301,1046,bed
4733,5,bed,5,0,292,40,354,829,2197,1392,1843,563,bed
4734,16,bottle,17,0,293,18,1227,132,1251,182,24,50,bottle
4735,28,bed,28,0,293,153,193,373,1013,852,820,479,bed
4736,6,bed,7,1,294,86,1030,415,1599,1065,569,650,bed
4737,11,bed,12,1,294,86,0,402,583,1067,583,665,bed
4738,18,chair,19,1,294,18,1479,854,1598,1065,119,211,chair
4739,5,flowerpot,6,0,295,26,34,338,108,411,74,73,potted plant
4740,9,bed,9,0,295,91,126,273,751,601,625,328,bed
4741,6,bed,6,1,296,55,520,1017,1534,2045,1014,1028,bed
4742,11,racket,12,0,297,20,1110,225,1453,430,343,205,tennis racket
4743,12,racket,13,0,297,18,907,255,1214,350,307,95,tennis racket
4744,19,clock,20,0,297,23,1437,902,1493,979,56,77,clock
4745,28,desk,29,1,297,37,341,844,810,979,469,135,desk
4746,31,window,32,0,297,18,0,376,331,1037,331,661,window
4747,33,bed,34,0,297,85,41,735,1480,1590,1439,855,bed
4748,9,chair,10,1,298,31,2,611,272,894,270,283,chair
4749,11,bed,12,0,298,80,7,481,1261,1199,1254,718,bed
4750,15,bed,15,1,299,58,484,519,1198,803,714,284,bed
4751,8,chair,9,1,300,20,679,432,799,535,120,103,chair
4752,14,window,14,0,300,23,385,231,460,308,75,77,window
4753,21,window,20,0,300,61,627,217,762,337,135,120,window
4754,23,mirror,22,0,300,24,507,162,578,248,71,86,mirror
4755,25,bed,24,0,300,106,360,248,635,481,275,233,bed
4756,7,person,7,1,301,22,1970,246,2045,724,75,478,person
4757,14,bed,14,1,301,171,271,100,2046,1534,1775,1434,bed
4758,2,bed,3,0,302,76,196,701,1425,1537,1229,836,bed
4759,15,mirror,14,0,302,20,1323,397,1508,834,185,437,mirror
4760,2,bed,3,0,303,307,176,370,1967,1655,1791,1285,bed
4761,5,window,6,1,303,61,1691,300,2055,964,364,664,window
4762,15,window,15,0,304,19,545,252,655,378,110,126,window
4763,30,bed,28,0,304,110,125,349,587,626,462,277,bed
4764,4,chair,4,1,305,32,160,939,357,1601,197,662,chair
4765,5,bed,5,0,305,126,251,800,1864,1649,1613,849,bed
4766,6,bed,6,1,305,169,947,727,2198,1614,1251,887,bed
4767,8,chair,8,1,305,27,1310,749,1428,878,118,129,chair
4768,2,window,3,0,306,30,597,105,972,341,375,236,window
4769,4,person,5,1,306,113,770,150,1273,1079,503,929,person
4770,8,bed,9,1,306,42,0,422,970,1079,970,657,bed
4771,6,bed,7,0,307,63,198,215,589,499,391,284,bed
4772,9,bed,7,0,308,79,46,124,462,479,416,355,bed
4773,3,window,4,0,309,17,1687,339,2198,1177,511,838,window
4774,8,bed,8,1,309,48,1059,760,2176,1649,1117,889,bed
4775,10,bed,10,1,309,21,2,1197,1298,1649,1296,452,bed
4776,2,bed,3,0,310,120,97,88,376,453,279,365,bed
4777,11,window,12,1,310,62,418,140,670,309,252,169,window
4778,12,sofa,13,0,310,31,436,276,569,363,133,87,couch
4779,18,window,19,0,310,17,309,181,357,293,48,112,window
4780,14,bed,13,0,311,62,224,335,675,677,451,342,bed
4781,12,bed,13,1,312,24,2,689,1176,999,1174,310,bed
4782,13,bed,12,0,313,95,351,294,870,599,519,305,bed
4783,12,bed,13,0,314,96,225,211,581,422,356,211,bed
4784,13,bed,14,1,314,96,2,205,546,491,544,286,bed
4785,7,bed,6,0,315,103,0,593,1795,1649,1795,1056,bed
4786,6,bed,7,1,316,25,641,751,1224,1630,583,879,bed
4787,7,bed,8,1,316,28,0,746,512,1630,512,884,bed
4788,18,chair,16,1,317,19,16,553,228,697,212,144,chair
4789,19,bed,17,1,317,21,2,654,817,959,815,305,bed
4790,4,bed,4,1,318,53,0,148,1459,2199,1459,2051,bed
4791,7,mirror,8,1,319,20,53,539,209,1199,156,660,mirror
4792,8,bed,9,0,319,105,362,713,1365,1199,1003,486,bed
4793,10,bed,11,1,319,37,871,973,1599,1199,728,226,bed
4794,7,desk,8,1,320,16,437,383,580,454,143,71,desk
4795,12,bed,12,0,320,46,136,290,740,683,604,393,bed
4796,5,bed,6,1,321,23,227,408,1022,767,795,359,bed
4797,3,bed,4,0,322,124,72,270,1774,1464,1702,1194,bed
4798,12,bed,11,0,323,98,136,61,772,768,636,707,bed
4799,4,chair,5,0,324,42,875,258,1023,523,148,265,chair
4800,5,window,6,0,324,35,653,1,1023,300,370,299,window
4801,7,bed,7,0,324,145,2,0,798,768,796,768,bed
4802,7,bed,8,0,325,50,166,195,1524,1199,1358,1004,bed
4803,8,door,9,0,326,15,167,68,407,530,240,462,door
4804,13,bed,14,0,326,68,274,314,872,666,598,352,bed
4805,11,bed,10,0,327,34,67,301,483,492,416,191,bed
4806,5,window,6,0,328,21,704,249,925,748,221,499,window
4807,8,bed,9,1,328,48,175,736,1787,1199,1612,463,bed
4808,16,window,14,0,329,36,515,223,823,956,308,733,window
4809,17,bed,15,1,329,51,3,710,1672,1649,1669,939,bed
4810,8,bed,8,0,330,56,2,860,1524,2047,1522,1187,bed
4811,8,bed,9,1,331,36,2,480,1103,1199,1101,719,bed
4812,10,flowerpot,10,0,332,21,751,470,820,542,69,72,potted plant
4813,11,window,11,0,332,27,466,96,849,454,383,358,window
4814,13,chair,13,1,332,16,509,362,606,448,97,86,chair
4815,42,bed,42,0,332,39,178,402,683,695,505,293,bed
4816,3,window,4,0,333,65,398,300,610,688,212,388,window
4817,6,window,7,0,333,22,845,300,1061,713,216,413,window
4818,9,bed,10,1,333,144,0,3,1248,1199,1248,1196,bed
4819,11,mirror,12,1,333,67,1076,200,1478,660,402,460,mirror
4820,3,bed,4,1,334,26,0,837,1648,2198,1648,1361,bed
4821,12,plate,12,0,334,15,1270,1916,1480,2056,210,140,plate
4822,14,bed,15,0,335,70,0,359,1099,959,1099,600,bed
4823,19,window,20,0,335,22,2,100,279,383,277,283,window
4824,12,bed,13,0,336,32,894,623,2045,1534,1151,911,bed
4825,5,bed,4,0,338,78,517,80,1933,1409,1416,1329,bed
4826,10,chair,11,0,339,26,575,330,647,446,72,116,chair
4827,11,bowl,12,0,339,27,1235,545,1405,632,170,87,bowl
4828,13,bed,13,0,339,41,465,408,1272,633,807,225,bed
4829,20,chair,19,1,339,22,2,370,245,633,243,263,chair
4830,6,window,5,0,340,53,2,156,369,530,367,374,window
4831,8,window,7,0,340,36,462,201,543,459,81,258,window
4832,12,bed,11,0,340,57,250,341,894,683,644,342,bed
4833,10,chair,11,1,342,19,176,208,224,241,48,33,chair
4834,15,bed,16,0,342,116,178,150,581,406,403,256,bed
4835,23,chair,24,1,342,19,0,292,35,348,35,56,chair
4836,4,bed,4,0,343,84,369,294,871,656,502,362,bed
4837,16,television,15,1,343,21,1,302,171,406,170,104,tv
4838,22,bowl,21,0,343,20,6,390,129,446,123,56,bowl
4839,3,bed,4,0,344,54,214,195,792,704,578,509,bed
4840,18,window,18,0,344,19,562,35,780,259,218,224,window
4841,6,bed,7,0,345,43,51,171,353,399,302,228,bed
4842,16,bed,17,1,345,21,323,187,600,399,277,212,bed
4843,5,bed,5,0,346,77,368,279,819,643,451,364,bed
4844,7,bed,8,1,347,52,254,1054,1532,2045,1278,991,bed
4845,9,bed,8,1,348,35,405,362,1023,767,618,405,bed
4846,13,chair,12,0,348,19,552,274,634,420,82,146,chair
4847,23,window,21,0,348,15,306,93,445,365,139,272,window
4848,4,window,5,1,349,16,1075,24,1289,657,214,633,window
4849,12,bed,13,0,349,113,130,368,1808,1289,1678,921,bed
4850,15,window,16,0,349,43,1447,0,2093,663,646,663,window
4851,7,window,8,1,351,19,851,293,1279,434,428,141,window
4852,15,bed,14,0,351,56,2,381,1200,998,1198,617,bed
4853,4,bed,4,1,352,24,2,807,2045,1649,2043,842,bed
4854,7,window,7,0,353,22,490,125,718,346,228,221,window
4855,23,mirror,22,0,353,26,195,172,280,298,85,126,mirror
4856,36,bed,35,0,353,30,254,294,799,532,545,238,bed
4857,10,bed,11,0,354,66,27,309,800,773,773,464,bed
4858,8,bed,8,1,355,29,619,865,2082,1649,1463,784,bed
4859,22,mirror,22,1,356,17,626,262,727,388,101,126,mirror
4860,10,bed,10,0,357,86,2,269,717,768,715,499,bed
4861,13,clock,13,0,357,27,662,73,719,245,57,172,clock
4862,7,bed,8,0,358,76,248,260,1449,1199,1201,939,bed
4863,9,bed,9,0,359,68,60,212,799,713,739,501,bed
4864,14,cup,15,0,360,15,1592,563,1617,651,25,88,cup
4865,18,bed,19,0,360,36,520,386,1498,1000,978,614,bed
4866,3,bed,4,0,361,22,304,300,1024,598,720,298,bed
4867,6,chair,7,1,362,31,1146,565,1356,907,210,342,chair
4868,8,bed,9,1,362,17,0,495,1143,907,1143,412,bed
4869,12,bed,10,0,363,59,175,286,705,599,530,313,bed
4870,3,bed,4,0,364,69,492,434,1134,957,642,523,bed
4871,5,bed,6,1,364,56,2,364,557,1163,555,799,bed
4872,7,chair,8,1,364,22,1525,726,1679,1122,154,396,chair
4873,8,bed,8,0,365,42,227,204,653,503,426,299,bed
4874,17,chair,16,0,365,30,28,248,136,353,108,105,chair
4875,46,window,45,0,365,21,1,73,197,236,196,163,window
4876,20,bed,20,0,366,117,216,626,1684,1461,1468,835,bed
4877,1,bed,2,0,367,65,21,659,1981,1649,1960,990,bed
4878,4,window,5,0,367,16,1221,0,1632,879,411,879,window
4879,7,bed,8,0,368,190,110,148,521,457,411,309,bed
4880,8,toilet,9,0,369,19,213,980,455,1223,242,243,toilet
4881,18,bed,17,1,369,67,1,783,1990,1649,1989,866,bed
4882,9,bed,9,0,370,77,171,566,657,918,486,352,bed
4883,2,bed,3,0,371,123,85,247,667,681,582,434,bed
4884,9,window,9,0,371,18,535,110,793,423,258,313,window
4885,13,bed,14,1,372,55,57,397,1504,999,1447,602,bed
4886,9,bed,10,1,373,53,351,303,1023,684,672,381,bed
4887,6,bed,6,0,374,43,105,233,525,524,420,291,bed
4888,16,chair,15,1,374,27,517,399,799,535,282,136,chair
4889,3,window,4,0,375,16,1634,105,2138,790,504,685,window
4890,6,bed,6,1,375,69,300,663,2063,1425,1763,762,bed
4891,7,window,8,0,376,18,275,262,391,481,116,219,window
4892,10,bed,11,0,376,65,209,331,891,735,682,404,bed
4893,7,bed,7,1,377,31,0,128,390,768,390,640,bed
4894,8,bed,8,1,377,18,256,173,1023,768,767,595,bed
4895,19,bed,18,0,378,47,306,272,542,422,236,150,bed
4896,4,bed,4,1,379,46,165,307,1152,863,987,556,bed
4897,9,bed,10,0,380,112,710,722,2188,1573,1478,851,bed
4898,3,window,4,0,381,22,263,194,546,767,283,573,window
4899,9,chair,10,1,381,15,609,739,661,970,52,231,chair
4900,10,bed,11,1,381,39,127,671,478,1093,351,422,bed
4901,4,bed,5,0,382,38,413,543,1533,1199,1120,656,bed
4902,2,bed,3,0,383,125,5,212,1972,1433,1967,1221,bed
4903,4,window,4,0,384,23,513,321,959,1015,446,694,window
4904,8,chair,8,1,384,79,7,720,636,1449,629,729,chair
4905,9,chair,9,1,384,21,86,1033,415,1461,329,428,chair
4906,4,bed,4,0,385,131,63,150,1019,768,956,618,bed
4907,11,bed,12,0,386,91,311,230,611,433,300,203,bed
4908,13,bed,10,0,387,36,703,722,1388,1270,685,548,bed
4909,11,bed,12,0,388,28,132,283,508,499,376,216,bed
4910,1,window,2,0,389,17,701,2,876,428,175,426,window
4911,3,bed,4,0,389,49,139,83,1034,720,895,637,bed
4912,6,bed,6,0,390,68,13,312,910,768,897,456,bed
4913,3,bed,4,0,391,51,192,311,653,601,461,290,bed
4914,8,window,8,0,391,21,28,89,353,377,325,288,window
4915,7,bed,8,0,392,38,241,442,1316,1023,1075,581,bed
4916,9,bed,10,1,392,31,728,417,1530,1023,802,606,bed
4917,12,plate,13,1,392,20,488,572,634,621,146,49,plate
4918,16,plate,17,0,392,16,748,625,859,659,111,34,plate
4919,19,plate,20,0,392,15,635,636,751,672,116,36,plate
4920,20,plate,21,1,392,17,511,627,641,662,130,35,plate
4921,13,bed,13,0,393,64,117,233,498,472,381,239,bed
4922,3,window,4,0,394,17,1395,356,1715,928,320,572,window
4923,14,chair,14,1,394,40,0,994,571,1464,571,470,chair
4924,15,bed,15,0,394,119,644,700,1618,1435,974,735,bed
4925,11,bed,11,1,395,35,0,910,1649,2198,1649,1288,bed
4926,3,bed,4,0,396,47,259,596,1146,1301,887,705,bed
4927,6,desk,7,0,397,54,0,942,1235,1483,1235,541,desk
4928,21,bed,22,1,397,18,0,1385,1639,1649,1639,264,bed
4929,2,window,3,0,398,18,1,1,604,830,603,829,window
4930,13,bed,14,0,398,46,1191,501,2199,1028,1008,527,bed
4931,23,pot,24,0,398,20,536,661,626,750,90,89,potted plant
4932,25,chair,26,1,398,16,2,803,445,1028,443,225,chair
4933,2,door,3,1,399,21,49,115,114,351,65,236,door
4934,6,window,6,0,399,27,454,0,645,340,191,340,window
4935,10,bed,10,1,399,36,0,281,872,768,872,487,bed
4936,8,bed,9,1,400,26,0,1167,1986,1648,1986,481,bed
4937,6,bed,6,0,401,88,197,264,669,529,472,265,bed
4938,18,window,17,0,401,21,30,39,171,429,141,390,window
4939,11,door,8,1,402,22,390,195,426,401,36,206,door
4940,19,window,16,1,402,17,140,146,210,362,70,216,window
4941,21,chair,18,0,402,66,311,305,405,457,94,152,chair
4942,27,bed,23,0,402,35,461,301,726,441,265,140,bed
4943,40,sofa,34,1,402,16,2,502,344,599,342,97,couch
4944,3,bed,4,0,403,70,3,272,578,670,575,398,bed
4945,4,sofa,5,0,403,37,435,331,1013,768,578,437,couch
4946,2,window,3,1,404,32,1587,12,1962,775,375,763,window
4947,11,bed,10,0,404,51,256,708,2013,1510,1757,802,bed
4948,7,bed,8,0,405,86,218,292,751,685,533,393,bed
4949,8,window,9,0,405,37,305,165,460,320,155,155,window
4950,14,desk,14,1,405,49,864,379,1021,550,157,171,desk
4951,2,mirror,3,0,406,195,1103,3,1943,1626,840,1623,mirror
4952,11,window,12,1,406,16,320,546,405,1159,85,613,window
4953,10,door,11,0,407,27,1483,237,2179,1229,696,992,door
4954,13,desk,14,0,407,55,932,851,1270,1243,338,392,desk
4955,5,window,5,0,408,21,1560,1,2199,967,639,966,window
4956,7,bed,7,0,408,67,20,667,2131,1649,2111,982,bed
4957,9,door,10,1,409,22,210,190,277,514,67,324,door
4958,13,bed,14,0,409,117,239,82,788,680,549,598,bed
4959,14,window,15,1,409,23,540,156,712,251,172,95,window
4960,21,flowerpot,21,0,409,18,922,477,1003,560,81,83,potted plant
4961,11,bed,12,0,410,49,510,480,1503,981,993,501,bed
4962,8,bed,7,0,411,91,194,269,1240,959,1046,690,bed
4963,18,bed,18,0,412,103,335,209,1015,768,680,559,bed
4964,12,bed,11,0,413,94,391,421,1985,1471,1594,1050,bed
4965,4,bed,5,0,414,105,1,716,1734,1648,1733,932,bed
4966,3,window,4,1,415,36,326,269,458,517,132,248,window
4967,8,vase,8,0,415,16,880,512,936,555,56,43,vase
4968,11,bed,10,0,415,117,37,266,902,851,865,585,bed
4969,3,bed,4,0,416,50,194,453,1318,1124,1124,671,bed
4970,7,bed,7,1,417,51,0,270,616,761,616,491,bed
4971,4,table,5,0,418,22,663,564,1554,1439,891,875,dining table
4972,6,window,7,1,419,16,867,214,993,337,126,123,window
4973,11,table,11,1,419,55,687,332,958,482,271,150,dining table
4974,13,chair,12,1,419,27,714,307,791,480,77,173,chair
4975,21,bed,19,0,419,40,273,290,614,454,341,164,bed
4976,2,mirror,3,0,420,15,968,104,1236,469,268,365,mirror
4977,4,chair,5,0,420,51,1322,435,1599,874,277,439,chair
4978,9,bed,10,0,420,65,2,348,1174,1199,1172,851,bed
4979,6,chair,7,1,421,38,1016,527,1387,979,371,452,chair
4980,9,bed,9,1,421,38,2,809,2046,1534,2044,725,bed
4981,5,window,5,0,422,20,379,187,431,337,52,150,window
4982,11,bed,11,0,422,99,2,328,558,599,556,271,bed
4983,5,bed,5,1,423,66,0,498,898,1647,898,1149,bed
4984,6,bed,6,1,423,53,255,539,2200,1648,1945,1109,bed
4985,6,bed,5,0,424,48,4,267,541,570,537,303,bed
4986,2,bed,3,0,425,182,468,498,1519,1426,1051,928,bed
4987,8,window,8,1,425,26,1164,443,1226,779,62,336,window
4988,11,chair,11,1,425,28,1206,709,1518,872,312,163,chair
4989,14,window,14,0,425,16,1934,268,2087,827,153,559,window
4990,14,window,15,1,426,19,830,87,1023,448,193,361,window
4991,16,bed,17,0,426,79,133,299,740,680,607,381,bed
4992,25,mirror,26,0,426,162,546,116,665,244,119,128,mirror
4993,9,bed,9,0,427,177,14,169,477,533,463,364,bed
4994,5,bed,6,1,428,36,1332,1014,2198,1649,866,635,bed
4995,6,bed,7,1,428,53,804,846,1740,1589,936,743,bed
4996,7,bed,8,1,428,59,554,770,1292,1264,738,494,bed
4997,8,bed,9,1,428,41,397,719,965,1081,568,362,bed
4998,4,bed,4,0,429,47,2,128,706,680,704,552,bed
4999,5,bed,5,1,429,34,17,220,1024,768,1007,548,bed
5000,11,bed,11,0,430,117,162,245,695,608,533,363,bed
5001,2,bed,3,0,431,59,35,337,1541,1199,1506,862,bed
5002,2,bed,3,1,432,51,2,389,508,767,506,378,bed
5003,7,bed,7,0,433,105,9,204,2001,1648,1992,1444,bed
5004,2,bed,3,1,434,17,534,243,818,737,284,494,bed
5005,3,bed,4,1,435,28,510,335,867,689,357,354,bed
5006,7,window,7,0,435,16,222,111,516,370,294,259,window
5007,10,bed,10,1,435,27,68,371,570,872,502,501,bed
5008,3,bed,4,0,436,70,2,199,657,774,655,575,bed
5009,14,chair,14,1,436,31,0,718,203,1065,203,347,chair
5010,9,table,10,1,437,21,575,358,680,449,105,91,dining table
5011,11,chair,12,0,437,31,630,367,708,465,78,98,chair
5012,13,bed,14,0,437,67,250,260,548,476,298,216,bed
5013,12,window,12,0,438,15,242,277,464,471,222,194,window
5014,15,door,15,1,438,88,564,250,898,568,334,318,door
5015,20,bed,19,1,438,28,2,364,332,626,330,262,bed
5016,32,table,31,1,438,25,118,574,1023,682,905,108,dining table
5017,4,bed,4,0,439,63,238,714,1284,1412,1046,698,bed
5018,4,bed,5,0,440,58,997,658,1826,1340,829,682,bed
5019,5,bed,6,0,440,57,513,651,1371,1215,858,564,bed
5020,11,bed,12,0,441,44,231,314,915,644,684,330,bed
5021,11,mirror,12,0,442,39,226,211,647,698,421,487,mirror
5022,15,bed,16,1,442,32,2,745,1631,1223,1629,478,bed
5023,19,door,20,0,442,27,984,195,1415,975,431,780,door
5024,5,pot,6,0,443,16,1914,617,2022,688,108,71,potted plant
5025,8,bed,8,0,443,39,240,453,1729,1324,1489,871,bed
5026,6,bed,6,0,444,86,403,454,2198,1649,1795,1195,bed
5027,14,pot,13,0,445,16,204,260,245,306,41,46,potted plant
5028,16,bed,15,0,445,22,198,312,668,597,470,285,bed
5029,6,vase,7,0,446,15,400,379,432,443,32,64,vase
5030,18,bed,17,0,446,48,27,280,845,767,818,487,bed
5031,7,bed,8,0,447,57,268,620,1214,1069,946,449,bed
5032,11,door,12,1,447,16,1471,0,1599,1199,128,1199,door
5033,4,window,5,0,448,24,239,176,340,231,101,55,window
5034,5,window,6,0,448,18,425,175,482,239,57,64,window
5035,8,window,9,0,448,15,97,156,133,257,36,101,window
5036,10,chair,11,0,448,26,234,231,280,285,46,54,chair
5037,11,chair,12,0,448,24,317,230,353,279,36,49,chair
5038,13,flowerpot,14,0,448,19,181,254,201,288,20,34,potted plant
5039,20,bed,21,1,448,35,0,191,417,426,417,235,bed
5040,3,bed,4,0,449,38,124,817,1741,1540,1617,723,bed
5041,1,bed,2,0,450,38,26,202,409,473,383,271,bed
5042,8,bed,6,0,451,47,152,310,697,718,545,408,bed
5043,13,bed,14,1,452,55,0,298,387,541,387,243,bed
5044,18,window,19,0,452,20,2,35,225,319,223,284,window
5045,20,pot,21,0,452,23,19,399,71,473,52,74,potted plant
5046,4,mirror,5,1,453,15,170,255,271,389,101,134,mirror
5047,6,mirror,6,1,453,16,507,280,562,375,55,95,mirror
5048,8,bed,7,0,453,164,290,122,675,586,385,464,bed
5049,4,window,5,0,454,17,695,191,842,494,147,303,window
5050,18,bed,16,0,454,39,228,368,531,580,303,212,bed
5051,6,mirror,7,0,455,77,1491,65,1873,535,382,470,mirror
5052,9,mirror,10,0,455,60,653,180,874,528,221,348,mirror
5053,14,desk,15,0,455,38,15,601,396,854,381,253,desk
5054,15,chair,16,0,455,67,262,566,468,877,206,311,chair
5055,18,sofa,19,0,455,69,847,590,1323,937,476,347,couch
5056,19,bed,20,1,455,22,2,832,1087,1311,1085,479,bed
5057,4,bed,5,0,456,103,281,140,857,659,576,519,bed
5058,9,table,10,0,456,46,0,356,316,768,316,412,dining table
5059,11,balls,12,0,456,33,2,379,136,463,134,84,sports ball
5060,4,window,5,0,457,26,432,22,548,224,116,202,window
5061,6,bed,7,0,457,127,99,137,527,425,428,288,bed
5062,1,bed,2,0,458,59,257,297,674,666,417,369,bed
5063,13,chair,12,0,458,43,0,309,155,553,155,244,chair
5064,7,bed,8,0,459,78,128,342,934,855,806,513,bed
5065,15,chair,16,1,459,16,92,774,378,855,286,81,chair
5066,4,bed,5,0,460,44,361,302,700,524,339,222,bed
5067,16,chair,14,1,461,27,1027,571,1306,813,279,242,chair
5068,19,chair,17,0,461,43,1575,665,1948,1006,373,341,chair
5069,22,bed,19,1,461,62,3,691,1930,1471,1927,780,bed
5070,4,chair,5,1,462,25,495,193,571,280,76,87,chair
5071,16,bed,16,0,462,95,173,183,681,590,508,407,bed
5072,18,window,18,1,462,18,2,90,126,180,124,90,window
5073,1,bed,2,1,463,55,2,155,1022,768,1020,613,bed
5074,6,bed,7,0,464,59,471,156,883,499,412,343,bed
5075,10,window,9,0,464,22,2,1,400,487,398,486,window
5076,12,bed,11,0,464,30,799,466,1504,998,705,532,bed
5077,8,bed,9,1,465,57,0,219,1248,1023,1248,804,bed
5078,3,bed,4,1,466,30,177,971,2200,1649,2023,678,bed
5079,4,bed,5,1,466,34,1128,762,2197,1415,1069,653,bed
5080,12,bed,13,0,467,117,199,172,607,464,408,292,bed
5081,20,bed,19,0,468,63,191,270,990,768,799,498,bed
5082,10,window,9,0,469,36,206,198,429,398,223,200,window
5083,20,chair,19,1,469,49,249,351,334,470,85,119,chair
5084,22,chair,21,0,469,48,139,391,294,557,155,166,chair
5085,26,bed,23,0,469,101,461,292,791,537,330,245,bed
5086,6,chair,7,1,470,16,1102,818,1278,959,176,141,chair
5087,10,window,10,0,470,18,428,225,632,500,204,275,window
5088,43,bed,42,1,470,42,32,499,667,959,635,460,bed
5089,5,bed,4,1,471,32,0,200,1180,781,1180,581,bed
5090,3,bed,4,1,472,73,485,84,890,596,405,512,bed
5091,4,sofa,5,0,472,32,419,407,719,644,300,237,couch
5092,9,window,9,0,472,21,255,215,445,455,190,240,window
5093,3,mirror,4,0,473,34,212,237,314,551,102,314,mirror
5094,4,bed,5,1,473,70,0,355,769,682,769,327,bed
5095,5,bed,6,0,474,74,267,248,652,479,385,231,bed
5096,6,flowerpot,7,0,474,15,133,320,169,356,36,36,potted plant
5097,7,window,8,0,475,60,46,189,260,434,214,245,window
5098,18,bed,18,0,475,47,271,283,920,684,649,401,bed
5099,11,window,12,1,476,44,376,316,450,438,74,122,window
5100,13,door,14,1,476,33,493,302,665,501,172,199,door
5101,17,bed,18,0,476,78,134,124,635,761,501,637,bed
5102,19,sofa,20,0,476,44,480,465,784,773,304,308,couch
5103,22,window,23,0,476,64,0,267,118,476,118,209,window
5104,3,window,4,0,477,15,1449,0,2125,844,676,844,window
5105,9,bed,9,1,477,32,1,785,1465,1649,1464,864,bed
5106,10,bed,10,1,477,16,1041,878,2197,1649,1156,771,bed
5107,8,window,7,0,478,33,341,177,452,319,111,142,window
5108,9,door,8,0,478,29,0,129,276,418,276,289,door
5109,11,bed,10,0,478,37,290,270,730,452,440,182,bed
5110,4,bed,5,0,479,97,86,279,661,728,575,449,bed
5111,19,chair,18,1,479,22,620,607,789,764,169,157,chair
5112,23,table,22,1,479,21,34,785,788,999,754,214,dining table
5113,33,shoe,31,0,479,17,386,728,457,780,71,52,shoe
5114,9,bed,8,0,480,72,103,135,644,534,541,399,bed
5115,7,bed,8,0,481,41,31,174,600,450,569,276,bed
5116,12,bed,11,0,482,64,328,338,1803,1452,1475,1114,bed
5117,7,bed,7,1,483,31,7,631,1719,1534,1712,903,bed
5118,8,bed,8,0,483,31,990,616,2046,1534,1056,918,bed
5119,13,bed,12,0,484,21,95,467,767,1024,672,557,bed
5120,3,bed,4,0,485,80,85,478,1557,1439,1472,961,bed
5121,4,bowl,5,0,485,22,1577,560,1713,678,136,118,bowl
5122,8,bed,8,1,485,26,885,628,2161,1439,1276,811,bed
5123,5,bed,5,1,486,41,2,338,856,768,854,430,bed
5124,16,bed,16,0,487,91,160,349,707,657,547,308,bed
5125,2,bed,3,0,488,61,227,243,975,768,748,525,bed
5126,6,door,7,1,488,26,59,2,334,691,275,689,door
5127,44,bed,40,0,489,39,346,372,803,708,457,336,bed
5128,7,bed,8,0,490,32,360,355,743,609,383,254,bed
5129,10,bed,11,0,491,45,108,89,548,300,440,211,bed
5130,3,bed,4,1,492,30,0,538,430,863,430,325,bed
5131,4,bed,5,1,492,61,406,494,1151,863,745,369,bed
5132,3,window,4,0,493,36,223,144,592,347,369,203,window
5133,10,bed,10,1,493,35,567,349,899,715,332,366,bed
5134,11,bed,11,1,493,28,0,378,589,872,589,494,bed
5135,3,pot,4,0,494,15,965,383,1019,434,54,51,potted plant
5136,7,bed,8,0,494,92,298,285,849,683,551,398,bed
5137,36,window,35,0,494,22,231,239,327,432,96,193,window
5138,7,bed,7,1,496,160,868,522,1881,1351,1013,829,bed
5139,20,window,19,0,496,86,1782,56,2199,745,417,689,window
5140,21,hat,20,0,496,19,840,501,917,639,77,138,hat
5141,4,window,5,0,497,18,443,152,497,294,54,142,window
5142,8,bed,8,0,497,89,351,213,726,498,375,285,bed
5143,23,hat,23,0,497,16,215,321,271,347,56,26,hat
5144,8,bed,7,0,498,33,213,168,646,537,433,369,bed
5145,9,flowerpot,9,0,499,16,541,505,639,575,98,70,potted plant
5146,11,door,11,0,499,21,0,102,273,863,273,761,door
5147,15,bed,15,1,499,37,276,374,1150,863,874,489,bed
5148,2,window,3,1,500,18,0,65,167,266,167,201,window
5149,8,bed,9,0,500,92,253,207,573,406,320,199,bed
5150,50,television,51,0,500,15,435,178,466,209,31,31,tv
5151,4,window,5,0,501,55,392,146,707,657,315,511,window
5152,6,window,7,0,501,75,1012,204,1278,759,266,555,window
5153,7,bed,8,1,501,68,352,516,1096,959,744,443,bed
5154,11,door,12,0,502,22,0,0,148,863,148,863,door
5155,12,bed,13,1,502,91,103,374,1149,864,1046,490,bed
5156,13,door,14,0,502,16,218,74,479,636,261,562,door
5157,4,pot,5,1,503,16,187,70,239,120,52,50,potted plant
5158,9,window,10,1,503,37,741,196,826,369,85,173,window
5159,15,bed,15,0,503,28,343,288,863,623,520,335,bed
5160,10,window,9,1,504,33,716,374,906,700,190,326,window
5161,19,bed,18,1,504,31,0,589,916,962,916,373,bed
5162,20,chair,19,0,504,27,487,576,596,742,109,166,chair
5163,11,window,10,0,505,27,69,71,216,330,147,259,window
5164,12,chair,11,0,505,81,95,277,201,476,106,199,chair
5165,14,bed,13,0,505,75,327,254,732,533,405,279,bed
5166,9,window,9,0,506,19,878,478,1142,657,264,179,window
5167,12,pot,12,0,506,18,410,655,502,728,92,73,potted plant
5168,7,sofa,7,1,507,42,1002,374,1349,617,347,243,couch
5169,16,window,14,0,507,24,163,250,454,524,291,274,window
5170,27,bed,25,1,507,54,474,538,1304,840,830,302,bed
5171,5,window,6,0,508,20,607,123,852,415,245,292,window
5172,7,window,8,0,508,16,200,166,373,366,173,200,window
5173,12,bed,12,1,508,34,277,358,934,623,657,265,bed
5174,9,bed,10,1,509,30,42,206,494,393,452,187,bed
5175,3,bed,4,0,510,39,564,169,743,308,179,139,bed
5176,6,bed,6,0,510,50,663,195,862,364,199,169,bed
5177,7,desk,7,0,510,24,840,266,997,385,157,119,desk
5178,8,chair,8,0,510,31,850,281,924,379,74,98,chair
5179,9,bed,9,0,510,45,156,214,487,511,331,297,bed
5180,16,window,16,0,510,44,145,113,493,307,348,194,window
5181,25,sofa,23,1,510,15,52,496,459,768,407,272,couch
5182,26,sofa,24,0,510,55,465,361,930,768,465,407,couch
5183,27,dog,25,0,510,57,678,426,883,639,205,213,dog
5184,11,window,12,1,511,18,716,305,783,571,67,266,window
5185,17,bed,17,0,511,54,2,417,605,925,603,508,bed
5186,28,window,28,1,511,20,505,282,618,476,113,194,window
5187,17,coffee pot,17,0,512,19,433,396,475,459,42,63,potted plant
5188,19,bed,19,0,512,61,164,288,859,683,695,395,bed
5189,26,sink,25,0,512,18,0,345,112,510,112,165,sink
5190,5,bed,6,0,513,81,0,189,721,673,721,484,bed
5191,2,window,3,1,514,24,325,169,573,999,248,830,window
5192,3,window,4,0,514,15,609,176,885,918,276,742,window
5193,8,chair,9,0,514,37,397,682,965,1123,568,441,chair
5194,9,chair,10,0,514,29,891,673,1168,1041,277,368,chair
5195,22,mirror,23,0,514,69,1394,307,1703,698,309,391,mirror
5196,25,bed,26,1,514,42,1153,725,2199,1467,1046,742,bed
5197,3,bed,3,1,515,44,467,554,2201,1644,1734,1090,bed
5198,7,window,7,0,515,20,2,0,688,745,686,745,window
5199,10,mirror,9,0,516,47,0,541,161,951,161,410,mirror
5200,13,bed,12,1,516,39,1073,688,2200,1403,1127,715,bed
5201,8,chair,6,1,517,25,876,329,1023,631,147,302,chair
5202,10,bed,8,0,517,64,278,319,807,683,529,364,bed
5203,7,bed,6,0,518,65,389,284,1268,1021,879,737,bed
5204,5,bed,6,0,519,134,183,306,2195,1648,2012,1342,bed
5205,4,window,5,0,520,17,338,153,376,339,38,186,window
5206,5,window,6,0,520,15,688,75,798,400,110,325,window
5207,6,bed,7,0,520,42,221,288,613,534,392,246,bed
5208,24,chair,23,1,520,27,82,314,160,461,78,147,chair
5209,3,bed,4,1,521,36,2,434,725,801,723,367,bed
5210,4,bed,5,1,521,21,611,442,1200,803,589,361,bed
5211,12,window,12,0,521,24,613,256,1081,470,468,214,window
5212,6,bed,7,1,522,39,175,90,325,221,150,131,bed
5213,7,sofa,8,0,522,30,23,117,120,196,97,79,couch
5214,12,chair,13,1,522,18,195,170,257,244,62,74,chair
5215,9,bed,9,1,523,52,0,563,1680,1447,1680,884,bed
5216,10,bed,10,1,523,30,1043,470,1805,1269,762,799,bed
5217,5,window,5,1,524,18,739,236,901,504,162,268,window
5218,16,bed,14,0,524,48,158,435,787,856,629,421,bed
5219,7,bed,6,1,525,42,669,423,1032,842,363,419,bed
5220,8,bed,7,1,525,15,76,475,683,959,607,484,bed
5221,12,window,11,0,525,23,352,157,672,448,320,291,window
5222,4,bed,5,0,526,35,43,134,586,617,543,483,bed
5223,4,bed,5,0,527,124,341,447,1130,1138,789,691,bed
5224,14,window,15,0,527,24,0,239,404,961,404,722,window
5225,0,bed,1,1,528,39,2,234,514,679,512,445,bed
5226,3,sofa,4,0,528,20,207,197,460,350,253,153,couch
5227,12,television,13,0,528,15,851,197,971,495,120,298,tv
5228,13,bed,14,0,529,50,177,222,615,464,438,242,bed
5229,7,chair,8,0,530,87,197,703,491,1067,294,364,chair
5230,8,table,9,0,530,58,2,669,344,1066,342,397,dining table
5231,9,mirror,10,0,530,185,2,105,185,654,183,549,mirror
5232,3,bed,4,0,531,43,4,80,173,253,169,173,bed
5233,6,clock,7,0,531,15,198,95,210,134,12,39,clock
5234,3,television,4,0,532,25,1780,606,2061,857,281,251,tv
5235,11,sofa,12,0,532,34,213,899,921,1395,708,496,couch
5236,9,bed,9,0,533,91,584,445,1925,1498,1341,1053,bed
5237,9,bed,10,1,534,16,640,262,1022,768,382,506,bed
5238,14,bed,14,0,534,46,2,235,465,656,463,421,bed
5239,5,bed,5,1,535,35,2,921,1919,1647,1917,726,bed
5240,4,bed,5,1,536,47,370,256,765,450,395,194,bed
5241,5,bed,6,1,536,64,426,296,863,652,437,356,bed
5242,46,bed,47,0,537,61,286,362,624,560,338,198,bed
5243,61,door,62,0,537,41,1,218,101,546,100,328,door
5244,6,bed,6,0,538,43,123,257,876,766,753,509,bed
5245,10,window,10,1,538,32,879,94,1024,487,145,393,window
5246,9,bed,8,0,539,69,218,674,1773,1639,1555,965,bed
5247,7,window,7,1,540,16,811,148,850,462,39,314,window
5248,11,window,11,1,540,25,631,204,680,395,49,191,window
5249,14,window,14,1,540,42,265,220,320,390,55,170,window
5250,21,bed,20,0,540,150,82,61,635,681,553,620,bed
5251,27,clock,26,0,540,15,677,357,713,403,36,46,clock
5252,8,bed,8,0,541,62,81,392,1012,959,931,567,bed
5253,2,window,3,0,542,18,315,1,834,426,519,425,window
5254,3,bed,4,0,542,46,2,351,908,885,906,534,bed
5255,2,window,3,0,543,17,1302,136,1520,522,218,386,window
5256,4,chair,5,1,543,21,1159,443,1281,707,122,264,chair
5257,8,bed,8,0,543,32,742,452,1120,749,378,297,bed
5258,24,desk,24,0,543,25,0,621,570,1004,570,383,desk
5259,7,bed,8,0,544,53,294,414,964,756,670,342,bed
5260,13,bed,12,0,545,58,87,397,548,627,461,230,bed
5261,7,bed,7,1,546,35,623,482,1280,957,657,475,bed
5262,8,bed,8,1,546,34,74,548,846,959,772,411,bed
5263,8,bed,9,1,547,27,0,37,278,245,278,208,bed
5264,8,bed,9,0,548,68,520,715,2019,1428,1499,713,bed
5265,15,mirror,16,0,548,38,391,233,698,696,307,463,mirror
5266,4,bed,5,1,549,64,7,283,792,953,785,670,bed
5267,7,bed,8,0,550,59,368,930,2188,1648,1820,718,bed
5268,10,glasses,10,0,550,20,304,1448,461,1542,157,94,eye glasses
5269,8,bed,9,1,551,38,270,454,1598,1199,1328,745,bed
5270,17,chair,17,1,552,38,574,298,672,458,98,160,chair
5271,20,window,20,1,552,30,0,175,223,386,223,211,window
5272,23,bed,22,1,552,42,2,406,938,766,936,360,bed
5273,0,bed,1,0,3203,29,390,618,2061,1653,1671,1035,bed
5274,5,bed,6,0,3204,20,570,800,1665,1330,1095,530,bed
5275,8,bed,9,0,3205,53,579,502,2197,1650,1618,1148,bed
5276,16,flowerpot,17,1,3206,15,1882,877,2002,1060,120,183,potted plant
5277,7,bed,8,0,3207,30,247,664,1953,1656,1706,992,bed
5278,10,bed,11,0,3208,26,3,573,1535,1647,1532,1074,bed
5279,0,bed,1,0,3209,34,487,479,1805,1524,1318,1045,bed
5280,3,bed,3,1,3210,21,991,1397,1648,2200,657,803,bed
5281,7,sofa,7,1,3210,15,416,1120,677,1467,261,347,couch
5282,25,chair,23,1,3211,43,873,671,1119,995,246,324,chair
5283,1,bed,2,0,3212,27,2,708,2049,1536,2047,828,bed
5284,12,bed,13,0,3213,59,669,441,2200,1650,1531,1209,bed
5285,0,bed,1,0,3214,23,42,302,1480,1536,1438,1234,bed
5286,19,bed,18,0,3215,47,121,645,2122,1647,2001,1002,bed
5287,21,plate,20,0,3215,18,1059,782,1150,812,91,30,plate
5288,24,window,23,0,3215,23,539,144,1049,958,510,814,window
5289,8,bed,9,0,3216,33,451,685,1873,1513,1422,828,bed
5290,18,window,16,1,3216,18,336,2,479,923,143,921,window
5291,0,bed,1,0,3217,35,588,691,1886,1588,1298,897,bed
5292,18,bed,14,0,3218,57,213,738,1581,1507,1368,769,bed
5293,13,table,13,0,3219,43,1585,682,1983,1285,398,603,dining table
5294,21,bed,21,0,3219,97,152,437,1765,1534,1613,1097,bed
5295,0,bed,1,0,3220,35,7,481,1581,1650,1574,1169,bed
5296,5,bed,6,0,3221,28,830,804,2015,1647,1185,843,bed
5297,6,bed,7,0,3222,51,62,119,345,318,283,199,bed
5298,10,bed,11,0,3223,19,63,105,186,171,123,66,bed
5299,19,chair,20,1,3223,15,206,120,273,155,67,35,chair
5300,20,chair,21,0,3223,32,182,130,303,243,121,113,chair
5301,8,bed,9,0,3224,39,232,205,799,598,567,393,bed
5302,11,chair,12,1,3224,17,2,503,268,595,266,92,chair
5303,3,chair,4,1,3225,16,128,185,172,246,44,61,chair
5304,4,television,5,0,3225,16,151,134,255,239,104,105,tv
5305,5,table,6,0,3225,16,10,177,105,255,95,78,dining table
5306,5,chair,4,0,3226,15,885,1275,1360,2011,475,736,chair
5307,11,bed,12,1,3227,28,57,111,350,232,293,121,bed
5308,2,bed,3,0,3228,30,0,474,667,933,667,459,bed
5309,5,bed,5,1,3230,72,2,459,1534,2046,1532,1587,bed
5310,14,chair,15,1,3231,18,1004,603,1428,890,424,287,chair
5311,14,chair,15,1,3232,28,207,131,285,215,78,84,chair
5312,15,chair,16,0,3232,35,131,128,205,215,74,87,chair
5313,7,desk,8,0,3233,16,76,127,270,202,194,75,desk
5314,9,television,10,0,3233,15,270,96,341,164,71,68,tv
5315,42,sofa,39,0,3234,40,339,494,1173,900,834,406,couch
5316,67,bed,63,1,3234,31,672,335,1199,624,527,289,bed
5317,5,bed,6,0,3235,92,556,705,2186,1647,1630,942,bed
5318,3,bed,4,1,3236,73,340,572,1678,1533,1338,961,bed
5319,2,bed,3,1,3237,52,2,646,687,1230,685,584,bed
5320,3,bed,4,1,3237,32,1156,596,1631,1230,475,634,bed
5321,4,table,5,0,3237,17,763,694,1112,1049,349,355,dining table
5322,8,bed,7,0,3238,85,130,307,910,766,780,459,bed
5323,3,window,4,0,3239,17,317,351,1091,829,774,478,window
5324,15,bed,14,0,3239,55,317,763,1530,1472,1213,709,bed
5325,4,bed,5,0,3240,69,185,271,843,632,658,361,bed
5326,11,bed,10,0,3241,78,82,237,655,767,573,530,bed
5327,7,mirror,8,0,3242,35,519,619,888,1210,369,591,mirror
5328,8,bed,9,0,3242,80,367,965,1519,1918,1152,953,bed
5329,6,bed,7,0,3243,64,334,423,960,850,626,427,bed
5330,0,bed,1,0,3244,21,0,133,175,230,175,97,bed
5331,2,plate,3,0,3245,16,786,357,850,419,64,62,plate
5332,6,window,6,0,3245,15,645,23,783,406,138,383,window
5333,7,bed,7,0,3245,79,330,233,1023,766,693,533,bed
5334,2,bed,3,0,3246,57,4,81,256,256,252,175,bed
5335,5,mirror,6,0,3246,59,12,30,97,142,85,112,mirror
5336,4,window,5,0,3247,19,1155,559,1412,1152,257,593,window
5337,11,pot,12,0,3247,17,730,1125,775,1188,45,63,potted plant
5338,12,bed,11,1,3248,77,449,549,2198,1648,1749,1099,bed
5339,4,bed,5,1,3249,19,79,95,255,255,176,160,bed
5340,8,bed,9,0,3250,52,36,44,295,248,259,204,bed
5341,7,bed,8,0,3252,26,313,332,995,899,682,567,bed
5342,8,cat,9,0,3252,37,614,485,731,639,117,154,cat
5343,1,window,2,0,3254,19,0,73,594,614,594,541,window
5344,6,bed,7,0,3254,43,319,388,1023,799,704,411,bed
5345,7,bed,8,0,3255,18,0,134,209,290,209,156,bed
5346,5,bed,6,0,3256,71,28,79,277,209,249,130,bed
5347,9,bed,10,0,3257,32,3,143,229,255,226,112,bed
5348,8,bed,8,1,3258,20,0,554,1557,1405,1557,851,bed
5349,9,bed,9,0,3258,49,949,513,2197,1405,1248,892,bed
5350,2,bed,3,1,3259,46,96,547,1149,1199,1053,652,bed
5351,4,bed,5,1,3259,42,969,522,1599,1198,630,676,bed
5352,10,bed,11,1,3260,44,464,512,1599,1199,1135,687,bed
5353,4,bed,5,0,3261,19,0,123,233,227,233,104,bed
5354,10,hat,11,0,3262,16,187,91,213,109,26,18,hat
5355,12,table,13,0,3262,17,155,158,219,206,64,48,dining table
5356,13,chair,14,0,3262,23,127,143,157,198,30,55,chair
5357,15,bed,16,1,3262,20,194,177,256,256,62,79,bed
5358,22,hat,23,0,3262,19,70,173,102,202,32,29,hat
5359,4,bed,5,0,3263,66,0,111,176,253,176,142,bed
5360,7,bed,8,0,3264,54,19,128,192,240,173,112,bed
5361,16,bed,17,0,3266,66,402,267,799,553,397,286,bed
5362,13,bed,14,0,3267,20,77,262,557,532,480,270,bed
5363,7,bed,8,0,3269,50,0,127,162,224,162,97,bed
5364,7,bed,8,0,3270,38,0,85,177,187,177,102,bed
5365,10,sofa,11,0,3270,34,32,118,154,209,122,91,couch
5366,9,bed,10,0,3271,67,72,84,242,225,170,141,bed
5367,12,chair,13,1,3271,18,0,158,100,225,100,67,chair
5368,2,bed,3,0,3272,20,0,107,220,243,220,136,bed
5369,5,window,6,0,3272,20,157,35,294,160,137,125,window
5370,10,bed,11,1,3274,23,2,139,238,334,236,195,bed
5371,20,chair,21,1,3274,19,291,177,340,292,49,115,chair
5372,3,mirror,4,0,3275,30,10,27,87,129,77,102,mirror
5373,9,bed,10,0,3275,42,129,69,246,168,117,99,bed
5374,4,bed,4,0,3276,60,174,62,757,619,583,557,bed
5375,3,flowerpot,4,0,3277,16,997,460,1122,562,125,102,potted plant
5376,10,bed,11,0,3277,51,2,702,969,1196,967,494,bed
5377,12,bed,13,0,3278,50,0,50,255,255,255,205,bed
5378,3,bed,3,1,3279,55,603,34,2194,1760,1591,1726,bed
5379,11,bed,10,0,3280,84,330,298,728,691,398,393,bed
5380,12,sofa,11,0,3280,26,443,450,863,691,420,241,couch
5381,10,bed,11,0,3281,83,301,289,869,666,568,377,bed
5382,1,sofa,2,1,3282,23,265,158,510,343,245,185,couch
5383,7,bed,8,1,3282,18,109,103,164,276,55,173,bed
5384,9,bed,9,0,3283,85,184,602,1496,1532,1312,930,bed
5385,5,bed,6,0,3284,55,56,94,255,249,199,155,bed
5386,1,bed,2,0,3285,21,19,83,192,189,173,106,bed
5387,2,bed,3,1,3285,16,99,101,255,255,156,154,bed
5388,5,window,5,0,3286,21,1346,0,2005,949,659,949,window
5389,14,bed,13,0,3286,71,48,727,1835,1647,1787,920,bed
5390,8,bed,9,0,3287,18,213,360,568,556,355,196,bed
5391,3,bicycle,4,0,3288,108,1253,310,1579,749,326,439,bicycle
5392,4,bed,5,0,3288,115,31,231,1295,1171,1264,940,bed
5393,10,window,11,0,3288,18,735,0,908,365,173,365,window
5394,15,bed,15,0,3289,48,752,728,2139,1532,1387,804,bed
5395,31,desk,29,1,3289,21,10,1071,450,1649,440,578,desk
5396,36,door,34,1,3289,15,1,1007,175,1649,174,642,door
5397,5,bed,6,0,3290,62,0,87,115,202,115,115,bed
5398,2,door,3,0,3291,15,45,60,91,386,46,326,door
5399,13,bed,14,0,3291,96,185,189,590,434,405,245,bed
5400,16,bed,17,0,3291,68,230,190,728,491,498,301,bed
5401,27,chair,28,1,3291,34,41,295,105,400,64,105,chair
5402,28,chair,29,1,3291,37,0,392,196,491,196,99,chair
5403,6,mirror,7,0,3292,19,255,68,291,117,36,49,mirror
5404,12,bed,13,1,3292,28,0,97,168,225,168,128,bed
5405,3,television,4,0,3293,15,20,33,95,120,75,87,tv
5406,9,chair,10,0,3293,29,112,84,180,173,68,89,chair
5407,2,bed,3,0,3294,76,4,522,1134,1428,1130,906,bed
5408,3,bed,4,0,3294,90,1180,541,2199,1645,1019,1104,bed
5409,10,bed,11,0,3295,51,108,309,674,666,566,357,bed
5410,1,bed,2,0,3296,41,27,135,361,284,334,149,bed
5411,7,vase,8,1,3296,21,129,93,188,149,59,56,vase
5412,8,vase,9,1,3296,16,196,105,244,137,48,32,vase
5413,3,desk,4,0,3297,15,43,133,174,220,131,87,desk
5414,5,chair,6,0,3297,28,93,141,141,223,48,82,chair
5415,11,chair,12,0,3298,27,12,151,61,196,49,45,chair
5416,7,mirror,8,0,3299,29,707,229,950,344,243,115,mirror
5417,9,bed,9,0,3299,47,400,352,988,791,588,439,bed
5418,12,bed,13,1,3300,27,626,432,1023,767,397,335,bed
5419,3,bed,4,0,3301,29,69,42,300,224,231,182,bed
5420,8,bed,8,1,3302,96,197,855,1860,1649,1663,794,bed
5421,13,bed,14,0,3303,23,51,103,185,182,134,79,bed
5422,3,mirror,4,0,3305,21,1322,154,1998,804,676,650,mirror
5423,6,vase,7,0,3305,50,1416,492,1769,778,353,286,vase
5424,8,bed,9,1,3305,32,0,653,1998,1607,1998,954,bed
5425,9,bed,10,0,3306,37,867,892,2197,1733,1330,841,bed
5426,18,vase,19,0,3306,22,1992,660,2067,818,75,158,vase
5427,20,sofa,21,0,3306,33,2,892,782,1424,780,532,couch
5428,10,mirror,9,0,3307,20,249,14,283,152,34,138,mirror
5429,8,bed,9,1,3308,19,91,162,244,201,153,39,bed
5430,9,bed,10,0,3308,23,11,169,292,262,281,93,bed
5431,17,chair,18,1,3308,22,48,153,88,197,40,44,chair
5432,18,table,19,0,3308,28,7,168,67,236,60,68,dining table
5433,7,bed,7,0,3309,114,115,229,455,456,340,227,bed
5434,1,bed,2,0,3310,41,11,80,233,254,222,174,bed
5435,2,bed,3,0,3311,22,0,87,224,229,224,142,bed
5436,4,bench,5,0,3311,23,0,167,125,244,125,77,bench
5437,3,bed,4,0,3312,28,125,540,837,780,712,240,bed
5438,4,bed,4,1,3313,42,208,219,1199,901,991,682,bed
5439,6,bed,7,0,3314,47,352,339,894,800,542,461,bed
5440,0,bed,1,1,3315,17,215,62,285,168,70,106,bed
5441,12,chair,13,1,3315,42,271,227,425,341,154,114,chair
5442,3,bed,4,0,3316,19,0,103,993,767,993,664,bed
5443,8,bed,7,0,3317,73,138,220,1023,766,885,546,bed
5444,1,bed,2,0,3318,19,68,35,260,187,192,152,bed
5445,2,bed,3,1,3319,53,89,167,309,511,220,344,bed
5446,8,bed,8,0,3320,42,275,394,1279,959,1004,565,bed
5447,16,television,16,0,3320,15,2,567,109,926,107,359,tv
5448,13,bed,14,0,3321,33,0,512,703,973,703,461,bed
5449,7,bed,8,0,3322,37,39,52,295,225,256,173,bed
5450,4,bed,5,1,3323,26,1199,641,1914,1374,715,733,bed
5451,8,bed,9,0,3323,32,204,685,1219,1643,1015,958,bed
5452,11,window,11,0,3323,19,679,256,1220,665,541,409,window
5453,5,bed,6,1,3324,27,98,1198,2162,1646,2064,448,bed
5454,5,bed,6,0,3325,45,88,124,237,209,149,85,bed
5455,6,bed,7,1,3325,28,0,131,196,255,196,124,bed
5456,1,bed,2,1,3326,36,46,40,255,255,209,215,bed
5457,3,bed,4,0,3327,25,38,79,200,202,162,123,bed
5458,20,bed,20,0,3328,21,2,312,886,767,884,455,bed
5459,26,mirror,26,0,3328,16,125,166,190,235,65,69,mirror
5460,28,mirror,28,0,3328,15,227,43,287,105,60,62,mirror
5461,10,bed,9,0,3329,32,2,140,760,767,758,627,bed
5462,3,desk,4,0,3330,19,192,127,299,206,107,79,desk
5463,8,window,9,0,3330,15,149,0,235,121,86,121,window
5464,12,chair,13,0,3330,34,211,137,281,225,70,88,chair
5465,13,bed,14,1,3330,27,0,105,168,225,168,120,bed
5466,7,bed,7,1,3331,76,217,421,1279,959,1062,538,bed
5467,4,bed,5,0,3332,85,101,111,497,395,396,284,bed
5468,4,bed,5,0,3333,53,73,696,1199,1482,1126,786,bed
5469,10,bed,9,0,3334,106,420,466,1898,1534,1478,1068,bed
5470,8,bed,9,0,3335,35,28,324,398,600,370,276,bed
5471,9,bed,10,0,3335,22,20,326,352,453,332,127,bed
5472,5,chair,6,1,3337,16,294,118,355,153,61,35,chair
5473,12,bed,13,0,3337,27,107,83,242,194,135,111,bed
5474,3,bed,4,0,3338,35,124,111,508,365,384,254,bed
5475,2,bed,3,1,3339,67,948,452,1511,1168,563,716,bed
5476,6,window,7,0,3339,22,706,40,1091,596,385,556,window
5477,5,mirror,4,0,3340,35,505,182,644,335,139,153,mirror
5478,11,bed,10,0,3340,46,2,335,504,532,502,197,bed
5479,2,bed,3,0,3341,24,0,238,277,455,277,217,bed
5480,3,bed,4,0,3341,19,345,271,599,455,254,184,bed
5481,6,bed,7,0,3342,51,446,984,1654,1647,1208,663,bed
5482,9,bed,10,1,3342,22,0,1068,1086,1649,1086,581,bed
5483,16,table,17,0,3343,15,156,158,219,207,63,49,dining table
5484,17,chair,18,0,3343,22,128,144,157,197,29,53,chair
5485,19,bed,20,1,3343,21,196,179,256,255,60,76,bed
5486,1,bed,2,0,3344,83,84,752,1433,1537,1349,785,bed
5487,27,chair,28,1,3344,15,0,1010,185,1643,185,633,chair
5488,10,table,11,0,3345,27,36,153,152,263,116,110,dining table
5489,11,chair,12,0,3345,19,112,144,165,240,53,96,chair
5490,12,chair,13,0,3345,16,36,179,91,289,55,110,chair
5491,0,bed,1,1,3346,16,2,115,181,225,179,110,bed
5492,15,chair,16,0,3346,19,241,82,264,108,23,26,chair
5493,12,bed,13,0,3347,31,530,328,744,455,214,127,bed
5494,5,bed,6,0,3348,27,4,829,1474,1990,1470,1161,bed
5495,8,bed,9,1,3349,48,3,336,903,767,900,431,bed
5496,3,bed,4,0,3350,21,47,114,164,207,117,93,bed
5497,4,bed,5,0,3350,36,129,111,240,178,111,67,bed
5498,2,bed,3,0,3351,49,82,395,1132,1194,1050,799,bed
5499,4,bed,5,0,3352,41,122,92,309,212,187,120,bed
5500,1,bed,2,0,3353,50,10,87,682,540,672,453,bed
5501,2,bed,3,0,3353,37,223,101,712,392,489,291,bed
5502,13,bed,13,0,3354,32,172,267,594,481,422,214,bed
5503,16,chair,16,1,3354,19,158,275,211,404,53,129,chair
5504,20,bed,21,1,3355,85,349,223,690,541,341,318,bed
5505,39,mirror,40,0,3355,26,937,80,1023,395,86,315,mirror
5506,56,sofa,57,0,3355,70,36,346,563,682,527,336,couch
5507,2,bed,3,0,3356,32,20,61,320,240,300,179,bed
5508,2,bed,3,0,3357,263,228,1,770,682,542,681,bed
5509,4,bed,5,0,3359,56,28,91,199,232,171,141,bed
5510,8,bed,9,0,3360,44,90,77,279,239,189,162,bed
5511,2,bed,3,0,3361,34,22,114,281,269,259,155,bed
5512,16,bed,17,0,3362,101,64,210,499,479,435,269,bed
5513,6,bed,6,0,3363,98,146,309,1023,683,877,374,bed
5514,14,mirror,13,1,3363,21,340,279,423,338,83,59,mirror
5515,21,chair,20,0,3363,21,58,399,190,633,132,234,chair
5516,22,table,21,1,3363,17,0,454,56,622,56,168,dining table
5517,7,bed,8,1,3364,22,49,211,240,319,191,108,bed
5518,5,bed,6,1,3365,19,624,1015,1060,1597,436,582,bed
5519,6,bed,7,1,3365,33,16,1013,536,1599,520,586,bed
5520,9,chair,10,1,3367,25,867,424,1035,594,168,170,chair
5521,10,bed,11,0,3367,36,384,359,734,591,350,232,bed
5522,12,bed,13,0,3367,45,93,380,617,796,524,416,bed
5523,2,bed,3,0,3368,48,331,277,998,799,667,522,bed
5524,18,bed,19,0,3369,31,211,276,589,532,378,256,bed
5525,2,chair,3,0,3370,16,3,443,177,766,174,323,chair
5526,40,chair,37,0,3370,38,898,451,1024,678,126,227,chair
5527,43,bench,40,0,3370,30,405,413,762,757,357,344,bench
5528,57,bed,54,0,3370,75,42,2,736,742,694,740,bed
5529,3,glasses,4,0,3371,17,1355,678,1430,705,75,27,eye glasses
5530,21,bed,22,0,3371,64,115,431,1373,1196,1258,765,bed
5531,22,table,23,1,3371,18,1358,907,1598,1199,240,292,dining table
5532,9,bed,9,0,3372,62,625,459,1924,1461,1299,1002,bed
5533,4,bed,5,0,3373,197,71,799,1352,2019,1281,1220,bed
5534,8,bed,9,0,3374,43,0,1,247,255,247,254,bed
5535,14,mirror,15,0,3375,62,683,216,812,452,129,236,mirror
5536,17,chair,18,0,3375,38,812,335,993,489,181,154,chair
5537,18,bed,19,0,3375,36,0,312,590,676,590,364,bed
5538,2,bed,3,0,3376,23,2,70,237,225,235,155,bed
5539,4,bed,5,0,3377,27,364,184,600,479,236,295,bed
5540,5,bed,6,0,3377,37,22,179,275,466,253,287,bed
5541,2,bed,3,0,3378,79,2,146,664,458,662,312,bed
5542,5,mirror,6,0,3378,35,492,53,649,256,157,203,mirror
5543,6,mirror,7,0,3378,40,18,47,178,248,160,201,mirror
5544,8,bed,9,1,3379,19,0,124,254,255,254,131,bed
5545,6,chair,7,0,3380,21,246,381,318,501,72,120,chair
5546,13,chair,14,0,3380,20,481,395,556,471,75,76,chair
5547,19,bed,20,0,3380,50,545,359,1022,643,477,284,bed
5548,14,bed,13,0,3381,54,513,882,2054,1465,1541,583,bed
5549,13,bed,14,0,3382,69,0,253,366,490,366,237,bed
5550,8,hat,9,0,3383,15,1421,759,1550,826,129,67,hat
5551,23,bed,24,0,3383,116,180,584,1586,1535,1406,951,bed
5552,5,bed,6,1,3384,37,46,137,216,270,170,133,bed
5553,3,bed,4,1,3385,112,0,82,340,254,340,172,bed
5554,3,chair,4,1,3386,17,218,116,280,197,62,81,chair
5555,6,bed,7,0,3386,72,22,58,242,259,220,201,bed
5556,3,bed,4,0,3387,45,129,119,348,234,219,115,bed
5557,7,sofa,8,0,3388,26,79,89,176,154,97,65,couch
5558,8,table,9,1,3388,19,2,137,85,221,83,84,dining table
5559,11,chair,12,1,3388,17,55,117,95,147,40,30,chair
5560,14,table,15,1,3388,22,187,117,290,203,103,86,dining table
5561,15,chair,16,0,3388,18,223,130,289,222,66,92,chair
5562,0,bed,1,1,3389,23,4,71,242,901,238,830,bed
5563,1,table,2,1,3389,42,69,441,518,828,449,387,dining table
5564,3,table,3,0,3389,66,3,768,929,1385,926,617,dining table
5565,5,sofa,5,1,3389,50,340,278,1412,924,1072,646,couch
5566,6,bed,7,0,3390,89,40,31,272,226,232,195,bed
5567,2,bed,3,1,3393,107,193,379,2107,1646,1914,1267,bed
5568,5,vase,6,0,3393,23,857,660,972,914,115,254,vase
5569,8,bottle,9,0,3393,15,383,655,446,770,63,115,bottle
5570,9,mirror,10,0,3393,16,159,202,511,721,352,519,mirror
5571,6,bed,7,1,3394,18,0,140,255,255,255,115,bed
5572,8,bed,9,1,3395,37,70,255,1021,766,951,511,bed
5573,3,window,4,0,3396,24,407,105,741,423,334,318,window
5574,7,chair,8,0,3396,37,608,329,779,502,171,173,chair
5575,12,bed,13,0,3396,58,65,250,442,507,377,257,bed
5576,3,bed,4,0,3397,22,341,235,671,461,330,226,bed
5577,14,window,15,0,3397,19,77,29,345,371,268,342,window
5578,14,clock,15,0,3398,19,962,199,1080,355,118,156,clock
5579,5,bed,6,0,3399,37,997,479,1580,832,583,353,bed
5580,6,bed,7,0,3399,58,676,426,1447,961,771,535,bed
5581,8,bed,9,0,3399,121,51,393,1157,1392,1106,999,bed
5582,3,bed,4,1,3400,26,0,163,191,300,191,137,bed
5583,7,bed,7,1,3401,51,103,321,943,604,840,283,bed
5584,14,bed,15,1,3402,33,2,1352,1728,2146,1726,794,bed
5585,7,bed,8,0,3403,34,109,159,296,260,187,101,bed
5586,6,bed,7,0,3404,55,150,178,553,473,403,295,bed
5587,24,table,25,1,3404,23,58,239,162,345,104,106,dining table
5588,11,bed,11,1,3406,86,326,704,2198,1470,1872,766,bed
5589,4,bed,5,1,3407,22,2,143,114,299,112,156,bed
5590,7,bed,8,0,3408,33,50,94,161,159,111,65,bed
5591,4,bed,5,1,3409,34,0,157,299,388,299,231,bed
5592,4,window,5,0,3410,19,795,32,1271,1133,476,1101,window
5593,6,bed,7,1,3410,31,588,639,2045,1531,1457,892,bed
5594,9,desk,10,0,3410,18,292,772,602,1297,310,525,desk
5595,10,chair,11,1,3410,30,467,676,730,1225,263,549,chair
5596,10,bed,11,0,3411,66,36,189,450,454,414,265,bed
5597,7,bed,8,0,3412,61,133,298,986,830,853,532,bed
5598,12,bed,13,0,3414,54,153,118,311,219,158,101,bed
5599,20,chair,21,1,3414,17,86,124,104,191,18,67,chair
5600,3,bed,4,0,3415,71,137,81,971,730,834,649,bed
5601,2,bed,3,1,3416,35,0,457,781,853,781,396,bed
5602,3,bed,4,0,3417,61,0,428,1031,1411,1031,983,bed
5603,5,bed,6,0,3417,71,862,432,1837,1531,975,1099,bed
5604,5,bed,6,0,3418,93,187,435,2196,1649,2009,1214,bed
5605,4,bed,5,1,3419,27,0,726,2196,1648,2196,922,bed
5606,31,window,32,0,3420,20,2,0,198,463,196,463,window
5607,35,glasses,36,0,3420,17,449,162,484,176,35,14,eye glasses
5608,38,bed,39,0,3420,77,214,118,1023,768,809,650,bed
5609,6,bed,7,0,3421,38,0,134,189,247,189,113,bed
5610,13,chair,14,1,3421,16,10,199,59,254,49,55,chair
5611,10,bed,10,0,3422,100,31,271,508,614,477,343,bed
5612,8,bed,9,0,3423,62,211,156,545,406,334,250,bed
5613,4,bed,5,0,3424,29,20,116,135,191,115,75,bed
5614,3,bed,4,0,3426,28,41,172,186,250,145,78,bed
5615,7,desk,8,0,3427,19,1230,473,1703,829,473,356,desk
5616,11,bed,12,1,3427,27,1204,794,2189,1271,985,477,bed
5617,2,bed,3,1,3428,30,0,142,101,255,101,113,bed
5618,4,mirror,5,0,3428,35,132,26,243,138,111,112,mirror
5619,4,person,5,1,3429,24,46,119,114,178,68,59,person
5620,9,bed,10,0,3429,52,46,138,473,409,427,271,bed
5621,6,bed,7,0,3430,30,138,528,1576,1462,1438,934,bed
5622,9,backpack,9,0,3430,15,1058,1022,1325,1360,267,338,backpack
5623,2,bed,3,0,3431,27,62,91,320,240,258,149,bed
5624,11,ball,12,0,3431,18,150,115,188,153,38,38,sports ball
5625,5,bed,6,0,3432,19,171,231,447,362,276,131,bed
5626,8,bed,9,0,3433,34,95,159,511,525,416,366,bed
5627,10,table,11,0,3433,16,19,290,156,451,137,161,dining table
5628,22,chair,23,0,3433,21,1,358,50,556,49,198,chair
5629,3,bed,4,0,3435,41,0,326,518,767,518,441,bed
5630,4,bed,5,1,3435,39,178,354,849,766,671,412,bed
5631,3,bed,4,0,3436,55,153,163,473,399,320,236,bed
5632,11,chair,12,1,3438,16,797,272,844,334,47,62,chair
5633,12,sofa,13,0,3438,34,459,290,746,461,287,171,couch
5634,13,bed,14,0,3438,54,0,316,680,585,680,269,bed
5635,4,bed,5,0,3439,79,37,79,304,223,267,144,bed
5636,5,chair,6,1,3439,28,151,121,303,236,152,115,chair
5637,0,bed,1,0,3440,22,2,92,633,428,631,336,bed
5638,5,chair,6,1,3440,22,550,16,640,207,90,191,chair
5639,12,bed,13,0,3441,34,41,236,673,601,632,365,bed
5640,5,bed,5,1,3442,49,0,1063,1913,1581,1913,518,bed
5641,8,chair,9,0,3444,54,8,178,140,331,132,153,chair
5642,9,bed,10,0,3444,56,193,177,460,331,267,154,bed
5643,12,bed,13,0,3445,52,147,310,577,532,430,222,bed
5644,6,bed,7,0,3446,16,75,136,283,198,208,62,bed
5645,7,chair,8,0,3446,30,36,127,128,223,92,96,chair
5646,10,desk,11,0,3446,22,2,158,55,224,53,66,desk
5647,2,window,3,0,3447,24,154,14,300,115,146,101,window
5648,5,bed,6,0,3447,36,0,84,224,200,224,116,bed
5649,8,chair,9,1,3447,22,173,97,205,136,32,39,chair
5650,9,chair,10,0,3447,26,246,107,291,169,45,62,chair
5651,6,mirror,6,0,3449,29,636,168,771,399,135,231,mirror
5652,20,bed,19,0,3449,54,122,348,591,568,469,220,bed
5653,22,table,21,1,3449,21,819,526,1023,681,204,155,dining table
5654,23,chair,22,0,3449,36,834,431,999,558,165,127,chair
5655,60,door,56,0,3449,21,954,75,994,452,40,377,door
5656,7,bed,8,0,3450,42,427,205,2069,1498,1642,1293,bed
5657,15,vase,16,0,3450,21,43,332,236,581,193,249,vase
5658,4,bed,5,0,3451,36,118,112,255,254,137,142,bed
5659,4,bed,5,0,3453,78,644,721,1916,1534,1272,813,bed
5660,6,bed,7,1,3454,23,0,315,234,598,234,283,bed
5661,5,bed,6,0,3455,16,91,155,254,254,163,99,bed
5662,2,bed,3,0,3457,21,59,66,299,224,240,158,bed
5663,10,bed,11,1,3458,41,0,123,255,255,255,132,bed
5664,4,window,5,0,3459,23,201,291,427,1078,226,787,window
5665,5,window,6,0,3459,33,536,322,763,1177,227,855,window
5666,6,window,7,0,3459,19,897,358,1066,1056,169,698,window
5667,13,bed,14,1,3459,24,2,1036,1199,1599,1197,563,bed
5668,3,bed,4,0,3460,25,62,67,508,360,446,293,bed
5669,2,bed,3,0,3461,46,647,340,1597,1106,950,766,bed
5670,11,vase,12,0,3461,16,125,479,207,622,82,143,vase
5671,2,bed,3,1,3462,16,184,719,928,1230,744,511,bed
5672,7,bed,8,0,3462,53,626,472,1631,1095,1005,623,bed
5673,3,bed,4,0,3464,24,34,93,259,186,225,93,bed
5674,4,bed,5,1,3466,20,146,110,255,255,109,145,bed
5675,7,bed,8,1,3467,26,173,1335,1584,2197,1411,862,bed
5676,4,bed,5,1,3468,64,1081,491,2045,1255,964,764,bed
5677,5,bed,6,0,3468,84,2,446,1121,1321,1119,875,bed
5678,4,bed,5,0,3469,86,70,48,342,226,272,178,bed
5679,4,bed,5,0,3470,47,143,91,287,222,144,131,bed
5680,8,chair,9,0,3470,23,75,98,129,168,54,70,chair
5681,0,bed,1,0,3471,30,96,168,254,255,158,87,bed
5682,4,chair,5,0,3471,16,134,144,163,178,29,34,chair
5683,6,bed,7,0,3472,21,0,135,146,256,146,121,bed
5684,12,bed,12,0,3473,55,0,417,2135,1649,2135,1232,bed
5685,8,bed,9,0,3475,94,5,257,761,719,756,462,bed
5686,3,sofa,4,0,3476,33,15,223,198,347,183,124,couch
5687,5,bed,6,1,3476,32,310,4,639,418,329,414,bed
5688,15,bed,14,0,3477,67,149,281,600,645,451,364,bed
5689,2,sofa,3,1,3479,33,340,367,515,471,175,104,couch
5690,6,bed,7,1,3479,29,326,326,1023,683,697,357,bed
5691,7,bed,8,0,3480,109,192,258,744,665,552,407,bed
5692,0,bed,1,0,3481,22,84,151,572,427,488,276,bed
5693,3,bed,4,1,3482,22,1116,250,2200,1649,1084,1399,bed
5694,5,bed,6,1,3483,15,0,837,506,1279,506,442,bed
5695,5,bed,6,0,3484,82,935,702,1914,1488,979,786,bed
5696,7,bed,8,1,3484,26,0,964,846,1647,846,683,bed
5697,3,bed,4,1,3485,31,703,613,2198,1628,1495,1015,bed
5698,7,bed,8,0,3487,45,16,112,198,256,182,144,bed
5699,9,chair,10,0,3488,20,242,580,406,794,164,214,chair
5700,10,bed,11,0,3488,31,589,533,1273,949,684,416,bed
5701,4,bed,5,0,3489,31,1,69,248,255,247,186,bed
5702,11,bed,11,0,3490,70,552,747,1886,1533,1334,786,bed
5703,15,chair,15,1,3490,18,1829,1111,2044,1534,215,423,chair
5704,7,bed,8,0,3491,72,22,82,253,224,231,142,bed
5705,2,bottle,3,0,3492,17,34,391,89,497,55,106,bottle
5706,9,bed,10,0,3492,196,225,171,1542,1259,1317,1088,bed
5707,10,bed,11,0,3493,16,302,351,1023,765,721,414,bed
5708,9,bed,10,0,3494,37,2,671,855,1646,853,975,bed
5709,7,bed,8,0,3496,50,196,221,850,632,654,411,bed
5710,5,bed,6,0,3497,33,340,310,989,677,649,367,bed
5711,16,chair,16,1,3497,27,147,416,233,677,86,261,chair
5712,1,bed,2,0,3498,19,80,108,215,221,135,113,bed
5713,8,bed,9,1,3499,22,67,93,255,255,188,162,bed
5714,7,bed,8,1,3500,63,508,1012,1975,1649,1467,637,bed
5715,7,chair,8,0,3501,22,222,101,256,152,34,51,chair
5716,8,bed,9,0,3501,51,78,74,216,200,138,126,bed
5717,6,bed,7,0,3502,87,0,25,263,224,263,199,bed
5718,10,bed,10,1,3503,41,363,849,1779,1647,1416,798,bed
5719,8,chair,9,0,3504,19,271,121,330,180,59,59,chair
5720,10,bed,11,0,3504,91,10,99,382,350,372,251,bed
5721,6,bed,6,0,3505,58,345,379,1277,956,932,577,bed
5722,7,glasses,7,0,3506,52,1576,1362,1816,1484,240,122,eye glasses
5723,8,bed,8,1,3506,68,82,537,1907,1572,1825,1035,bed
5724,3,bed,4,0,3507,70,55,32,329,258,274,226,bed
5725,7,chair,8,0,3508,15,229,141,258,198,29,57,chair
5726,8,bed,9,1,3508,17,275,141,407,271,132,130,bed
5727,9,bed,10,0,3508,52,58,114,236,260,178,146,bed
5728,7,bed,6,0,3509,107,60,513,805,1122,745,609,bed
5729,7,bed,8,0,3510,46,2,260,641,1022,639,762,bed
5730,10,shoe,11,0,3511,15,611,1051,744,1104,133,53,shoe
5731,11,shoe,12,0,3511,18,564,1092,690,1156,126,64,shoe
5732,15,bed,16,0,3511,66,859,718,2199,1454,1340,736,bed
5733,5,bed,6,0,3512,45,94,100,317,249,223,149,bed
5734,6,sofa,7,1,3512,23,300,160,431,322,131,162,couch
5735,14,chair,15,0,3512,19,45,107,80,147,35,40,chair
5736,16,chair,17,0,3512,20,128,104,156,135,28,31,chair
5737,9,bed,10,0,3513,18,41,95,204,196,163,101,bed
5738,17,chair,18,0,3513,15,293,100,353,189,60,89,chair
5739,4,bed,5,0,3514,47,23,41,258,299,235,258,bed
5740,7,book,8,0,3515,25,1096,829,1233,945,137,116,book
5741,16,bed,17,1,3515,44,1285,394,2045,1417,760,1023,bed
5742,25,bed,25,0,3515,43,5,441,1337,1533,1332,1092,bed
5743,3,bed,4,0,3516,36,639,273,1141,577,502,304,bed
5744,11,mirror,10,0,3516,16,273,155,430,353,157,198,mirror
5745,10,bed,11,0,3518,51,156,234,524,426,368,192,bed
5746,5,bed,6,0,3519,47,316,336,729,603,413,267,bed
5747,6,bed,7,0,3520,24,0,190,399,442,399,252,bed
5748,2,bed,3,1,3521,24,305,904,885,1809,580,905,bed
5749,3,bed,4,0,3522,33,72,286,804,661,732,375,bed
5750,6,chair,7,0,3522,44,689,314,1022,685,333,371,chair
5751,8,bed,9,0,3523,25,342,660,1228,1001,886,341,bed
5752,10,bed,11,0,3524,29,0,175,406,399,406,224,bed
5753,11,bench,12,0,3524,16,248,273,426,399,178,126,bench
5754,11,chair,12,1,3525,20,128,130,178,177,50,47,chair
5755,15,bed,16,1,3525,28,0,166,222,252,222,86,bed
5756,9,bed,10,1,3526,32,1,699,1856,1464,1855,765,bed
5757,6,bed,7,0,3527,183,159,165,871,767,712,602,bed
5758,7,bed,8,0,3529,25,73,123,245,248,172,125,bed
5759,2,bed,3,1,3530,30,0,123,114,255,114,132,bed
5760,4,window,5,0,3531,20,72,88,143,132,71,44,window
5761,4,bed,5,1,3532,33,3,129,256,255,253,126,bed
5762,4,bed,5,1,3533,49,2,537,987,1414,985,877,bed
5763,7,bed,7,0,3533,41,438,574,1791,1437,1353,863,bed
5764,2,bed,3,0,3534,62,2,637,1987,1645,1985,1008,bed
5765,0,bed,1,0,3535,31,220,458,1866,1314,1646,856,bed
5766,6,window,7,0,3536,17,573,9,1273,445,700,436,window
5767,7,bed,8,0,3536,82,693,259,1589,922,896,663,bed
5768,4,bed,5,0,3537,37,318,269,861,668,543,399,bed
5769,5,bed,6,0,3538,69,170,134,357,298,187,164,bed
5770,10,chair,11,0,3538,27,102,161,146,232,44,71,chair
5771,5,bed,6,0,3539,60,94,247,510,551,416,304,bed
5772,7,bed,8,1,3540,25,0,79,299,228,299,149,bed
5773,4,bed,5,0,3541,79,299,347,942,739,643,392,bed
5774,23,window,22,0,3541,15,69,137,364,529,295,392,window
5775,0,bed,1,0,3542,22,0,89,123,256,123,167,bed
5776,1,bed,2,0,3543,41,19,129,217,255,198,126,bed
5777,5,chair,6,0,3544,22,1973,788,2196,1103,223,315,chair
5778,8,bed,9,1,3544,34,425,1054,2197,1617,1772,563,bed
5779,13,window,14,0,3544,20,54,14,840,1076,786,1062,window
5780,2,bed,3,0,3545,20,2,98,415,389,413,291,bed
5781,12,mirror,13,0,3546,33,578,30,798,352,220,322,mirror
5782,44,chair,45,0,3546,53,174,363,375,646,201,283,chair
5783,61,door,62,0,3546,15,929,33,1025,492,96,459,door
5784,2,window,3,0,3547,30,592,310,1278,627,686,317,window
5785,15,bed,13,1,3547,26,340,494,1279,896,939,402,bed
5786,9,chair,10,0,3548,30,201,106,249,179,48,73,chair
5787,13,bench,14,1,3548,19,0,117,58,196,58,79,bench
5788,14,chair,15,0,3548,16,123,88,148,122,25,34,chair
5789,1,bed,2,0,3549,168,54,40,249,239,195,199,bed
5790,5,desk,6,0,3549,16,155,112,242,161,87,49,desk
5791,7,chair,8,1,3549,16,204,112,238,164,34,52,chair
5792,3,bed,4,0,3550,37,0,98,201,280,201,182,bed
5793,11,bed,12,1,3551,23,39,103,98,189,59,86,bed
5794,12,bed,13,1,3551,20,91,102,162,162,71,60,bed
5795,13,sofa,14,1,3551,79,50,136,171,239,121,103,couch
5796,6,bed,7,0,3552,59,361,281,935,799,574,518,bed
5797,18,mirror,18,0,3552,60,3,332,157,746,154,414,mirror
5798,2,bed,3,0,3553,30,271,323,2015,1538,1744,1215,bed
5799,4,bed,5,1,3554,39,335,227,844,767,509,540,bed
5800,7,bed,8,0,3555,39,532,747,2198,1463,1666,716,bed
5801,11,window,11,0,3555,20,531,156,944,870,413,714,window
5802,1,bed,2,0,3556,34,102,37,223,208,121,171,bed
5803,5,window,6,0,3557,23,362,180,480,303,118,123,window
5804,6,sofa,7,1,3557,23,363,284,477,359,114,75,couch
5805,16,bed,17,0,3557,39,2,278,378,535,376,257,bed
5806,30,mirror,29,0,3557,41,695,65,798,244,103,179,mirror
5807,7,bed,8,0,3558,69,126,206,533,468,407,262,bed
5808,3,bed,4,0,3559,23,0,76,255,255,255,179,bed
5809,2,bed,3,0,3560,22,46,66,282,234,236,168,bed
5810,21,bed,21,0,3561,40,503,472,1032,851,529,379,bed
5811,6,bed,7,0,3562,43,7,302,804,802,797,500,bed
5812,4,window,5,0,3563,16,198,110,563,502,365,392,window
5813,18,bed,19,0,3563,57,2,355,735,784,733,429,bed
5814,4,bed,4,0,3564,77,2,273,1036,956,1034,683,bed
5815,8,bed,9,1,3565,86,0,62,188,240,188,178,bed
5816,9,window,10,1,3565,24,0,26,59,160,59,134,window
5817,11,bed,12,0,3566,33,401,630,1743,1268,1342,638,bed
5818,5,bed,6,1,3567,28,5,211,243,324,238,113,bed
5819,10,bed,11,0,3568,30,0,95,292,239,292,144,bed
5820,9,bed,10,0,3569,22,67,126,249,246,182,120,bed
5821,4,bed,4,1,3570,68,0,380,2197,1648,2197,1268,bed
5822,7,desk,8,1,3571,16,30,139,90,255,60,116,desk
5823,8,chair,9,1,3571,33,67,121,135,254,68,133,chair
5824,7,bed,8,1,3573,15,0,153,141,225,141,72,bed
5825,6,bed,7,0,3574,44,121,222,640,532,519,310,bed
5826,8,bed,9,0,3576,105,520,658,1592,1413,1072,755,bed
5827,11,bed,10,0,3577,93,332,650,1557,1605,1225,955,bed
5828,5,bed,6,0,3578,16,0,199,297,397,297,198,bed
5829,6,bed,7,1,3579,20,0,106,255,255,255,149,bed
5830,3,door,4,1,3580,15,1,402,354,1256,353,854,door
5831,5,window,6,0,3580,22,581,460,1000,980,419,520,window
5832,8,bed,9,1,3580,96,439,690,2199,1513,1760,823,bed
5833,6,table,7,0,3581,32,310,226,446,301,136,75,dining table
5834,9,bed,10,0,3581,35,2,114,249,301,247,187,bed
5835,14,mirror,15,0,3581,17,378,72,410,109,32,37,mirror
5836,15,chair,16,1,3581,15,399,173,436,231,37,58,chair
5837,8,bed,9,0,3582,37,238,290,647,598,409,308,bed
5838,11,chair,12,0,3582,25,651,334,778,505,127,171,chair
5839,2,window,3,0,3583,19,15,6,339,404,324,398,window
5840,12,bed,12,0,3583,73,65,206,700,599,635,393,bed
5841,3,window,4,0,3584,26,635,158,967,397,332,239,window
5842,6,chair,7,1,3584,37,654,328,722,453,68,125,chair
5843,7,chair,8,0,3584,59,830,336,943,493,113,157,chair
5844,10,bed,11,0,3584,52,194,298,692,637,498,339,bed
5845,4,bed,5,0,3585,40,57,109,264,233,207,124,bed
5846,2,window,3,1,3586,15,751,178,878,480,127,302,window
5847,8,window,9,1,3586,20,43,262,132,527,89,265,window
5848,9,window,10,0,3586,21,176,266,379,533,203,267,window
5849,22,mirror,21,0,3586,25,588,270,715,418,127,148,mirror
5850,24,bed,22,1,3586,46,463,358,1023,767,560,409,bed
5851,10,bed,9,0,3588,100,151,339,670,668,519,329,bed
5852,10,bed,10,1,3589,37,0,748,1337,1509,1337,761,bed
5853,2,bed,3,0,3590,38,76,430,1057,796,981,366,bed
5854,5,bed,6,0,3591,58,407,386,1210,959,803,573,bed
5855,4,chair,5,0,3592,38,334,455,477,712,143,257,chair
5856,6,bed,6,1,3592,22,2,638,724,819,722,181,bed
5857,2,bed,3,0,3593,38,43,55,300,224,257,169,bed
5858,5,table,6,1,3593,24,0,128,41,212,41,84,dining table
5859,4,bed,5,0,3594,27,48,88,294,224,246,136,bed
5860,0,bed,1,1,3595,20,2,111,154,224,152,113,bed
5861,12,sofa,13,0,3596,20,78,125,188,184,110,59,couch
5862,14,bed,15,1,3596,15,157,165,255,255,98,90,bed
5863,3,bed,4,0,3597,80,348,341,975,716,627,375,bed
5864,17,chair,17,1,3597,25,2,471,218,799,216,328,chair
5865,23,bed,23,0,3598,34,312,321,855,664,543,343,bed
5866,1,bed,2,0,3599,20,103,295,1977,1534,1874,1239,bed
5867,12,bed,12,0,3601,51,68,265,629,532,561,267,bed
5868,5,bed,6,0,3602,46,72,94,447,341,375,247,bed
5869,4,bed,5,0,3603,56,76,181,572,516,496,335,bed
5870,13,bed,14,0,3604,39,185,58,550,442,365,384,bed
5871,25,window,26,0,3604,25,49,1,169,200,120,199,window
5872,1,bed,2,1,3605,47,75,181,333,452,258,271,bed
5873,5,vase,6,0,3606,32,1796,926,1949,1106,153,180,vase
5874,10,bed,11,0,3606,85,32,663,1405,1533,1373,870,bed
5875,14,window,15,1,3606,77,888,69,1256,686,368,617,window
5876,5,bed,6,0,3607,69,50,78,251,221,201,143,bed
5877,4,bed,5,0,3608,19,65,164,339,227,274,63,bed
5878,2,bed,3,0,3609,48,65,704,1670,1587,1605,883,bed
5879,4,bed,5,1,3610,84,2,327,448,600,446,273,bed
5880,1,bed,2,1,3611,41,68,537,1171,959,1103,422,bed
5881,11,bed,12,0,3612,35,159,101,314,234,155,133,bed
5882,3,bed,4,1,3613,25,2,163,738,524,736,361,bed
5883,1,bed,2,0,3614,26,0,56,1138,1650,1138,1594,bed
5884,8,bed,9,0,3614,18,1064,244,2191,1644,1127,1400,bed
5885,3,bed,4,0,3615,32,223,11,2014,1509,1791,1498,bed
5886,4,bed,5,0,3616,16,119,154,510,339,391,185,bed
5887,4,bed,5,1,3617,39,113,116,255,244,142,128,bed
5888,9,bed,10,0,3618,28,54,107,382,266,328,159,bed
5889,4,bed,5,0,3619,29,96,127,255,223,159,96,bed
5890,6,vase,6,0,3620,15,1513,552,1635,705,122,153,vase
5891,11,bed,10,0,3620,61,0,727,1291,1651,1291,924,bed
5892,4,bed,5,0,3621,51,89,122,368,306,279,184,bed
5893,9,mirror,10,0,3623,16,3,47,122,189,119,142,mirror
5894,13,bed,14,1,3623,21,2,569,645,767,643,198,bed
5895,7,chair,8,1,3624,17,0,132,19,165,19,33,chair
5896,11,bed,12,0,3624,122,0,77,292,239,292,162,bed
5897,5,bed,5,0,3625,54,183,234,1022,766,839,532,bed
5898,3,bed,4,1,3626,23,0,83,277,239,277,156,bed
5899,13,bed,12,0,3627,35,231,380,937,797,706,417,bed
5900,5,bed,6,0,3628,22,321,243,683,466,362,223,bed
5901,6,bed,7,0,3629,63,202,632,1746,1649,1544,1017,bed
5902,3,bed,4,1,3630,54,3,393,2025,1644,2022,1251,bed
5903,6,bed,7,1,3631,35,50,105,255,255,205,150,bed
5904,9,bed,10,1,3632,26,221,52,358,238,137,186,bed
5905,13,chair,14,0,3632,34,102,153,172,237,70,84,chair
5906,14,bed,15,0,3632,21,0,61,95,238,95,177,bed
5907,13,bed,14,0,3633,50,481,453,1499,1124,1018,671,bed
5908,7,desk,8,1,3634,49,146,418,464,671,318,253,desk
5909,8,bed,9,1,3634,57,273,431,767,745,494,314,bed
5910,5,bed,6,0,3635,39,39,119,224,277,185,158,bed
5911,4,bed,4,0,3636,65,194,180,995,742,801,562,bed
5912,12,bed,13,0,3637,27,50,75,319,223,269,148,bed
5913,3,bed,3,0,3638,116,105,204,628,590,523,386,bed
5914,15,flowerpot,15,0,3638,24,647,374,795,536,148,162,potted plant
5915,4,bed,5,0,3639,159,94,2,2088,1649,1994,1647,bed
5916,5,bed,6,0,3640,42,497,467,2196,1647,1699,1180,bed
5917,10,clock,10,0,3640,16,305,435,383,575,78,140,clock
5918,8,bed,7,0,3641,59,173,261,459,447,286,186,bed
5919,9,bed,8,1,3641,28,459,263,799,530,340,267,bed
5920,17,bed,18,0,3644,32,483,220,999,499,516,279,bed
5921,18,sofa,19,0,3644,21,414,230,574,324,160,94,couch
5922,19,sofa,20,0,3644,24,201,252,443,416,242,164,couch
5923,16,window,15,0,3645,15,636,282,868,518,232,236,window
5924,20,bed,18,0,3645,51,435,406,1116,851,681,445,bed
5925,3,bed,4,0,3646,225,93,141,864,767,771,626,bed
5926,6,bed,7,0,3647,68,0,124,730,1223,730,1099,bed
5927,7,bed,8,1,3647,69,759,154,1629,1222,870,1068,bed
5928,4,door,5,1,3648,22,557,121,733,495,176,374,door
5929,7,bed,8,1,3648,48,574,355,1023,646,449,291,bed
5930,9,bed,10,0,3649,230,208,46,672,533,464,487,bed
5931,5,chair,6,1,3650,23,333,605,526,838,193,233,chair
5932,8,bed,9,0,3651,29,88,103,202,193,114,90,bed
5933,16,vase,17,0,3651,26,132,192,157,253,25,61,vase
5934,5,mirror,6,0,3652,18,452,254,514,352,62,98,mirror
5935,8,bed,8,0,3652,213,201,185,615,599,414,414,bed
5936,11,bowl,10,0,3652,21,765,168,823,211,58,43,bowl
5937,13,mirror,12,0,3652,21,71,238,179,368,108,130,mirror
5938,18,vase,15,1,3652,16,2,402,63,598,61,196,vase
5939,6,bed,6,0,3654,23,90,399,687,872,597,473,bed
5940,7,bed,7,1,3654,41,605,368,1034,783,429,415,bed
5941,8,bed,9,0,3655,23,20,112,127,176,107,64,bed
5942,2,hat,3,0,3656,24,1626,57,1753,387,127,330,hat
5943,4,bed,5,0,3656,33,273,857,1780,1647,1507,790,bed
5944,7,bottle,7,0,3656,16,342,897,446,1004,104,107,bottle
5945,3,window,4,0,3657,25,429,85,818,421,389,336,window
5946,14,vase,13,0,3657,17,327,352,368,413,41,61,vase
5947,20,bed,19,0,3657,76,404,283,1006,681,602,398,bed
5948,8,bed,8,0,3658,54,0,265,1066,1573,1066,1308,bed
5949,10,bed,10,1,3658,34,318,337,2197,1649,1879,1312,bed
5950,2,bed,3,0,3659,35,0,258,738,767,738,509,bed
5951,5,bed,6,0,3659,56,439,269,860,553,421,284,bed
5952,6,bed,7,0,3660,51,0,420,1021,767,1021,347,bed
5953,2,bed,3,0,3661,30,62,464,1672,1180,1610,716,bed
5954,17,window,18,0,3661,15,1390,138,1860,924,470,786,window
5955,3,bed,4,0,3662,53,0,363,1725,1646,1725,1283,bed
5956,4,bed,5,0,3664,100,75,291,801,848,726,557,bed
5957,5,door,6,1,3664,23,407,155,521,429,114,274,door
5958,15,chair,14,1,3664,23,1023,680,1278,956,255,276,chair
5959,11,bed,11,0,3665,64,297,254,981,683,684,429,bed
5960,11,bed,12,1,3666,42,58,268,762,532,704,264,bed
5961,4,bed,5,0,3667,41,119,365,1311,1083,1192,718,bed
5962,4,bed,5,1,3668,24,175,169,360,364,185,195,bed
5963,12,sofa,13,0,3668,16,317,241,520,403,203,162,couch
5964,25,window,26,0,3668,29,86,95,152,238,66,143,window
5965,2,bed,3,1,3669,38,262,232,1023,765,761,533,bed
5966,6,bed,6,0,3669,77,0,186,642,711,642,525,bed
5967,2,bed,3,1,3670,41,6,91,240,319,234,228,bed
5968,0,bed,1,0,3671,25,14,206,609,538,595,332,bed
5969,1,bed,2,1,3671,26,370,155,715,517,345,362,bed
5970,12,bed,13,0,3672,62,0,850,1111,1473,1111,623,bed
5971,2,bed,3,0,3673,45,31,91,236,229,205,138,bed
5972,18,window,19,0,3673,23,112,50,159,145,47,95,window
5973,3,bed,4,0,3674,45,69,116,255,255,186,139,bed
5974,1,bed,2,0,3675,18,498,336,875,584,377,248,bed
5975,8,bed,9,0,3676,69,286,208,585,396,299,188,bed
5976,7,bed,8,1,3677,19,259,441,1199,897,940,456,bed
5977,8,bed,8,0,3678,39,422,599,1773,1463,1351,864,bed
5978,23,bottle,21,0,3678,37,50,846,178,1041,128,195,bottle
5979,3,bed,4,0,3679,36,88,328,660,873,572,545,bed
5980,6,bed,7,0,3679,59,596,293,1105,699,509,406,bed
5981,11,bed,12,1,3680,29,104,396,998,663,894,267,bed
5982,7,chair,8,1,3681,29,63,116,114,199,51,83,chair
5983,15,bed,15,0,3682,50,130,358,621,664,491,306,bed
5984,10,vase,11,0,3683,24,817,455,900,607,83,152,vase
5985,16,bed,16,0,3683,42,163,427,704,784,541,357,bed
5986,11,table,12,0,3684,18,64,145,103,185,39,40,dining table
5987,4,door,5,1,3685,19,1321,308,1488,759,167,451,door
5988,8,bed,9,1,3685,32,16,589,939,991,923,402,bed
5989,12,person,13,1,3685,50,1268,478,1412,671,144,193,person
5990,13,person,14,0,3685,79,938,560,1379,771,441,211,person
5991,3,bed,4,0,3686,27,51,133,215,256,164,123,bed
5992,2,bed,3,0,3687,97,132,224,1421,1078,1289,854,bed
5993,2,bed,3,0,3688,52,0,601,1236,1100,1236,499,bed
5994,6,bed,5,1,3690,97,0,833,1340,1649,1340,816,bed
5995,9,mirror,8,0,3690,119,1417,146,2198,1079,781,933,mirror
5996,17,chair,14,1,3690,55,634,850,950,1447,316,597,chair
5997,13,bed,14,0,3691,43,6,111,165,185,159,74,bed
5998,20,bed,21,1,3691,16,80,149,320,240,240,91,bed
5999,5,television,6,1,3692,15,245,146,286,205,41,59,tv
6000,7,chair,8,1,3692,17,213,175,245,235,32,60,chair
6001,23,bed,24,1,3692,18,0,153,171,245,171,92,bed
6002,1,bed,2,1,3693,16,1345,295,2197,1647,852,1352,bed
6003,8,chair,9,0,3694,28,867,693,1142,1080,275,387,chair
6004,6,table,7,1,3695,17,53,99,96,147,43,48,dining table
6005,8,chair,9,1,3695,20,77,96,111,149,34,53,chair
6006,10,window,11,0,3695,16,41,40,212,127,171,87,window
6007,18,bed,19,0,3695,45,167,78,354,207,187,129,bed
6008,2,bed,3,0,3696,155,44,327,1230,1159,1186,832,bed
6009,7,bed,8,0,3697,50,125,362,736,766,611,404,bed
6010,5,bed,6,0,3698,62,90,231,458,472,368,241,bed
6011,4,bed,5,0,3699,21,44,130,206,181,162,51,bed
6012,21,bed,19,0,3700,47,248,765,1912,1646,1664,881,bed
6013,3,bed,4,0,3701,49,24,108,254,315,230,207,bed
6014,4,bed,5,1,3702,46,587,821,1558,1347,971,526,bed
6015,5,bed,6,1,3702,45,279,886,1457,1506,1178,620,bed
6016,6,bed,7,1,3702,29,0,985,1346,1509,1346,524,bed
6017,7,chair,8,1,3702,20,1922,769,2014,1181,92,412,chair
6018,6,bed,7,0,3703,43,5,149,223,299,218,150,bed
6019,5,bed,6,1,3704,25,2,111,510,391,508,280,bed
6020,4,bed,5,0,3705,50,145,343,891,738,746,395,bed
6021,3,desk,4,0,3706,39,558,1117,1936,1465,1378,348,desk
6022,10,clock,11,0,3706,19,1707,1033,1829,1181,122,148,clock
6023,15,plate,16,0,3706,15,1456,1150,1635,1201,179,51,plate
6024,25,chair,25,1,3706,30,709,1063,1176,1464,467,401,chair
6025,4,bed,5,0,3707,57,27,81,352,270,325,189,bed
6026,1,bed,2,1,3708,15,332,203,511,341,179,138,bed
6027,6,chair,7,1,3708,25,316,167,370,266,54,99,chair
6028,23,bed,23,0,3709,70,290,600,1568,1432,1278,832,bed
6029,4,bed,5,0,3710,30,454,267,1110,942,656,675,bed
6030,12,bed,12,0,3711,48,117,329,596,647,479,318,bed
6031,6,bed,7,0,3712,77,132,248,566,529,434,281,bed
6032,2,bed,3,0,3713,85,420,177,1133,864,713,687,bed
6033,7,bed,6,0,3713,71,2,158,665,664,663,506,bed
6034,2,bed,3,1,3714,21,31,126,256,256,225,130,bed
6035,6,bed,7,0,3717,98,376,340,1002,639,626,299,bed
6036,0,bed,1,1,3718,50,415,4,796,1062,381,1058,bed
6037,8,bed,9,1,3719,32,178,258,500,501,322,243,bed
6038,10,sofa,11,1,3719,20,128,276,273,354,145,78,couch
6039,11,desk,12,1,3719,16,258,269,354,314,96,45,desk
6040,7,table,8,1,3720,20,21,144,42,184,21,40,dining table
6041,9,bed,10,0,3720,30,66,129,220,235,154,106,bed
6042,5,bed,6,0,3721,61,233,221,516,395,283,174,bed
6043,16,bed,17,1,3722,54,89,135,349,232,260,97,bed
6044,28,mirror,29,0,3722,20,0,92,39,171,39,79,mirror
6045,0,bed,1,0,3723,18,0,175,228,344,228,169,bed
6046,2,window,3,0,3724,15,573,94,673,355,100,261,window
6047,4,window,5,0,3724,27,392,133,468,262,76,129,window
6048,5,bed,6,0,3724,132,113,1,463,461,350,460,bed
6049,3,window,4,0,3725,16,169,31,219,163,50,132,window
6050,3,bed,4,0,3726,39,17,84,236,176,219,92,bed
6051,5,bed,6,0,3726,21,39,113,309,239,270,126,bed
6052,3,bed,4,0,3727,69,217,258,617,532,400,274,bed
6053,11,mirror,9,0,3728,23,52,174,247,334,195,160,mirror
6054,17,bed,14,0,3728,49,364,259,756,541,392,282,bed
6055,2,bed,3,1,3730,51,332,426,1245,856,913,430,bed
6056,7,bed,8,0,3731,69,428,303,716,558,288,255,bed
6057,17,desk,17,1,3731,19,750,369,924,615,174,246,desk
6058,15,bed,12,0,3732,349,316,228,1540,1456,1224,1228,bed
6059,0,bed,1,0,3733,50,13,137,617,423,604,286,bed
6060,19,desk,19,0,3734,18,330,685,1091,1510,761,825,desk
6061,17,bed,18,0,3735,59,347,418,1193,1121,846,703,bed
6062,21,mirror,22,0,3735,20,1245,324,1574,582,329,258,mirror
6063,5,bed,6,0,3736,66,384,268,1136,793,752,525,bed
6064,15,chair,14,1,3736,16,104,646,305,931,201,285,chair
6065,0,bed,1,0,3737,29,41,94,187,217,146,123,bed
6066,13,bed,14,0,3738,26,15,140,237,227,222,87,bed
6067,2,bed,3,0,3739,38,2,151,224,282,222,131,bed
6068,8,bed,9,1,3740,50,11,132,320,240,309,108,bed
6069,4,bed,5,1,3741,39,182,292,1279,958,1097,666,bed
6070,3,bed,4,0,3742,17,0,124,202,246,202,122,bed
6071,4,window,5,0,3743,24,0,0,103,139,103,139,window
6072,5,chair,6,0,3743,15,0,167,83,256,83,89,chair
6073,6,bed,7,0,3743,19,99,142,255,255,156,113,bed
6074,5,bed,6,0,3744,45,615,477,1598,1198,983,721,bed
6075,8,bed,9,1,3745,23,0,161,59,255,59,94,bed
6076,10,bed,10,1,3746,58,0,1028,832,1645,832,617,bed
6077,8,bed,8,1,3747,79,504,453,2199,1649,1695,1196,bed
6078,11,bed,12,1,3748,28,0,119,226,225,226,106,bed
6079,3,bed,4,0,3749,27,2,150,207,209,205,59,bed
6080,5,bed,6,1,3749,15,0,182,320,240,320,58,bed
6081,11,bed,12,0,3750,49,120,170,420,294,300,124,bed
6082,0,bed,1,0,3751,227,23,23,284,213,261,190,bed
6083,3,bed,4,0,3752,43,26,125,297,300,271,175,bed
6084,5,window,6,0,3753,28,461,91,757,378,296,287,window
6085,8,bed,9,0,3753,82,518,295,1023,599,505,304,bed
6086,5,bed,6,1,3755,66,101,472,711,1204,610,732,bed
6087,8,bed,8,0,3756,108,0,373,1277,957,1277,584,bed
6088,10,chair,11,0,3757,21,87,914,554,1637,467,723,chair
6089,5,bed,6,0,3759,73,6,54,276,231,270,177,bed
6090,2,bed,3,0,3760,21,33,117,152,192,119,75,bed
6091,6,window,7,0,3761,34,623,2,798,407,175,405,window
6092,7,sofa,8,0,3761,39,585,258,775,429,190,171,couch
6093,14,bed,15,0,3761,22,157,235,507,485,350,250,bed
6094,25,bed,26,0,3762,39,273,279,749,498,476,219,bed
6095,17,bed,18,0,3763,99,551,444,1251,984,700,540,bed
6096,22,bed,23,1,3763,46,808,450,1598,1067,790,617,bed
6097,34,desk,35,1,3763,15,1,699,51,1069,50,370,desk
6098,2,bed,3,1,3764,158,2,244,1825,1648,1823,1404,bed
6099,1,bed,2,0,3765,49,0,105,264,299,264,194,bed
6100,12,bed,11,1,3767,30,109,202,679,532,570,330,bed
6101,8,bed,9,0,3768,56,74,111,179,217,105,106,bed
6102,9,bed,10,0,3768,29,133,127,271,233,138,106,bed
6103,3,bed,4,0,3769,113,122,129,571,387,449,258,bed
6104,7,window,8,0,3769,20,433,28,599,226,166,198,window
6105,2,bed,3,0,3770,69,144,218,630,532,486,314,bed
6106,6,bed,7,0,3771,99,257,199,1259,994,1002,795,bed
6107,20,bed,20,1,3772,32,2,313,549,682,547,369,bed
6108,1,bed,2,0,3773,18,4,75,385,219,381,144,bed
6109,4,table,5,0,3775,16,250,381,542,480,292,99,dining table
6110,0,bed,1,0,3776,18,122,1146,1011,2191,889,1045,bed
6111,8,cup,9,0,3776,18,100,1886,265,2018,165,132,cup
6112,19,plate,20,0,3776,16,74,1950,271,2039,197,89,plate
6113,14,desk,15,0,3777,35,577,275,1175,689,598,414,desk
6114,19,chair,20,0,3777,51,140,459,566,802,426,343,chair
6115,10,bed,9,0,3778,36,10,503,1494,1532,1484,1029,bed
6116,0,remote control,1,0,3779,19,611,1186,1348,1501,737,315,remote
6117,6,bed,7,1,3780,27,200,300,312,412,112,112,bed
6118,8,person,9,0,3780,25,404,314,450,446,46,132,person
6119,7,bed,8,0,3782,30,17,71,180,260,163,189,bed
6120,3,bed,4,0,3783,193,64,187,565,680,501,493,bed
6121,13,book,13,0,3783,15,770,533,853,562,83,29,book
6122,27,window,26,1,3783,17,306,176,369,245,63,69,window
6123,3,bed,4,0,3785,57,99,207,489,499,390,292,bed
6124,3,bed,4,0,3786,62,39,173,310,314,271,141,bed
6125,11,chair,12,0,3786,30,290,165,353,258,63,93,chair
6126,5,bed,6,0,3787,55,95,97,227,208,132,111,bed
6127,13,mirror,14,0,3788,20,52,49,78,98,26,49,mirror
6128,14,sofa,15,1,3788,23,15,183,255,255,240,72,couch
6129,28,bottle,27,0,3789,15,222,534,255,633,33,99,bottle
6130,2,bed,3,0,3790,36,93,106,303,201,210,95,bed
6131,5,bed,6,1,3791,61,0,106,230,249,230,143,bed
6132,4,bed,5,0,3792,31,63,134,248,239,185,105,bed
6133,4,bed,5,1,3793,31,324,990,2045,1534,1721,544,bed
6134,5,backpack,6,1,3793,20,900,835,1085,1055,185,220,backpack
6135,8,window,9,1,3793,15,269,212,660,854,391,642,window
6136,6,bed,7,0,3794,18,2,141,128,224,126,83,bed
6137,5,bed,5,0,3796,46,219,515,1469,1359,1250,844,bed
6138,8,bed,9,1,3797,34,0,713,1162,1647,1162,934,bed
6139,10,bed,11,0,3798,68,138,283,534,561,396,278,bed
6140,21,chair,20,1,3798,39,592,478,930,620,338,142,chair
6141,8,bed,9,1,3799,22,189,95,299,225,110,130,bed
6142,7,bed,8,0,3800,31,147,132,267,202,120,70,bed
6143,2,bed,3,0,3801,25,2,67,256,255,254,188,bed
6144,6,table,7,1,3801,16,94,95,148,113,54,18,dining table
6145,19,bed,19,0,3802,59,80,262,596,532,516,270,bed
6146,3,bed,4,1,3803,94,0,101,656,455,656,354,bed
6147,3,bed,4,0,3804,35,2,322,669,679,667,357,bed
6148,32,bed,33,0,3805,207,496,393,972,773,476,380,bed
6149,33,bed,34,1,3805,197,12,386,560,899,548,513,bed
6150,48,plate,49,0,3805,15,258,265,301,309,43,44,plate
6151,10,bed,10,0,3806,95,219,130,659,448,440,318,bed
6152,11,hat,12,0,3807,17,295,302,343,339,48,37,hat
6153,13,bed,14,1,3807,64,0,293,642,596,642,303,bed
6154,5,window,5,0,3808,21,89,18,473,454,384,436,window
6155,9,bed,9,0,3808,41,180,343,738,660,558,317,bed
6156,2,chair,3,0,3809,31,846,1111,1211,1576,365,465,chair
6157,19,bed,18,1,3809,19,2,1330,1088,1580,1086,250,bed
6158,12,bed,13,1,3810,44,0,574,1763,1647,1763,1073,bed
6159,7,bed,8,0,3811,20,474,166,640,446,166,280,bed
6160,6,bed,6,0,3812,184,57,18,1130,822,1073,804,bed
6161,14,bed,15,1,3813,20,2,642,959,1437,957,795,bed
6162,5,bed,6,1,3814,55,164,332,2136,953,1972,621,bed
6163,5,bed,6,1,3815,19,141,137,255,221,114,84,bed
6164,9,chair,10,1,3815,25,91,135,158,235,67,100,chair
6165,12,bed,13,0,3816,68,11,88,246,239,235,151,bed
6166,7,window,6,0,3817,18,649,146,771,314,122,168,window
6167,18,bed,16,0,3817,56,0,279,540,652,540,373,bed
6168,6,bed,7,0,3820,52,300,569,1673,1408,1373,839,bed
6169,10,table,9,0,3820,25,1281,1226,2074,1647,793,421,dining table
6170,4,bed,5,0,3821,30,0,595,958,1279,958,684,bed
6171,5,bed,6,1,3821,19,406,992,959,1278,553,286,bed
6172,7,bed,8,0,3822,42,683,792,1888,1533,1205,741,bed
6173,3,bed,4,0,3823,41,107,88,315,237,208,149,bed
6174,13,chair,14,0,3823,20,101,105,139,169,38,64,chair
6175,3,bed,4,0,3824,32,185,200,555,405,370,205,bed
6176,3,bed,4,1,3825,30,0,128,292,239,292,111,bed
6177,6,bed,5,0,3826,33,2,267,886,838,884,571,bed
6178,3,bed,4,0,3827,51,54,120,294,249,240,129,bed
6179,6,bed,7,0,3828,36,137,151,276,218,139,67,bed
6180,13,table,14,1,3828,19,53,194,127,229,74,35,dining table
6181,6,sofa,7,1,3829,28,217,139,435,282,218,143,couch
6182,4,bed,5,1,3830,21,254,700,1354,907,1100,207,bed
6183,9,mirror,9,0,3830,19,108,348,292,603,184,255,mirror
6184,13,bed,12,0,3831,50,342,358,1722,1422,1380,1064,bed
6185,5,bed,6,0,3832,80,185,82,639,479,454,397,bed
6186,8,bed,8,1,3833,19,448,427,999,816,551,389,bed
6187,6,bed,6,1,3834,21,0,575,814,899,814,324,bed
6188,7,bed,7,0,3834,55,416,493,1187,890,771,397,bed
6189,11,sofa,11,0,3835,18,2,350,269,550,267,200,couch
6190,8,bed,8,1,3837,35,0,753,1608,1534,1608,781,bed
6191,8,bed,9,0,3839,73,109,51,267,160,158,109,bed
6192,6,chair,7,0,3840,18,37,121,69,175,32,54,chair
6193,9,bed,10,0,3840,44,41,140,253,247,212,107,bed
6194,6,bed,6,0,3841,71,93,395,461,626,368,231,bed
6195,5,bed,6,0,3843,48,31,141,255,255,224,114,bed
6196,2,bed,3,1,3844,23,2,1220,285,1648,283,428,bed
6197,5,bed,5,0,3844,98,210,811,1358,1649,1148,838,bed
6198,13,chair,13,1,3844,35,1630,1172,1945,1649,315,477,chair
6199,0,bed,1,0,3845,24,1,93,197,243,196,150,bed
6200,5,bed,6,1,3846,102,48,508,1375,1198,1327,690,bed
6201,8,bed,9,0,3846,89,746,473,1598,1101,852,628,bed
6202,12,bed,11,0,3847,63,301,422,1029,793,728,371,bed
6203,23,vase,21,1,3847,15,338,457,391,532,53,75,vase
6204,2,bed,3,1,3848,26,2,157,317,336,315,179,bed
6205,10,bed,8,0,3849,73,395,736,1988,1531,1593,795,bed
6206,5,bed,6,0,3850,29,60,102,268,216,208,114,bed
6207,6,chair,7,0,3850,29,19,104,69,175,50,71,chair
6208,13,bed,12,0,3851,58,193,264,709,532,516,268,bed
6209,18,bed,19,1,3852,43,269,475,1199,801,930,326,bed
6210,2,window,3,0,3853,38,21,89,317,376,296,287,window
6211,9,bed,9,0,3853,108,254,189,695,520,441,331,bed
6212,18,sofa,17,0,3853,31,147,280,263,384,116,104,couch
6213,3,bed,4,0,3854,23,49,125,190,210,141,85,bed
6214,6,bed,7,1,3855,39,2,114,256,225,254,111,bed
6215,8,bed,9,0,3856,64,12,153,955,998,943,845,bed
6216,9,bed,10,0,3857,41,0,70,203,240,203,170,bed
6217,14,bed,15,1,3857,37,74,68,289,239,215,171,bed
6218,5,bed,4,1,3858,72,335,573,865,1167,530,594,bed
6219,9,sofa,7,0,3858,98,662,686,1493,1288,831,602,couch
6220,28,window,25,0,3858,17,82,250,299,657,217,407,window
6221,7,bed,8,0,3859,52,113,170,433,426,320,256,bed
6222,0,bed,1,0,3862,35,0,16,318,228,318,212,bed
6223,8,chair,9,0,3862,21,234,32,282,64,48,32,chair
6224,17,bed,18,0,3863,40,108,415,978,1078,870,663,bed
6225,1,bed,2,1,3864,31,2,134,171,299,169,165,bed
6226,2,window,3,0,3864,19,169,1,299,254,130,253,window
6227,5,bed,6,0,3865,17,119,29,253,175,134,146,bed
6228,11,vase,12,0,3866,18,829,416,877,486,48,70,vase
6229,21,bed,20,0,3866,53,164,452,628,706,464,254,bed
6230,6,bed,7,0,3867,37,1109,560,2083,1277,974,717,bed
6231,6,bed,7,1,3868,33,0,155,90,252,90,97,bed
6232,2,bed,3,1,3869,25,329,152,644,299,315,147,bed
6233,3,suitcase,4,0,3869,16,477,170,626,232,149,62,suitcase
6234,4,bed,5,1,3869,20,663,196,799,371,136,175,bed
6235,10,table,9,1,3869,22,289,265,471,520,182,255,dining table
6236,11,chair,10,0,3869,25,428,247,568,488,140,241,chair
6237,15,suitcase,14,1,3869,25,2,402,240,597,238,195,suitcase
6238,5,bed,6,1,3870,30,0,163,213,299,213,136,bed
6239,1,bed,2,1,3871,22,98,136,271,240,173,104,bed
6240,3,bed,4,0,3872,113,45,150,248,335,203,185,bed
6241,3,bed,4,1,3873,46,600,431,1630,1223,1030,792,bed
6242,7,bed,8,0,3874,57,6,30,228,241,222,211,bed
6243,3,bed,4,0,3875,29,152,147,466,320,314,173,bed
6244,6,bed,7,1,3875,17,248,229,512,417,264,188,bed
6245,1,bed,2,0,3876,66,957,613,2132,1378,1175,765,bed
6246,3,bed,4,1,3876,22,1719,1139,2158,1438,439,299,bed
6247,7,chair,8,0,3876,51,645,755,1012,1297,367,542,chair
6248,10,chair,11,1,3877,15,45,171,138,256,93,85,chair
6249,3,bed,4,0,3878,100,2,786,1335,2198,1333,1412,bed
6250,13,window,13,1,3878,20,586,389,1249,836,663,447,window
6251,0,bed,1,0,3879,23,2,43,188,201,186,158,bed
6252,6,bed,6,0,3880,47,23,273,814,656,791,383,bed
6253,4,bed,5,1,3882,23,96,88,162,224,66,136,bed
6254,9,sofa,10,1,3882,20,216,145,510,364,294,219,couch
6255,10,table,11,0,3882,51,167,180,472,365,305,185,dining table
6256,1,bed,2,0,3883,61,105,102,611,426,506,324,bed
6257,1,bed,2,0,3884,16,5,764,1479,1540,1474,776,bed
6258,5,bed,5,1,3885,31,2,427,1465,2196,1463,1769,bed
6259,2,bed,3,0,3886,73,193,110,728,532,535,422,bed
6260,5,window,6,0,3886,18,666,37,777,314,111,277,window
6261,6,bed,7,0,3887,46,12,94,255,255,243,161,bed
6262,6,bed,7,1,3888,23,0,766,792,1054,792,288,bed
6263,1,window,2,0,3889,15,73,7,162,162,89,155,window
6264,7,bed,8,1,3889,47,108,89,287,215,179,126,bed
6265,6,bed,7,1,3890,32,64,399,994,767,930,368,bed
6266,4,bed,5,0,3891,33,51,123,189,256,138,133,bed
6267,6,chair,7,0,3891,23,103,202,135,269,32,67,chair
6268,10,chair,11,0,3891,18,190,184,210,220,20,36,chair
6269,12,bed,13,1,3892,26,2,136,119,181,117,45,bed
6270,14,bed,15,1,3892,23,175,132,278,164,103,32,bed
6271,15,bed,16,1,3892,24,186,139,298,182,112,43,bed
6272,16,bed,17,1,3892,19,182,169,299,265,117,96,bed
6273,4,bed,5,0,3893,40,31,142,250,242,219,100,bed
6274,5,bed,5,0,3894,114,354,590,1633,1315,1279,725,bed
6275,15,television,14,0,3894,16,1560,356,1710,511,150,155,tv
6276,76,mirror,74,0,3894,26,1858,185,2194,686,336,501,mirror
6277,2,bed,3,1,3895,16,107,126,196,286,89,160,bed
6278,6,sofa,7,0,3895,36,275,164,505,320,230,156,couch
6279,7,table,8,1,3895,20,217,224,342,333,125,109,dining table
6280,12,table,13,1,3895,22,1,281,256,465,255,184,dining table
6281,13,chair,14,0,3895,17,198,236,271,465,73,229,chair
6282,14,chair,15,1,3895,25,43,306,249,465,206,159,chair
6283,13,bed,13,0,3896,29,1,273,1023,771,1022,498,bed
6284,9,bed,10,0,3897,22,258,652,1234,1160,976,508,bed
6285,5,bed,6,1,3898,43,458,991,1534,2045,1076,1054,bed
6286,6,bed,6,1,3899,30,70,370,655,871,585,501,bed
6287,8,bed,8,1,3899,30,574,332,938,737,364,405,bed
6288,8,bed,7,1,3900,33,0,394,1168,959,1168,565,bed
6289,5,bed,6,0,3901,96,292,250,944,765,652,515,bed
6290,11,mirror,12,0,3901,44,647,136,771,311,124,175,mirror
6291,7,window,7,1,3902,18,471,206,523,367,52,161,window
6292,23,bed,23,0,3902,33,199,281,772,622,573,341,bed
6293,2,bed,3,0,3903,43,311,198,1216,799,905,601,bed
6294,15,bed,14,1,3904,66,207,422,963,830,756,408,bed
6295,5,bed,6,0,3906,94,2,178,1023,767,1021,589,bed
6296,5,bed,5,0,3907,18,1290,673,2196,1647,906,974,bed
6297,7,bed,7,1,3907,40,2,623,916,1649,914,1026,bed
6298,7,bed,6,1,3908,28,326,773,2197,1647,1871,874,bed
6299,9,bed,10,1,3909,28,2,301,471,637,469,336,bed
6300,12,bed,12,1,3910,74,124,272,978,665,854,393,bed
6301,8,chair,9,1,3911,17,32,131,99,195,67,64,chair
6302,4,bed,5,1,3912,93,905,163,1598,1094,693,931,bed
6303,10,bed,11,1,3913,43,0,171,1023,767,1023,596,bed
6304,12,bed,13,0,3913,74,0,119,670,711,670,592,bed
6305,10,bed,11,1,3914,41,160,576,959,1276,799,700,bed
6306,2,bed,3,0,3915,40,72,113,257,229,185,116,bed
6307,8,table,9,0,3916,32,176,373,349,517,173,144,dining table
6308,12,mirror,13,0,3916,17,608,254,679,367,71,113,mirror
6309,14,chair,15,0,3916,34,517,343,610,482,93,139,chair
6310,4,bed,5,0,3917,51,448,387,959,755,511,368,bed
6311,7,bed,8,0,3917,78,2,413,525,829,523,416,bed
6312,5,window,6,0,3918,16,402,156,482,436,80,280,window
6313,16,bed,15,0,3918,43,62,329,742,670,680,341,bed
6314,14,bed,14,0,3919,73,168,275,760,640,592,365,bed
6315,7,bed,8,1,3920,26,154,771,1109,1198,955,427,bed
6316,9,bed,10,0,3920,30,638,687,1598,1198,960,511,bed
6317,6,bed,7,0,3921,39,212,693,1102,1340,890,647,bed
6318,2,bed,3,0,3922,19,3,152,1221,1122,1218,970,bed
6319,11,bed,10,1,3923,43,147,319,829,679,682,360,bed
6320,7,bed,7,0,3924,73,618,272,1245,852,627,580,bed
6321,8,bed,8,0,3924,76,31,278,808,969,777,691,bed
6322,11,window,11,0,3924,32,310,89,635,384,325,295,window
6323,0,bed,1,0,3925,15,2,1036,2199,1650,2197,614,bed
6324,4,desk,4,0,3925,17,557,686,2130,1391,1573,705,desk
6325,5,chair,5,0,3925,23,1277,680,1619,1269,342,589,chair
6326,4,person,5,1,3926,21,2,161,57,310,55,149,person
6327,13,bed,14,0,3926,46,2,182,409,374,407,192,bed
6328,1,bed,2,0,3927,71,114,406,1632,1536,1518,1130,bed
6329,12,chair,12,1,3927,16,3,542,112,1092,109,550,chair
6330,7,bed,8,0,3928,43,148,205,372,355,224,150,bed
6331,14,bed,15,0,3928,58,0,203,344,446,344,243,bed
6332,19,chair,20,1,3928,27,410,229,466,325,56,96,chair
6333,10,bed,11,0,3929,62,371,323,885,652,514,329,bed
6334,5,bed,6,0,3930,23,4,186,344,318,340,132,bed
6335,8,bed,9,1,3931,20,7,888,511,1647,504,759,bed
6336,7,table,8,0,3932,26,94,175,121,218,27,43,dining table
6337,10,bed,11,0,3933,75,476,296,890,607,414,311,bed
6338,24,flowerpot,23,0,3933,15,928,317,957,356,29,39,potted plant
6339,3,bed,4,0,3934,39,1,209,512,418,511,209,bed
6340,1,bed,2,1,3937,16,884,795,2039,1534,1155,739,bed
6341,2,bed,3,1,3938,50,123,120,255,255,132,135,bed
6342,19,bed,17,0,3939,49,415,433,1027,934,612,501,bed
6343,6,bed,7,1,3940,55,0,76,255,255,255,179,bed
6344,7,bed,8,0,3941,59,378,534,1382,1198,1004,664,bed
6345,0,bed,1,0,3942,17,144,140,256,219,112,79,bed
6346,6,bed,6,0,3943,36,0,484,1467,1648,1467,1164,bed
6347,4,bed,5,1,3944,40,0,181,1021,765,1021,584,bed
6348,8,bed,9,0,3945,49,481,449,1233,1018,752,569,bed
6349,10,bed,11,1,3945,28,2,451,1027,1124,1025,673,bed
6350,4,bed,5,0,3946,69,35,93,251,242,216,149,bed
6351,20,bed,18,0,3947,46,266,291,719,571,453,280,bed
6352,9,bed,9,0,3948,43,0,153,1804,1648,1804,1495,bed
6353,6,bed,6,0,3949,64,2,679,1856,1647,1854,968,bed
6354,7,bed,8,0,3951,37,34,106,222,255,188,149,bed
6355,7,bed,8,1,3952,79,1309,352,1982,1408,673,1056,bed
6356,8,bed,9,0,3952,81,19,346,1305,1406,1286,1060,bed
6357,16,bed,17,0,3953,43,324,230,679,469,355,239,bed
6358,3,sofa,4,1,3954,15,0,134,86,189,86,55,couch
6359,8,bed,9,1,3954,16,0,184,147,255,147,71,bed
6360,3,window,4,0,3955,19,457,371,981,952,524,581,window
6361,8,bed,9,0,3955,50,744,512,1662,1299,918,787,bed
6362,1,bed,2,1,3956,17,0,370,962,1672,962,1302,bed
6363,7,glasses,7,0,3956,26,1038,1018,1229,1073,191,55,eye glasses
6364,1,bed,2,0,3957,15,122,112,255,242,133,130,bed
6365,10,chair,11,0,3957,55,30,153,112,254,82,101,chair
6366,5,chair,6,0,3958,31,5,147,92,255,87,108,chair
6367,8,window,9,1,3958,20,24,0,123,156,99,156,window
6368,12,bed,13,1,3959,21,352,1123,1199,1596,847,473,bed
6369,4,table,5,0,3960,16,40,210,288,271,248,61,dining table
6370,1,bed,2,1,3961,17,411,149,510,373,99,224,bed
6371,2,bed,3,0,3961,19,196,183,415,270,219,87,bed
6372,3,chair,4,1,3961,20,216,229,270,316,54,87,chair
6373,4,table,5,0,3961,19,168,233,260,332,92,99,dining table
6374,7,bed,8,0,3962,31,56,60,510,382,454,322,bed
6375,5,bed,6,0,3963,45,368,268,737,523,369,255,bed
6376,3,bed,4,0,3964,41,99,251,585,590,486,339,bed
6377,10,bed,11,0,3965,26,40,117,252,279,212,162,bed
6378,2,mirror,3,0,3966,18,29,43,69,124,40,81,mirror
6379,3,bed,4,0,3966,15,108,86,299,226,191,140,bed
6380,4,window,5,0,3966,16,0,1,75,73,75,72,window
6381,9,bed,10,1,3967,33,0,101,300,224,300,123,bed
6382,0,bed,1,0,3969,40,58,185,264,352,206,167,bed
6383,1,bed,2,1,3969,75,0,170,184,341,184,171,bed
6384,13,chair,14,1,3969,18,42,182,92,225,50,43,chair
6385,2,bed,3,0,3970,31,4,733,1687,1650,1683,917,bed
6386,0,bed,1,0,3972,39,52,50,254,255,202,205,bed
6387,1,chair,2,0,3972,17,0,136,60,249,60,113,chair
6388,8,bed,9,0,3973,20,6,421,1163,1247,1157,826,bed
6389,5,bed,6,0,3974,117,103,113,423,337,320,224,bed
6390,6,bed,7,1,3974,49,20,174,286,354,266,180,bed
6391,3,bed,4,0,3975,19,2,135,210,225,208,90,bed
6392,8,bed,9,0,3976,24,51,123,196,203,145,80,bed
6393,38,mirror,39,0,3978,38,1,1,541,439,540,438,mirror
6394,45,sofa,46,1,3978,42,594,257,765,403,171,146,couch
6395,54,sofa,55,1,3978,51,731,242,1022,342,291,100,couch
6396,60,bed,61,0,3978,145,96,225,1017,768,921,543,bed
6397,69,mirror,69,0,3978,17,1,502,102,568,101,66,mirror
6398,71,vase,71,0,3978,23,1,574,76,712,75,138,vase
6399,5,sofa,6,0,3979,24,2,174,241,335,239,161,couch
6400,7,bed,6,0,3982,31,681,647,2046,1537,1365,890,bed
6401,1,bed,1,0,3984,51,58,382,1881,1636,1823,1254,bed
6402,12,bed,13,0,3986,28,415,510,1115,1021,700,511,bed
6403,13,sofa,14,0,3986,22,502,714,1047,1018,545,304,couch
6404,8,chair,9,1,3987,19,637,393,800,600,163,207,chair
6405,10,bed,10,1,3987,28,2,229,500,596,498,367,bed
6406,6,bed,7,0,3989,23,2,204,315,382,313,178,bed
6407,4,bed,5,0,3990,76,76,49,242,225,166,176,bed
6408,1,bed,2,0,3991,21,34,113,213,257,179,144,bed
6409,0,bed,1,0,3992,29,224,283,1981,1484,1757,1201,bed
6410,1,bed,2,0,3994,34,4,85,227,233,223,148,bed
6411,2,sofa,3,0,3995,35,16,117,202,207,186,90,couch
6412,8,bed,9,0,3996,33,611,746,2067,1646,1456,900,bed
6413,46,window,43,0,3996,32,720,433,1357,765,637,332,window
6414,3,bed,4,1,3997,26,201,168,512,411,311,243,bed
6415,4,bed,5,0,3998,54,3,118,242,274,239,156,bed
6416,0,bed,1,0,4000,16,105,69,229,210,124,141,bed
6417,0,bed,1,0,4001,22,0,85,210,248,210,163,bed
6418,0,bed,1,0,4002,29,35,105,256,247,221,142,bed
6419,2,bed,3,0,4003,23,95,145,269,218,174,73,bed
6420,10,bed,10,0,4004,28,64,182,444,366,380,184,bed
6421,3,chair,3,0,4006,18,862,706,1427,1484,565,778,chair
6422,1,bed,2,0,4007,18,2,260,609,479,607,219,bed
6423,0,bed,1,0,4008,25,8,63,511,383,503,320,bed
6424,0,bed,1,0,4009,42,11,71,206,240,195,169,bed
6425,12,bed,13,0,4010,19,25,92,179,173,154,81,bed
6426,0,bed,1,0,4011,19,95,75,298,225,203,150,bed
6427,1,mirror,2,0,4011,20,2,1,76,153,74,152,mirror
6428,4,chair,5,0,4012,24,91,147,129,220,38,73,chair
6429,7,bed,8,1,4012,16,2,173,497,367,495,194,bed
6430,53,bed,53,0,4014,107,333,286,859,635,526,349,bed
6431,90,mirror,90,0,4014,63,52,192,194,419,142,227,mirror
6432,8,bed,8,1,4015,32,2,430,1868,1532,1866,1102,bed
6433,8,bed,9,1,4016,28,0,174,169,255,169,81,bed
6434,9,bed,10,1,4016,25,203,173,255,255,52,82,bed
6435,11,chair,12,0,4016,19,157,162,180,209,23,47,chair
6436,18,door,19,0,4016,17,226,114,245,186,19,72,door
6437,1,bed,2,0,4017,22,113,135,360,275,247,140,bed
6438,16,bed,17,0,4020,30,308,262,637,479,329,217,bed
6439,6,bed,7,0,4022,27,81,129,228,224,147,95,bed
6440,13,chair,14,1,4022,21,10,161,99,253,89,92,chair
6441,0,bed,1,0,4023,27,104,34,255,227,151,193,bed
6442,8,bed,8,0,4024,44,74,214,530,448,456,234,bed
6443,4,bed,5,0,4025,45,104,145,473,384,369,239,bed
6444,5,table,6,0,4026,43,240,149,291,206,51,57,dining table
6445,18,bed,19,1,4026,16,118,107,226,190,108,83,bed
6446,19,bed,20,0,4026,22,0,105,178,235,178,130,bed
6447,5,bed,6,1,4027,24,89,35,299,224,210,189,bed
6448,0,bed,1,0,4028,29,55,106,382,264,327,158,bed
6449,8,bed,9,1,4029,22,188,142,256,228,68,86,bed
6450,2,mirror,3,0,4031,16,54,16,126,126,72,110,mirror
6451,4,bed,5,0,4031,21,200,110,490,293,290,183,bed
6452,13,bench,14,0,4031,27,180,211,361,308,181,97,bench
6453,1,bed,2,0,4032,44,2,175,319,377,317,202,bed
6454,3,bed,4,0,4034,46,99,54,312,240,213,186,bed
6455,5,person,6,1,4034,18,110,77,166,129,56,52,person
6456,1,bed,2,0,4035,36,114,118,447,308,333,190,bed
6457,5,bed,6,0,4036,19,79,90,256,254,177,164,bed
6458,8,bed,9,0,4037,39,1,62,212,247,211,185,bed
6459,1,bed,1,1,4038,49,391,357,1119,767,728,410,bed
6460,3,bed,4,0,4039,26,50,170,231,256,181,86,bed
6461,2,bed,3,0,4040,30,707,499,2048,1536,1341,1037,bed
6462,12,backpack,12,0,4040,19,879,567,1259,814,380,247,backpack
6463,2,bed,3,0,4041,24,37,89,184,208,147,119,bed
6464,17,bed,18,1,4042,32,661,635,1868,1650,1207,1015,bed
6465,29,vase,30,0,4042,21,138,1132,256,1344,118,212,vase
6466,2,bed,3,1,4043,33,5,416,2039,1538,2034,1122,bed
6467,1,chair,2,0,4044,18,956,535,1159,769,203,234,chair
6468,6,bed,6,0,4044,40,335,491,804,862,469,371,bed
6469,5,bed,6,0,4045,23,90,122,256,255,166,133,bed
6470,6,bed,7,0,4045,22,23,105,192,216,169,111,bed
6471,1,mirror,2,0,4047,23,372,40,464,155,92,115,mirror
6472,7,bed,8,1,4047,39,58,119,510,410,452,291,bed
6473,0,bed,1,0,4048,24,1,109,438,384,437,275,bed
6474,15,bed,16,1,4049,15,2,169,508,338,506,169,bed
6475,4,backpack,5,0,4050,15,753,1141,1108,1529,355,388,backpack
6476,9,bed,10,0,4052,54,138,229,828,941,690,712,bed
6477,3,bed,4,0,4054,30,14,55,284,225,270,170,bed
6478,6,person,7,1,4055,15,2,162,58,314,56,152,person
6479,7,bed,8,1,4055,31,0,184,408,374,408,190,bed
6480,0,mirror,1,0,4056,18,13,36,60,105,47,69,mirror
6481,8,bed,9,0,4056,25,81,72,255,202,174,130,bed
6482,11,window,12,0,4056,18,22,1,76,104,54,103,window
6483,0,sofa,1,0,4057,66,67,122,188,223,121,101,couch
6484,4,bed,5,0,4057,65,29,94,127,192,98,98,bed
6485,6,bed,7,0,4058,32,72,148,330,296,258,148,bed
6486,10,table,11,0,4058,25,311,187,381,265,70,78,dining table
6487,11,chair,12,1,4058,17,372,182,423,269,51,87,chair
6488,7,bed,8,0,4059,38,157,751,1100,1333,943,582,bed
6489,5,bed,6,0,4060,48,61,568,2008,1643,1947,1075,bed
6490,2,bed,3,1,4061,15,810,615,1648,2200,838,1585,bed
6491,0,bed,1,0,4062,37,18,109,215,171,197,62,bed
6492,4,bed,5,1,4063,47,144,150,510,471,366,321,bed
6493,11,bed,10,0,4064,33,195,482,1718,1449,1523,967,bed
6494,18,clock,16,0,4064,17,683,670,739,747,56,77,clock
6495,2,bed,3,0,4065,60,37,93,251,243,214,150,bed
6496,12,bed,13,0,4066,41,19,65,253,221,234,156,bed
6497,2,bed,3,0,4067,16,100,139,348,317,248,178,bed
6498,0,bed,1,0,4068,39,391,209,2048,1535,1657,1326,bed
6499,8,suitcase,9,0,4068,16,1535,474,1720,846,185,372,suitcase
6500,6,bed,7,0,4069,43,39,107,203,212,164,105,bed
6501,4,bed,5,0,4070,31,47,638,1842,1650,1795,1012,bed
6502,1,table,2,0,4071,19,90,153,150,165,60,12,dining table
6503,6,bed,7,1,4071,21,0,111,256,255,256,144,bed
6504,0,chair,1,0,4072,26,35,193,80,246,45,53,chair
6505,3,bed,4,0,4073,23,194,571,1703,1523,1509,952,bed
6506,4,bed,5,0,4074,44,14,135,500,368,486,233,bed
6507,0,bed,1,0,4075,31,75,92,236,188,161,96,bed
6508,2,bed,3,1,4076,30,2,145,510,339,508,194,bed
6509,11,bed,12,0,4077,27,72,162,487,424,415,262,bed
6510,1,chair,2,0,4078,21,878,663,1184,1365,306,702,chair
6511,2,chair,3,0,4078,33,1117,603,1513,1148,396,545,chair
6512,3,television,4,0,4078,19,347,480,759,932,412,452,tv
6513,3,bed,4,0,4079,23,165,101,424,275,259,174,bed
6514,2,bed,3,0,4080,23,195,579,1248,958,1053,379,bed
6515,12,chair,12,0,4081,18,358,242,426,344,68,102,chair
6516,25,chair,25,0,4081,34,439,222,502,322,63,100,chair
6517,31,table,31,0,4081,31,359,224,456,330,97,106,dining table
6518,3,bed,3,1,4082,15,448,896,2048,1535,1600,639,bed
6519,2,bed,3,1,4083,16,928,295,2047,1533,1119,1238,bed
6520,7,bed,7,1,4083,16,5,281,448,1536,443,1255,bed
6521,13,bed,13,1,4085,31,3,127,869,1535,866,1408,bed
6522,14,bed,14,1,4085,32,1547,85,2048,1535,501,1450,bed
6523,1,bed,2,0,4086,19,232,592,1437,1383,1205,791,bed
6524,11,bed,11,0,4087,54,95,96,695,468,600,372,bed
6525,0,bed,1,0,4088,52,0,52,204,230,204,178,bed
6526,2,bed,2,1,4089,16,1710,613,2048,1529,338,916,bed
6527,3,bed,3,0,4089,57,210,277,1516,1533,1306,1256,bed
6528,0,bed,1,0,4090,19,0,151,139,229,139,78,bed
6529,5,sofa,6,0,4090,16,182,174,256,254,74,80,couch
6530,0,bed,1,0,4091,20,370,1050,2198,1647,1828,597,bed
6531,1,bed,2,0,4092,16,39,258,792,532,753,274,bed
6532,10,chair,10,0,4092,20,718,176,777,288,59,112,chair
6533,1,bench,2,0,4093,18,793,730,1161,1124,368,394,bench
6534,2,person,3,0,4093,23,243,644,874,1419,631,775,person
6535,25,door,26,0,4093,17,1385,920,1743,1342,358,422,door
6536,1,bed,2,0,4094,19,1,134,125,255,124,121,bed
6537,0,bed,1,0,4095,20,19,132,255,254,236,122,bed
6538,6,bed,7,0,4096,55,127,111,255,250,128,139,bed
6539,2,bed,3,0,4097,22,81,155,219,232,138,77,bed
6540,1,bed,2,0,4098,44,97,61,256,255,159,194,bed
6541,1,bed,2,0,4099,17,15,110,189,236,174,126,bed
6542,9,bench,10,0,4099,16,211,150,242,181,31,31,bench
6543,10,desk,11,0,4099,17,185,130,255,181,70,51,desk
6544,9,bed,10,1,4100,21,83,73,255,256,172,183,bed
6545,2,bed,3,0,4101,37,64,107,551,452,487,345,bed
6546,3,bed,4,0,4101,42,146,109,788,561,642,452,bed
6547,0,bed,1,1,4102,46,425,384,1056,810,631,426,bed
6548,5,bed,6,0,4103,59,113,143,396,334,283,191,bed
6549,1,desk,2,0,4105,25,161,167,581,340,420,173,desk
6550,10,bed,11,0,4106,21,79,116,299,225,220,109,bed
6551,1,bed,2,0,4107,18,84,15,229,239,145,224,bed
6552,31,chair,32,1,4107,36,0,137,32,201,32,64,chair
6553,3,bed,2,0,4108,21,10,506,1547,1650,1537,1144,bed
6554,2,bed,3,0,4109,30,33,70,299,240,266,170,bed
6555,5,bed,6,0,4112,18,278,197,639,479,361,282,bed
6556,10,bed,11,0,4113,192,0,188,2002,1535,2002,1347,bed
6557,10,table,11,0,4114,19,176,71,203,115,27,44,dining table
6558,11,table,12,0,4114,23,197,70,232,124,35,54,dining table
6559,3,bed,4,0,4115,20,50,116,200,210,150,94,bed
6560,20,bench,21,0,4115,28,27,146,56,197,29,51,bench
6561,12,bed,13,0,4116,20,110,117,270,225,160,108,bed
6562,2,bed,3,0,4117,37,36,91,256,255,220,164,bed
6563,4,bed,5,0,4118,21,241,114,510,425,269,311,bed
6564,5,chair,6,0,4118,28,6,157,142,354,136,197,chair
6565,5,bed,5,0,4119,32,69,120,286,224,217,104,bed
6566,13,table,14,0,4120,16,234,154,300,218,66,64,dining table
6567,3,bed,4,0,4122,15,19,102,319,240,300,138,bed
6568,7,bed,6,0,4123,42,2,244,1665,1537,1663,1293,bed
6569,2,bed,3,0,4125,25,2,151,185,248,183,97,bed
6570,1,bed,2,0,4126,31,89,147,332,273,243,126,bed
6571,27,mirror,27,0,4127,20,474,308,544,434,70,126,mirror
6572,33,bed,33,0,4127,77,355,322,734,531,379,209,bed
6573,49,sofa,49,1,4127,36,0,535,371,863,371,328,couch
6574,51,desk,51,1,4127,51,798,490,1151,864,353,374,desk
6575,0,vase,1,0,4128,17,204,198,245,256,41,58,vase
6576,1,vase,2,0,4128,18,175,215,205,255,30,40,vase
6577,14,bed,15,0,4128,43,23,105,179,208,156,103,bed
6578,15,table,16,1,4128,18,139,234,252,254,113,20,dining table
6579,11,door,12,1,4129,26,607,171,773,610,166,439,door
6580,12,window,13,0,4129,21,115,136,393,570,278,434,window
6581,14,mirror,15,0,4129,42,59,293,197,659,138,366,mirror
6582,18,chair,19,1,4129,20,952,699,1166,959,214,260,chair
6583,19,bed,20,0,4129,50,50,493,1086,960,1036,467,bed
6584,10,bed,11,0,4130,75,245,205,1042,756,797,551,bed
6585,2,bed,3,0,4131,36,18,709,1257,1442,1239,733,bed
6586,8,table,9,1,4132,17,521,334,627,397,106,63,dining table
6587,11,bed,12,0,4132,22,2,229,358,484,356,255,bed
6588,27,bed,28,0,4133,123,308,212,1327,905,1019,693,bed
6589,40,bottle,41,1,4133,22,897,396,940,499,43,103,bottle
6590,15,bed,16,0,4134,22,89,117,213,199,124,82,bed
6591,5,bed,6,1,4135,35,237,106,477,606,240,500,bed
6592,11,bed,11,0,4136,68,271,90,511,374,240,284,bed
6593,27,bowl,28,0,4137,26,118,503,191,555,73,52,bowl
6594,29,bed,30,0,4137,169,266,253,1023,768,757,515,bed
6595,34,window,35,1,4137,107,324,55,625,375,301,320,window
6596,0,chair,1,0,4139,24,19,125,82,192,63,67,chair
6597,3,bed,4,0,4139,17,81,127,255,253,174,126,bed
6598,8,bed,9,0,4140,17,42,175,355,374,313,199,bed
6599,1,sink,2,0,4141,16,358,228,406,261,48,33,sink
6600,16,table,13,0,4141,15,131,244,276,345,145,101,dining table
6601,6,bed,7,0,4142,19,0,390,832,689,832,299,bed
6602,19,clock,19,0,4142,17,102,388,134,430,32,42,clock
6603,3,bed,4,0,4143,21,287,261,1864,1534,1577,1273,bed
6604,4,bed,5,0,4143,17,1214,257,2041,1047,827,790,bed
6605,8,bed,9,0,4144,26,64,67,192,140,128,73,bed
6606,9,table,10,0,4144,16,180,72,205,96,25,24,dining table
6607,3,bed,4,0,4145,18,33,109,402,308,369,199,bed
6608,9,bed,10,1,4146,35,214,133,510,314,296,181,bed
6609,10,bed,11,1,4146,22,342,220,503,375,161,155,bed
6610,5,bed,6,0,4147,20,0,115,166,253,166,138,bed
6611,10,bed,11,0,4148,19,2,122,175,224,173,102,bed
6612,0,sofa,1,0,4149,16,721,610,998,830,277,220,couch
6613,12,desk,12,0,4149,19,450,378,942,660,492,282,desk
6614,3,bed,3,1,4150,30,2,656,889,1534,887,878,bed
6615,3,bed,4,1,4151,15,145,112,256,255,111,143,bed
6616,9,vase,10,0,4151,27,132,104,163,159,31,55,vase
6617,3,bed,4,0,4152,41,58,3,1964,1647,1906,1644,bed
6618,2,bed,3,0,4153,19,122,119,255,247,133,128,bed
6619,9,handbag,10,0,4154,18,403,434,503,573,100,139,handbag
6620,3,bed,4,0,4155,33,44,285,377,449,333,164,bed
6621,2,bed,3,0,4156,15,28,120,203,229,175,109,bed
6622,44,television,45,0,4157,25,556,354,634,439,78,85,tv
6623,46,bed,47,0,4157,64,274,322,558,583,284,261,bed
6624,50,sofa,51,1,4157,61,251,490,1152,863,901,373,couch
6625,56,bowl,57,0,4157,27,524,560,611,605,87,45,bowl
6626,29,bed,30,0,4158,72,439,267,810,478,371,211,bed
6627,38,flowerpot,39,0,4158,26,879,375,937,498,58,123,potted plant
6628,40,sofa,41,0,4158,34,1,345,493,639,492,294,couch
6629,64,vase,65,0,4158,17,452,182,473,244,21,62,vase
6630,1,bed,2,0,4160,200,14,129,223,300,209,171,bed
6631,7,bed,8,0,4162,30,0,79,177,241,177,162,bed
6632,12,bench,13,0,4162,34,79,147,204,255,125,108,bench
6633,4,bed,5,1,4163,15,2,216,623,532,621,316,bed
6634,38,bed,39,0,4164,43,401,366,1124,750,723,384,bed
6635,45,mirror,46,0,4164,32,1,0,192,395,191,395,mirror
6636,46,window,47,0,4164,24,352,216,499,468,147,252,window
6637,51,chair,52,0,4164,46,299,462,433,600,134,138,chair
6638,2,bed,3,0,4165,19,0,95,204,194,204,99,bed
6639,5,bed,6,1,4167,31,186,139,485,316,299,177,bed
6640,6,bed,7,0,4168,65,6,4,153,148,147,144,bed
6641,7,sofa,8,0,4168,21,111,91,196,148,85,57,couch
6642,3,bed,4,0,4169,38,133,156,1023,767,890,611,bed
6643,5,bed,6,0,4170,23,73,121,195,198,122,77,bed
6644,2,bed,3,1,4171,22,163,138,255,255,92,117,bed
6645,3,bed,4,1,4171,22,0,137,92,255,92,118,bed
6646,2,door,3,0,4172,18,426,106,498,347,72,241,door
6647,3,table,4,0,4172,22,75,304,229,348,154,44,dining table
6648,17,chair,18,0,4172,23,85,335,217,478,132,143,chair
6649,6,bed,7,0,4173,31,2,93,398,413,396,320,bed
6650,5,bed,6,0,4174,39,23,99,207,200,184,101,bed
6651,3,bed,4,0,4175,28,92,106,255,209,163,103,bed
6652,14,table,15,0,4176,16,2,149,55,223,53,74,dining table
6653,15,chair,16,0,4176,18,42,165,91,224,49,59,chair
6654,1,bed,2,0,4177,28,9,149,218,256,209,107,bed
6655,4,bed,5,0,4178,40,26,87,256,255,230,168,bed
6656,5,bed,6,1,4178,16,159,93,256,207,97,114,bed
6657,21,window,22,0,4179,32,1,193,201,617,200,424,window
6658,38,bed,39,0,4179,110,320,278,999,750,679,472,bed
6659,49,window,50,0,4179,24,705,231,790,468,85,237,window
6660,14,bed,14,1,4180,81,1,218,843,1189,842,971,bed
6661,30,bed,30,0,4181,73,193,290,826,667,633,377,bed
6662,15,window,16,0,4182,22,537,73,670,362,133,289,window
6663,16,door,17,0,4182,19,289,108,438,344,149,236,door
6664,25,bed,26,0,4182,57,40,307,738,532,698,225,bed
6665,8,bed,9,0,4183,23,0,124,125,256,125,132,bed
6666,9,sofa,10,0,4184,20,326,202,440,259,114,57,couch
6667,11,table,12,0,4184,21,413,225,552,315,139,90,dining table
6668,8,bed,9,0,4185,32,34,267,477,498,443,231,bed
6669,14,chair,15,1,4185,16,606,377,733,499,127,122,chair
6670,23,bed,24,0,4186,53,2,344,969,960,967,616,bed
6671,17,bed,17,1,4187,17,0,849,1772,1533,1772,684,bed
6672,18,bed,18,0,4187,19,1136,760,2046,1501,910,741,bed
6673,0,bed,1,0,4188,34,485,256,1023,765,538,509,bed
6674,12,chair,13,0,4188,17,291,316,393,491,102,175,chair
6675,19,chair,19,1,4188,20,496,363,539,479,43,116,chair
6676,49,bed,50,0,4189,47,563,288,868,477,305,189,bed
6677,60,bed,61,0,4189,37,302,360,753,477,451,117,bed
6678,63,bed,64,0,4189,51,16,212,983,570,967,358,bed
6679,69,window,70,0,4189,25,149,2,308,417,159,415,window
6680,72,window,73,0,4189,29,399,65,512,371,113,306,window
6681,11,bed,12,0,4190,31,87,79,255,208,168,129,bed
6682,22,bench,23,0,4190,21,153,150,255,214,102,64,bench
6683,0,bed,1,0,4192,24,50,64,256,252,206,188,bed
6684,2,bed,3,1,4193,19,0,102,256,255,256,153,bed
6685,5,bed,6,1,4193,22,19,85,170,145,151,60,bed
6686,5,window,6,0,4194,18,747,183,952,461,205,278,window
6687,7,bed,8,0,4194,39,254,334,617,622,363,288,bed
6688,16,sofa,16,0,4194,31,779,382,1023,605,244,223,couch
6689,2,window,3,0,4195,17,79,123,445,414,366,291,window
6690,9,mirror,10,0,4195,20,812,199,1030,364,218,165,mirror
6691,11,bed,12,0,4195,48,135,346,724,628,589,282,bed
6692,9,bed,10,1,4196,30,19,143,300,225,281,82,bed
6693,0,bed,1,1,4197,18,2,99,265,427,263,328,bed
6694,4,bed,5,1,4198,40,2,530,601,768,599,238,bed
6695,3,window,4,1,4199,18,0,2,446,729,446,727,window
6696,7,bed,8,0,4199,59,2,573,1323,1198,1321,625,bed
6697,5,door,6,0,4200,16,979,328,1231,852,252,524,door
6698,7,window,8,0,4200,21,1424,236,2047,913,623,677,window
6699,21,bed,20,0,4200,56,469,637,1921,1534,1452,897,bed
6700,3,table,4,0,4201,29,189,131,241,192,52,61,dining table
6701,14,bed,15,0,4201,35,38,103,168,196,130,93,bed
6702,8,desk,9,1,4202,38,9,149,109,246,100,97,desk
6703,3,bed,4,0,4203,16,26,108,241,252,215,144,bed
6704,12,bed,13,0,4204,29,142,669,1704,1547,1562,878,bed
6705,9,bed,10,0,4205,98,2,347,1753,1534,1751,1187,bed
6706,9,bed,10,0,4206,55,57,100,208,207,151,107,bed
6707,2,door,3,1,4207,18,0,83,134,1072,134,989,door
6708,6,window,7,0,4207,59,403,4,1052,566,649,562,window
6709,10,bed,11,1,4207,19,666,546,1432,1074,766,528,bed
6710,9,window,9,0,4208,27,568,138,1077,392,509,254,window
6711,14,mirror,13,0,4208,54,1433,338,1694,552,261,214,mirror
6712,22,bed,21,0,4208,100,411,377,2058,1458,1647,1081,bed
6713,5,window,6,0,4209,15,2,36,53,180,51,144,window
6714,13,bed,14,0,4209,41,11,142,259,300,248,158,bed
6715,6,bed,7,0,4210,22,91,131,300,266,209,135,bed
6716,4,person,5,0,4211,68,1182,522,1577,1021,395,499,person
6717,6,bed,7,0,4211,51,722,745,2045,1471,1323,726,bed
6718,13,desk,14,1,4211,28,2,819,505,1292,503,473,desk
6719,14,chair,15,0,4211,37,12,780,480,1471,468,691,chair
6720,6,door,7,1,4212,15,1048,449,1172,1043,124,594,door
6721,7,bed,8,1,4212,46,597,723,1106,1012,509,289,bed
6722,8,bed,9,1,4212,50,258,726,650,1173,392,447,bed
6723,14,sofa,15,0,4212,27,456,893,1115,1248,659,355,couch
6724,15,bed,16,1,4212,26,668,1224,1649,2196,981,972,bed
6725,17,door,18,1,4212,15,0,1232,39,2196,39,964,door
6726,5,bed,6,0,4213,42,30,86,273,232,243,146,bed
6727,8,bed,9,0,4214,24,82,422,950,767,868,345,bed
6728,2,bed,3,0,4215,34,0,83,1023,768,1023,685,bed
6729,6,bed,6,1,4216,42,334,726,906,1269,572,543,bed
6730,8,window,8,0,4216,16,32,83,241,502,209,419,window
6731,11,mirror,11,0,4216,33,667,205,768,683,101,478,mirror
6732,14,door,14,0,4216,17,0,0,74,1270,74,1270,door
6733,19,bed,18,0,4217,63,723,742,2038,1456,1315,714,bed
6734,24,sofa,23,1,4217,42,0,678,491,1398,491,720,couch
6735,38,door,36,0,4217,19,855,154,1061,915,206,761,door
6736,2,window,3,0,4218,17,346,3,481,601,135,598,window
6737,8,sofa,9,0,4218,28,0,337,381,714,381,377,couch
6738,9,bed,10,0,4218,75,73,366,1432,1139,1359,773,bed
6739,6,chair,6,1,4219,30,410,506,581,722,171,216,chair
6740,9,window,9,0,4219,33,17,169,293,721,276,552,window
6741,12,bed,12,1,4219,89,73,326,1280,959,1207,633,bed
6742,3,bed,4,1,4220,25,474,299,973,485,499,186,bed
6743,4,bed,5,1,4220,31,21,404,963,768,942,364,bed
6744,8,bed,9,1,4221,37,0,376,803,1499,803,1123,bed
6745,14,mirror,15,0,4221,16,297,134,389,227,92,93,mirror
6746,9,bed,10,1,4222,54,93,72,260,170,167,98,bed
6747,11,bed,12,1,4222,57,139,83,318,228,179,145,bed
6748,13,pot,14,1,4222,18,303,123,333,159,30,36,potted plant
6749,15,television,16,0,4222,20,0,67,48,128,48,61,tv
6750,21,mirror,22,0,4222,19,219,30,245,71,26,41,mirror
6751,8,bed,8,0,4223,96,99,290,1511,1453,1412,1163,bed
6752,10,window,10,1,4223,17,0,266,166,1215,166,949,window
6753,10,chair,11,1,4224,17,27,187,119,250,92,63,chair
6754,13,bed,14,1,4224,29,2,153,417,375,415,222,bed
6755,12,bed,13,1,4225,31,0,101,300,225,300,124,bed
6756,9,bed,10,0,4226,66,47,147,1259,1020,1212,873,bed
6757,4,chair,5,1,4227,30,842,453,975,697,133,244,chair
6758,6,vase,7,0,4227,20,957,513,1033,585,76,72,vase
6759,8,chair,9,1,4227,33,1014,470,1237,796,223,326,chair
6760,9,bed,10,0,4227,114,2,376,1150,1073,1148,697,bed
6761,9,mirror,10,0,4228,18,401,127,446,238,45,111,mirror
6762,12,bed,13,0,4228,25,0,201,383,375,383,174,bed
6763,2,bed,3,1,4229,85,356,273,1279,958,923,685,bed
6764,7,window,8,0,4230,32,80,124,171,339,91,215,window
6765,15,bed,16,1,4230,41,100,225,629,458,529,233,bed
6766,5,bed,5,0,20357,76,244,445,1300,860,1056,415,bed
6767,7,window,7,0,20357,19,591,0,946,571,355,571,window
6768,5,bed,6,0,20358,37,325,356,1024,668,699,312,bed
6769,17,desk,18,0,20358,20,128,415,367,601,239,186,desk
6770,6,bed,7,0,20359,45,183,322,783,600,600,278,bed
6771,7,cat,8,0,20359,23,415,370,487,405,72,35,cat
6772,0,bed,1,0,20360,22,14,45,283,180,269,135,bed
6773,10,bed,11,0,20361,111,745,27,1616,738,871,711,bed
6774,11,bed,12,0,20361,137,2,76,1277,1440,1275,1364,bed
6775,19,window,20,0,20362,32,653,155,817,326,164,171,window
6776,20,bed,21,0,20362,43,264,322,882,686,618,364,bed
6777,31,chair,32,1,20362,18,302,375,368,418,66,43,chair
6778,7,bed,8,0,20363,85,120,182,980,818,860,636,bed
6779,10,window,11,0,20363,15,855,63,1060,452,205,389,window
6780,7,bed,8,1,20365,45,579,423,1280,960,701,537,bed
6781,8,bed,9,1,20365,41,9,339,580,895,571,556,bed
6782,19,mirror,20,0,20365,57,60,130,232,337,172,207,mirror
6783,10,window,11,0,20366,19,701,248,904,590,203,342,window
6784,14,bed,15,0,20366,57,188,331,822,741,634,410,bed
6785,10,bed,11,1,20367,40,262,371,1199,673,937,302,bed
6786,24,window,25,0,20367,19,2,49,362,588,360,539,window
6787,0,bed,1,1,20368,18,359,127,428,575,69,448,bed
6788,6,bed,7,0,20369,63,510,479,2198,1351,1688,872,bed
6789,8,bed,9,0,20369,118,0,476,2087,1352,2087,876,bed
6790,3,bed,4,1,20370,27,253,317,1215,958,962,641,bed
6791,13,bed,14,0,20371,19,90,435,608,1024,518,589,bed
6792,11,bed,12,0,20372,73,182,43,704,623,522,580,bed
6793,26,window,27,0,20372,27,552,89,823,454,271,365,window
6794,9,bottle,10,0,20373,20,1923,505,2043,809,120,304,bottle
6795,14,bed,15,0,20373,126,160,324,1649,1461,1489,1137,bed
6796,10,bed,11,0,20374,160,265,303,731,680,466,377,bed
6797,17,chair,18,0,20374,62,65,388,181,570,116,182,chair
6798,6,bed,7,0,20375,125,129,197,814,678,685,481,bed
6799,14,chair,15,1,20375,16,732,458,996,675,264,217,chair
6800,7,chair,8,0,20376,21,1997,924,2100,1272,103,348,chair
6801,8,table,9,0,20376,16,1863,1032,1993,1244,130,212,dining table
6802,11,door,12,0,20376,19,1734,430,2099,1399,365,969,door
6803,18,hat,19,0,20376,18,1422,1100,1584,1184,162,84,hat
6804,26,window,27,0,20376,26,345,463,937,1030,592,567,window
6805,27,clock,28,0,20376,16,479,973,532,1034,53,61,clock
6806,28,table,29,0,20376,17,361,995,688,1063,327,68,dining table
6807,33,window,34,0,20376,30,975,218,1620,991,645,773,window
6808,34,bed,35,0,20376,31,0,286,1117,1634,1117,1348,bed
6809,12,bed,13,0,20377,89,46,64,841,768,795,704,bed
6810,7,bed,8,0,20378,54,134,2,1062,954,928,952,bed
6811,11,bed,12,1,20379,19,1434,1261,2159,1440,725,179,bed
6812,12,chair,13,1,20379,32,1345,997,1906,1432,561,435,chair
6813,11,table,12,0,20380,57,549,1134,1528,1650,979,516,dining table
6814,13,bed,14,1,20380,17,2079,1321,2199,1650,120,329,bed
6815,28,chair,29,0,20381,25,2,903,306,1404,304,501,chair
6816,13,bed,14,0,20382,58,137,471,768,923,631,452,bed
6817,30,bed,31,0,20383,148,435,57,898,568,463,511,bed
6818,6,bed,7,1,20384,55,212,217,1023,768,811,551,bed
6819,4,mirror,5,0,20385,98,0,1,1024,627,1024,626,mirror
6820,8,bed,9,1,20385,41,1,286,296,768,295,482,bed
6821,9,bed,10,1,20385,43,167,341,1022,768,855,427,bed
6822,17,window,18,0,20386,47,498,146,607,393,109,247,window
6823,19,window,20,0,20386,39,634,121,770,394,136,273,window
6824,21,window,22,0,20386,47,814,79,908,422,94,343,window
6825,23,window,24,0,20386,17,953,8,1024,457,71,449,window
6826,27,bed,28,0,20386,161,115,70,597,644,482,574,bed
6827,38,mirror,39,0,20386,33,372,198,431,360,59,162,mirror
6828,41,mirror,42,1,20386,18,0,118,57,373,57,255,mirror
6829,44,vase,45,0,20386,15,519,358,554,390,35,32,vase
6830,52,sofa,53,1,20386,59,574,376,798,503,224,127,couch
6831,7,bed,8,1,20387,53,1495,577,2020,1536,525,959,bed
6832,8,bed,9,1,20387,18,0,1254,948,1536,948,282,bed
6833,16,mirror,17,0,20387,19,689,487,899,702,210,215,mirror
6834,10,bed,11,0,20388,113,254,215,748,533,494,318,bed
6835,9,door,10,0,20389,24,1187,336,1649,1407,462,1071,door
6836,11,bed,12,0,20389,69,105,543,1649,1978,1544,1435,bed
6837,12,cat,13,0,20389,19,998,1094,1313,1190,315,96,cat
6838,9,television,10,0,20390,16,976,237,1169,622,193,385,tv
6839,10,bed,11,0,20390,39,35,396,595,873,560,477,bed
6840,11,bed,12,1,20390,50,593,380,998,708,405,328,bed
6841,18,door,19,0,20390,17,1,633,86,872,85,239,door
6842,26,racket,27,0,20390,19,186,144,262,234,76,90,tennis racket
6843,27,racket,28,0,20390,18,125,164,188,268,63,104,tennis racket
6844,6,mirror,7,0,20391,21,544,120,805,458,261,338,mirror
6845,19,bed,20,0,20391,60,264,364,803,682,539,318,bed
6846,11,bed,12,1,20392,47,52,549,806,1075,754,526,bed
6847,5,window,6,0,20393,22,1,51,964,270,963,219,window
6848,19,bed,20,0,20393,36,49,453,1023,768,974,315,bed
6849,31,bed,32,0,20394,127,262,316,887,799,625,483,bed
6850,7,bed,8,0,20395,31,502,452,1228,819,726,367,bed
6851,9,bed,10,0,20396,21,529,608,1598,1303,1069,695,bed
6852,13,sofa,14,1,20396,19,1634,883,2047,1536,413,653,couch
6853,19,bed,20,0,20397,63,408,138,735,537,327,399,bed
6854,8,bed,9,0,20398,80,11,293,1668,1440,1657,1147,bed
6855,9,bed,10,0,20398,77,1087,321,2081,1362,994,1041,bed
6856,20,bed,21,0,20399,37,424,394,1001,800,577,406,bed
6857,12,door,13,0,20400,15,556,191,678,395,122,204,door
6858,15,bed,16,0,20400,154,1,77,933,622,932,545,bed
6859,16,chair,17,1,20400,19,332,345,416,401,84,56,chair
6860,17,chair,18,0,20400,18,446,342,500,380,54,38,chair
6861,30,window,31,0,20400,25,59,101,136,324,77,223,window
6862,31,window,32,0,20400,32,187,187,451,391,264,204,window
6863,32,window,33,0,20400,16,500,216,555,365,55,149,window
6864,10,bed,11,0,20401,33,400,498,1161,864,761,366,bed
6865,19,door,20,0,20401,27,134,223,267,765,133,542,door
6866,23,chair,24,0,20401,52,536,385,638,558,102,173,chair
6867,24,chair,25,0,20401,49,271,400,426,584,155,184,chair
6868,26,chair,27,0,20401,18,491,435,532,502,41,67,chair
6869,5,bed,6,0,20402,72,276,59,731,587,455,528,bed
6870,9,window,10,0,20402,26,324,214,436,407,112,193,window
6871,12,bed,13,0,20403,70,250,265,851,774,601,509,bed
6872,14,table,15,0,20403,66,0,388,266,679,266,291,dining table
6873,28,chair,29,0,20404,20,146,360,209,461,63,101,chair
6874,29,chair,30,1,20404,25,85,359,151,456,66,97,chair
6875,44,bed,45,0,20404,107,305,331,797,667,492,336,bed
6876,11,bed,12,0,20405,57,157,326,642,570,485,244,bed
6877,22,window,23,0,20405,20,549,182,666,369,117,187,window
6878,6,bed,7,1,20406,78,2,24,738,767,736,743,bed
6879,9,window,10,0,20406,56,660,2,1024,256,364,254,window
6880,25,mirror,26,0,20407,26,451,331,500,458,49,127,mirror
6881,34,bed,35,0,20407,29,234,425,945,709,711,284,bed
6882,18,bed,18,0,20408,18,120,244,439,453,319,209,bed
6883,23,table,23,0,20408,26,589,275,687,379,98,104,dining table
6884,24,chair,24,0,20408,26,518,257,592,367,74,110,chair
6885,25,chair,25,0,20408,30,667,271,775,418,108,147,chair
6886,7,bed,8,0,20409,57,216,189,1227,819,1011,630,bed
6887,18,bed,19,0,20410,30,0,489,852,798,852,309,bed
6888,19,bed,20,1,20410,19,26,454,544,542,518,88,bed
6889,10,bed,11,0,20411,47,1,208,628,542,627,334,bed
6890,24,bed,25,0,20412,44,0,332,497,547,497,215,bed
6891,19,bed,20,0,20413,97,545,425,1631,1013,1086,588,bed
6892,20,plant pot,21,0,20413,18,477,714,592,816,115,102,potted plant
6893,22,window,23,0,20413,17,37,24,410,717,373,693,window
6894,14,bed,15,0,20414,41,146,250,1023,768,877,518,bed
6895,5,bed,6,0,20415,59,479,593,1959,1704,1480,1111,bed
6896,8,table,9,0,20415,24,1200,764,1478,918,278,154,dining table
6897,16,bed,17,0,20416,97,161,224,668,530,507,306,bed
6898,7,window,8,0,20417,29,435,2,688,321,253,319,window
6899,10,bed,11,1,20417,40,721,187,1024,767,303,580,bed
6900,11,bed,12,0,20417,40,0,200,467,768,467,568,bed
6901,10,chair,11,0,20418,39,565,761,901,1195,336,434,chair
6902,15,bed,16,0,20418,77,752,726,2094,1650,1342,924,bed
6903,7,bed,8,0,20419,40,1,301,997,1333,996,1032,bed
6904,10,door,11,0,20420,17,279,0,808,972,529,972,door
6905,15,bed,16,0,20420,82,435,538,1850,1536,1415,998,bed
6906,29,chair,29,0,20420,25,0,637,257,1347,257,710,chair
6907,30,desk,30,1,20420,15,0,681,370,1121,370,440,desk
6908,7,bed,8,0,20421,74,0,264,2198,1650,2198,1386,bed
6909,7,mirror,8,0,20422,34,532,84,669,298,137,214,mirror
6910,10,sofa,11,0,20422,34,699,492,1200,800,501,308,couch
6911,12,table,13,0,20422,41,253,487,478,623,225,136,dining table
6912,13,chair,14,1,20422,38,318,443,431,609,113,166,chair
6913,22,window,23,0,20422,16,119,3,177,519,58,516,window
6914,10,bed,11,0,20423,115,354,274,1280,960,926,686,bed
6915,8,bed,9,0,22874,71,64,216,655,622,591,406,bed
6916,2,window,3,0,22875,17,86,218,350,498,264,280,window
6917,7,bed,8,0,22875,49,222,2,1023,678,801,676,bed
6918,14,chair,15,1,22875,15,2,484,63,617,61,133,chair
6919,24,glasses,25,0,22875,30,580,594,652,641,72,47,eye glasses
6920,4,door,5,0,22876,18,389,118,629,663,240,545,door
6921,8,chair,9,1,22876,15,1,454,139,645,138,191,chair
6922,10,table,11,0,22876,15,1,619,452,767,451,148,dining table
6923,11,bed,12,0,22876,20,474,549,1024,767,550,218,bed
6924,15,bed,16,1,22877,32,348,296,561,512,213,216,bed
6925,4,bed,5,0,22878,34,120,1,1015,600,895,599,bed
6926,13,television,14,0,22878,15,1,156,148,341,147,185,tv
6927,3,bed,4,0,22879,54,2,45,502,594,500,549,bed
6928,2,bed,3,0,22880,65,46,200,570,714,524,514,bed
6929,7,glasses,8,0,22880,23,30,359,63,373,33,14,eye glasses
6930,3,window,4,0,22881,36,597,233,882,506,285,273,window
6931,4,bed,5,0,22881,155,297,102,711,667,414,565,bed
6932,8,chair,9,1,22881,29,805,374,929,562,124,188,chair
6933,8,teddy bear,9,0,22882,34,811,327,899,436,88,109,teddy bear
6934,10,bed,11,0,22882,64,4,384,587,680,583,296,bed
6935,5,bed,6,0,22883,60,300,310,727,631,427,321,bed
6936,13,table,14,1,22883,26,3,392,58,498,55,106,dining table
6937,1,bed,2,0,22884,72,0,655,2196,1630,2196,975,bed
6938,3,bed,4,0,22885,64,406,322,1598,1066,1192,744,bed
6939,15,plate,16,1,22885,18,1195,623,1264,695,69,72,plate
6940,2,bed,3,0,22886,60,37,38,1470,1039,1433,1001,bed
6941,5,bed,6,0,22887,42,383,345,1005,682,622,337,bed
6942,7,sofa,8,0,22887,25,387,382,562,479,175,97,couch
6943,10,chair,11,1,22887,36,212,382,282,542,70,160,chair
6944,2,bed,3,1,22888,22,2,645,346,773,344,128,bed
6945,3,bed,4,0,22888,26,0,641,767,1023,767,382,bed
6946,9,bed,10,0,22889,60,257,183,781,473,524,290,bed
6947,10,bed,11,0,22889,47,28,212,618,500,590,288,bed
6948,7,vase,8,0,22890,16,688,174,733,224,45,50,vase
6949,8,vase,9,0,22890,16,738,165,789,221,51,56,vase
6950,9,bed,10,0,22890,134,337,255,791,680,454,425,bed
6951,4,bed,5,0,22891,68,0,300,693,559,693,259,bed
6952,19,bed,20,0,22892,115,378,345,854,682,476,337,bed
6953,6,person,7,1,4282,61,2,136,802,1198,800,1062,person
6954,11,table,12,0,4431,28,21,163,112,241,91,78,dining table
6955,15,sofa,16,1,4435,55,157,239,445,395,288,156,couch
6956,17,table,18,0,4435,19,626,321,698,464,72,143,dining table
6957,11,flowerpot,12,0,4436,15,186,174,209,199,23,25,potted plant
6958,12,sofa,13,0,4438,15,254,149,349,270,95,121,couch
6959,3,sofa,4,0,4440,22,89,123,419,306,330,183,couch
6960,5,window,6,0,4442,27,199,37,250,172,51,135,window
6961,6,window,7,0,4442,15,256,37,312,169,56,132,window
6962,9,chair,10,1,4442,15,110,168,138,271,28,103,chair
6963,10,table,11,1,4442,26,142,172,315,270,173,98,dining table
6964,14,chair,15,1,4442,17,229,186,328,271,99,85,chair
6965,4,chair,5,1,4446,22,1505,481,1595,885,90,404,chair
6966,16,sofa,16,1,4446,24,0,526,416,885,416,359,couch
6967,4,window,5,0,4449,28,39,28,527,261,488,233,window
6968,6,flowerpot,7,0,4452,15,184,205,214,236,30,31,potted plant
6969,10,window,11,0,4452,34,77,30,332,228,255,198,window
6970,11,sofa,12,1,4453,35,35,251,228,336,193,85,couch
6971,17,window,18,0,4453,17,11,163,164,297,153,134,window
6972,18,chair,19,0,4453,15,0,281,128,433,128,152,chair
6973,11,bowl,12,0,4454,15,111,142,143,157,32,15,bowl
6974,2,window,3,0,4455,16,547,141,1416,792,869,651,window
6975,8,sofa,9,1,4455,16,1007,633,1598,1058,591,425,couch
6976,6,sofa,7,0,4458,32,0,320,424,473,424,153,couch
6977,7,window,8,0,24858,26,391,156,556,473,165,317,window
6978,13,sofa,14,0,24858,35,510,300,768,506,258,206,couch
6979,7,plate,8,0,24859,16,391,335,445,351,54,16,plate
6980,9,bed,10,0,24859,38,1,160,471,550,470,390,bed
6981,7,table,8,0,24860,23,532,254,639,447,107,193,dining table
6982,8,chair,9,1,24860,29,531,231,640,447,109,216,chair
6983,16,window,17,0,24860,21,1,21,250,269,249,248,window
6984,2,bed,3,0,24861,34,0,332,622,517,622,185,bed
6985,0,window,1,0,24862,53,1,0,1299,562,1298,562,window
6986,1,plant pot,2,1,24862,30,952,480,1188,563,236,83,potted plant
6987,9,sofa,10,0,24862,66,327,442,1007,728,680,286,couch
6988,7,bowl,8,1,24864,19,1,610,78,768,77,158,bowl
6989,3,vase,4,0,24865,16,59,119,99,186,40,67,vase
6990,8,sofa,9,0,24865,42,510,321,953,750,443,429,couch
6991,11,bowl,12,0,24865,25,199,450,344,562,145,112,bowl
6992,17,vase,18,0,24865,27,338,441,398,535,60,94,vase
6993,25,window,26,0,24865,55,244,65,682,437,438,372,window
6994,26,door,27,0,24865,16,791,56,952,365,161,309,door
6995,5,bed,6,0,24866,15,1,169,343,455,342,286,bed
6996,9,chair,10,0,24866,36,587,223,750,475,163,252,chair
6997,4,window,5,0,24867,33,235,76,534,511,299,435,window
6998,5,window,6,0,24867,19,549,104,802,480,253,376,window
6999,6,window,7,0,24867,17,804,62,1023,595,219,533,window
7000,9,plant pot,10,0,24867,15,763,466,817,537,54,71,potted plant
7001,16,pot,17,0,24867,17,333,308,365,340,32,32,potted plant
7002,27,chair,28,0,24867,40,236,453,408,665,172,212,chair
7003,28,chair,29,1,24867,21,379,524,598,664,219,140,chair
7004,29,chair,30,0,24867,28,583,496,773,664,190,168,chair
7005,30,table,31,0,24867,20,316,454,724,562,408,108,dining table
7006,6,table,7,0,4931,18,212,140,265,188,53,48,dining table
7007,9,bed,10,0,4932,22,191,157,376,240,185,83,bed
7008,5,person,6,1,101,53,148,8,364,338,216,330,person
7009,14,person,15,1,101,77,306,0,504,338,198,338,person
7010,25,book,26,0,101,36,279,157,473,288,194,131,book
7011,10,chair,11,0,5463,27,470,461,578,574,108,113,chair
7012,45,train,44,0,5464,20,983,353,1024,389,41,36,train
7013,49,clock,48,0,5464,21,665,380,713,434,48,54,clock
7014,64,bed,63,0,5464,38,144,312,686,549,542,237,bed
7015,25,bed,26,1,5465,41,147,701,921,1460,774,759,bed
7016,30,bed,31,0,5465,76,790,679,1660,1400,870,721,bed
7017,0,bed,1,0,5466,15,241,152,798,598,557,446,bed
7018,1,bed,2,0,5467,48,0,20,213,205,213,185,bed
7019,1,bed,2,0,5468,33,118,160,437,445,319,285,bed
7020,9,bed,10,1,5469,71,856,359,1525,992,669,633,bed
7021,10,person,11,0,5469,45,964,365,1154,605,190,240,person
7022,12,chair,13,1,5469,25,1444,633,1620,942,176,309,chair
7023,13,table,14,0,5469,23,1240,684,1622,1047,382,363,dining table
7024,18,chair,19,0,5469,25,1513,743,1749,1073,236,330,chair
7025,13,bed,14,0,5470,18,173,229,362,364,189,135,bed
7026,2,person,3,1,5472,38,34,18,92,95,58,77,person
7027,3,book,4,0,5472,16,58,55,83,84,25,29,book
7028,6,person,7,0,5472,53,91,60,180,187,89,127,person
7029,7,book,8,1,5472,18,97,113,181,161,84,48,book
7030,8,window,9,1,5472,17,95,0,216,51,121,51,window
7031,3,bed,4,0,5473,17,101,169,332,341,231,172,bed
7032,4,bed,5,0,5474,55,71,158,254,325,183,167,bed
7033,5,bed,6,0,5474,61,285,157,479,332,194,175,bed
7034,2,bed,3,0,5475,50,57,27,218,198,161,171,bed
7035,5,bed,6,0,5476,30,192,209,421,474,229,265,bed
7036,4,bed,5,1,5477,26,2,191,113,310,111,119,bed
7037,5,bed,6,0,5478,89,262,177,619,425,357,248,bed
7038,12,chair,13,1,5478,23,564,338,689,463,125,125,chair
7039,4,bed,5,0,5479,18,39,131,248,241,209,110,bed
7040,5,bed,6,0,5480,34,704,759,2197,1647,1493,888,bed
7041,14,table,15,0,5480,26,6,962,879,1644,873,682,dining table
7042,15,chair,16,0,5480,49,372,912,873,1644,501,732,chair
7043,3,person,4,0,5482,30,209,105,259,168,50,63,person
7044,4,bed,5,1,5482,39,81,137,350,252,269,115,bed
7045,6,chair,7,1,5482,18,129,124,169,161,40,37,chair
7046,8,chair,9,0,5482,17,111,122,139,158,28,36,chair
7047,4,window,5,0,5483,24,517,127,679,353,162,226,window
7048,12,bed,13,0,5483,46,121,219,472,478,351,259,bed
7049,20,bed,21,1,5483,18,0,242,325,480,325,238,bed
7050,2,bed,3,0,5484,38,36,314,374,480,338,166,bed
7051,18,boat,19,0,5484,31,447,210,668,380,221,170,boat
7052,21,umbrella,22,0,5484,21,382,148,472,273,90,125,umbrella
7053,1,bed,2,1,5485,51,99,0,299,245,200,245,bed
7054,2,bed,3,0,5486,33,149,225,479,434,330,209,bed
7055,2,bed,3,1,5487,34,87,89,249,290,162,201,bed
7056,4,bed,5,0,5488,71,311,227,940,683,629,456,bed
7057,22,hat,23,0,5488,17,718,133,768,209,50,76,hat
7058,27,hat,28,0,5488,17,60,237,154,313,94,76,hat
7059,4,bed,5,1,5489,19,682,379,1021,749,339,370,bed
7060,0,bed,1,0,5490,45,225,149,684,458,459,309,bed
7061,7,table,8,0,5490,24,165,209,226,273,61,64,dining table
7062,8,chair,9,0,5490,24,130,205,173,274,43,69,chair
7063,9,chair,10,0,5490,20,222,197,258,263,36,66,chair
7064,1,bed,2,0,5491,35,162,62,881,767,719,705,bed
7065,4,bed,5,1,5492,61,33,644,1021,1364,988,720,bed
7066,3,bed,4,0,5493,37,28,125,167,183,139,58,bed
7067,1,bed,2,1,5494,47,0,81,109,252,109,171,bed
7068,4,bed,5,1,5494,25,42,128,225,300,183,172,bed
7069,8,bed,9,1,5495,35,334,332,639,479,305,147,bed
7070,23,clock,24,0,5495,16,159,65,211,121,52,56,clock
7071,4,bed,5,0,5496,67,221,234,524,455,303,221,bed
7072,4,chair,5,1,5497,19,342,182,440,333,98,151,chair
7073,17,chair,18,1,5497,17,2,306,76,469,74,163,chair
7074,18,chair,19,0,5497,30,52,298,180,465,128,167,chair
7075,0,bed,1,0,5498,22,32,89,253,255,221,166,bed
7076,24,chair,25,0,5498,15,84,137,114,172,30,35,chair
7077,15,bed,16,0,5499,31,196,327,669,681,473,354,bed
7078,8,bed,9,0,5500,59,164,103,400,289,236,186,bed
7079,11,bed,12,0,5501,39,417,337,1023,680,606,343,bed
7080,2,bed,3,0,5502,25,220,14,469,279,249,265,bed
7081,1,mirror,2,0,5503,15,388,84,525,287,137,203,mirror
7082,3,bed,4,0,5503,121,0,335,1289,1195,1289,860,bed
7083,13,window,14,1,5503,17,1414,0,1791,981,377,981,window
7084,17,bed,18,0,5504,100,231,221,557,525,326,304,bed
7085,18,bed,19,1,5504,47,0,220,381,583,381,363,bed
7086,32,backpack,33,0,5504,28,431,360,499,489,68,129,backpack
7087,9,chair,10,0,5505,16,203,246,240,302,37,56,chair
7088,10,chair,11,0,5505,17,253,244,292,299,39,55,chair
7089,17,chair,18,0,5505,22,509,251,585,348,76,97,chair
7090,18,chair,19,1,5505,30,612,266,689,401,77,135,chair
7091,4,bed,5,0,5506,69,52,61,270,263,218,202,bed
7092,1,window,2,0,5508,15,403,2,627,756,224,754,window
7093,6,bed,7,0,5508,135,528,45,1514,1269,986,1224,bed
7094,12,window,13,0,5508,24,1340,1,1675,591,335,590,window
7095,17,clock,18,0,5508,28,1599,531,1640,593,41,62,clock
7096,26,chair,27,0,5508,61,1856,675,2102,1122,246,447,chair
7097,11,bed,12,1,5509,37,701,845,1620,1167,919,322,bed
7098,1,bed,2,1,5510,18,0,11,158,274,158,263,bed
7099,4,clock,5,0,5510,18,174,91,220,137,46,46,clock
7100,2,window,3,0,5511,16,723,0,1023,418,300,418,window
7101,6,bed,7,1,5511,44,274,395,854,766,580,371,bed
7102,18,bed,19,0,5512,43,394,337,780,641,386,304,bed
7103,10,bed,11,1,5513,46,497,367,2196,1649,1699,1282,bed
7104,4,window,5,0,5514,17,562,113,613,366,51,253,window
7105,12,bed,13,0,5514,17,7,128,184,236,177,108,bed
7106,15,chair,16,0,5514,40,380,217,594,423,214,206,chair
7107,21,chair,22,1,5514,17,148,213,183,290,35,77,chair
7108,6,bed,7,0,5515,95,299,233,748,539,449,306,bed
7109,12,chair,13,1,5515,32,249,314,320,438,71,124,chair
7110,1,bed,2,0,5516,47,56,157,471,466,415,309,bed
7111,6,bed,7,0,5516,33,291,168,567,397,276,229,bed
7112,1,bed,2,1,5517,32,0,473,1016,1225,1016,752,bed
7113,6,bed,7,1,5517,42,1137,440,1631,1176,494,736,bed
7114,3,bed,4,0,5518,120,239,92,1118,841,879,749,bed
7115,2,window,3,0,5520,16,106,69,302,334,196,265,window
7116,3,chair,4,1,5520,16,247,208,305,369,58,161,chair
7117,4,bed,5,0,5520,71,187,147,621,616,434,469,bed
7118,6,bed,7,0,5521,33,219,138,485,325,266,187,bed
7119,7,bed,8,0,5521,31,297,153,689,460,392,307,bed
7120,4,bed,5,0,5522,18,32,127,253,253,221,126,bed
7121,1,bed,2,0,5524,45,225,175,494,375,269,200,bed
7122,10,table,11,0,5524,30,84,308,182,424,98,116,dining table
7123,11,chair,12,0,5524,53,0,309,105,454,105,145,chair
7124,12,chair,13,1,5524,28,152,283,235,395,83,112,chair
7125,24,bed,25,0,5525,45,421,280,878,661,457,381,bed
7126,2,bed,3,0,5526,64,50,51,257,160,207,109,bed
7127,11,mirror,12,0,5527,18,63,187,163,307,100,120,mirror
7128,19,table,20,1,5527,20,0,447,99,624,99,177,dining table
7129,8,bed,9,0,5528,16,369,1,689,458,320,457,bed
7130,4,window,5,0,5529,21,453,75,629,352,176,277,window
7131,8,bed,9,1,5529,119,2,240,651,598,649,358,bed
7132,3,bed,4,0,5530,29,492,430,1103,726,611,296,bed
7133,11,desk,12,0,5530,16,1165,458,1530,725,365,267,desk
7134,1,bed,2,0,5531,40,89,187,544,612,455,425,bed
7135,4,bed,5,0,5532,42,232,182,511,415,279,233,bed
7136,8,table,9,1,5532,18,91,256,187,372,96,116,dining table
7137,10,table,11,0,5532,17,545,282,658,360,113,78,dining table
7138,11,chair,12,0,5532,29,587,283,674,389,87,106,chair
7139,14,television,15,0,23080,19,545,172,731,319,186,147,tv
7140,16,table,17,0,23080,33,309,422,427,540,118,118,dining table
7141,18,ball,19,0,23080,15,62,432,133,499,71,67,sports ball
7142,29,window,30,0,23080,20,887,52,1023,354,136,302,window
7143,35,person,36,0,23080,48,614,354,758,558,144,204,person
7144,3,window,4,0,23081,15,1571,4,2197,401,626,397,window
7145,6,teddy bear,7,0,23081,29,649,744,829,929,180,185,teddy bear
7146,7,teddy bear,8,0,23081,33,793,710,975,917,182,207,teddy bear
7147,10,bed,11,0,23081,39,2,832,2201,1648,2199,816,bed
7148,122,shoe,123,0,566,17,79,220,109,235,30,15,shoe
7149,124,shoe,125,0,566,22,83,291,128,312,45,21,shoe
7150,125,shoe,126,1,566,16,104,324,135,341,31,17,shoe
7151,126,shoe,127,0,566,19,87,331,124,348,37,17,shoe
7152,127,shoe,128,1,566,16,107,362,138,381,31,19,shoe
7153,128,shoe,129,1,566,17,91,369,124,387,33,18,shoe
7154,9,chair,10,1,5707,38,0,770,252,851,252,81,chair
7155,10,shoe,11,0,5707,17,783,682,839,712,56,30,shoe
7156,11,shoe,12,1,5707,17,810,673,857,710,47,37,shoe
7157,24,chair,25,1,5707,38,1190,536,1279,765,89,229,chair
7158,25,bed,26,1,5709,24,0,239,64,385,64,146,bed
7159,14,person,15,0,5711,61,133,128,214,236,81,108,person
7160,11,vase,12,0,5714,20,421,164,463,268,42,104,vase
7161,26,clock,27,0,5714,15,1062,201,1118,262,56,61,clock
7162,9,suitcase,10,0,5715,20,135,4,191,33,56,29,suitcase
7163,29,sink,29,0,5721,32,797,374,890,561,93,187,sink
7164,32,mirror,32,1,5721,21,794,196,816,309,22,113,mirror
7165,63,shoe,63,0,5721,18,378,567,415,608,37,41,shoe
7166,2,window,3,0,5722,18,269,3,322,181,53,178,window
7167,8,person,9,1,5724,16,0,178,43,232,43,54,person
7168,9,backpack,10,0,5724,20,41,181,87,233,46,52,backpack
7169,14,hat,15,0,5736,15,363,151,453,205,90,54,hat
7170,5,hat,6,0,5738,16,612,224,760,381,148,157,hat
7171,22,eyeglasses,23,0,5740,15,290,915,357,946,67,31,eye glasses
7172,3,mirror,4,0,5741,22,123,120,147,219,24,99,mirror
7173,18,hat,19,0,5751,17,162,105,185,130,23,25,hat
7174,2,window,3,0,5757,27,27,255,176,549,149,294,window
7175,3,window,4,1,5757,15,282,266,423,501,141,235,window
7176,4,sofa,5,1,5757,17,283,456,425,653,142,197,couch
7177,55,bed,56,1,5757,61,0,457,295,749,295,292,bed
7178,7,suitcase,8,0,5758,19,131,8,185,38,54,30,suitcase
7179,2,desk,3,0,5759,15,155,158,255,245,100,87,desk
7180,12,bottle,13,0,5760,19,120,181,186,321,66,140,bottle
7181,22,shoe,23,0,5768,15,133,302,163,325,30,23,shoe
7182,4,bench,5,0,23104,49,1,537,538,761,537,224,bench
7183,6,person,7,1,23104,79,262,143,650,698,388,555,person
7184,7,person,8,1,23104,72,607,119,906,768,299,649,person
7185,9,person,10,1,23104,57,862,383,1024,768,162,385,person
7186,15,person,16,1,23104,48,517,364,698,767,181,403,person
7187,20,bench,21,1,23104,19,847,571,1023,768,176,197,bench
7188,3,person,4,0,6462,60,187,262,752,779,565,517,person
7189,2,table,3,0,6737,66,150,134,518,430,368,296,dining table
7190,3,chair,4,0,6737,45,10,136,300,479,290,343,chair
7191,4,chair,5,0,6737,41,382,112,632,478,250,366,chair
7192,5,chair,6,1,6737,19,366,49,483,151,117,102,chair
7193,6,chair,7,1,6737,26,72,59,186,208,114,149,chair
7194,7,sofa,8,1,6737,16,2,79,114,278,112,199,couch
7195,4,chair,5,0,6738,27,60,269,190,499,130,230,chair
7196,13,pot,14,0,6738,17,316,227,353,279,37,52,potted plant
7197,17,chair,18,1,6738,24,163,253,274,485,111,232,chair
7198,17,table,18,0,6739,18,112,182,292,423,180,241,dining table
7199,2,bench,3,1,6740,45,9,3,467,248,458,245,bench
7200,3,table,4,0,6740,39,15,37,353,275,338,238,dining table
7201,4,bench,5,0,6740,56,43,130,353,310,310,180,bench
7202,10,sofa,11,1,6741,16,162,269,354,436,192,167,couch
7203,11,sofa,12,1,6741,16,212,284,448,559,236,275,couch
7204,3,table,4,0,6742,31,94,110,288,239,194,129,dining table
7205,5,chair,6,0,6742,32,159,101,252,238,93,137,chair
7206,6,chair,7,1,6742,23,262,89,304,229,42,140,chair
7207,7,chair,8,1,6743,16,644,584,844,690,200,106,chair
7208,8,chair,9,1,6743,17,875,650,1095,827,220,177,chair
7209,11,vase,12,0,6743,29,505,600,674,749,169,149,vase
7210,11,table,12,1,6744,25,251,826,604,1102,353,276,dining table
7211,12,chair,13,0,6744,20,146,754,300,1063,154,309,chair
7212,13,chair,14,0,6744,27,268,783,463,1122,195,339,chair
7213,15,chair,16,0,6744,25,551,780,737,1129,186,349,chair
7214,8,chair,9,0,6745,29,1345,606,1604,963,259,357,chair
7215,11,chair,12,1,6745,17,204,582,424,989,220,407,chair
7216,12,chair,13,0,6745,24,73,600,323,987,250,387,chair
7217,16,sofa,17,0,6745,21,0,962,389,1645,389,683,couch
7218,25,chair,26,0,6745,24,763,661,1010,1110,247,449,chair
7219,26,chair,27,0,6745,15,1002,657,1212,1107,210,450,chair
7220,76,door,75,0,6745,15,738,238,990,706,252,468,door
7221,10,table,11,1,6746,16,248,560,642,763,394,203,dining table
7222,12,chair,13,1,6746,17,251,505,348,666,97,161,chair
7223,15,vase,16,0,6746,15,434,531,520,620,86,89,vase
7224,8,chair,9,1,6747,27,807,483,961,820,154,337,chair
7225,9,table,10,1,6747,29,10,722,732,930,722,208,dining table
7226,13,chair,14,1,6747,17,137,645,365,763,228,118,chair
7227,14,chair,15,1,6747,27,626,671,827,959,201,288,chair
7228,4,table,5,0,6748,21,83,116,284,212,201,96,dining table
7229,7,chair,8,1,6748,19,130,159,196,212,66,53,chair
7230,18,chair,19,0,6749,25,306,148,357,228,51,80,chair
7231,19,table,20,0,6749,28,100,158,208,239,108,81,dining table
7232,20,chair,21,0,6749,28,184,163,240,240,56,77,chair
7233,21,chair,22,1,6749,25,61,173,127,240,66,67,chair
7234,32,plate,31,0,6749,15,108,171,138,182,30,11,plate
7235,9,chair,10,1,6751,35,89,556,313,962,224,406,chair
7236,10,table,11,0,6751,68,467,640,1352,1188,885,548,dining table
7237,11,chair,12,1,6751,15,604,572,765,693,161,121,chair
7238,14,chair,15,1,6751,15,1202,570,1342,695,140,125,chair
7239,15,chair,16,1,6751,24,1070,623,1308,1070,238,447,chair
7240,16,chair,17,1,6751,32,784,640,1140,1145,356,505,chair
7241,17,chair,18,1,6751,32,459,630,811,1147,352,517,chair
7242,11,chair,12,1,6752,34,21,84,108,219,87,135,chair
7243,12,chair,13,1,6752,30,103,91,170,213,67,122,chair
7244,2,door,3,1,6753,15,1151,1,1279,682,128,681,door
7245,3,person,4,1,6753,28,1146,272,1278,957,132,685,person
7246,7,chair,8,1,6753,41,612,325,796,780,184,455,chair
7247,8,chair,9,0,6753,51,67,389,325,878,258,489,chair
7248,9,chair,10,0,6753,65,263,431,599,958,336,527,chair
7249,16,plate,17,1,6753,18,617,424,764,474,147,50,plate
7250,18,vase,19,0,6753,16,427,359,513,470,86,111,vase
7251,17,chair,18,1,6754,17,57,576,231,1061,174,485,chair
7252,18,chair,19,1,6754,16,195,675,554,1064,359,389,chair
7253,23,bowl,24,0,6754,20,395,556,576,673,181,117,bowl
7254,5,table,6,1,6755,19,553,798,1558,1489,1005,691,dining table
7255,6,window,7,0,6755,30,226,0,1459,949,1233,949,window
7256,7,chair,8,1,6755,38,420,815,843,1444,423,629,chair
7257,8,chair,9,0,6755,31,828,854,1255,1528,427,674,chair
7258,9,chair,10,1,6755,15,1410,736,1571,886,161,150,chair
7259,10,chair,11,0,6755,34,1128,818,1558,1480,430,662,chair
7260,42,plate,43,0,6756,17,591,403,645,461,54,58,plate
7261,44,table,45,1,6756,21,332,604,683,775,351,171,dining table
7262,46,chair,47,1,6756,18,275,569,315,868,40,299,chair
7263,47,chair,48,1,6756,23,295,589,477,924,182,335,chair
7264,48,chair,49,0,6756,27,447,620,646,959,199,339,chair
7265,50,chair,51,1,6756,21,637,575,724,878,87,303,chair
7266,3,window,4,0,6757,16,665,134,857,347,192,213,window
7267,9,sofa,10,1,6757,26,2,434,204,765,202,331,couch
7268,15,table,16,1,6757,16,382,377,896,539,514,162,dining table
7269,19,chair,20,1,6757,19,371,327,537,640,166,313,chair
7270,20,chair,21,0,6757,24,509,349,697,704,188,355,chair
7271,14,chair,15,1,6758,16,216,1390,453,1630,237,240,chair
7272,16,vase,17,0,6758,27,427,1500,604,1828,177,328,vase
7273,14,table,15,1,6759,36,736,881,1382,1509,646,628,dining table
7274,15,chair,16,0,6759,66,532,847,1014,1590,482,743,chair
7275,16,chair,17,0,6759,66,1047,851,1524,1609,477,758,chair
7276,17,chair,18,1,6759,49,1082,743,1470,1202,388,459,chair
7277,19,vase,20,0,6759,19,963,800,1103,955,140,155,vase
7278,21,chair,22,1,6759,41,654,739,992,1152,338,413,chair
7279,10,chair,11,1,6760,20,516,686,705,1023,189,337,chair
7280,11,chair,12,1,6760,25,277,617,475,1019,198,402,chair
7281,5,chair,6,1,6761,19,227,149,259,188,32,39,chair
7282,13,chair,14,1,6761,35,89,128,127,199,38,71,chair
7283,14,chair,15,1,6761,20,172,127,198,221,26,94,chair
7284,15,chair,16,0,6761,32,52,136,118,240,66,104,chair
7285,16,chair,17,0,6761,30,124,146,192,240,68,94,chair
7286,12,window,13,0,6762,22,492,70,1119,647,627,577,window
7287,13,table,14,1,6762,29,418,612,1064,980,646,368,dining table
7288,15,chair,16,0,6762,46,938,579,1292,1021,354,442,chair
7289,16,chair,17,0,6762,34,298,565,587,1021,289,456,chair
7290,17,chair,18,0,6762,36,514,639,878,1023,364,384,chair
7291,18,bowl,19,0,6762,16,647,570,836,649,189,79,bowl
7292,9,chair,10,0,6763,36,49,73,121,185,72,112,chair
7293,10,chair,11,0,6763,26,119,88,197,207,78,119,chair
7294,11,chair,12,1,6763,25,186,70,228,168,42,98,chair
7295,7,table,8,0,6764,18,737,656,1049,869,312,213,dining table
7296,9,chair,10,0,6764,17,1035,609,1195,850,160,241,chair
7297,10,chair,11,1,6764,17,855,585,952,655,97,70,chair
7298,11,chair,12,0,6764,22,564,609,736,915,172,306,chair
7299,17,chair,18,1,6764,18,830,628,974,920,144,292,chair
7300,19,bowl,20,0,6764,15,888,984,1114,1125,226,141,bowl
7301,4,chair,5,1,6765,23,965,250,1267,531,302,281,chair
7302,14,chair,15,1,6765,30,3,760,426,1198,423,438,chair
7303,15,chair,16,1,6765,16,45,944,377,1198,332,254,chair
7304,4,table,5,0,6766,33,718,987,1915,1648,1197,661,dining table
7305,5,chair,6,1,6766,44,1554,1098,2195,1648,641,550,chair
7306,6,chair,7,1,6766,32,771,1187,1427,1648,656,461,chair
7307,7,chair,8,1,6766,30,559,936,1104,1613,545,677,chair
7308,9,cup,10,0,6766,25,1186,892,1287,1119,101,227,cup
7309,10,cup,11,0,6766,23,1452,895,1554,1117,102,222,cup
7310,13,plate,14,1,6766,23,1562,1090,1834,1166,272,76,plate
7311,14,plate,15,1,6766,18,1595,1086,1790,1151,195,65,plate
7312,17,plate,18,1,6766,15,938,1021,1118,1078,180,57,plate
7313,18,plate,19,1,6766,16,965,1008,1121,1061,156,53,plate
7314,21,door,22,1,6766,31,641,60,1019,1238,378,1178,door
7315,42,chair,43,0,6766,40,1304,920,1738,1645,434,725,chair
7316,5,door,6,0,6767,20,1283,275,1454,884,171,609,door
7317,8,window,9,0,6767,17,468,296,814,719,346,423,window
7318,13,table,14,0,6767,45,559,623,1000,893,441,270,dining table
7319,14,chair,15,1,6767,25,904,597,1005,857,101,260,chair
7320,15,chair,16,0,6767,34,522,594,690,890,168,296,chair
7321,16,chair,17,0,6767,34,734,612,919,919,185,307,chair
7322,19,chair,20,1,6767,23,1365,565,1561,1057,196,492,chair
7323,28,chair,29,1,6767,27,676,580,765,810,89,230,chair
7324,3,table,4,0,6768,27,28,1299,1535,2046,1507,747,dining table
7325,4,chair,5,1,6768,24,918,1455,1535,2046,617,591,chair
7326,5,chair,6,1,6768,15,1093,1236,1378,1380,285,144,chair
7327,6,chair,7,1,6768,22,221,1219,519,1388,298,169,chair
7328,7,chair,8,1,6768,39,2,1411,771,2046,769,635,chair
7329,7,table,8,0,6769,48,115,827,994,1587,879,760,dining table
7330,8,chair,9,1,6769,23,106,789,471,1484,365,695,chair
7331,9,chair,10,0,6769,20,539,888,1036,1587,497,699,chair
7332,1,window,2,0,6770,23,118,6,281,548,163,542,window
7333,3,table,4,1,6770,17,391,342,859,727,468,385,dining table
7334,6,chair,7,0,6770,38,260,314,489,658,229,344,chair
7335,7,chair,8,0,6770,38,450,335,703,722,253,387,chair
7336,10,table,11,1,6771,29,204,147,255,220,51,73,dining table
7337,11,chair,12,1,6771,19,162,136,177,207,15,71,chair
7338,12,chair,13,0,6771,35,172,141,224,232,52,91,chair
7339,21,television,22,0,6771,16,247,156,339,232,92,76,tv
7340,8,table,9,0,6772,43,361,528,760,887,399,359,dining table
7341,11,chair,12,1,6772,43,636,528,784,844,148,316,chair
7342,12,chair,13,0,6772,56,381,563,607,909,226,346,chair
7343,16,chair,17,0,6772,47,168,474,341,740,173,266,chair
7344,19,window,20,0,6772,15,251,78,526,536,275,458,window
7345,20,window,21,0,6772,18,572,113,868,545,296,432,window
7346,6,window,7,0,6773,19,755,11,1300,861,545,850,window
7347,7,window,8,0,6773,17,292,4,556,959,264,955,window
7348,8,chair,9,1,6773,36,382,752,607,1474,225,722,chair
7349,9,chair,10,1,6773,18,888,642,1185,785,297,143,chair
7350,10,chair,11,1,6773,36,1035,778,1297,1514,262,736,chair
7351,11,chair,12,1,6773,45,586,987,1098,1534,512,547,chair
7352,12,table,13,1,6773,58,462,763,1220,1533,758,770,dining table
7353,3,table,4,0,6774,62,10,393,469,748,459,355,dining table
7354,4,chair,5,0,6774,42,324,307,519,721,195,414,chair
7355,5,chair,6,0,6774,28,3,304,157,731,154,427,chair
7356,12,window,13,0,6774,16,2,1,248,417,246,416,window
7357,11,window,12,0,6775,15,575,156,1066,572,491,416,window
7358,15,table,16,1,6775,19,504,544,865,629,361,85,dining table
7359,16,chair,17,1,6775,24,646,470,783,687,137,217,chair
7360,17,chair,18,0,6775,38,743,503,946,869,203,366,chair
7361,18,chair,19,1,6775,29,408,496,563,828,155,332,chair
7362,19,chair,20,0,6775,30,551,544,751,899,200,355,chair
7363,7,table,8,0,6776,63,39,218,225,343,186,125,dining table
7364,8,chair,9,1,6776,19,106,185,154,217,48,32,chair
7365,9,chair,10,1,6776,42,161,197,243,340,82,143,chair
7366,10,chair,11,1,6776,27,23,193,76,331,53,138,chair
7367,11,chair,12,1,6776,34,89,219,166,344,77,125,chair
7368,4,table,5,0,6845,23,2,232,374,418,372,186,dining table
7369,8,chair,9,1,6845,15,302,216,374,289,72,73,chair
7370,10,chair,11,1,6845,27,29,261,203,419,174,158,chair
7371,11,chair,12,1,6845,21,355,152,559,417,204,265,chair
7372,33,bowl,34,0,6845,16,262,233,283,259,21,26,bowl
7373,39,bowl,39,0,6845,17,230,232,252,263,22,31,bowl
7374,43,bowl,43,0,6845,15,151,222,169,243,18,21,bowl
7375,5,table,6,0,6846,99,82,666,943,1136,861,470,dining table
7376,6,chair,7,0,6846,69,425,683,716,1194,291,511,chair
7377,7,chair,8,0,6846,71,167,674,457,1141,290,467,chair
7378,9,window,10,1,6847,18,88,89,350,309,262,220,window
7379,12,chair,13,1,6847,39,38,266,207,480,169,214,chair
7380,17,chair,18,1,6847,21,423,255,521,433,98,178,chair
7381,18,chair,19,1,6847,34,360,259,439,472,79,213,chair
7382,19,chair,20,1,6847,36,235,266,377,480,142,214,chair
7383,6,table,7,0,6848,23,338,423,676,594,338,171,dining table
7384,10,chair,11,1,6848,33,596,424,692,654,96,230,chair
7385,11,chair,12,0,6848,26,480,454,611,682,131,228,chair
7386,12,chair,13,0,6848,43,318,436,472,680,154,244,chair
7387,13,window,14,0,6848,16,179,175,437,433,258,258,window
7388,15,chair,16,0,6848,16,183,391,283,526,100,135,chair
7389,0,chair,1,0,6849,22,37,128,146,254,109,126,chair
7390,9,table,9,0,6849,17,83,115,242,255,159,140,dining table
7391,47,chair,46,0,6849,27,190,109,256,254,66,145,chair
7392,7,table,8,1,6850,66,240,295,626,548,386,253,dining table
7393,9,chair,10,1,6850,17,304,256,381,317,77,61,chair
7394,10,chair,11,1,6850,22,568,250,644,278,76,28,chair
7395,11,chair,12,1,6850,32,560,259,660,478,100,219,chair
7396,12,chair,13,0,6850,72,390,267,595,550,205,283,chair
7397,7,door,8,0,6851,15,4,1,61,131,57,130,door
7398,10,chair,11,1,6851,29,33,74,106,184,73,110,chair
7399,11,chair,12,1,6851,27,47,81,118,219,71,138,chair
7400,26,chair,27,1,6852,17,535,308,610,358,75,50,chair
7401,29,chair,30,1,6852,26,200,300,235,470,35,170,chair
7402,30,chair,31,1,6852,25,215,311,252,535,37,224,chair
7403,31,chair,32,1,6852,29,231,334,391,577,160,243,chair
7404,8,table,9,0,6853,51,68,123,165,192,97,69,dining table
7405,9,chair,10,0,6853,26,34,95,85,199,51,104,chair
7406,10,chair,11,1,6853,17,59,106,90,151,31,45,chair
7407,11,chair,12,1,6853,16,127,97,162,125,35,28,chair
7408,12,chair,13,1,6853,24,138,105,178,186,40,81,chair
7409,13,window,14,1,6853,23,127,38,256,113,129,75,window
7410,15,vase,16,0,6854,15,110,210,147,252,37,42,vase
7411,17,bowl,18,0,6854,15,167,224,210,250,43,26,bowl
7412,4,window,5,1,6855,24,2,85,94,194,92,109,window
7413,7,table,8,0,6855,19,59,167,184,199,125,32,dining table
7414,10,chair,11,1,6855,21,128,166,213,255,85,89,chair
7415,11,chair,12,1,6855,20,32,170,120,256,88,86,chair
7416,7,chair,8,1,6856,37,293,295,405,506,112,211,chair
7417,8,chair,9,1,6856,42,232,285,310,460,78,175,chair
7418,9,chair,10,1,6856,30,189,274,246,428,57,154,chair
7419,0,chair,1,0,6857,32,6,225,173,452,167,227,chair
7420,1,chair,2,0,6857,38,195,218,325,454,130,236,chair
7421,2,chair,3,1,6857,15,143,199,215,258,72,59,chair
7422,4,chair,5,1,6857,21,315,196,381,365,66,169,chair
7423,5,chair,6,1,6857,22,3,196,68,316,65,120,chair
7424,6,table,7,1,6857,36,64,246,364,452,300,206,dining table
7425,12,table,13,1,6858,18,238,219,476,346,238,127,dining table
7426,13,chair,14,1,6858,23,206,171,289,356,83,185,chair
7427,14,chair,15,0,6858,33,276,169,380,387,104,218,chair
7428,15,chair,16,0,6858,49,397,169,500,374,103,205,chair
7429,16,chair,17,1,6858,21,386,171,449,280,63,109,chair
7430,3,table,4,0,6859,66,2,119,412,340,410,221,dining table
7431,4,chair,5,1,6859,32,232,67,303,137,71,70,chair
7432,5,chair,6,1,6859,55,267,74,397,266,130,192,chair
7433,6,chair,7,1,6859,27,13,63,87,129,74,66,chair
7434,7,chair,8,1,6859,35,2,87,79,323,77,236,chair
7435,8,chair,9,0,6859,64,61,98,239,353,178,255,chair
7436,16,window,16,1,6859,38,269,1,438,141,169,140,window
7437,3,window,4,1,6860,16,14,135,418,661,404,526,window
7438,4,chair,5,1,6860,16,366,433,493,550,127,117,chair
7439,5,chair,6,1,6860,22,183,457,367,617,184,160,chair
7440,7,table,8,1,6860,15,124,493,759,662,635,169,dining table
7441,14,chair,15,1,6860,15,799,455,880,542,81,87,chair
7442,15,chair,16,1,6860,18,648,496,862,662,214,166,chair
7443,5,chair,6,0,6861,28,11,216,58,285,47,69,chair
7444,9,chair,10,0,6861,30,503,198,545,262,42,64,chair
7445,13,mirror,14,0,6861,35,419,12,502,194,83,182,mirror
7446,16,chair,17,1,6861,21,437,222,477,322,40,100,chair
7447,17,chair,18,1,6861,21,402,235,444,343,42,108,chair
7448,18,chair,19,0,6861,31,318,242,407,369,89,127,chair
7449,19,chair,20,0,6861,39,215,243,305,373,90,130,chair
7450,20,chair,21,1,6861,23,161,244,222,352,61,108,chair
7451,21,chair,22,1,6861,25,113,235,170,332,57,97,chair
7452,22,chair,23,1,6861,23,83,233,122,319,39,86,chair
7453,23,clock,24,0,6861,17,109,157,130,194,21,37,clock
7454,32,mirror,33,0,6861,16,63,15,154,196,91,181,mirror
7455,17,window,18,1,6862,15,207,146,293,336,86,190,window
7456,21,table,22,0,6862,30,271,344,536,430,265,86,dining table
7457,24,chair,25,1,6862,16,502,319,549,375,47,56,chair
7458,25,chair,26,1,6862,32,536,302,593,401,57,99,chair
7459,26,chair,27,1,6862,20,583,335,627,393,44,58,chair
7460,28,chair,29,1,6862,15,227,304,264,341,37,37,chair
7461,29,chair,30,1,6862,23,217,327,287,428,70,101,chair
7462,31,chair,32,1,6862,26,278,405,433,532,155,127,chair
7463,13,table,14,0,6863,42,153,284,507,479,354,195,dining table
7464,14,chair,15,1,6863,15,407,257,467,321,60,64,chair
7465,16,chair,17,1,6863,15,172,247,223,292,51,45,chair
7466,17,chair,18,1,6863,30,132,256,236,455,104,199,chair
7467,18,chair,19,1,6863,45,154,261,318,479,164,218,chair
7468,15,chair,16,1,6864,29,96,138,135,197,39,59,chair
7469,16,chair,17,0,6864,20,137,145,172,206,35,61,chair
7470,17,chair,18,0,6864,24,176,142,210,205,34,63,chair
7471,19,chair,20,0,6864,25,214,142,249,207,35,65,chair
7472,4,clock,5,0,6865,17,8,116,67,193,59,77,clock
7473,14,table,15,1,6865,87,282,341,809,682,527,341,dining table
7474,16,chair,17,1,6865,50,315,294,484,670,169,376,chair
7475,18,chair,19,1,6865,15,547,293,622,359,75,66,chair
7476,19,chair,20,1,6865,28,284,293,350,569,66,276,chair
7477,21,chair,22,0,6865,32,2,299,148,513,146,214,chair
7478,13,table,14,1,6866,30,397,327,662,477,265,150,dining table
7479,14,pot,15,0,6866,15,490,294,543,359,53,65,potted plant
7480,19,chair,20,0,6866,19,522,313,741,531,219,218,chair
7481,20,chair,21,0,6866,18,297,321,532,531,235,210,chair
7482,46,vase,47,0,6866,22,257,231,281,284,24,53,vase
7483,0,chair,1,0,6867,44,755,509,1088,939,333,430,chair
7484,8,table,9,0,6867,49,956,495,1387,874,431,379,dining table
7485,9,chair,10,1,6867,21,856,454,1132,744,276,290,chair
7486,10,chair,11,1,6867,18,1200,452,1419,666,219,214,chair
7487,23,chair,24,0,6867,89,1223,484,1511,879,288,395,chair
7488,8,table,9,0,6868,35,40,121,140,180,100,59,dining table
7489,14,chair,15,0,6869,25,161,166,202,237,41,71,chair
7490,16,chair,17,1,6869,18,74,165,111,236,37,71,chair
7491,17,chair,18,0,6869,19,110,178,161,254,51,76,chair
7492,3,window,4,0,6870,20,49,0,206,140,157,140,window
7493,4,chair,5,1,6870,30,80,116,128,217,48,101,chair
7494,5,table,6,1,6870,45,41,138,195,234,154,96,dining table
7495,6,chair,7,1,6870,20,150,116,211,188,61,72,chair
7496,7,chair,8,1,6870,20,221,120,255,230,34,110,chair
7497,8,chair,9,1,6870,34,6,118,92,219,86,101,chair
7498,12,table,13,1,6871,19,321,242,420,304,99,62,dining table
7499,18,table,19,1,6871,26,148,267,312,339,164,72,dining table
7500,24,chair,25,1,6871,21,296,273,353,352,57,79,chair
7501,28,table,29,1,6871,17,2,242,87,304,85,62,dining table
7502,30,chair,31,1,6871,16,84,240,103,300,19,60,chair
7503,31,chair,32,1,6871,19,51,251,95,302,44,51,chair
7504,33,chair,34,1,6871,15,10,265,44,316,34,51,chair
7505,35,chair,36,1,6871,16,9,281,85,383,76,102,chair
7506,38,table,39,1,6871,17,2,336,422,537,420,201,dining table
7507,50,plate,51,0,6871,16,28,418,122,466,94,48,plate
7508,51,plate,52,0,6871,15,147,443,251,504,104,61,plate
7509,52,plate,53,0,6871,15,271,435,381,488,110,53,plate
7510,53,plate,54,0,6871,15,317,400,409,437,92,37,plate
7511,69,bowl,70,0,6871,17,216,402,236,432,20,30,bowl
7512,75,bowl,76,0,6871,16,192,384,217,419,25,35,bowl
7513,77,bowl,78,0,6871,17,278,384,300,414,22,30,bowl
7514,81,bowl,82,0,6871,16,255,382,277,412,22,30,bowl
7515,85,bowl,86,0,6871,15,301,363,321,388,20,25,bowl
7516,89,bowl,90,0,6871,17,127,388,148,419,21,31,bowl
7517,93,bowl,94,0,6871,17,82,370,102,394,20,24,bowl
7518,5,plate,6,0,6872,21,148,228,230,248,82,20,plate
7519,6,plate,7,0,6872,17,152,220,221,241,69,21,plate
7520,27,plate,28,1,6872,17,96,196,137,207,41,11,plate
7521,17,table,18,0,6873,16,90,431,592,766,502,335,dining table
7522,20,chair,21,1,6873,29,412,415,541,644,129,229,chair
7523,21,chair,22,1,6873,24,93,420,182,634,89,214,chair
7524,22,chair,23,1,6873,32,155,426,262,673,107,247,chair
7525,23,chair,24,1,6873,41,234,428,435,743,201,315,chair
7526,98,vase,99,0,6873,16,251,393,285,434,34,41,vase
7527,45,plate,46,0,6874,20,883,827,1023,868,140,41,plate
7528,46,plate,47,0,6874,20,761,799,899,835,138,36,plate
7529,3,chair,4,0,6875,16,31,109,92,245,61,136,chair
7530,5,chair,6,0,6875,31,113,109,202,255,89,146,chair
7531,9,table,9,0,6875,45,48,128,215,255,167,127,dining table
7532,2,window,3,0,6876,20,67,133,479,685,412,552,window
7533,5,table,6,0,6876,34,286,462,698,737,412,275,dining table
7534,11,chair,12,1,6876,33,876,431,1110,740,234,309,chair
7535,16,chair,17,1,6876,24,657,450,724,716,67,266,chair
7536,17,chair,18,0,6876,33,487,468,679,739,192,271,chair
7537,20,chair,21,1,6876,29,207,509,467,740,260,231,chair
7538,6,table,7,0,6877,33,31,154,242,256,211,102,dining table
7539,7,chair,8,1,6877,18,3,118,64,182,61,64,chair
7540,9,chair,10,1,6877,21,0,162,142,256,142,94,chair
7541,3,table,4,0,6878,15,38,154,201,247,163,93,dining table
7542,4,chair,5,0,6878,28,98,159,153,248,55,89,chair
7543,6,chair,6,0,6878,17,153,157,206,246,53,89,chair
7544,22,chair,21,0,6878,35,49,156,99,238,50,82,chair
7545,0,chair,1,0,6879,19,414,397,571,694,157,297,chair
7546,1,chair,2,0,6879,19,82,437,293,756,211,319,chair
7547,9,table,10,0,6879,17,0,403,474,720,474,317,dining table
7548,24,vase,25,0,6879,17,108,404,159,446,51,42,vase
7549,11,table,12,0,6880,75,129,264,511,471,382,207,dining table
7550,13,chair,14,1,6880,38,124,210,192,435,68,225,chair
7551,14,chair,15,1,6880,43,162,210,267,471,105,261,chair
7552,4,table,5,0,6881,29,240,225,691,589,451,364,dining table
7553,12,chair,13,1,6881,15,298,195,386,261,88,66,chair
7554,13,chair,14,1,6881,33,639,220,715,467,76,247,chair
7555,14,chair,15,0,6881,49,474,239,670,570,196,331,chair
7556,2,chair,3,1,6882,16,348,177,415,245,67,68,chair
7557,3,chair,4,1,6882,16,113,180,201,263,88,83,chair
7558,7,table,8,1,6882,21,2,232,359,393,357,161,dining table
7559,8,chair,9,1,6882,19,242,233,420,394,178,161,chair
7560,10,sofa,11,1,6882,16,34,164,124,235,90,71,couch
7561,6,table,7,0,6883,26,76,196,357,328,281,132,dining table
7562,9,plate,10,0,6883,17,399,15,446,64,47,49,plate
7563,10,vase,11,0,6883,21,416,36,444,65,28,29,vase
7564,23,chair,21,1,6883,18,364,161,421,300,57,139,chair
7565,24,chair,22,1,6883,21,318,164,383,323,65,159,chair
7566,26,vase,24,1,6883,20,191,186,223,215,32,29,vase
7567,41,chair,39,0,6883,57,204,162,336,353,132,191,chair
7568,7,window,8,0,6884,20,510,101,657,303,147,202,window
7569,8,sofa,9,1,6884,17,493,278,664,361,171,83,couch
7570,18,table,19,0,6884,21,222,288,438,456,216,168,dining table
7571,20,chair,21,1,6884,32,346,271,420,417,74,146,chair
7572,21,chair,22,1,6884,17,224,272,256,405,32,133,chair
7573,22,chair,23,1,6884,30,254,274,305,433,51,159,chair
7574,8,clock,9,0,6885,19,339,260,397,382,58,122,clock
7575,43,door,44,0,6885,16,584,253,691,477,107,224,door
7576,10,chair,10,1,6886,19,485,610,779,1197,294,587,chair
7577,12,bowl,12,0,6886,20,367,608,504,690,137,82,bowl
7578,34,chair,33,0,6886,95,50,611,479,1199,429,588,chair
7579,51,bowl,50,0,6886,15,588,584,624,642,36,58,bowl
7580,55,bowl,54,0,6886,15,389,590,437,667,48,77,bowl
7581,60,bowl,59,0,6886,15,657,589,702,661,45,72,bowl
7582,7,chair,8,0,6887,23,201,122,252,206,51,84,chair
7583,8,chair,9,0,6887,25,127,125,186,215,59,90,chair
7584,9,chair,10,1,6887,15,118,112,142,182,24,70,chair
7585,5,table,6,0,6888,16,49,153,186,255,137,102,dining table
7586,9,chair,10,1,6888,26,148,169,200,255,52,86,chair
7587,1,table,2,0,6889,48,41,147,246,255,205,108,dining table
7588,3,chair,4,0,6889,23,0,139,60,249,60,110,chair
7589,20,chair,21,1,6890,19,433,269,549,368,116,99,chair
7590,25,sofa,26,1,6890,24,2,302,224,442,222,140,couch
7591,2,table,3,0,6891,26,64,103,186,182,122,79,dining table
7592,3,chair,4,1,6891,21,36,74,89,138,53,64,chair
7593,5,chair,6,1,6891,27,221,79,255,179,34,100,chair
7594,6,chair,7,1,6891,18,2,80,38,183,36,103,chair
7595,7,chair,8,0,6891,35,19,83,111,197,92,114,chair
7596,12,chair,13,0,6891,28,150,84,239,197,89,113,chair
7597,2,chair,3,0,6892,18,78,174,173,254,95,80,chair
7598,5,table,6,0,6892,17,23,171,178,255,155,84,dining table
7599,6,chair,7,0,6892,15,5,163,46,255,41,92,chair
7600,9,mirror,10,0,6892,22,209,10,255,146,46,136,mirror
7601,17,chair,18,0,6892,17,1,168,39,253,38,85,chair
7602,2,window,3,0,6893,23,279,1,1021,699,742,698,window
7603,8,chair,9,1,6893,26,611,393,693,693,82,300,chair
7604,9,chair,10,0,6893,24,420,404,642,699,222,295,chair
7605,10,table,11,0,6893,24,209,407,587,699,378,292,dining table
7606,11,chair,12,1,6893,21,130,421,421,699,291,278,chair
7607,0,chair,1,0,6894,18,114,104,187,256,73,152,chair
7608,1,chair,2,1,6894,16,176,93,236,229,60,136,chair
7609,2,table,3,0,6894,22,6,86,218,256,212,170,dining table
7610,3,chair,4,0,6894,17,224,86,256,199,32,113,chair
7611,15,chair,16,1,6894,18,10,86,82,234,72,148,chair
7612,14,chair,15,1,6895,29,519,359,630,499,111,140,chair
7613,16,chair,17,1,6895,18,248,386,374,500,126,114,chair
7614,17,chair,18,1,6895,24,126,358,257,499,131,141,chair
7615,12,chair,13,1,6896,15,371,371,451,615,80,244,chair
7616,15,chair,16,1,6896,22,607,367,646,600,39,233,chair
7617,16,chair,17,0,6896,22,470,391,625,682,155,291,chair
7618,6,table,7,0,6897,27,204,307,496,433,292,126,dining table
7619,7,chair,8,1,6897,18,191,318,245,402,54,84,chair
7620,8,chair,9,1,6897,23,236,322,296,413,60,91,chair
7621,9,chair,10,1,6897,23,287,327,364,430,77,103,chair
7622,10,chair,11,1,6897,23,355,329,437,445,82,116,chair
7623,9,table,10,0,6898,39,225,421,610,695,385,274,dining table
7624,10,chair,11,0,6898,37,599,395,695,652,96,257,chair
7625,11,chair,12,0,6898,63,420,405,622,695,202,290,chair
7626,12,chair,13,0,6898,70,861,400,1023,612,162,212,chair
7627,14,mirror,15,0,6898,16,604,319,752,382,148,63,mirror
7628,15,chair,16,1,6898,15,354,383,414,430,60,47,chair
7629,16,chair,17,1,6898,20,253,387,329,440,76,53,chair
7630,17,chair,18,0,6898,65,119,401,358,698,239,297,chair
7631,2,window,3,1,6899,20,423,20,785,331,362,311,window
7632,3,table,4,1,6899,24,366,275,699,376,333,101,dining table
7633,8,chair,9,1,6899,26,213,255,280,505,67,250,chair
7634,9,chair,10,0,6899,37,268,284,470,534,202,250,chair
7635,10,chair,11,0,6899,25,480,297,687,534,207,237,chair
7636,11,chair,12,1,6899,33,677,267,788,533,111,266,chair
7637,12,flowerpot,13,0,6899,17,452,259,528,314,76,55,potted plant
7638,11,chair,12,1,6900,15,122,122,175,165,53,43,chair
7639,13,sofa,14,0,6900,28,0,131,126,220,126,89,couch
7640,17,table,18,0,6900,18,126,168,312,280,186,112,dining table
7641,20,chair,21,1,6900,23,106,178,183,254,77,76,chair
7642,21,chair,22,1,6900,18,111,204,219,280,108,76,chair
7643,18,window,19,1,6901,15,2,128,178,417,176,289,window
7644,23,chair,24,1,6901,24,494,325,547,532,53,207,chair
7645,24,chair,25,1,6901,23,373,342,516,532,143,190,chair
7646,31,chair,32,1,6901,19,53,344,169,533,116,189,chair
7647,32,chair,33,1,6901,20,144,358,339,532,195,174,chair
7648,1,chair,2,0,6903,19,589,292,668,483,79,191,chair
7649,14,chair,12,0,6903,83,629,303,762,570,133,267,chair
7650,15,chair,13,0,6903,85,143,315,322,600,179,285,chair
7651,17,chair,15,0,6903,26,468,298,543,357,75,59,chair
7652,18,chair,16,0,6903,77,400,321,591,600,191,279,chair
7653,22,bowl,19,0,6903,16,424,303,471,320,47,17,bowl
7654,23,mirror,20,0,6903,25,105,40,668,463,563,423,mirror
7655,2,window,3,0,6904,20,2,28,256,140,254,112,window
7656,4,table,5,0,6904,23,75,129,197,182,122,53,dining table
7657,6,chair,7,0,6904,17,71,137,111,191,40,54,chair
7658,7,chair,8,0,6904,22,108,138,144,193,36,55,chair
7659,8,chair,9,0,6904,29,144,137,181,192,37,55,chair
7660,9,chair,10,0,6904,23,176,135,209,187,33,52,chair
7661,6,table,7,0,6905,40,126,216,511,394,385,178,dining table
7662,9,chair,10,0,6905,37,154,199,296,393,142,194,chair
7663,10,chair,11,1,6905,29,458,202,639,331,181,129,chair
7664,11,chair,12,1,6905,32,399,220,673,392,274,172,chair
7665,5,window,6,1,6906,35,403,128,597,351,194,223,window
7666,12,table,13,0,6906,18,174,272,498,458,324,186,dining table
7667,13,chair,14,1,6906,15,185,236,256,300,71,64,chair
7668,14,chair,15,1,6906,33,445,239,518,431,73,192,chair
7669,15,chair,16,1,6906,31,333,237,473,460,140,223,chair
7670,16,chair,17,1,6906,35,80,231,295,460,215,229,chair
7671,28,table,28,1,6907,40,263,354,798,580,535,226,dining table
7672,30,chair,30,1,6907,35,715,324,900,665,185,341,chair
7673,33,chair,33,1,6907,34,145,357,472,665,327,308,chair
7674,34,chair,34,1,6907,32,413,366,772,665,359,299,chair
7675,37,plate,37,1,6907,15,529,420,638,458,109,38,plate
7676,4,table,5,0,6908,15,307,474,835,682,528,208,dining table
7677,13,chair,14,1,6908,33,267,425,425,677,158,252,chair
7678,16,chair,17,1,6908,36,728,425,874,677,146,252,chair
7679,17,chair,18,0,6908,35,585,445,743,681,158,236,chair
7680,18,chair,19,0,6908,39,422,443,565,682,143,239,chair
7681,15,sofa,16,1,6909,28,108,360,278,472,170,112,couch
7682,18,table,19,0,6909,53,237,383,628,653,391,270,dining table
7683,19,chair,20,1,6909,24,272,349,388,562,116,213,chair
7684,20,chair,21,0,6909,40,493,371,695,666,202,295,chair
7685,21,chair,22,0,6909,27,68,374,351,683,283,309,chair
7686,1,table,2,0,6910,20,194,258,539,464,345,206,dining table
7687,9,chair,10,0,6910,31,2,213,131,379,129,166,chair
7688,10,chair,11,0,6910,34,156,211,305,464,149,253,chair
7689,11,chair,12,0,6910,39,411,214,588,479,177,265,chair
7690,12,chair,13,1,6910,23,615,221,720,451,105,230,chair
7691,9,chair,10,1,6911,18,149,196,216,259,67,63,chair
7692,11,chair,12,1,6911,26,82,243,174,328,92,85,chair
7693,13,chair,14,1,6911,21,290,237,395,328,105,91,chair
7694,11,table,12,0,6912,25,202,293,552,511,350,218,dining table
7695,12,chair,13,1,6912,33,194,249,266,439,72,190,chair
7696,13,chair,14,0,6912,37,252,243,394,509,142,266,chair
7697,14,chair,15,0,6912,45,464,239,608,524,144,285,chair
7698,17,vase,18,0,6912,27,433,235,477,325,44,90,vase
7699,12,table,13,1,6913,17,44,207,173,290,129,83,dining table
7700,14,chair,15,1,6913,20,83,206,260,364,177,158,chair
7701,16,chair,17,1,6913,19,2,194,94,351,92,157,chair
7702,6,table,7,0,6914,41,69,104,178,159,109,55,dining table
7703,8,chair,9,1,6914,21,22,103,76,159,54,56,chair
7704,10,chair,11,1,6914,22,176,99,226,149,50,50,chair
7705,11,chair,12,1,6914,15,163,119,239,159,76,40,chair
7706,21,window,22,1,6914,19,110,38,136,104,26,66,window
7707,15,chair,16,1,6915,25,862,488,1082,656,220,168,chair
7708,17,chair,18,1,6915,16,629,462,750,582,121,120,chair
7709,34,chair,35,1,6915,23,201,497,377,852,176,355,chair
7710,35,chair,36,1,6915,33,322,548,545,852,223,304,chair
7711,9,sofa,10,1,6916,19,401,343,618,402,217,59,couch
7712,11,sofa,12,0,6916,28,579,352,854,535,275,183,couch
7713,13,table,14,0,6916,41,157,387,470,664,313,277,dining table
7714,18,chair,19,1,6916,37,334,396,554,680,220,284,chair
7715,31,chair,32,1,6916,35,100,377,275,653,175,276,chair
7716,32,chair,33,0,6916,42,111,390,333,680,222,290,chair
7717,52,door,53,1,6916,18,117,112,235,418,118,306,door
7718,7,table,8,0,6917,31,239,230,507,396,268,166,dining table
7719,10,chair,11,1,6917,34,252,211,304,370,52,159,chair
7720,11,chair,12,0,6917,37,294,220,404,397,110,177,chair
7721,8,table,9,0,6918,41,340,582,807,970,467,388,dining table
7722,10,chair,11,1,6918,20,755,511,868,861,113,350,chair
7723,12,chair,13,0,6918,28,227,590,526,1007,299,417,chair
7724,21,chair,22,0,6918,31,550,602,823,1018,273,416,chair
7725,7,chair,8,1,6919,28,201,455,481,1051,280,596,chair
7726,8,chair,9,1,6919,33,411,504,1099,1055,688,551,chair
7727,15,vase,16,0,6919,16,951,412,1057,572,106,160,vase
7728,44,chair,43,1,6919,32,356,385,637,522,281,137,chair
7729,49,plate,48,0,6919,25,868,565,1084,613,216,48,plate
7730,50,plate,49,1,6919,29,858,583,1097,635,239,52,plate
7731,51,spoon,50,0,6919,20,986,621,1128,651,142,30,spoon
7732,55,plate,54,1,6919,36,598,515,778,554,180,39,plate
7733,56,plate,55,1,6919,23,618,538,791,572,173,34,plate
7734,21,chair,22,0,6920,22,243,226,317,327,74,101,chair
7735,22,chair,23,0,6920,27,315,209,408,346,93,137,chair
7736,9,table,10,0,6921,45,189,1171,1501,1763,1312,592,dining table
7737,12,mirror,13,0,6921,20,1086,429,1466,1086,380,657,mirror
7738,14,chair,15,1,6921,18,756,1092,915,1210,159,118,chair
7739,15,chair,16,1,6921,19,1100,1117,1317,1276,217,159,chair
7740,16,chair,17,1,6921,45,1649,1111,1923,1720,274,609,chair
7741,18,chair,19,1,6921,32,215,1079,448,1384,233,305,chair
7742,19,chair,20,1,6921,50,46,1145,412,1818,366,673,chair
7743,20,chair,21,0,6921,54,349,1215,973,2097,624,882,chair
7744,28,flowerpot,27,0,6921,20,1144,1054,1275,1127,131,73,potted plant
7745,2,table,3,0,6922,15,38,148,196,254,158,106,dining table
7746,8,chair,9,1,6922,18,61,171,197,256,136,85,chair
7747,16,table,17,1,6923,16,280,271,639,413,359,142,dining table
7748,17,vase,18,0,6923,17,435,231,477,303,42,72,vase
7749,22,chair,23,1,6923,16,205,281,370,451,165,170,chair
7750,29,table,30,1,6923,15,347,251,404,279,57,28,dining table
7751,10,chair,11,1,6924,15,511,356,901,768,390,412,chair
7752,12,chair,13,1,6924,17,280,354,465,767,185,413,chair
7753,3,window,4,1,6925,29,478,153,575,268,97,115,window
7754,19,vase,20,1,6925,20,389,278,435,338,46,60,vase
7755,23,table,24,1,6925,39,540,313,800,533,260,220,dining table
7756,24,vase,25,1,6925,16,756,149,800,374,44,225,vase
7757,28,sofa,29,1,6925,31,68,282,269,413,201,131,couch
7758,29,table,30,1,6925,39,214,312,525,533,311,221,dining table
7759,30,chair,31,1,6925,15,497,258,541,318,44,60,chair
7760,31,chair,32,1,6925,17,344,260,402,327,58,67,chair
7761,34,chair,35,1,6925,35,497,263,595,508,98,245,chair
7762,35,chair,36,1,6925,35,357,263,519,532,162,269,chair
7763,36,chair,37,0,6925,49,121,265,332,533,211,268,chair
7764,9,chair,10,1,6926,24,182,165,255,255,73,90,chair
7765,10,table,11,0,6926,23,53,163,210,255,157,92,dining table
7766,15,window,16,0,6927,32,91,55,169,195,78,140,window
7767,11,chair,12,1,6928,26,186,251,298,480,112,229,chair
7768,12,chair,13,0,6928,30,281,246,461,528,180,282,chair
7769,6,chair,6,0,6929,19,637,470,1031,995,394,525,chair
7770,7,chair,7,0,6929,19,3,526,259,1045,256,519,chair
7771,9,table,10,1,6930,23,191,388,291,460,100,72,dining table
7772,10,chair,11,0,6930,34,277,372,330,461,53,89,chair
7773,11,chair,12,0,6930,22,193,383,248,485,55,102,chair
7774,25,chair,26,1,6930,16,597,390,674,467,77,77,chair
7775,26,chair,27,1,6930,23,720,398,810,494,90,96,chair
7776,27,chair,28,1,6930,25,841,413,997,527,156,114,chair
7777,29,chair,30,1,6930,25,346,385,429,456,83,71,chair
7778,30,chair,31,1,6930,45,324,422,459,691,135,269,chair
7779,31,chair,32,1,6930,34,425,443,617,691,192,248,chair
7780,32,chair,33,1,6930,27,581,479,853,691,272,212,chair
7781,5,window,6,0,6931,17,108,117,431,548,323,431,window
7782,8,chair,9,1,6931,16,121,353,195,548,74,195,chair
7783,10,chair,11,1,6931,31,392,343,484,599,92,256,chair
7784,14,chair,15,1,6931,46,767,353,976,614,209,261,chair
7785,15,chair,16,0,6931,50,683,366,928,697,245,331,chair
7786,16,chair,17,0,6931,47,438,372,693,698,255,326,chair
7787,21,vase,22,0,6931,19,499,227,534,286,35,59,vase
7788,9,window,10,0,6932,35,113,150,383,466,270,316,window
7789,11,table,12,0,6932,69,244,384,758,681,514,297,dining table
7790,12,chair,13,1,6932,34,183,349,294,642,111,293,chair
7791,14,chair,15,1,6932,62,248,364,519,682,271,318,chair
7792,18,vase,19,0,6932,15,395,378,420,436,25,58,vase
7793,11,table,12,0,6933,16,401,387,722,514,321,127,dining table
7794,15,chair,16,0,6933,22,333,371,513,630,180,259,chair
7795,16,bench,17,0,6933,35,529,454,777,655,248,201,bench
7796,9,chair,10,1,6934,19,434,259,507,337,73,78,chair
7797,11,chair,12,1,6934,43,501,296,714,543,213,247,chair
7798,12,chair,13,1,6934,21,175,262,236,301,61,39,chair
7799,13,chair,14,1,6934,20,165,281,227,510,62,229,chair
7800,14,chair,15,1,6934,29,215,267,297,542,82,275,chair
7801,15,chair,16,1,6934,28,283,298,433,545,150,247,chair
7802,31,window,32,0,6934,20,228,137,305,307,77,170,window
7803,17,table,18,0,6935,28,213,611,483,886,270,275,dining table
7804,23,chair,24,0,6935,21,269,689,440,988,171,299,chair
7805,20,chair,21,0,6936,21,190,312,318,510,128,198,chair
7806,21,chair,22,0,6936,25,309,320,450,532,141,212,chair
7807,22,chair,23,1,6936,17,445,312,515,511,70,199,chair
7808,5,table,6,0,6937,25,190,259,466,479,276,220,dining table
7809,6,vase,7,0,6937,17,275,235,353,278,78,43,vase
7810,10,chair,11,1,6937,27,320,219,474,410,154,191,chair
7811,11,chair,12,0,6937,41,337,223,551,480,214,257,chair
7812,12,chair,13,0,6937,48,141,222,308,471,167,249,chair
7813,4,table,5,0,6938,21,80,173,718,597,638,424,dining table
7814,7,chair,8,0,6938,32,333,165,600,566,267,401,chair
7815,9,chair,10,1,6938,35,39,121,287,554,248,433,chair
7816,28,clock,29,0,6939,18,1081,121,1185,234,104,113,clock
7817,32,bowl,33,0,6939,17,344,523,406,547,62,24,bowl
7818,75,bench,76,0,6939,17,284,598,1085,900,801,302,bench
7819,77,sofa,78,0,6939,36,23,416,712,645,689,229,couch
7820,0,table,1,0,6940,30,33,355,540,766,507,411,dining table
7821,13,chair,12,1,6940,36,320,309,597,765,277,456,chair
7822,22,chair,21,1,6940,45,2,307,269,675,267,368,chair
7823,43,chair,42,1,6940,20,404,290,514,455,110,165,chair
7824,17,table,18,0,6942,17,4,317,562,514,558,197,dining table
7825,19,chair,20,1,6942,16,57,287,197,377,140,90,chair
7826,20,chair,21,1,6942,16,431,270,528,327,97,57,chair
7827,21,chair,22,1,6942,29,480,283,584,515,104,232,chair
7828,22,chair,23,1,6942,24,273,306,521,515,248,209,chair
7829,25,chair,26,1,6942,19,2,348,226,515,224,167,chair
7830,28,cup,29,0,6942,18,731,324,760,359,29,35,cup
7831,29,cup,30,0,6942,19,762,331,792,366,30,35,cup
7832,31,door,32,0,6942,20,506,114,593,345,87,231,door
7833,32,door,33,0,6942,15,422,114,506,320,84,206,door
7834,10,table,10,1,6943,18,184,299,526,521,342,222,dining table
7835,13,chair,13,1,6943,19,184,272,240,431,56,159,chair
7836,14,chair,14,1,6943,32,226,274,325,465,99,191,chair
7837,15,chair,15,0,6943,24,271,274,375,512,104,238,chair
7838,25,chair,25,1,6943,15,402,270,489,375,87,105,chair
7839,14,chair,15,1,6944,21,420,223,467,327,47,104,chair
7840,15,chair,16,1,6944,27,370,250,459,407,89,157,chair
7841,16,chair,17,0,6944,31,251,264,384,426,133,162,chair
7842,17,chair,18,0,6944,35,76,266,217,424,141,158,chair
7843,18,table,19,1,6944,32,148,247,467,427,319,180,dining table
7844,27,flowerpot,28,0,6944,21,45,300,87,331,42,31,potted plant
7845,26,table,27,0,6945,39,303,372,692,622,389,250,dining table
7846,27,chair,28,1,6945,31,649,340,711,512,62,172,chair
7847,29,chair,30,1,6945,16,371,345,439,393,68,48,chair
7848,30,chair,31,0,6945,51,246,362,409,623,163,261,chair
7849,31,chair,32,0,6945,37,573,356,705,591,132,235,chair
7850,32,chair,33,0,6945,39,436,367,599,622,163,255,chair
7851,72,bottle,73,0,6945,26,393,280,403,320,10,40,bottle
7852,76,door,77,0,6945,20,676,177,763,463,87,286,door
7853,3,chair,4,0,6946,17,120,171,194,254,74,83,chair
7854,10,chair,11,1,6947,16,860,545,997,622,137,77,chair
7855,16,table,17,1,6947,16,80,491,244,610,164,119,dining table
7856,17,chair,18,1,6947,25,207,477,241,578,34,101,chair
7857,18,chair,19,0,6947,26,126,483,215,613,89,130,chair
7858,23,chair,24,1,6947,31,610,471,687,573,77,102,chair
7859,30,chair,31,1,6947,27,331,586,504,797,173,211,chair
7860,31,chair,32,1,6947,20,475,597,715,796,240,199,chair
7861,14,bench,15,0,6948,15,501,190,570,237,69,47,bench
7862,18,chair,19,1,6948,27,367,199,416,324,49,125,chair
7863,19,chair,20,1,6948,27,344,214,410,369,66,155,chair
7864,20,chair,21,1,6948,22,149,206,205,260,56,54,chair
7865,21,chair,22,0,6948,38,111,229,240,421,129,192,chair
7866,22,chair,23,0,6948,37,246,215,356,411,110,196,chair
7867,26,sofa,20,1,6950,107,4,770,1203,1378,1199,608,couch
7868,27,table,21,1,6950,26,300,889,817,1116,517,227,dining table
7869,28,chair,22,1,6950,33,1022,759,1188,1287,166,528,chair
7870,29,chair,23,0,6950,48,536,759,1073,1462,537,703,chair
7871,30,chair,24,0,6950,43,88,763,569,1458,481,695,chair
7872,9,chair,10,0,6951,20,105,133,168,226,63,93,chair
7873,11,chair,12,0,6951,18,44,130,95,213,51,83,chair
7874,15,chair,16,0,6952,24,32,122,92,214,60,92,chair
7875,16,chair,17,0,6952,19,130,119,189,203,59,84,chair
7876,28,table,29,0,6952,17,59,106,192,213,133,107,dining table
7877,14,table,15,0,6953,29,328,330,800,598,472,268,dining table
7878,19,chair,20,1,6953,17,332,307,417,558,85,251,chair
7879,20,chair,21,1,6953,21,389,320,492,599,103,279,chair
7880,21,chair,22,1,6953,26,579,355,784,599,205,244,chair
7881,29,bottle,30,0,6953,20,374,205,408,250,34,45,bottle
7882,18,table,19,0,6954,18,124,392,647,667,523,275,dining table
7883,23,flowerpot,24,0,6954,20,244,376,375,440,131,64,potted plant
7884,25,chair,26,1,6954,18,17,404,211,512,194,108,chair
7885,26,chair,27,1,6954,26,22,445,334,667,312,222,chair
7886,27,chair,28,1,6954,23,414,467,738,667,324,200,chair
7887,10,chair,11,1,6955,19,308,330,382,530,74,200,chair
7888,12,chair,13,1,6955,16,681,359,800,450,119,91,chair
7889,15,vase,16,0,6955,18,638,388,748,473,110,85,vase
7890,1,chair,2,0,6956,26,118,101,225,243,107,142,chair
7891,2,chair,3,0,6956,30,6,92,104,224,98,132,chair
7892,7,table,8,0,6956,28,39,106,166,218,127,112,dining table
7893,3,window,4,0,6957,19,391,124,623,435,232,311,window
7894,10,table,11,0,6957,23,324,421,743,682,419,261,dining table
7895,12,chair,13,1,6957,17,650,386,745,485,95,99,chair
7896,14,chair,15,1,6957,17,267,385,351,509,84,124,chair
7897,16,chair,17,1,6957,19,199,430,316,591,117,161,chair
7898,8,chair,9,1,6958,17,343,309,401,379,58,70,chair
7899,9,chair,10,1,6958,17,405,317,478,397,73,80,chair
7900,10,chair,11,1,6958,16,484,321,573,417,89,96,chair
7901,11,chair,12,1,6958,18,595,343,705,450,110,107,chair
7902,15,chair,16,1,6958,38,108,323,195,555,87,232,chair
7903,16,chair,17,1,6958,37,152,340,257,579,105,239,chair
7904,17,chair,18,1,6958,22,210,360,367,579,157,219,chair
7905,18,chair,19,1,6958,30,316,401,502,578,186,177,chair
7906,3,chair,4,0,6959,24,67,155,121,231,54,76,chair
7907,5,chair,6,0,6959,19,139,150,180,217,41,67,chair
7908,6,table,7,0,6959,18,72,158,164,219,92,61,dining table
7909,11,chair,12,1,6960,20,179,130,209,199,30,69,chair
7910,12,chair,13,0,6960,23,115,139,160,215,45,76,chair
7911,14,chair,15,1,6960,18,91,121,113,156,22,35,chair
7912,18,pot,18,0,6961,36,888,193,965,380,77,187,potted plant
7913,19,pot,19,0,6961,26,833,252,924,398,91,146,potted plant
7914,20,pot,20,0,6961,18,698,335,752,421,54,86,potted plant
7915,21,pot,21,0,6961,26,684,240,765,397,81,157,potted plant
7916,22,pot,22,0,6961,40,571,199,687,431,116,232,potted plant
7917,23,window,23,0,6961,15,111,1,349,452,238,451,window
7918,27,chair,27,0,6961,19,103,420,457,606,354,186,chair
7919,29,chair,29,0,6961,30,912,591,1366,1023,454,432,chair
7920,31,chair,31,0,6961,21,2,685,103,1050,101,365,chair
7921,35,plate,35,0,6961,18,575,637,893,754,318,117,plate
7922,41,table,41,0,6961,24,55,525,1049,1049,994,524,dining table
7923,0,chair,1,0,6962,16,110,148,203,256,93,108,chair
7924,14,table,15,0,6962,33,13,142,190,252,177,110,dining table
7925,22,bowl,23,0,6962,18,87,124,125,157,38,33,bowl
7926,25,plate,26,0,6962,15,29,155,66,163,37,8,plate
7927,6,table,7,0,6963,24,130,216,329,358,199,142,dining table
7928,8,chair,9,0,6963,33,265,199,391,400,126,201,chair
7929,9,chair,10,0,6963,29,58,192,166,379,108,187,chair
7930,2,table,3,0,6964,33,112,86,621,324,509,238,dining table
7931,5,chair,6,1,6964,25,68,101,216,295,148,194,chair
7932,6,chair,7,0,6964,22,580,115,676,290,96,175,chair
7933,7,chair,8,0,6964,24,477,132,590,322,113,190,chair
7934,8,chair,9,0,6964,23,310,154,487,361,177,207,chair
7935,4,chair,5,1,6965,21,4,118,72,236,68,118,chair
7936,14,chair,15,1,6965,22,159,161,241,246,82,85,chair
7937,15,chair,16,1,6965,26,109,202,201,283,92,81,chair
7938,8,mirror,9,0,6966,17,255,97,373,199,118,102,mirror
7939,11,chair,12,0,6966,31,74,230,187,364,113,134,chair
7940,12,chair,13,0,6966,24,180,234,266,378,86,144,chair
7941,16,chair,17,0,6966,22,367,233,459,370,92,137,chair
7942,21,chair,22,0,6966,22,278,236,362,382,84,146,chair
7943,5,chair,6,0,6967,27,186,180,242,255,56,75,chair
7944,4,chair,5,0,6968,29,70,141,159,255,89,114,chair
7945,8,table,9,0,6968,30,119,129,248,231,129,102,dining table
7946,1,table,2,0,6969,35,20,130,195,235,175,105,dining table
7947,2,chair,3,0,6969,19,78,122,151,239,73,117,chair
7948,3,chair,4,0,6969,19,148,107,208,220,60,113,chair
7949,5,chair,6,0,6969,15,5,110,68,228,63,118,chair
7950,8,table,9,1,6970,20,2,330,71,381,69,51,dining table
7951,18,table,19,0,6970,32,278,347,493,528,215,181,dining table
7952,20,chair,21,1,6970,21,509,328,578,503,69,175,chair
7953,21,chair,22,0,6970,34,365,359,526,533,161,174,chair
7954,22,chair,23,0,6970,38,181,336,321,533,140,197,chair
7955,23,table,24,0,6970,24,143,304,291,456,148,152,dining table
7956,10,chair,11,1,6971,16,295,301,391,339,96,38,chair
7957,14,table,15,0,6971,63,220,319,800,530,580,211,dining table
7958,15,chair,16,1,6971,16,655,286,757,321,102,35,chair
7959,16,chair,17,1,6971,29,724,296,799,530,75,234,chair
7960,17,chair,18,1,6971,40,570,302,765,531,195,229,chair
7961,18,chair,19,1,6971,35,528,314,696,531,168,217,chair
7962,19,chair,20,1,6971,24,253,326,483,532,230,206,chair
7963,20,vase,21,0,6971,27,542,218,596,350,54,132,vase
7964,3,sofa,4,1,6972,19,2,184,294,301,292,117,couch
7965,10,table,11,0,6972,20,90,223,409,360,319,137,dining table
7966,12,chair,13,1,6972,15,362,223,409,358,47,135,chair
7967,17,chair,17,0,6973,23,663,288,733,361,70,73,chair
7968,22,table,22,0,6973,44,208,301,567,526,359,225,dining table
7969,25,chair,25,0,6973,36,139,289,291,491,152,202,chair
7970,26,chair,26,0,6973,38,280,297,439,534,159,237,chair
7971,27,chair,27,0,6973,27,492,280,637,521,145,241,chair
7972,3,chair,4,0,6974,19,176,148,255,253,79,105,chair
7973,4,chair,5,0,6974,24,79,143,179,254,100,111,chair
7974,5,chair,6,0,6974,20,59,140,98,232,39,92,chair
7975,6,chair,7,0,6974,21,44,137,73,213,29,76,chair
7976,19,table,19,0,6974,16,68,142,234,178,166,36,dining table
7977,6,chair,6,0,6975,21,821,669,1097,1184,276,515,chair
7978,7,table,7,1,6975,35,493,716,1400,1092,907,376,dining table
7979,8,chair,8,0,6975,21,505,664,801,1147,296,483,chair
7980,9,chair,9,0,6975,18,338,652,515,1025,177,373,chair
7981,86,bowl,85,0,6975,17,1046,675,1089,722,43,47,bowl
7982,90,bowl,89,0,6975,15,1203,657,1243,710,40,53,bowl
7983,94,bowl,93,0,6975,16,759,658,796,698,37,40,bowl
7984,11,chair,12,1,6976,29,104,205,253,472,149,267,chair
7985,12,chair,13,1,6976,26,133,206,261,479,128,273,chair
7986,14,chair,15,1,6976,21,462,207,538,475,76,268,chair
7987,15,chair,16,0,6976,28,307,207,477,478,170,271,chair
7988,7,table,8,0,6977,41,174,392,691,680,517,288,dining table
7989,9,chair,10,1,6977,28,170,376,280,641,110,265,chair
7990,17,table,18,1,6977,38,844,408,1023,673,179,265,dining table
7991,31,chair,32,0,6977,55,249,385,490,682,241,297,chair
7992,11,table,12,0,6978,18,272,235,461,387,189,152,dining table
7993,12,chair,13,1,6978,18,279,237,310,350,31,113,chair
7994,14,chair,15,1,6978,21,409,256,492,375,83,119,chair
7995,15,chair,16,0,6978,26,320,271,417,419,97,148,chair
7996,20,chair,21,1,6979,30,391,354,507,592,116,238,chair
7997,23,chair,24,0,6979,33,476,358,672,665,196,307,chair
7998,24,chair,25,0,6979,50,648,364,914,694,266,330,chair
7999,7,chair,8,0,6980,24,24,183,116,297,92,114,chair
8000,8,chair,9,1,6980,16,7,183,37,281,30,98,chair
8001,10,chair,11,0,6980,26,128,180,228,305,100,125,chair
8002,15,chair,16,1,6981,15,1069,749,1392,1050,323,301,chair
8003,24,chair,25,0,6982,17,97,152,164,255,67,103,chair
8004,15,chair,16,1,6983,22,30,425,99,767,69,342,chair
8005,16,chair,17,1,6983,16,456,411,539,492,83,81,chair
8006,18,chair,19,1,6983,26,315,444,639,768,324,324,chair
8007,19,chair,20,1,6983,34,67,446,347,768,280,322,chair
8008,30,vase,31,0,6983,17,675,484,727,637,52,153,vase
8009,2,chair,3,0,6984,26,137,453,410,768,273,315,chair
8010,3,chair,4,0,6984,30,417,456,648,765,231,309,chair
8011,4,chair,5,0,6984,23,658,458,928,766,270,308,chair
8012,12,chair,13,0,6984,23,1,398,174,763,173,365,chair
8013,14,table,15,0,6984,44,76,432,997,769,921,337,dining table
8014,15,chair,16,0,6984,33,867,387,1024,765,157,378,chair
8015,0,window,1,0,6985,20,156,1,255,175,99,174,window
8016,4,table,5,1,6985,32,61,121,237,236,176,115,dining table
8017,6,chair,7,1,6985,24,23,104,110,190,87,86,chair
8018,7,chair,8,0,6985,34,14,130,125,255,111,125,chair
8019,17,chair,18,1,6985,23,209,103,254,180,45,77,chair
8020,19,chair,20,0,6985,30,129,149,221,255,92,106,chair
8021,7,chair,8,1,6986,20,197,120,225,245,28,125,chair
8022,8,chair,9,1,6986,17,41,114,63,175,22,61,chair
8023,9,chair,10,1,6986,24,16,122,60,251,44,129,chair
8024,10,chair,11,1,6986,24,73,142,194,256,121,114,chair
8025,16,cat,17,0,6986,17,213,196,246,222,33,26,cat
8026,10,table,11,0,6987,30,205,597,969,1026,764,429,dining table
8027,13,chair,14,1,6987,16,812,449,938,627,126,178,chair
8028,15,bench,16,0,6987,25,488,816,1004,1272,516,456,bench
8029,12,window,13,1,6988,33,513,227,764,355,251,128,window
8030,15,chair,16,1,6988,22,625,321,697,599,72,278,chair
8031,16,chair,17,1,6988,30,451,324,667,599,216,275,chair
8032,20,vase,21,0,6988,15,508,302,567,378,59,76,vase
8033,2,chair,3,0,6989,26,163,133,255,253,92,120,chair
8034,5,chair,6,0,6989,26,81,126,161,243,80,117,chair
8035,15,clock,16,0,6990,15,512,179,556,238,44,59,clock
8036,6,table,7,0,6991,17,124,251,500,427,376,176,dining table
8037,9,chair,10,1,6991,15,196,211,273,272,77,61,chair
8038,10,chair,11,1,6991,28,456,237,548,427,92,190,chair
8039,11,chair,12,1,6991,25,297,243,482,427,185,184,chair
8040,12,chair,13,1,6991,27,49,224,244,427,195,203,chair
8041,14,cup,15,0,6991,20,248,256,274,313,26,57,cup
8042,10,table,11,0,6992,27,135,325,501,465,366,140,dining table
8043,11,chair,12,1,6992,18,160,272,207,324,47,52,chair
8044,12,chair,13,0,6992,15,60,275,120,344,60,69,chair
8045,13,chair,14,1,6992,15,373,297,426,335,53,38,chair
8046,14,chair,15,1,6992,23,301,322,478,533,177,211,chair
8047,16,chair,17,0,6992,29,146,317,301,532,155,215,chair
8048,17,vase,18,0,6992,19,282,287,323,355,41,68,vase
8049,12,chair,13,1,6993,28,293,182,347,301,54,119,chair
8050,14,chair,15,1,6993,32,160,184,213,300,53,116,chair
8051,15,chair,16,0,6993,33,208,194,300,360,92,166,chair
8052,4,clock,5,0,6994,20,1,39,26,180,25,141,clock
8053,8,chair,9,0,6994,24,99,154,158,254,59,100,chair
8054,9,chair,10,0,6994,22,164,151,233,255,69,104,chair
8055,13,chair,14,0,6994,21,22,154,91,255,69,101,chair
8056,14,table,15,0,6994,30,8,144,253,170,245,26,dining table
8057,21,flowerpot,22,0,6995,20,462,363,518,419,56,56,potted plant
8058,27,chair,28,1,6995,55,261,339,432,646,171,307,chair
8059,28,chair,29,1,6995,61,549,338,713,645,164,307,chair
8060,30,table,31,0,6995,79,244,378,749,657,505,279,dining table
8061,2,table,3,1,6996,29,2,97,230,255,228,158,dining table
8062,6,chair,7,1,6996,16,141,76,254,255,113,179,chair
8063,6,sofa,7,0,6997,16,633,294,712,365,79,71,couch
8064,7,chair,8,0,6997,22,557,285,629,379,72,94,chair
8065,24,table,25,0,6997,31,120,330,537,533,417,203,dining table
8066,26,chair,27,1,6997,25,470,323,575,524,105,201,chair
8067,27,chair,28,1,6997,29,378,343,558,533,180,190,chair
8068,30,chair,31,1,6997,19,2,391,225,531,223,140,chair
8069,10,chair,11,1,6998,17,552,251,661,444,109,193,chair
8070,12,chair,13,0,6998,20,32,250,142,452,110,202,chair
8071,23,plate,24,1,6998,16,429,365,535,395,106,30,plate
8072,26,plate,27,1,6998,19,281,423,430,463,149,40,plate
8073,41,plate,42,1,6998,15,453,366,524,390,71,24,plate
8074,21,table,16,1,6999,31,263,1086,1035,1288,772,202,dining table
8075,22,chair,17,1,6999,15,968,1035,1077,1195,109,160,chair
8076,23,chair,18,1,6999,35,982,1047,1153,1418,171,371,chair
8077,24,chair,19,0,6999,53,716,1068,1030,1539,314,471,chair
8078,25,chair,20,0,6999,54,372,1092,693,1605,321,513,chair
8079,27,chair,22,1,6999,22,215,1041,409,1248,194,207,chair
8080,28,chair,23,0,6999,44,142,1068,427,1540,285,472,chair
8081,29,flowerpot,24,0,6999,15,608,1038,738,1124,130,86,potted plant
8082,44,table,45,0,7000,32,2,510,816,769,814,259,dining table
8083,49,plate,50,0,7000,21,541,537,647,558,106,21,plate
8084,50,plate,51,0,7000,16,657,537,723,555,66,18,plate
8085,52,chair,53,0,7000,22,2,451,168,768,166,317,chair
8086,53,chair,54,0,7000,40,288,503,548,768,260,265,chair
8087,54,chair,55,0,7000,30,400,442,639,768,239,326,chair
8088,55,chair,56,0,7000,64,739,470,1024,768,285,298,chair
8089,18,table,19,1,7001,24,345,283,519,447,174,164,dining table
8090,21,chair,22,1,7001,18,568,253,622,420,54,167,chair
8091,22,chair,23,0,7001,30,426,264,610,491,184,227,chair
8092,23,chair,24,1,7001,17,213,253,269,421,56,168,chair
8093,24,chair,25,0,7001,25,244,264,407,488,163,224,chair
8094,29,vase,30,0,7001,20,12,173,74,272,62,99,vase
8095,0,mirror,1,0,7002,16,210,305,516,611,306,306,mirror
8096,12,table,12,1,7002,34,137,929,1336,1591,1199,662,dining table
8097,13,vase,13,0,7002,20,547,749,677,1028,130,279,vase
8098,17,chair,17,1,7002,16,1038,783,1271,1072,233,289,chair
8099,18,chair,18,1,7002,16,584,1137,1342,1588,758,451,chair
8100,29,chair,29,1,7002,23,285,733,547,929,262,196,chair
8101,10,chair,11,1,7003,19,171,501,236,600,65,99,chair
8102,21,bottle,22,0,7003,21,360,522,394,604,34,82,bottle
8103,1,chair,2,0,7004,19,16,137,134,255,118,118,chair
8104,4,table,5,0,7004,19,78,143,238,255,160,112,dining table
8105,29,bowl,30,0,7004,15,157,132,187,154,30,22,bowl
8106,0,mirror,1,0,7005,15,140,0,192,61,52,61,mirror
8107,1,window,2,0,7005,21,69,10,120,112,51,102,window
8108,7,table,8,0,7005,28,14,144,211,255,197,111,dining table
8109,8,chair,9,0,7005,19,47,162,125,255,78,93,chair
8110,9,chair,10,0,7005,20,158,152,222,255,64,103,chair
8111,4,table,5,0,7006,64,114,67,404,319,290,252,dining table
8112,7,chair,8,1,7006,45,80,31,228,216,148,185,chair
8113,8,chair,9,0,7006,57,6,76,191,372,185,296,chair
8114,5,chair,6,0,7007,25,70,131,168,256,98,125,chair
8115,15,chair,16,1,7007,27,53,133,86,246,33,113,chair
8116,9,table,10,0,7008,20,171,259,471,466,300,207,dining table
8117,10,chair,11,1,7008,16,392,234,449,263,57,29,chair
8118,11,chair,12,1,7008,20,427,246,483,467,56,221,chair
8119,12,chair,13,1,7008,24,284,253,437,467,153,214,chair
8120,15,chair,16,1,7008,27,118,246,248,466,130,220,chair
8121,17,chair,18,0,7009,30,280,354,418,532,138,178,chair
8122,19,chair,20,1,7009,16,191,317,261,466,70,149,chair
8123,3,table,4,1,7010,19,106,133,255,217,149,84,dining table
8124,5,chair,6,1,7010,19,81,111,133,161,52,50,chair
8125,7,chair,8,1,7010,22,34,139,187,255,153,116,chair
8126,8,table,9,1,7011,20,210,319,539,403,329,84,dining table
8127,10,chair,11,1,7011,40,145,276,293,474,148,198,chair
8128,11,chair,12,1,7011,42,439,276,608,475,169,199,chair
8129,7,table,8,0,7012,30,311,505,720,853,409,348,dining table
8130,12,chair,13,1,7012,28,277,489,352,786,75,297,chair
8131,13,chair,14,0,7012,32,355,538,559,871,204,333,chair
8132,14,chair,15,1,7012,22,593,493,794,850,201,357,chair
8133,4,table,5,1,7013,49,439,405,794,654,355,249,dining table
8134,6,chair,7,1,7013,20,662,330,767,423,105,93,chair
8135,10,chair,11,1,7013,15,437,336,515,417,78,81,chair
8136,11,chair,12,0,7013,60,377,335,622,682,245,347,chair
8137,7,chair,7,0,7014,27,293,329,356,437,63,108,chair
8138,8,chair,8,0,7014,41,191,360,311,512,120,152,chair
8139,20,chair,20,1,7014,20,95,416,216,512,121,96,chair
8140,9,chair,10,0,7016,18,207,133,256,251,49,118,chair
8141,13,chair,14,0,7016,16,120,184,214,255,94,71,chair
8142,19,chair,20,1,7016,18,0,131,30,256,30,125,chair
8143,8,table,9,1,7017,15,485,440,848,787,363,347,dining table
8144,11,chair,12,0,7017,19,324,408,665,797,341,389,chair
8145,12,chair,13,0,7017,29,694,402,945,790,251,388,chair
8146,13,chair,14,1,7017,24,897,398,1015,708,118,310,chair
8147,29,vase,30,0,7017,21,737,390,793,461,56,71,vase
8148,30,vase,31,1,7017,22,774,375,813,463,39,88,vase
8149,3,chair,4,0,7018,35,564,633,904,1050,340,417,chair
8150,4,chair,5,1,7018,15,914,747,1076,1050,162,303,chair
8151,5,bench,6,0,7018,16,1182,804,1400,1018,218,214,bench
8152,8,vase,9,0,7018,18,148,643,316,802,168,159,vase
8153,11,table,12,0,7018,46,1,719,802,1050,801,331,dining table
8154,12,chair,13,1,7018,19,1,500,217,739,216,239,chair
8155,23,plate,24,0,7018,15,240,81,405,192,165,111,plate
8156,25,pot,26,0,7018,22,133,258,229,328,96,70,potted plant
8157,26,plate,27,0,7018,17,18,2,179,182,161,180,plate
8158,27,plate,28,0,7018,20,464,63,616,205,152,142,plate
8159,30,mirror,31,0,7018,30,1357,157,1399,448,42,291,mirror
8160,32,surfboard,33,0,7018,25,1174,626,1399,724,225,98,surfboard
8161,2,table,3,0,7019,31,3,126,256,255,253,129,dining table
8162,15,chair,16,1,7020,21,207,356,274,532,67,176,chair
8163,16,chair,17,1,7020,26,251,368,337,577,86,209,chair
8164,17,chair,18,1,7020,26,314,379,444,622,130,243,chair
8165,23,vase,24,1,7020,19,615,420,664,517,49,97,vase
8166,5,table,6,1,7021,34,182,354,567,533,385,179,dining table
8167,7,chair,8,1,7021,15,183,304,241,376,58,72,chair
8168,8,chair,9,1,7021,27,106,358,244,532,138,174,chair
8169,9,chair,10,1,7021,33,199,381,426,532,227,151,chair
8170,10,chair,11,1,7021,43,436,326,611,533,175,207,chair
8171,13,window,14,0,7021,19,436,142,534,389,98,247,window
8172,14,window,15,0,7021,19,343,160,417,330,74,170,window
8173,11,chair,12,0,7022,37,554,248,661,424,107,176,chair
8174,12,chair,13,0,7022,31,145,257,300,472,155,215,chair
8175,13,table,14,0,7022,36,189,281,464,471,275,190,dining table
8176,14,chair,15,0,7022,27,340,238,553,472,213,234,chair
8177,18,bowl,19,0,7022,32,283,224,340,303,57,79,bowl
8178,7,sofa,8,0,7023,17,604,637,1156,1496,552,859,couch
8179,5,chair,6,0,7024,15,171,187,243,255,72,68,chair
8180,22,chair,22,1,7024,16,58,151,74,235,16,84,chair
8181,11,table,12,0,7025,19,72,126,205,169,133,43,dining table
8182,23,chair,24,0,7025,21,28,117,99,245,71,128,chair
8183,24,chair,25,0,7025,18,130,138,235,253,105,115,chair
8184,3,table,4,1,7026,15,0,157,164,255,164,98,dining table
8185,11,chair,12,1,7026,21,21,161,58,256,37,95,chair
8186,6,chair,7,1,7027,23,687,346,745,446,58,100,chair
8187,8,table,9,1,7027,41,83,278,469,466,386,188,dining table
8188,14,chair,15,1,7027,25,94,260,167,468,73,208,chair
8189,18,chair,19,1,7027,35,147,269,283,469,136,200,chair
8190,13,table,14,0,7028,40,351,300,611,474,260,174,dining table
8191,16,chair,17,0,7028,39,324,249,456,488,132,239,chair
8192,17,chair,18,0,7028,38,478,256,613,469,135,213,chair
8193,18,chair,19,1,7028,22,594,261,643,447,49,186,chair
8194,18,chair,19,1,7029,20,3,182,41,316,38,134,chair
8195,19,chair,20,1,7029,31,13,179,141,363,128,184,chair
8196,20,chair,21,1,7029,22,48,215,221,364,173,149,chair
8197,1,chair,2,0,7030,17,81,138,138,226,57,88,chair
8198,3,chair,4,0,7030,16,150,145,222,242,72,97,chair
8199,8,table,9,0,7030,17,53,124,224,217,171,93,dining table
8200,9,table,10,1,7031,23,268,296,467,476,199,180,dining table
8201,11,chair,12,0,7031,28,416,271,538,463,122,192,chair
8202,12,chair,13,1,7031,25,221,294,393,479,172,185,chair
8203,13,chair,14,1,7031,22,190,268,259,441,69,173,chair
8204,3,vase,4,0,7033,17,617,308,714,449,97,141,vase
8205,4,pot,5,0,7033,24,191,75,249,128,58,53,potted plant
8206,5,vase,6,0,7033,16,71,158,117,199,46,41,vase
8207,6,vase,7,0,7033,15,119,162,160,201,41,39,vase
8208,22,sofa,23,0,7033,33,2,417,466,854,464,437,couch
8209,35,plate,36,0,7033,25,3,623,252,667,249,44,plate
8210,42,plate,43,0,7033,23,3,725,256,771,253,46,plate
8211,43,ball,44,0,7033,15,187,809,239,857,52,48,sports ball
8212,45,ball,46,0,7033,16,98,819,140,856,42,37,sports ball
8213,46,ball,47,0,7033,18,112,805,158,830,46,25,sports ball
8214,47,ball,48,0,7033,17,49,822,90,854,41,32,sports ball
8215,48,ball,49,0,7033,19,13,816,53,852,40,36,sports ball
8216,49,ball,50,0,7033,18,69,799,114,837,45,38,sports ball
8217,50,plate,51,0,7033,29,2,820,256,871,254,51,plate
8218,71,ball,72,0,7033,16,816,226,859,260,43,34,sports ball
8219,74,pot,75,0,7033,15,810,342,855,398,45,56,potted plant
8220,77,vase,78,0,7033,15,916,376,940,471,24,95,vase
8221,82,bowl,83,0,7033,15,572,432,620,451,48,19,bowl
8222,91,plate,90,0,7033,17,759,448,865,464,106,16,plate
8223,93,plate,92,0,7033,19,758,460,876,475,118,15,plate
8224,95,plate,94,0,7033,21,762,472,890,491,128,19,plate
8225,100,table,99,0,7033,106,455,439,978,838,523,399,dining table
8226,105,chair,104,0,7033,62,933,478,1147,831,214,353,chair
8227,106,chair,105,0,7033,58,900,450,1080,734,180,284,chair
8228,3,sofa,4,1,7034,22,702,562,1339,889,637,327,couch
8229,5,chair,6,0,7034,21,873,702,1187,1128,314,426,chair
8230,7,chair,8,1,7034,20,87,1090,730,1597,643,507,chair
8231,16,vase,17,0,7034,20,590,564,676,740,86,176,vase
8232,11,table,12,0,7035,24,83,261,477,466,394,205,dining table
8233,12,chair,13,1,7035,26,371,259,467,450,96,191,chair
8234,13,chair,14,1,7035,35,235,272,388,467,153,195,chair
8235,14,chair,15,1,7035,27,39,279,204,467,165,188,chair
8236,27,sofa,28,1,7036,16,2,311,74,367,72,56,couch
8237,12,table,13,0,7038,26,113,275,577,459,464,184,dining table
8238,13,chair,14,1,7038,16,493,247,541,262,48,15,chair
8239,14,chair,15,1,7038,25,528,253,584,460,56,207,chair
8240,15,chair,16,1,7038,35,382,257,552,461,170,204,chair
8241,16,chair,17,1,7039,37,379,206,471,380,92,174,chair
8242,17,chair,18,0,7039,56,319,207,446,422,127,215,chair
8243,20,chair,21,1,7039,15,218,207,265,247,47,40,chair
8244,12,chair,13,0,7040,16,21,110,50,204,29,94,chair
8245,13,chair,14,0,7040,26,42,112,80,231,38,119,chair
8246,14,chair,15,0,7040,27,71,120,141,256,70,136,chair
8247,15,table,16,0,7040,17,28,116,200,254,172,138,dining table
8248,11,chair,12,0,7041,19,197,266,298,415,101,149,chair
8249,16,chair,17,1,7041,25,625,275,800,534,175,259,chair
8250,17,chair,18,1,7041,17,465,270,507,452,42,182,chair
8251,18,chair,19,1,7041,23,493,273,648,533,155,260,chair
8252,3,table,4,1,7042,30,72,135,255,228,183,93,dining table
8253,7,chair,7,0,7042,49,3,110,136,256,133,146,chair
8254,32,chair,32,1,7042,45,100,107,190,233,90,126,chair
8255,15,sofa,16,1,7043,27,286,230,449,291,163,61,couch
8256,18,chair,19,0,7043,20,71,225,130,324,59,99,chair
8257,19,chair,20,0,7043,18,131,220,185,319,54,99,chair
8258,23,table,24,1,7043,33,2,312,429,511,427,199,dining table
8259,24,chair,25,1,7043,18,12,327,152,512,140,185,chair
8260,25,chair,26,1,7043,15,126,359,340,511,214,152,chair
8261,32,vase,33,0,7043,15,284,357,339,401,55,44,vase
8262,17,chair,18,0,7044,21,141,132,208,226,67,94,chair
8263,18,chair,19,0,7044,18,91,141,157,243,66,102,chair
8264,19,chair,20,0,7044,21,0,121,64,227,64,106,chair
8265,4,table,5,0,7045,18,568,855,1405,1458,837,603,dining table
8266,26,chair,27,0,7045,26,861,889,1259,1457,398,568,chair
8267,32,chair,33,1,7045,18,1215,853,1422,1311,207,458,chair
8268,45,desk,46,1,7045,25,2,874,421,1238,419,364,desk
8269,9,table,10,1,7046,39,344,467,630,757,286,290,dining table
8270,11,chair,12,1,7046,31,237,440,402,752,165,312,chair
8271,13,chair,14,0,7046,30,308,478,579,800,271,322,chair
8272,3,table,4,0,7047,98,39,136,621,478,582,342,dining table
8273,4,chair,5,1,7047,49,24,91,178,364,154,273,chair
8274,5,chair,6,0,7047,53,551,91,814,478,263,387,chair
8275,2,chair,3,0,7048,20,54,138,152,255,98,117,chair
8276,3,chair,4,0,7048,20,148,123,209,255,61,132,chair
8277,8,table,9,0,7048,32,0,129,178,255,178,126,dining table
8278,2,table,3,0,7049,53,77,73,531,297,454,224,dining table
8279,5,chair,5,1,7049,17,395,15,465,79,70,64,chair
8280,6,chair,6,1,7049,33,414,49,531,284,117,235,chair
8281,7,chair,7,0,7049,45,261,62,439,319,178,257,chair
8282,40,chair,40,1,7049,57,113,24,252,222,139,198,chair
8283,8,chair,9,0,7050,29,35,185,148,254,113,69,chair
8284,13,table,14,0,7051,19,317,408,674,597,357,189,dining table
8285,15,chair,16,1,7051,37,627,376,781,683,154,307,chair
8286,16,chair,17,1,7051,18,300,371,391,457,91,86,chair
8287,17,chair,18,1,7051,36,231,378,382,680,151,302,chair
8288,18,chair,19,1,7051,37,365,412,646,682,281,270,chair
8289,9,chair,10,1,7052,21,700,302,779,521,79,219,chair
8290,13,chair,14,1,7052,20,158,301,220,506,62,205,chair
8291,15,chair,16,1,7052,18,195,306,281,567,86,261,chair
8292,1,chair,2,0,7053,36,165,114,253,245,88,131,chair
8293,4,chair,3,0,7053,33,53,120,148,252,95,132,chair
8294,24,chair,22,1,7053,31,70,103,138,172,68,69,chair
8295,26,flowerpot,24,0,7053,18,24,91,44,109,20,18,potted plant
8296,27,flowerpot,25,0,7053,18,3,91,24,112,21,21,potted plant
8297,28,chair,26,1,7053,31,164,101,206,172,42,71,chair
8298,29,table,27,1,7053,36,80,112,227,240,147,128,dining table
8299,5,table,6,0,7055,15,69,105,231,256,162,151,dining table
8300,7,chair,8,1,7055,21,46,90,69,145,23,55,chair
8301,17,chair,18,1,7055,24,67,144,109,255,42,111,chair
8302,18,chair,19,1,7055,19,131,180,238,255,107,75,chair
8303,6,table,7,0,7056,58,278,358,865,676,587,318,dining table
8304,11,chair,12,1,7056,37,281,339,405,597,124,258,chair
8305,12,chair,13,0,7056,53,377,359,607,674,230,315,chair
8306,14,vase,15,0,7056,16,488,327,527,396,39,69,vase
8307,3,sofa,4,0,7057,17,32,131,117,157,85,26,couch
8308,5,chair,6,0,7057,21,86,181,150,255,64,74,chair
8309,6,chair,7,0,7057,18,66,165,108,238,42,73,chair
8310,21,table,22,0,7057,27,106,156,252,256,146,100,dining table
8311,9,chair,10,0,7058,17,0,161,104,256,104,95,chair
8312,7,table,8,0,7059,25,270,424,828,661,558,237,dining table
8313,8,chair,9,1,7059,20,443,352,520,433,77,81,chair
8314,9,chair,10,1,7059,16,535,371,614,450,79,79,chair
8315,10,chair,11,1,7059,18,632,380,735,476,103,96,chair
8316,11,chair,12,1,7059,23,317,368,404,438,87,70,chair
8317,12,chair,13,1,7059,30,261,391,365,661,104,270,chair
8318,13,chair,14,1,7059,29,322,406,612,661,290,255,chair
8319,19,chair,20,1,7059,29,662,405,972,659,310,254,chair
8320,21,chair,22,1,7059,19,3,456,107,593,104,137,chair
8321,0,chair,1,0,7060,37,734,413,954,720,220,307,chair
8322,1,chair,2,0,7060,23,557,457,749,758,192,301,chair
8323,2,chair,3,0,7060,19,328,459,522,700,194,241,chair
8324,3,chair,4,0,7060,24,88,452,280,752,192,300,chair
8325,4,chair,5,0,7060,20,5,466,82,760,77,294,chair
8326,54,plate,54,0,7060,19,127,210,214,272,87,62,plate
8327,56,plate,56,0,7060,17,223,210,310,270,87,60,plate
8328,58,plate,58,0,7060,17,315,211,380,271,65,60,plate
8329,74,plate,74,0,7060,16,222,288,281,337,59,49,plate
8330,75,plate,75,0,7060,15,164,281,221,335,57,54,plate
8331,80,chair,80,0,7060,17,545,421,679,463,134,42,chair
8332,9,table,10,0,7061,32,220,280,538,480,318,200,dining table
8333,14,chair,15,1,7061,19,289,357,375,468,86,111,chair
8334,15,chair,16,0,7061,46,597,264,720,417,123,153,chair
8335,16,chair,17,1,7061,25,490,279,544,455,54,176,chair
8336,17,chair,18,1,7061,39,363,292,513,479,150,187,chair
8337,18,chair,19,1,7061,40,101,295,298,479,197,184,chair
8338,2,chair,3,0,7062,15,46,185,93,241,47,56,chair
8339,5,chair,6,0,7062,16,196,168,227,219,31,51,chair
8340,18,table,19,0,7063,26,197,257,407,395,210,138,dining table
8341,19,chair,20,1,7063,22,183,233,278,343,95,110,chair
8342,20,window,21,0,7063,18,158,70,237,318,79,248,window
8343,21,chair,22,0,7063,33,161,240,274,424,113,184,chair
8344,8,chair,9,1,7064,17,155,54,194,101,39,47,chair
8345,10,chair,11,0,7064,29,144,107,238,250,94,143,chair
8346,11,chair,12,0,7064,35,23,111,131,254,108,143,chair
8347,8,chair,9,0,7065,26,85,127,184,256,99,129,chair
8348,5,table,6,0,7066,27,125,95,256,169,131,74,dining table
8349,19,chair,19,1,7067,52,1022,608,1307,1057,285,449,chair
8350,20,chair,20,1,7067,37,271,606,556,1016,285,410,chair
8351,21,table,21,0,7067,23,259,662,1276,1058,1017,396,dining table
8352,42,chair,41,1,7067,23,800,585,1009,905,209,320,chair
8353,47,chair,46,1,7067,26,574,585,779,903,205,318,chair
8354,8,table,9,1,7068,28,132,292,542,469,410,177,dining table
8355,10,chair,11,1,7068,20,378,243,496,437,118,194,chair
8356,11,chair,12,0,7068,31,254,238,395,466,141,228,chair
8357,14,chair,15,1,7068,15,23,255,65,414,42,159,chair
8358,6,pot,7,0,7069,25,182,9,203,35,21,26,potted plant
8359,9,chair,10,1,7069,15,194,169,255,248,61,79,chair
8360,12,table,13,0,7070,19,298,403,516,582,218,179,dining table
8361,14,chair,15,1,7070,15,247,391,275,497,28,106,chair
8362,15,chair,16,1,7070,20,263,401,299,529,36,128,chair
8363,16,chair,17,1,7070,32,285,412,398,575,113,163,chair
8364,19,chair,20,1,7070,33,446,438,605,634,159,196,chair
8365,20,flowerpot,21,0,7070,16,189,399,261,447,72,48,potted plant
8366,30,vase,31,1,7070,15,597,432,645,556,48,124,vase
8367,0,chair,1,0,7071,36,78,129,128,224,50,95,chair
8368,1,chair,2,0,7071,29,134,128,183,223,49,95,chair
8369,3,chair,4,0,7071,16,36,124,69,200,33,76,chair
8370,11,table,12,0,7071,28,55,140,210,211,155,71,dining table
8371,11,window,12,0,7072,25,384,168,716,429,332,261,window
8372,14,chair,15,1,7072,21,712,383,765,563,53,180,chair
8373,20,table,21,1,7072,30,324,399,696,507,372,108,dining table
8374,21,chair,22,1,7072,26,274,375,398,497,124,122,chair
8375,24,chair,25,0,7072,36,263,407,419,626,156,219,chair
8376,25,chair,26,0,7072,22,413,436,562,673,149,237,chair
8377,26,chair,27,0,7072,31,561,418,738,654,177,236,chair
8378,8,table,9,0,7073,18,13,167,189,255,176,88,dining table
8379,11,chair,12,1,7073,26,138,157,204,255,66,98,chair
8380,12,chair,13,1,7073,22,31,170,121,255,90,85,chair
8381,6,table,7,0,7074,18,79,167,194,254,115,87,dining table
8382,10,mirror,11,0,7075,104,5,658,738,1191,733,533,mirror
8383,35,chair,36,1,7075,68,977,1304,1191,1876,214,572,chair
8384,36,chair,37,1,7075,96,543,1456,931,2156,388,700,chair
8385,37,chair,38,1,7075,59,393,1348,588,1907,195,559,chair
8386,38,table,39,1,7075,147,303,1262,1215,2162,912,900,dining table
8387,8,table,9,0,7076,34,95,188,292,339,197,151,dining table
8388,11,chair,12,0,7076,27,82,217,200,380,118,163,chair
8389,12,chair,13,0,7076,28,219,197,317,354,98,157,chair
8390,14,chair,15,1,7077,17,130,405,194,542,64,137,chair
8391,17,chair,18,1,7077,16,300,447,493,597,193,150,chair
8392,10,table,11,1,7078,18,71,418,263,475,192,57,dining table
8393,13,table,14,0,7078,29,154,459,720,768,566,309,dining table
8394,19,plate,20,1,7078,15,261,510,356,537,95,27,plate
8395,25,chair,26,1,7078,17,545,428,655,504,110,76,chair
8396,29,plate,30,1,7078,16,544,532,679,571,135,39,plate
8397,44,chair,45,1,7078,27,478,486,880,768,402,282,chair
8398,45,chair,46,1,7078,27,75,442,162,767,87,325,chair
8399,46,chair,47,1,7078,31,98,470,397,768,299,298,chair
8400,55,bowl,56,0,7078,15,407,439,445,486,38,47,bowl
8401,14,table,15,0,7079,37,434,354,798,629,364,275,dining table
8402,16,chair,17,1,7079,15,535,321,582,371,47,50,chair
8403,17,chair,18,1,7079,18,463,325,529,358,66,33,chair
8404,19,chair,20,1,7079,26,830,328,879,517,49,189,chair
8405,20,chair,21,1,7079,28,804,334,859,559,55,225,chair
8406,21,chair,22,1,7079,45,716,338,839,611,123,273,chair
8407,17,chair,18,1,7080,29,226,314,336,436,110,122,chair
8408,18,table,19,1,7080,15,226,346,482,555,256,209,dining table
8409,19,chair,20,1,7080,25,460,332,544,536,84,204,chair
8410,20,chair,21,1,7080,21,355,340,478,565,123,225,chair
8411,21,chair,22,0,7080,32,162,343,319,571,157,228,chair
8412,34,chair,35,0,7081,19,115,179,182,253,67,74,chair
8413,39,table,40,0,7081,15,47,147,238,193,191,46,dining table
8414,9,chair,10,0,7082,16,147,170,229,255,82,85,chair
8415,13,chair,14,0,7082,20,61,148,143,255,82,107,chair
8416,9,table,10,0,7083,59,375,437,920,935,545,498,dining table
8417,10,chair,11,1,7083,19,446,384,581,452,135,68,chair
8418,11,chair,12,1,7083,29,307,424,453,785,146,361,chair
8419,20,chair,21,0,7083,47,534,477,871,943,337,466,chair
8420,21,chair,22,0,7083,38,5,376,260,656,255,280,chair
8421,7,chair,8,1,7084,18,728,420,869,524,141,104,chair
8422,12,vase,13,0,7084,20,584,416,660,590,76,174,vase
8423,17,chair,18,1,7084,21,190,452,381,623,191,171,chair
8424,18,chair,19,1,7084,31,746,473,1018,849,272,376,chair
8425,19,chair,20,1,7084,25,668,521,996,851,328,330,chair
8426,14,table,15,0,7085,19,164,248,488,423,324,175,dining table
8427,18,chair,19,1,7085,27,419,228,497,411,78,183,chair
8428,19,chair,20,1,7085,33,276,237,449,424,173,187,chair
8429,20,chair,21,1,7085,30,82,231,261,422,179,191,chair
8430,9,chair,10,0,7086,23,242,309,320,443,78,134,chair
8431,12,chair,13,1,7086,19,378,311,451,442,73,131,chair
8432,13,chair,14,1,7086,21,302,317,386,465,84,148,chair
8433,4,table,5,0,7087,30,45,419,466,705,421,286,dining table
8434,5,chair,6,1,7087,18,115,422,260,556,145,134,chair
8435,7,chair,8,1,7087,17,279,441,426,676,147,235,chair
8436,8,chair,9,1,7087,30,186,456,345,708,159,252,chair
8437,9,chair,10,0,7087,24,9,466,184,716,175,250,chair
8438,15,table,15,0,7088,26,99,960,1003,1594,904,634,dining table
8439,16,chair,16,1,7088,18,892,845,1084,1184,192,339,chair
8440,17,chair,17,0,7088,43,644,888,1135,1596,491,708,chair
8441,8,window,9,0,7089,20,510,3,734,474,224,471,window
8442,14,chair,15,1,7089,15,504,334,632,532,128,198,chair
8443,17,chair,18,1,7089,15,54,331,175,532,121,201,chair
8444,6,table,7,0,7090,18,0,185,231,256,231,71,dining table
8445,14,chair,15,1,7090,16,109,170,195,255,86,85,chair
8446,15,chair,16,1,7090,24,2,164,98,255,96,91,chair
8447,6,table,7,0,7091,19,341,458,872,776,531,318,dining table
8448,13,chair,14,1,7091,26,167,431,235,665,68,234,chair
8449,14,chair,15,1,7091,34,190,443,283,720,93,277,chair
8450,15,chair,16,1,7091,31,248,448,348,778,100,330,chair
8451,16,chair,17,1,7091,28,296,459,579,779,283,320,chair
8452,7,table,8,0,7092,16,2,301,465,480,463,179,dining table
8453,8,sofa,9,1,7092,23,425,249,578,311,153,62,couch
8454,22,chair,23,1,7092,16,1,318,45,480,44,162,chair
8455,23,chair,24,1,7092,21,15,332,160,479,145,147,chair
8456,8,sofa,9,0,7093,35,194,190,503,336,309,146,couch
8457,22,chair,23,1,7094,26,682,373,775,608,93,235,chair
8458,23,chair,24,1,7094,27,497,381,732,667,235,286,chair
8459,24,chair,25,1,7094,22,224,377,459,667,235,290,chair
8460,37,chair,38,1,7094,16,462,358,526,408,64,50,chair
8461,50,door,51,0,7094,21,727,226,801,452,74,226,door
8462,6,table,7,0,7095,17,102,313,341,479,239,166,dining table
8463,9,chair,10,1,7095,21,245,300,436,480,191,180,chair
8464,10,chair,11,1,7095,22,36,295,220,479,184,184,chair
8465,5,table,6,0,7096,16,220,343,799,612,579,269,dining table
8466,7,chair,8,0,7096,27,558,257,759,683,201,426,chair
8467,8,chair,9,0,7096,15,298,257,481,691,183,434,chair
8468,9,chair,10,0,7096,33,70,262,255,604,185,342,chair
8469,10,chair,11,0,7096,29,771,257,961,595,190,338,chair
8470,4,window,5,0,7097,26,611,192,1008,520,397,328,window
8471,5,table,6,1,7097,20,225,404,761,631,536,227,dining table
8472,10,chair,11,1,7097,23,724,349,826,595,102,246,chair
8473,11,chair,12,1,7097,29,613,359,761,650,148,291,chair
8474,12,chair,13,0,7097,43,408,369,651,683,243,314,chair
8475,4,plate,5,0,7098,21,331,187,489,319,158,132,plate
8476,6,vase,7,0,7098,17,1266,233,1302,306,36,73,vase
8477,17,plate,18,0,7098,18,1147,394,1191,441,44,47,plate
8478,28,chair,29,1,7098,19,688,553,793,652,105,99,chair
8479,30,chair,31,1,7098,34,974,534,1197,654,223,120,chair
8480,68,chair,69,1,7098,17,425,579,603,739,178,160,chair
8481,75,chair,76,0,7098,70,148,759,703,1200,555,441,chair
8482,76,chair,77,0,7098,48,789,690,1218,1200,429,510,chair
8483,77,chair,78,0,7098,39,1014,620,1325,1103,311,483,chair
8484,87,chair,88,0,7098,19,1512,488,1590,595,78,107,chair
8485,99,table,99,0,7098,58,357,607,1214,1197,857,590,dining table
8486,146,vase,145,0,7098,26,812,665,904,721,92,56,vase
8487,10,window,11,0,7099,30,651,137,918,416,267,279,window
8488,17,table,18,1,7099,27,491,426,1024,660,533,234,dining table
8489,18,chair,19,1,7099,16,650,360,736,426,86,66,chair
8490,19,chair,20,1,7099,17,779,366,898,408,119,42,chair
8491,20,vase,21,0,7099,32,710,333,799,464,89,131,vase
8492,24,chair,25,0,7099,43,534,386,732,674,198,288,chair
8493,25,chair,26,1,7099,34,764,399,1000,674,236,275,chair
8494,3,window,4,0,7100,23,319,118,667,521,348,403,window
8495,5,mirror,6,0,7100,53,840,30,1023,580,183,550,mirror
8496,7,chair,8,1,7100,15,620,408,683,477,63,69,chair
8497,8,chair,9,1,7100,38,658,430,756,683,98,253,chair
8498,10,chair,11,1,7100,38,232,424,444,683,212,259,chair
8499,8,table,9,0,7101,20,131,161,254,255,123,94,dining table
8500,10,chair,11,1,7101,41,94,161,195,256,101,95,chair
8501,11,chair,12,1,7101,15,217,212,255,256,38,44,chair
8502,1,chair,2,0,7102,22,83,333,259,649,176,316,chair
8503,6,table,7,0,7102,46,186,326,649,614,463,288,dining table
8504,7,chair,8,0,7102,38,416,352,597,682,181,330,chair
8505,8,chair,9,1,7102,18,597,301,657,432,60,131,chair
8506,9,chair,10,1,7102,20,647,321,766,559,119,238,chair
8507,10,chair,11,1,7102,19,133,304,196,461,63,157,chair
8508,11,chair,12,1,7102,17,3,297,61,493,58,196,chair
8509,4,chair,5,1,7103,23,170,27,222,68,52,41,chair
8510,5,chair,6,0,7103,32,149,51,265,224,116,173,chair
8511,6,chair,7,1,7103,25,7,25,91,159,84,134,chair
8512,7,chair,8,0,7103,25,49,53,158,218,109,165,chair
8513,5,window,6,0,7104,23,129,70,415,243,286,173,window
8514,11,chair,12,0,7104,22,569,209,640,304,71,95,chair
8515,13,chair,14,1,7104,15,101,194,157,289,56,95,chair
8516,15,table,16,1,7104,21,11,275,479,479,468,204,dining table
8517,18,chair,19,1,7104,23,248,304,640,479,392,175,chair
8518,9,table,10,0,7105,18,297,330,640,600,343,270,dining table
8519,17,chair,18,1,7105,15,489,453,586,584,97,131,chair
8520,4,table,5,0,7106,16,102,174,256,255,154,81,dining table
8521,5,chair,6,0,7106,23,182,181,255,256,73,75,chair
8522,14,chair,15,0,7106,15,106,163,171,251,65,88,chair
8523,1,table,2,0,7107,32,229,295,569,590,340,295,dining table
8524,13,chair,14,1,7107,15,461,251,539,330,78,79,chair
8525,14,chair,15,1,7107,15,261,242,345,309,84,67,chair
8526,15,chair,16,1,7107,19,522,257,635,350,113,93,chair
8527,16,chair,17,1,7107,37,111,262,268,536,157,274,chair
8528,17,chair,18,1,7107,64,143,279,392,591,249,312,chair
8529,18,chair,19,1,7107,37,376,327,749,591,373,264,chair
8530,29,pot,27,0,7108,15,515,421,547,454,32,33,potted plant
8531,33,plate,31,0,7108,20,497,463,568,531,71,68,plate
8532,38,plate,36,0,7108,18,496,536,569,602,73,66,plate
8533,49,bowl,47,0,7108,26,530,755,746,835,216,80,bowl
8534,59,chair,57,0,7108,20,396,711,457,815,61,104,chair
8535,60,chair,58,0,7108,18,843,709,894,831,51,122,chair
8536,61,chair,59,0,7108,25,888,755,974,900,86,145,chair
8537,63,chair,61,0,7108,27,319,752,403,900,84,148,chair
8538,7,table,8,1,7109,15,36,61,393,298,357,237,dining table
8539,9,chair,10,1,7109,34,222,34,348,212,126,178,chair
8540,12,chair,13,1,7109,24,11,53,112,263,101,210,chair
8541,13,chair,14,0,7109,42,89,68,243,302,154,234,chair
8542,0,chair,1,0,7110,24,182,118,254,236,72,118,chair
8543,7,chair,8,0,7110,23,0,121,68,236,68,115,chair
8544,8,table,9,0,7110,23,31,139,216,241,185,102,dining table
8545,11,vase,12,1,7111,27,287,350,393,549,106,199,vase
8546,10,table,11,0,7112,21,201,284,566,480,365,196,dining table
8547,12,chair,13,1,7112,20,195,253,251,411,56,158,chair
8548,13,chair,14,1,7112,21,224,272,333,478,109,206,chair
8549,14,chair,15,1,7112,26,321,278,462,479,141,201,chair
8550,15,chair,16,0,7112,21,503,271,639,478,136,207,chair
8551,21,chair,22,0,7113,21,260,409,494,685,234,276,chair
8552,22,chair,23,1,7113,16,677,381,740,633,63,252,chair
8553,23,chair,24,0,7113,21,521,399,708,685,187,286,chair
8554,0,table,1,0,7114,17,43,83,244,245,201,162,dining table
8555,4,chair,5,0,7114,22,172,118,256,255,84,137,chair
8556,5,chair,6,0,7114,20,62,114,144,255,82,141,chair
8557,6,table,7,0,7115,31,117,788,1234,1091,1117,303,dining table
8558,8,chair,9,1,7115,16,851,693,967,791,116,98,chair
8559,12,chair,13,1,7115,18,947,753,1156,1090,209,337,chair
8560,31,bowl,31,1,7115,18,632,784,785,858,153,74,bowl
8561,8,chair,9,1,7116,23,59,83,97,105,38,22,chair
8562,9,table,10,1,7116,37,24,103,159,151,135,48,dining table
8563,10,chair,11,1,7116,26,149,93,185,194,36,101,chair
8564,11,chair,12,0,7116,29,5,107,81,219,76,112,chair
8565,12,chair,13,0,7116,35,77,130,153,243,76,113,chair
8566,3,chair,4,0,7117,18,740,540,867,662,127,122,chair
8567,4,chair,5,0,7117,15,987,558,1168,711,181,153,chair
8568,5,chair,6,0,7117,26,334,576,595,898,261,322,chair
8569,6,chair,7,0,7117,21,241,434,436,808,195,374,chair
8570,23,pot,24,0,7117,15,7,382,62,422,55,40,potted plant
8571,26,pot,27,0,7117,15,16,709,64,740,48,31,potted plant
8572,27,plate,28,0,7117,16,465,497,535,576,70,79,plate
8573,33,pot,34,0,7117,29,579,568,685,663,106,95,potted plant
8574,34,bowl,35,0,7117,29,762,618,907,712,145,94,bowl
8575,47,chair,48,0,7117,40,150,546,357,899,207,353,chair
8576,9,chair,10,0,7118,26,191,119,256,227,65,108,chair
8577,13,chair,14,0,7118,22,124,147,183,255,59,108,chair
8578,14,chair,15,0,7118,24,49,148,125,256,76,108,chair
8579,14,chair,15,1,7119,32,113,252,225,458,112,206,chair
8580,15,chair,16,1,7119,30,242,259,352,477,110,218,chair
8581,7,chair,8,1,7120,21,344,355,435,435,91,80,chair
8582,8,chair,9,1,7120,16,443,350,516,420,73,70,chair
8583,10,chair,11,1,7120,17,516,347,580,402,64,55,chair
8584,13,chair,14,1,7120,16,727,345,815,410,88,65,chair
8585,14,chair,15,1,7120,23,846,372,943,667,97,295,chair
8586,15,chair,16,1,7120,25,763,376,907,667,144,291,chair
8587,16,chair,17,1,7120,26,432,407,834,667,402,260,chair
8588,24,chair,25,1,7120,27,4,388,405,667,401,279,chair
8589,26,table,27,0,7120,29,247,390,796,667,549,277,dining table
8590,28,plate,29,1,7120,21,460,472,582,521,122,49,plate
8591,34,plate,35,1,7120,19,246,460,371,510,125,50,plate
8592,3,mirror,4,0,7121,27,120,1,640,394,520,393,mirror
8593,11,chair,12,1,7121,16,480,246,583,479,103,233,chair
8594,11,sofa,12,1,7122,16,2,432,119,509,117,77,couch
8595,33,chair,34,1,7122,16,801,506,988,683,187,177,chair
8596,2,chair,3,0,7123,15,436,431,583,560,147,129,chair
8597,6,chair,7,0,7123,23,150,574,411,896,261,322,chair
8598,30,chair,30,1,7123,24,1004,522,1039,624,35,102,chair
8599,31,chair,31,1,7123,16,1088,464,1131,510,43,46,chair
8600,32,sofa,32,0,7123,25,957,435,1138,545,181,110,couch
8601,36,bowl,36,0,7123,29,774,619,872,689,98,70,bowl
8602,38,bowl,38,0,7123,33,633,588,728,695,95,107,bowl
8603,43,bowl,43,0,7123,22,272,440,338,511,66,71,bowl
8604,44,chair,44,0,7123,32,35,521,204,900,169,379,chair
8605,0,chair,1,0,7124,20,29,123,105,248,76,125,chair
8606,1,chair,2,0,7124,18,101,132,174,256,73,124,chair
8607,2,chair,3,0,7124,24,180,128,256,255,76,127,chair
8608,6,table,7,0,7124,36,49,144,254,255,205,111,dining table
8609,9,window,10,0,7124,37,0,48,256,194,256,146,window
8610,5,table,6,1,7125,18,223,99,308,132,85,33,dining table
8611,6,table,7,1,7125,37,142,118,264,197,122,79,dining table
8612,7,chair,8,1,7125,16,290,104,321,166,31,62,chair
8613,8,chair,9,1,7125,20,254,116,293,207,39,91,chair
8614,9,chair,10,0,7125,28,162,135,251,242,89,107,chair
8615,10,table,11,1,7125,17,25,100,85,126,60,26,dining table
8616,11,chair,12,1,7125,22,72,100,104,147,32,47,chair
8617,12,chair,13,1,7125,18,4,103,22,147,18,44,chair
8618,13,chair,14,0,7125,24,19,107,63,155,44,48,chair
8619,4,chair,5,0,7126,17,99,164,153,241,54,77,chair
8620,5,chair,6,0,7126,19,54,158,101,220,47,62,chair
8621,6,chair,7,0,7126,17,31,154,60,208,29,54,chair
8622,7,chair,8,0,7126,15,12,152,36,201,24,49,chair
8623,31,table,31,1,7126,111,10,155,216,246,206,91,dining table
8624,32,chair,32,1,7126,24,177,156,212,222,35,66,chair
8625,2,door,3,1,7127,15,288,115,359,271,71,156,door
8626,4,window,5,0,7127,16,404,2,787,368,383,366,window
8627,8,table,9,0,7127,20,147,263,588,542,441,279,dining table
8628,14,chair,15,1,7127,28,368,234,698,544,330,310,chair
8629,15,chair,16,1,7127,35,69,224,280,542,211,318,chair
8630,21,chair,22,1,7128,22,136,228,213,358,77,130,chair
8631,24,chair,25,1,7128,21,70,242,190,389,120,147,chair
8632,25,chair,26,1,7128,18,294,230,332,387,38,157,chair
8633,26,chair,27,1,7128,22,201,236,301,389,100,153,chair
8634,2,chair,3,0,7129,23,150,144,202,240,52,96,chair
8635,3,chair,4,0,7129,21,97,144,153,252,56,108,chair
8636,4,chair,5,0,7129,25,30,149,99,254,69,105,chair
8637,26,table,27,0,7129,23,47,158,223,255,176,97,dining table
8638,6,table,7,1,7130,19,186,234,267,283,81,49,dining table
8639,7,table,8,1,7130,19,236,250,305,342,69,92,dining table
8640,9,chair,10,1,7130,23,171,232,201,300,30,68,chair
8641,20,table,21,1,7130,26,2,346,153,448,151,102,dining table
8642,21,chair,22,1,7130,17,145,331,179,477,34,146,chair
8643,23,table,24,1,7130,35,294,298,443,403,149,105,dining table
8644,25,chair,26,1,7130,27,272,313,360,439,88,126,chair
8645,28,table,29,0,7130,18,397,344,640,480,243,136,dining table
8646,61,plate,54,0,7130,20,351,322,375,332,24,10,plate
8647,65,plate,58,0,7130,16,360,306,381,312,21,6,plate
8648,69,plate,62,0,7130,23,466,378,497,390,31,12,plate
8649,70,plate,63,0,7130,15,448,388,481,403,33,15,plate
8650,72,plate,65,0,7130,17,22,372,52,384,30,12,plate
8651,76,plate,69,0,7130,16,68,352,96,360,28,8,plate
8652,83,plate,76,0,7130,20,524,376,556,387,32,11,plate
8653,84,plate,77,0,7130,20,519,364,550,372,31,8,plate
8654,88,plate,81,0,7130,21,554,368,586,379,32,11,plate
8655,13,refrigerator,14,1,7131,16,402,311,495,575,93,264,refrigerator
8656,34,plate,35,1,7131,22,205,615,385,691,180,76,plate
8657,35,plate,36,1,7131,22,217,614,371,680,154,66,plate
8658,38,vase,39,0,7131,24,465,460,641,629,176,169,vase
8659,45,plate,46,1,7131,24,439,705,672,800,233,95,plate
8660,46,plate,47,1,7131,20,457,711,654,800,197,89,plate
8661,47,plate,48,0,7131,19,473,683,634,782,161,99,plate
8662,52,chair,53,1,7131,20,783,543,861,800,78,257,chair
8663,0,chair,1,1,7132,20,535,541,956,852,421,311,chair
8664,3,chair,3,0,7132,21,54,538,491,852,437,314,chair
8665,4,table,4,0,7132,29,230,580,762,853,532,273,dining table
8666,11,window,11,0,7132,17,661,61,1227,713,566,652,window
8667,30,plate,28,1,7132,26,639,631,739,659,100,28,plate
8668,31,plate,29,1,7132,28,625,632,753,670,128,38,plate
8669,33,plate,31,1,7132,25,321,630,426,657,105,27,plate
8670,34,plate,32,1,7132,23,304,634,444,668,140,34,plate
8671,36,chair,34,1,7132,39,291,502,472,611,181,109,chair
8672,0,chair,1,0,7133,17,401,245,633,479,232,234,chair
8673,17,table,18,0,7133,34,211,266,518,476,307,210,dining table
8674,20,chair,21,0,7133,43,195,232,367,474,172,242,chair
8675,34,chair,35,1,7133,41,391,231,510,414,119,183,chair
8676,43,chair,44,1,7133,47,170,226,286,456,116,230,chair
8677,5,window,6,0,7134,16,347,117,485,292,138,175,window
8678,9,table,10,0,7134,86,177,287,623,480,446,193,dining table
8679,10,chair,11,0,7134,34,436,264,586,479,150,215,chair
8680,11,chair,12,0,7134,39,226,260,390,480,164,220,chair
8681,10,chair,11,1,7135,21,352,470,470,612,118,142,chair
8682,11,chair,12,0,7135,34,390,491,551,714,161,223,chair
8683,13,chair,14,0,7135,34,128,505,307,748,179,243,chair
8684,14,table,15,0,7135,37,213,518,472,709,259,191,dining table
8685,9,table,10,0,7136,22,189,426,526,681,337,255,dining table
8686,10,chair,11,0,7136,32,427,429,625,683,198,254,chair
8687,14,chair,15,1,7136,26,192,406,280,628,88,222,chair
8688,15,chair,16,0,7136,38,258,417,440,682,182,265,chair
8689,0,chair,1,0,7137,18,116,133,255,254,139,121,chair
8690,1,chair,2,0,7137,16,0,109,88,254,88,145,chair
8691,2,mirror,3,0,7137,16,61,26,105,71,44,45,mirror
8692,13,table,14,0,7137,27,47,124,256,255,209,131,dining table
8693,17,chair,18,0,7138,16,2,544,291,798,289,254,chair
8694,18,table,19,0,7138,37,90,485,839,800,749,315,dining table
8695,22,chair,23,1,7138,24,626,560,1002,800,376,240,chair
8696,2,window,3,0,7139,24,59,2,403,459,344,457,window
8697,9,chair,10,1,7139,15,463,358,568,426,105,68,chair
8698,13,table,14,1,7139,33,276,420,919,610,643,190,dining table
8699,14,chair,15,1,7139,29,424,522,904,611,480,89,chair
8700,12,vase,13,0,7140,20,75,327,118,392,43,65,vase
8701,15,table,16,1,7140,16,519,373,918,453,399,80,dining table
8702,21,chair,22,1,7140,27,873,365,971,577,98,212,chair
8703,22,chair,23,1,7140,27,460,356,534,543,74,187,chair
8704,23,chair,24,0,7140,39,500,390,692,633,192,243,chair
8705,24,chair,25,0,7140,46,700,398,914,645,214,247,chair
8706,11,chair,12,1,7141,17,444,414,534,496,90,82,chair
8707,12,chair,13,1,7141,26,398,472,662,683,264,211,chair
8708,15,chair,16,1,7141,15,138,405,247,475,109,70,chair
8709,16,table,17,0,7141,63,124,452,533,683,409,231,dining table
8710,17,bowl,18,0,7141,28,270,424,373,504,103,80,bowl
8711,26,chair,27,1,7141,45,27,459,266,683,239,224,chair
8712,23,chair,24,1,7142,22,301,222,385,389,84,167,chair
8713,25,chair,26,1,7142,27,531,241,708,441,177,200,chair
8714,26,chair,27,0,7142,29,347,270,530,501,183,231,chair
8715,7,chair,8,0,7143,36,126,150,255,256,129,106,chair
8716,9,chair,10,0,7143,20,188,119,255,162,67,43,chair
8717,7,chair,8,1,7144,29,37,412,245,643,208,231,chair
8718,8,chair,9,1,7144,18,104,404,210,506,106,102,chair
8719,17,vase,18,0,7144,49,793,235,967,604,174,369,vase
8720,21,door,22,0,7144,18,706,157,764,484,58,327,door
8721,28,table,29,1,7144,48,147,434,319,605,172,171,dining table
8722,29,chair,30,1,7144,24,351,401,404,558,53,157,chair
8723,30,chair,31,1,7144,32,235,406,362,591,127,185,chair
8724,32,sofa,33,1,7144,15,0,464,124,799,124,335,couch
8725,2,chair,3,0,7145,15,380,849,742,1403,362,554,chair
8726,14,chair,15,0,7145,19,795,814,1075,1320,280,506,chair
8727,33,chair,33,1,7145,17,347,769,476,1046,129,277,chair
8728,6,table,7,0,7146,20,245,273,490,479,245,206,dining table
8729,11,chair,12,1,7146,26,401,300,526,478,125,178,chair
8730,12,chair,13,1,7146,39,259,347,391,479,132,132,chair
8731,6,chair,7,1,7147,17,43,495,326,618,283,123,chair
8732,11,chair,12,1,7147,20,545,393,738,616,193,223,chair
8733,12,chair,13,1,7147,19,698,345,785,512,87,167,chair
8734,13,clock,14,0,7147,17,680,203,791,301,111,98,clock
8735,21,table,22,0,7147,19,222,399,634,618,412,219,dining table
8736,6,table,7,0,7148,25,55,164,246,222,191,58,dining table
8737,8,chair,9,0,7148,19,24,161,96,231,72,70,chair
8738,9,chair,10,0,7148,21,214,156,254,224,40,68,chair
8739,12,chair,13,0,7148,19,0,184,77,255,77,71,chair
8740,5,chair,6,1,7150,17,347,311,430,398,83,87,chair
8741,8,chair,9,1,7150,23,326,344,521,531,195,187,chair
8742,9,chair,10,1,7150,17,36,312,154,412,118,100,chair
8743,11,table,12,1,7150,24,64,371,430,533,366,162,dining table
8744,16,cup,17,0,7150,22,185,387,221,455,36,68,cup
8745,28,window,29,0,7150,15,2,51,163,387,161,336,window
8746,14,chair,15,0,7151,21,147,154,192,219,45,65,chair
8747,15,chair,16,0,7151,25,184,156,242,231,58,75,chair
8748,17,table,18,0,7151,18,135,154,255,179,120,25,dining table
8749,11,table,12,0,7152,53,232,234,440,409,208,175,dining table
8750,12,chair,13,0,7152,43,366,226,499,434,133,208,chair
8751,36,door,37,0,7152,24,212,222,289,314,77,92,door
8752,9,table,10,0,7153,23,145,261,537,456,392,195,dining table
8753,12,chair,13,0,7153,26,373,202,541,460,168,258,chair
8754,13,chair,14,1,7153,23,150,213,203,427,53,214,chair
8755,14,chair,15,0,7153,36,184,207,324,459,140,252,chair
8756,4,chair,5,1,7154,43,117,65,263,299,146,234,chair
8757,5,chair,6,1,7154,47,349,65,494,289,145,224,chair
8758,6,chair,7,0,7154,35,361,73,575,393,214,320,chair
8759,7,chair,8,0,7154,37,13,73,237,390,224,317,chair
8760,8,table,9,0,7154,58,138,133,461,347,323,214,dining table
8761,12,table,13,0,7155,62,566,328,689,437,123,109,dining table
8762,13,mirror,14,0,7155,17,568,213,615,279,47,66,mirror
8763,15,table,16,1,7155,35,46,344,413,532,367,188,dining table
8764,21,chair,22,1,7155,25,8,329,70,532,62,203,chair
8765,22,chair,23,1,7155,28,48,344,232,533,184,189,chair
8766,23,chair,24,1,7155,20,291,384,490,531,199,147,chair
8767,10,table,11,0,7156,46,654,803,1709,1648,1055,845,dining table
8768,11,chair,12,0,7156,35,1371,891,1887,1648,516,757,chair
8769,13,chair,14,0,7156,43,647,974,1276,1648,629,674,chair
8770,52,bowl,52,0,7156,16,1124,762,1201,845,77,83,bowl
8771,3,chair,3,1,7157,18,1628,1232,2049,1536,421,304,chair
8772,4,chair,4,0,7157,57,1212,772,1640,1518,428,746,chair
8773,5,table,5,1,7157,26,629,949,1514,1201,885,252,dining table
8774,6,chair,6,1,7157,32,1124,804,1316,1193,192,389,chair
8775,7,chair,7,0,7157,36,510,785,781,1462,271,677,chair
8776,8,chair,8,0,7157,36,706,760,1174,1536,468,776,chair
8777,10,window,10,0,7157,17,1568,167,2013,1087,445,920,window
8778,11,window,11,0,7157,24,999,325,1491,976,492,651,window
8779,12,window,12,0,7157,21,406,289,910,1033,504,744,window
8780,14,chair,14,1,7157,25,4,635,223,1536,219,901,chair
8781,1,table,2,1,7158,18,199,722,1265,1156,1066,434,dining table
8782,2,chair,3,0,7158,19,346,745,592,1184,246,439,chair
8783,3,chair,4,0,7158,15,183,688,363,1089,180,401,chair
8784,4,chair,5,0,7158,15,644,736,854,1175,210,439,chair
8785,5,chair,6,0,7158,26,881,728,1118,1166,237,438,chair
8786,48,chair,47,1,7158,29,471,662,611,967,140,305,chair
8787,2,chair,2,0,7159,22,384,1415,604,1758,220,343,chair
8788,3,chair,3,0,7159,16,619,1412,831,1770,212,358,chair
8789,4,chair,4,0,7159,17,849,1409,1066,1761,217,352,chair
8790,13,mirror,13,0,7159,45,635,819,887,1214,252,395,mirror
8791,57,chair,57,1,7159,16,1104,1342,1189,1433,85,91,chair
8792,60,chair,60,1,7159,16,1126,1345,1225,1451,99,106,chair
8793,63,chair,63,1,7159,27,1167,1353,1268,1519,101,166,chair
8794,66,chair,66,1,7159,32,1175,1364,1317,1695,142,331,chair
8795,83,chair,83,1,7159,26,169,1374,292,1694,123,320,chair
8796,146,chair,146,1,7159,16,579,1332,650,1370,71,38,chair
8797,1,table,2,0,7160,37,0,734,705,1183,705,449,dining table
8798,12,chair,12,1,7160,67,452,688,753,1091,301,403,chair
8799,13,chair,13,1,7160,62,523,848,791,1163,268,315,chair
8800,3,table,4,0,7161,34,2,95,316,224,314,129,dining table
8801,13,chair,14,1,7161,27,11,103,71,222,60,119,chair
8802,14,chair,15,1,7161,24,60,117,139,224,79,107,chair
8803,6,chair,7,1,7162,17,1209,873,1518,1107,309,234,chair
8804,7,chair,8,0,7162,52,1206,980,1799,1651,593,671,chair
8805,8,chair,9,0,7162,36,481,975,1131,1651,650,676,chair
8806,9,table,10,1,7162,70,418,1011,1473,1649,1055,638,dining table
8807,28,chair,28,1,7162,34,476,862,778,1622,302,760,chair
8808,8,table,9,1,7163,28,221,1503,1135,2049,914,546,dining table
8809,0,table,1,0,7164,16,159,710,1523,1647,1364,937,dining table
8810,1,chair,2,1,7164,25,762,693,1407,1581,645,888,chair
8811,2,chair,3,1,7164,16,1154,568,1466,1342,312,774,chair
8812,4,chair,5,0,7164,30,147,675,819,1610,672,935,chair
8813,9,table,10,0,7165,35,2,451,682,767,680,316,dining table
8814,4,table,5,0,7166,89,653,879,1531,1651,878,772,dining table
8815,5,chair,6,1,7166,18,1515,774,1613,1092,98,318,chair
8816,6,chair,7,1,7166,17,1513,805,1619,1136,106,331,chair
8817,7,chair,8,1,7166,122,1151,843,1639,1637,488,794,chair
8818,8,chair,9,0,7166,15,887,777,1007,961,120,184,chair
8819,9,chair,10,1,7166,18,789,802,930,1016,141,214,chair
8820,10,chair,11,1,7166,111,621,841,1145,1617,524,776,chair
8821,6,chair,7,1,7167,25,1195,572,1448,1022,253,450,chair
8822,7,chair,8,0,7167,33,842,640,1251,1191,409,551,chair
8823,19,chair,20,1,7167,22,706,573,980,1033,274,460,chair
8824,20,chair,21,0,7167,32,152,601,570,1176,418,575,chair
8825,27,table,28,1,7167,105,387,660,1472,1173,1085,513,dining table
8826,28,vase,29,0,7167,19,817,451,922,708,105,257,vase
8827,29,vase,30,0,7167,19,915,451,1020,713,105,262,vase
8828,28,door,29,0,7168,18,275,374,412,769,137,395,door
8829,34,table,35,1,7168,30,0,702,171,796,171,94,dining table
8830,36,plate,37,0,7168,15,33,716,83,727,50,11,plate
8831,37,chair,38,1,7168,43,0,718,127,987,127,269,chair
8832,39,door,40,0,7168,22,1150,375,1254,727,104,352,door
8833,45,flowerpot,46,0,7168,25,1464,723,1541,814,77,91,potted plant
8834,54,chair,55,1,7168,34,376,679,488,811,112,132,chair
8835,55,chair,56,1,7168,35,290,723,539,900,249,177,chair
8836,56,chair,57,1,7168,34,714,681,812,853,98,172,chair
8837,57,chair,58,1,7168,52,542,722,790,974,248,252,chair
8838,67,table,68,1,7168,71,357,720,719,862,362,142,dining table
8839,78,plate,79,0,7168,16,509,748,564,760,55,12,plate
8840,92,plate,93,0,7168,18,1320,747,1373,758,53,11,plate
8841,95,chair,96,1,7168,61,1316,688,1484,845,168,157,chair
8842,96,chair,97,1,7168,73,1325,730,1582,1002,257,272,chair
8843,97,chair,98,1,7168,35,1047,686,1133,949,86,263,chair
8844,98,chair,99,1,7168,54,1081,728,1315,1008,234,280,chair
8845,99,table,100,1,7168,79,1144,715,1486,836,342,121,dining table
8846,102,chair,103,1,7168,77,1131,890,1487,1379,356,489,chair
8847,103,table,104,1,7168,85,1258,929,1807,1143,549,214,dining table
8848,104,plate,105,0,7168,17,1715,962,1806,992,91,30,plate
8849,108,bowl,109,0,7168,21,1641,953,1717,1002,76,49,bowl
8850,112,chair,113,1,7168,52,1564,854,1806,955,242,101,chair
8851,118,plate,119,0,7168,15,1425,996,1533,1030,108,34,plate
8852,120,plate,121,0,7168,23,1327,1009,1430,1041,103,32,plate
8853,122,chair,123,1,7168,25,178,823,408,920,230,97,chair
8854,133,plate,134,0,7168,22,578,986,679,1013,101,27,plate
8855,134,plate,135,0,7168,15,416,904,503,931,87,27,plate
8856,143,plate,144,0,7168,20,98,1019,205,1054,107,35,plate
8857,144,table,145,1,7168,108,33,907,729,1198,696,291,dining table
8858,146,chair,147,1,7168,74,625,848,916,1378,291,530,chair
8859,147,chair,148,1,7168,36,195,1077,632,1379,437,302,chair
8860,148,chair,149,1,7168,37,1,1031,202,1380,201,349,chair
8861,150,chair,151,1,7168,30,1760,685,1806,875,46,190,chair
8862,13,window,14,0,7169,15,884,495,1118,959,234,464,window
8863,15,chair,16,1,7169,31,824,888,1008,1200,184,312,chair
8864,16,chair,17,1,7169,22,756,898,994,1234,238,336,chair
8865,17,chair,18,1,7169,28,519,870,634,1171,115,301,chair
8866,18,chair,19,1,7169,34,450,878,672,1207,222,329,chair
8867,19,table,20,1,7169,31,564,919,936,1262,372,343,dining table
8868,28,chair,29,1,7169,34,626,919,847,1275,221,356,chair
8869,19,window,20,1,7170,70,256,521,593,1457,337,936,window
8870,31,vase,32,0,7170,33,1154,1019,1235,1159,81,140,vase
8871,33,plate,34,1,7170,19,897,925,1048,1056,151,131,plate
8872,38,flowerpot,39,0,7170,16,1365,1160,1499,1282,134,122,potted plant
8873,40,chair,41,1,7170,29,923,1043,1165,1489,242,446,chair
8874,41,chair,42,1,7170,18,910,1467,1158,1608,248,141,chair
8875,42,chair,43,1,7170,50,524,1050,671,1593,147,543,chair
8876,43,chair,44,0,7170,81,620,1043,1367,2197,747,1154,chair
8877,56,chair,57,1,7170,43,1349,1535,1647,1972,298,437,chair
8878,60,chair,61,1,7170,28,1507,1068,1646,1225,139,157,chair
8879,62,table,63,1,7170,116,860,1204,1646,2087,786,883,dining table
8880,68,bottle,69,1,7170,15,1216,1227,1265,1305,49,78,bottle
8881,11,plate,12,0,7171,15,561,452,639,536,78,84,plate
8882,14,chair,15,1,7171,17,790,586,950,672,160,86,chair
8883,15,chair,16,1,7171,25,397,621,528,768,131,147,chair
8884,17,table,18,1,7171,18,440,649,1023,768,583,119,dining table
8885,18,plate,19,1,7171,15,672,709,821,761,149,52,plate
8886,5,table,6,0,7172,34,38,141,160,254,122,113,dining table
8887,8,chair,9,1,7172,20,22,138,52,242,30,104,chair
8888,9,chair,10,0,7172,29,78,154,148,275,70,121,chair
8889,20,window,20,0,7173,16,40,634,85,758,45,124,window
8890,21,person,21,0,7173,44,41,719,87,955,46,236,person
8891,34,mirror,33,1,7173,16,510,680,1163,924,653,244,mirror
8892,41,chair,39,1,7173,45,455,930,624,1236,169,306,chair
8893,42,table,40,1,7173,26,501,972,661,1239,160,267,dining table
8894,43,chair,41,1,7173,33,624,933,804,1258,180,325,chair
8895,45,table,43,1,7173,33,794,922,1156,1051,362,129,dining table
8896,49,chair,47,1,7173,15,793,968,957,1061,164,93,chair
8897,51,chair,48,1,7173,99,672,1003,944,1479,272,476,chair
8898,52,chair,49,1,7173,73,942,1022,1233,1512,291,490,chair
8899,53,chair,50,1,7173,28,1068,1213,1420,1647,352,434,chair
8900,54,chair,51,1,7173,18,1156,925,1282,984,126,59,chair
8901,56,chair,53,1,7173,17,1163,974,1294,1090,131,116,chair
8902,57,table,54,1,7173,120,752,1048,1309,1473,557,425,dining table
8903,59,table,56,1,7173,27,1266,979,1416,1151,150,172,dining table
8904,60,chair,57,1,7173,45,1332,953,1556,1153,224,200,chair
8905,65,chair,62,1,7173,20,1595,979,1746,1090,151,111,chair
8906,66,vase,63,0,7173,23,1724,816,1830,894,106,78,vase
8907,70,mirror,67,0,7173,98,1685,413,2031,855,346,442,mirror
8908,71,chair,68,1,7173,34,1900,856,2057,1076,157,220,chair
8909,72,chair,69,1,7173,22,1976,992,2157,1094,181,102,chair
8910,76,chair,73,1,7173,25,1624,1017,1805,1287,181,270,chair
8911,77,table,74,1,7173,27,1792,1060,2103,1207,311,147,dining table
8912,79,chair,75,1,7173,30,1736,1163,2001,1377,265,214,chair
8913,80,chair,76,1,7173,27,1561,1300,1999,1649,438,349,chair
8914,81,chair,77,1,7173,72,1250,1134,1561,1643,311,509,chair
8915,82,table,78,1,7173,58,1275,1258,1859,1650,584,392,dining table
8916,84,chair,80,1,7173,69,1972,1043,2200,1492,228,449,chair
8917,89,table,85,1,7173,32,1,1295,254,1619,253,324,dining table
8918,92,window,88,1,7173,52,1340,387,1520,917,180,530,window
8919,17,person,15,1,7174,32,465,455,627,800,162,345,person
8920,24,table,22,1,7174,18,1,786,739,1103,738,317,dining table
8921,25,bowl,23,1,7174,23,138,730,328,857,190,127,bowl
8922,41,spoon,39,0,7174,17,334,1075,509,1103,175,28,spoon
8923,42,chair,40,0,7174,22,741,654,875,882,134,228,chair
8924,43,chair,41,1,7174,24,615,638,740,860,125,222,chair
8925,44,chair,42,0,7174,31,856,670,1008,929,152,259,chair
8926,48,bowl,46,0,7174,19,1160,550,1229,607,69,57,bowl
8927,10,door,11,1,7175,20,792,719,1084,1427,292,708,door
8928,14,chair,15,1,7175,23,402,1137,528,1251,126,114,chair
8929,15,vase,16,0,7175,21,522,1119,589,1278,67,159,vase
8930,16,chair,17,1,7175,39,134,1143,294,1253,160,110,chair
8931,17,vase,18,1,7175,17,166,1117,235,1232,69,115,vase
8932,22,bowl,23,1,7175,21,321,1217,446,1288,125,71,bowl
8933,24,chair,25,1,7175,57,780,1117,947,1624,167,507,chair
8934,25,chair,26,1,7175,41,525,1196,798,1748,273,552,chair
8935,26,chair,27,1,7175,34,120,1218,391,1793,271,575,chair
8936,27,table,28,1,7175,72,2,1248,881,1693,879,445,dining table
8937,46,door,47,0,7176,24,703,234,849,405,146,171,door
8938,57,chair,58,1,7176,15,924,402,989,579,65,177,chair
8939,66,chair,67,1,7176,35,1417,563,1596,1028,179,465,chair
8940,68,chair,69,1,7176,44,677,647,1099,1253,422,606,chair
8941,69,chair,70,0,7176,45,1083,650,1516,1253,433,603,chair
8942,70,table,71,1,7176,47,656,621,1658,1253,1002,632,dining table
8943,72,plate,73,0,7176,18,985,642,1167,688,182,46,plate
8944,75,plate,76,0,7176,16,827,703,1012,765,185,62,plate
8945,78,plate,79,0,7176,17,1181,696,1313,757,132,61,plate
8946,80,plate,81,0,7176,19,1307,633,1484,676,177,43,plate
8947,36,window,36,0,7177,30,1094,358,1302,917,208,559,window
8948,40,chair,40,1,7177,35,781,936,1055,1409,274,473,chair
8949,42,chair,42,1,7177,25,1096,946,1388,1418,292,472,chair
8950,29,chair,25,0,7178,45,908,670,1278,962,370,292,chair
8951,30,vase,26,1,7178,22,995,513,1080,618,85,105,vase
8952,9,table,10,0,7179,34,263,534,787,839,524,305,dining table
8953,11,chair,12,1,7179,26,721,481,869,856,148,375,chair
8954,12,chair,13,1,7179,24,131,506,381,909,250,403,chair
8955,13,chair,14,1,7179,22,471,559,750,944,279,385,chair
8956,7,table,8,1,7180,32,950,704,1387,952,437,248,dining table
8957,8,chair,9,1,7180,16,1036,609,1166,826,130,217,chair
8958,9,chair,10,1,7180,22,1358,622,1510,950,152,328,chair
8959,10,chair,11,0,7180,32,1143,648,1390,1035,247,387,chair
8960,11,chair,12,0,7180,30,860,627,1082,983,222,356,chair
8961,17,table,18,0,7181,43,129,374,659,872,530,498,dining table
8962,21,chair,22,1,7181,40,302,497,662,873,360,376,chair
8963,23,chair,24,1,7181,37,100,435,364,873,264,438,chair
8964,2,mirror,3,1,7182,16,817,82,1020,424,203,342,mirror
8965,22,plate,21,0,7183,18,847,613,936,651,89,38,plate
8966,27,plate,26,0,7183,18,991,780,1135,862,144,82,plate
8967,28,knife,27,0,7183,15,1036,771,1084,857,48,86,knife
8968,29,plate,28,0,7183,15,32,566,116,600,84,34,plate
8969,33,chair,32,1,7183,36,403,415,481,608,78,193,chair
8970,34,chair,33,1,7183,32,358,450,440,671,82,221,chair
8971,35,chair,34,1,7183,46,224,481,381,741,157,260,chair
8972,36,chair,35,0,7183,57,87,543,321,862,234,319,chair
8973,37,chair,36,1,7183,32,425,359,512,488,87,129,chair
8974,39,chair,38,1,7183,25,658,630,877,861,219,231,chair
8975,40,chair,39,1,7183,39,712,518,842,766,130,248,chair
8976,41,chair,40,1,7183,28,660,462,741,631,81,169,chair
8977,42,chair,41,1,7183,33,691,420,806,519,115,99,chair
8978,43,chair,42,1,7183,33,693,398,802,486,109,88,chair
8979,1,table,2,0,7184,18,227,928,1704,1465,1477,537,dining table
8980,2,chair,3,1,7184,33,788,752,1295,940,507,188,chair
8981,5,chair,6,1,7184,18,1356,859,1922,1462,566,603,chair
8982,6,chair,7,1,7184,21,78,821,719,1465,641,644,chair
8983,7,chair,8,1,7184,38,629,1027,1424,1465,795,438,chair
8984,20,table,21,1,7186,36,56,604,512,792,456,188,dining table
8985,22,chair,23,1,7186,15,63,624,124,760,61,136,chair
8986,23,chair,24,1,7186,26,116,645,182,760,66,115,chair
8987,24,chair,25,1,7186,26,181,656,271,695,90,39,chair
8988,40,chair,41,1,7186,22,515,647,581,788,66,141,chair
8989,41,chair,42,1,7186,26,468,734,547,831,79,97,chair
8990,43,chair,44,1,7186,16,399,714,443,740,44,26,chair
8991,44,chair,45,1,7186,22,347,699,410,741,63,42,chair
8992,47,chair,48,1,7186,26,565,754,658,862,93,108,chair
8993,48,table,49,1,7186,131,1,736,754,1056,753,320,dining table
8994,73,plate,73,0,7186,15,611,885,709,918,98,33,plate
8995,77,chair,77,1,7186,28,25,738,235,1200,210,462,chair
8996,78,chair,78,1,7186,17,191,847,278,1200,87,353,chair
8997,79,chair,79,1,7186,37,225,851,375,1200,150,349,chair
8998,80,table,80,0,7186,76,347,775,1599,1200,1252,425,dining table
8999,81,table,81,1,7186,51,699,674,1529,811,830,137,dining table
9000,83,flowerpot,83,1,7186,23,902,939,969,1017,67,78,potted plant
9001,85,chair,85,1,7186,63,743,684,826,915,83,231,chair
9002,86,chair,86,1,7186,59,811,688,896,911,85,223,chair
9003,87,chair,87,1,7186,60,914,702,1026,881,112,179,chair
9004,89,chair,89,1,7186,24,1131,735,1271,854,140,119,chair
9005,90,chair,90,1,7186,31,981,619,1057,687,76,68,chair
9006,91,chair,91,1,7186,35,1076,628,1169,679,93,51,chair
9007,92,chair,92,1,7186,31,1191,635,1280,721,89,86,chair
9008,93,chair,93,1,7186,32,1324,649,1434,724,110,75,chair
9009,94,chair,94,1,7186,60,1459,616,1586,774,127,158,chair
9010,122,spoon,122,0,7186,17,756,1075,859,1138,103,63,spoon
9011,123,knife,123,0,7186,15,702,1158,891,1200,189,42,knife
9012,129,spoon,129,0,7186,16,1092,1116,1208,1150,116,34,spoon
9013,130,chair,130,1,7186,20,685,780,804,925,119,145,chair
9014,131,chair,131,1,7186,70,1216,870,1540,1199,324,329,chair
9015,133,bowl,133,1,7186,36,1111,865,1324,973,213,108,bowl
9016,137,plate,137,1,7186,17,482,1020,574,1073,92,53,plate
9017,141,door,141,0,7186,37,902,359,1029,681,127,322,door
9018,13,chair,14,0,7187,30,959,841,1079,1003,120,162,chair
9019,16,table,17,1,7187,21,278,847,543,976,265,129,dining table
9020,22,bottle,23,0,7187,16,538,145,584,224,46,79,bottle
9021,26,vase,27,0,7187,16,315,224,379,298,64,74,vase
9022,34,plate,35,1,7187,22,341,459,440,552,99,93,plate
9023,35,pot,36,0,7187,16,395,504,458,558,63,54,potted plant
9024,39,plate,40,0,7187,16,445,580,517,669,72,89,plate
9025,41,plate,42,0,7187,16,355,576,427,662,72,86,plate
9026,51,table,52,0,7187,84,40,939,1085,1725,1045,786,dining table
9027,52,chair,53,1,7187,15,471,876,547,958,76,82,chair
9028,54,chair,55,1,7187,44,1,1077,274,1602,273,525,chair
9029,55,chair,56,1,7187,45,790,975,1162,1542,372,567,chair
9030,56,chair,57,0,7187,32,357,1155,721,1732,364,577,chair
9031,61,bowl,62,0,7187,35,485,940,728,1065,243,125,bowl
9032,62,plate,63,1,7187,28,449,1011,731,1080,282,69,plate
9033,10,chair,11,1,7188,49,134,1011,455,1697,321,686,chair
9034,12,mirror,13,1,7188,22,1316,331,1898,1075,582,744,mirror
9035,13,window,14,0,7188,63,3,297,777,1323,774,1026,window
9036,14,vase,15,0,7188,19,774,1063,867,1281,93,218,vase
9037,16,chair,17,1,7188,20,926,1028,1230,1251,304,223,chair
9038,17,chair,18,1,7188,40,1095,1048,1695,1644,600,596,chair
9039,18,chair,19,1,7188,33,1068,1164,1893,1876,825,712,chair
9040,19,chair,20,1,7188,55,259,1073,1039,1881,780,808,chair
9041,20,chair,21,1,7188,47,3,1043,365,1879,362,836,chair
9042,21,table,22,1,7188,51,275,1183,1526,1878,1251,695,dining table
9043,13,chair,13,1,7189,19,534,650,650,810,116,160,chair
9044,14,chair,14,1,7189,16,540,778,757,918,217,140,chair
9045,15,chair,15,1,7189,34,1424,708,1599,1173,175,465,chair
9046,15,chair,16,0,7190,95,1074,867,1524,1591,450,724,chair
9047,28,chair,29,0,7190,106,573,869,998,1577,425,708,chair
9048,43,chair,43,1,7190,82,962,837,1293,1398,331,561,chair
9049,44,chair,44,1,7190,40,796,826,1039,1157,243,331,chair
9050,45,chair,45,1,7190,31,416,823,603,1088,187,265,chair
9051,46,chair,46,1,7190,75,341,846,618,1452,277,606,chair
9052,47,table,47,1,7190,98,516,918,1312,1493,796,575,dining table
9053,16,door,17,1,7191,17,1318,241,1593,750,275,509,door
9054,22,chair,23,1,7191,15,557,581,695,665,138,84,chair
9055,24,chair,25,1,7191,15,179,645,298,796,119,151,chair
9056,25,chair,26,1,7191,19,66,703,183,961,117,258,chair
9057,26,chair,27,1,7191,17,26,784,110,1055,84,271,chair
9058,27,chair,28,1,7191,18,99,905,466,1199,367,294,chair
9059,32,table,33,1,7191,66,157,650,1599,1200,1442,550,dining table
9060,33,bowl,34,0,7191,28,850,681,1046,816,196,135,bowl
9061,0,table,1,0,7192,17,0,700,1215,1647,1215,947,dining table
9062,4,chair,4,0,7192,34,1544,800,2109,1503,565,703,chair
9063,33,chair,28,1,7192,59,531,1043,1024,1649,493,606,chair
9064,35,chair,30,1,7192,25,999,799,1113,1325,114,526,chair
9065,36,chair,31,1,7192,18,1097,748,1173,1152,76,404,chair
9066,37,chair,32,1,7192,18,1165,684,1225,1042,60,358,chair
9067,47,chair,42,0,7192,16,1413,584,1595,764,182,180,chair
9068,67,vase,62,0,7192,26,1892,1515,2197,1649,305,134,vase
9069,31,door,32,1,7193,80,628,202,880,822,252,620,door
9070,35,chair,36,1,7193,40,1126,534,1289,784,163,250,chair
9071,36,chair,37,1,7193,25,1102,603,1156,774,54,171,chair
9072,54,bottle,55,0,7193,28,1606,539,1662,717,56,178,bottle
9073,59,chair,60,0,7193,82,1699,552,2045,1194,346,642,chair
9074,60,chair,61,1,7193,131,1008,675,1539,1356,531,681,chair
9075,61,chair,62,1,7193,100,390,693,890,1359,500,666,chair
9076,62,table,63,1,7193,152,539,765,1363,1342,824,577,dining table
9077,63,vase,64,1,7193,17,906,779,997,871,91,92,vase
9078,10,window,11,0,7194,25,1214,203,2049,1011,835,808,window
9079,14,cat,15,0,7194,24,1716,1171,2049,1304,333,133,cat
9080,22,chair,23,0,7194,17,894,781,1090,1001,196,220,chair
9081,23,chair,24,1,7194,47,417,822,826,1535,409,713,chair
9082,24,chair,25,0,7194,54,1364,932,1740,1535,376,603,chair
9083,39,chair,40,1,7194,44,880,1030,1443,1536,563,506,chair
9084,40,table,41,1,7194,34,418,931,1624,1533,1206,602,dining table
9085,43,cat,44,0,7194,42,329,1132,467,1353,138,221,cat
9086,27,chair,28,1,7195,49,1048,974,1324,1384,276,410,chair
9087,28,chair,29,1,7195,56,668,949,907,1340,239,391,chair
9088,29,chair,30,1,7195,78,695,1008,872,1543,177,535,chair
9089,30,chair,31,1,7195,136,1299,1023,1615,1580,316,557,chair
9090,31,chair,32,0,7195,123,1574,962,1878,1433,304,471,chair
9091,54,table,55,1,7195,145,775,1075,1468,1593,693,518,dining table
9092,55,chair,56,1,7195,154,845,1101,1255,1648,410,547,chair
9093,56,window,57,0,7195,120,958,538,1564,1149,606,611,window
9094,0,table,1,0,7196,27,423,525,1110,958,687,433,dining table
9095,5,chair,5,0,7196,22,900,566,1232,958,332,392,chair
9096,21,chair,21,1,7196,74,450,556,708,899,258,343,chair
9097,22,chair,22,0,7196,70,649,604,912,958,263,354,chair
9098,34,chair,35,1,7197,16,1103,807,1266,954,163,147,chair
9099,35,chair,36,1,7197,21,1518,867,1869,1427,351,560,chair
9100,38,vase,38,0,7197,30,1394,830,1459,984,65,154,vase
9101,45,plate,45,1,7197,19,1517,985,1672,1019,155,34,plate
9102,46,plate,46,1,7197,17,1553,984,1657,1012,104,28,plate
9103,53,plate,53,0,7197,16,1009,1045,1192,1126,183,81,plate
9104,55,spoon,55,0,7197,18,1161,1126,1250,1175,89,49,spoon
9105,56,spoon,56,0,7197,17,1134,1115,1219,1167,85,52,spoon
9106,57,window,57,0,7197,110,1469,249,1813,915,344,666,window
9107,59,table,59,1,7197,108,862,860,1760,1464,898,604,dining table
9108,64,chair,64,1,7197,95,621,949,1071,1466,450,517,chair
9109,76,vase,76,0,7197,21,2002,1016,2067,1185,65,169,vase
9110,81,door,81,0,7197,17,853,401,944,653,91,252,door
9111,83,door,83,0,7197,19,1085,452,1143,654,58,202,door
9112,28,chair,29,1,7198,16,651,719,977,873,326,154,chair
9113,31,chair,32,1,7198,54,1077,725,1580,1479,503,754,chair
9114,32,chair,33,1,7198,33,121,783,464,1569,343,786,chair
9115,33,chair,34,0,7198,48,374,850,1114,1650,740,800,chair
9116,38,mirror,39,0,7198,35,3,166,640,1099,637,933,mirror
9117,8,chair,9,0,7199,34,495,548,791,862,296,314,chair
9118,9,chair,10,0,7199,29,293,464,452,862,159,398,chair
9119,10,table,11,0,7199,24,254,435,1149,862,895,427,dining table
9120,15,sofa,16,1,7200,23,25,592,186,666,161,74,couch
9121,18,chair,19,1,7200,17,72,609,130,749,58,140,chair
9122,19,chair,20,1,7200,27,82,616,186,769,104,153,chair
9123,25,window,26,0,7200,31,1087,386,1252,727,165,341,window
9124,28,window,29,0,7200,33,679,438,753,660,74,222,window
9125,33,chair,34,1,7200,25,768,635,879,740,111,105,chair
9126,34,chair,35,1,7200,22,643,626,730,715,87,89,chair
9127,35,chair,36,1,7200,18,548,617,615,692,67,75,chair
9128,36,chair,37,1,7200,33,258,611,366,682,108,71,chair
9129,37,chair,38,1,7200,43,202,636,304,990,102,354,chair
9130,38,chair,39,1,7200,57,266,656,513,1086,247,430,chair
9131,39,chair,40,1,7200,77,343,683,703,1155,360,472,chair
9132,41,table,42,1,7200,88,257,673,987,1156,730,483,dining table
9133,46,bowl,47,0,7200,16,836,613,884,642,48,29,bowl
9134,30,window,31,0,7201,33,1557,129,2031,833,474,704,window
9135,39,sofa,40,1,7201,55,861,665,1342,945,481,280,couch
9136,41,table,42,1,7201,65,1127,820,1852,1472,725,652,dining table
9137,42,chair,43,1,7201,15,1258,700,1437,847,179,147,chair
9138,43,chair,44,1,7201,33,1056,710,1406,1097,350,387,chair
9139,44,chair,45,1,7201,47,1733,711,1950,1021,217,310,chair
9140,45,chair,46,1,7201,34,1731,770,2004,1339,273,569,chair
9141,46,chair,47,1,7201,74,1346,800,1851,1446,505,646,chair
9142,47,chair,48,0,7201,68,926,781,1411,1462,485,681,chair
9143,59,bowl,60,0,7201,16,681,799,812,839,131,40,bowl
9144,60,bowl,61,0,7201,28,1478,818,1641,896,163,78,bowl
9145,31,plate,32,0,7202,17,1224,467,1301,540,77,73,plate
9146,32,chair,33,1,7202,21,617,473,763,588,146,115,chair
9147,33,chair,34,1,7202,22,302,481,394,661,92,180,chair
9148,34,chair,35,1,7202,25,193,493,321,714,128,221,chair
9149,36,chair,37,1,7202,23,2,679,788,1031,786,352,chair
9150,37,chair,38,1,7202,17,943,482,1025,675,82,193,chair
9151,38,chair,39,1,7202,17,998,494,1109,760,111,266,chair
9152,39,chair,40,1,7202,21,1100,520,1301,942,201,422,chair
9153,40,table,41,1,7202,32,238,589,1267,1030,1029,441,dining table
9154,68,chair,69,1,7203,19,900,789,1068,963,168,174,chair
9155,69,chair,70,1,7203,16,1287,771,1469,900,182,129,chair
9156,70,chair,71,1,7203,44,1402,810,1765,1266,363,456,chair
9157,71,chair,72,1,7203,44,1316,887,1828,1330,512,443,chair
9158,72,chair,73,1,7203,27,696,820,916,970,220,150,chair
9159,73,chair,74,1,7203,39,597,941,1163,1330,566,389,chair
9160,74,table,75,1,7203,48,666,880,1552,1330,886,450,dining table
9161,14,chair,14,0,7204,20,1508,745,1786,939,278,194,chair
9162,21,chair,21,1,7204,31,247,937,897,1650,650,713,chair
9163,22,chair,22,1,7204,23,516,793,897,1424,381,631,chair
9164,23,chair,23,1,7204,25,1003,908,1698,1646,695,738,chair
9165,24,chair,24,1,7204,31,1604,849,1956,1646,352,797,chair
9166,25,window,25,0,7204,28,1335,21,1860,834,525,813,window
9167,14,table,14,0,7205,27,413,661,879,958,466,297,dining table
9168,16,chair,16,0,7205,17,655,698,933,958,278,260,chair
9169,30,chair,31,1,7206,19,1100,753,1251,829,151,76,chair
9170,31,chair,32,1,7206,16,1417,762,1539,855,122,93,chair
9171,32,chair,33,1,7206,36,1273,791,1568,1142,295,351,chair
9172,33,chair,34,1,7206,17,883,771,988,997,105,226,chair
9173,34,chair,35,1,7206,32,993,797,1273,1082,280,285,chair
9174,35,chair,36,1,7206,22,936,859,1162,1101,226,242,chair
9175,36,chair,37,1,7206,68,971,924,1381,1530,410,606,chair
9176,37,chair,38,1,7206,19,425,847,655,1008,230,161,chair
9177,38,chair,39,1,7206,35,34,834,362,1077,328,243,chair
9178,39,chair,40,1,7206,20,37,899,203,1050,166,151,chair
9179,40,chair,41,0,7206,104,0,979,554,1622,554,643,chair
9180,41,chair,42,0,7206,60,592,1001,1035,1650,443,649,chair
9181,42,table,43,1,7206,30,1134,822,1460,978,326,156,dining table
9182,45,table,46,1,7206,25,218,856,495,1018,277,162,dining table
9183,48,chair,49,1,7206,17,622,771,695,970,73,199,chair
9184,49,chair,50,1,7206,20,524,804,674,975,150,171,chair
9185,50,chair,51,1,7206,19,211,763,360,862,149,99,chair
9186,51,table,52,1,7206,75,231,983,1132,1245,901,262,dining table
9187,53,chair,54,1,7206,42,1529,804,1831,1169,302,365,chair
9188,54,table,55,1,7206,37,1689,1190,2198,1544,509,354,dining table
9189,55,chair,56,1,7206,39,1525,1022,1808,1647,283,625,chair
9190,56,chair,57,1,7206,20,1729,1352,2199,1649,470,297,chair
9191,10,mirror,11,0,7207,17,1110,511,1240,789,130,278,mirror
9192,24,table,25,1,7207,81,211,935,1013,1649,802,714,dining table
9193,25,chair,26,1,7207,29,418,798,607,940,189,142,chair
9194,26,window,27,0,7207,38,143,661,773,964,630,303,window
9195,29,chair,30,1,7207,37,912,869,1028,1553,116,684,chair
9196,30,chair,31,1,7207,50,385,1056,943,1648,558,592,chair
9197,32,chair,33,1,7207,52,126,905,394,1649,268,744,chair
9198,34,bowl,35,0,7207,37,505,945,660,1057,155,112,bowl
9199,30,chair,31,1,7208,33,415,1039,766,1280,351,241,chair
9200,31,chair,32,1,7208,22,972,984,1216,1154,244,170,chair
9201,32,chair,33,1,7208,68,1270,762,1559,1082,289,320,chair
9202,33,chair,34,1,7208,35,1704,864,1901,1014,197,150,chair
9203,39,table,40,1,7208,83,15,990,2199,1649,2184,659,dining table
9204,41,bowl,42,0,7208,31,1072,815,1199,895,127,80,bowl
9205,43,bowl,44,0,7208,22,857,853,972,923,115,70,bowl
9206,44,bowl,45,0,7208,26,681,885,857,940,176,55,bowl
9207,55,plate,56,1,7208,36,1128,1075,1308,1151,180,76,plate
9208,57,plate,58,0,7208,30,1300,1060,1452,1115,152,55,plate
9209,59,spoon,60,0,7208,16,1023,1142,1127,1179,104,37,spoon
9210,61,plate,62,0,7208,44,533,1333,726,1415,193,82,plate
9211,63,plate,64,0,7208,44,551,1187,780,1289,229,102,plate
9212,65,fork,66,0,7208,23,772,1206,889,1251,117,45,fork
9213,68,bowl,69,0,7208,25,1299,1213,1409,1307,110,94,bowl
9214,69,plate,70,0,7208,21,136,1405,422,1536,286,131,plate
9215,71,fork,72,0,7208,24,192,1473,486,1599,294,126,fork
9216,75,pot,76,1,7208,41,1532,1078,1623,1225,91,147,potted plant
9217,77,pot,78,0,7208,28,1594,1136,1716,1263,122,127,potted plant
9218,79,vase,80,1,7208,23,1616,1005,1703,1152,87,147,vase
9219,81,chair,82,1,7208,19,1977,958,2199,1098,222,140,chair
9220,84,plate,85,0,7208,20,1946,1325,2198,1463,252,138,plate
9221,91,plate,92,0,7208,16,1940,1030,2102,1096,162,66,plate
9222,92,plate,93,0,7208,19,1774,1461,2074,1604,300,143,plate
9223,94,plate,95,0,7208,17,824,1157,1011,1231,187,74,plate
9224,97,plate,98,1,7208,16,1147,1195,1300,1238,153,43,plate
9225,98,spoon,99,0,7208,19,415,1276,504,1337,89,61,spoon
9226,99,plate,100,1,7208,16,1390,1451,1608,1555,218,104,plate
9227,101,cup,102,1,7208,18,1458,1404,1579,1527,121,123,cup
9228,102,fork,103,1,7208,19,1859,1419,2134,1556,275,137,fork
9229,105,bowl,106,0,7208,16,570,1280,696,1392,126,112,bowl
9230,109,bowl,110,0,7208,16,649,1190,745,1291,96,101,bowl
9231,111,bowl,112,0,7208,20,737,1426,868,1574,131,148,bowl
9232,115,bowl,116,0,7208,15,1916,1182,2010,1276,94,94,bowl
9233,127,plate,128,0,7208,20,264,1514,630,1648,366,134,plate
9234,15,bench,16,1,7209,60,205,644,963,1097,758,453,bench
9235,16,chair,17,1,7209,25,775,683,958,1089,183,406,chair
9236,18,chair,19,1,7209,15,376,693,632,849,256,156,chair
9237,19,chair,20,0,7209,47,356,869,713,1536,357,667,chair
9238,20,table,21,1,7209,63,284,805,963,1442,679,637,dining table
9239,52,chair,53,1,7210,35,1118,931,1261,1062,143,131,chair
9240,53,chair,54,1,7210,47,1363,1005,1546,1504,183,499,chair
9241,55,chair,56,1,7210,34,325,850,578,1172,253,322,chair
9242,57,chair,58,1,7210,37,2,946,177,1266,175,320,chair
9243,58,table,59,1,7210,68,0,861,529,1240,529,379,dining table
9244,71,vase,72,0,7210,17,780,791,845,829,65,38,vase
9245,85,chair,86,1,7210,56,601,1048,866,1648,265,600,chair
9246,86,chair,87,1,7210,60,823,1114,1237,1649,414,535,chair
9247,87,table,88,1,7210,143,582,1015,1628,1646,1046,631,dining table
9248,88,bowl,89,0,7210,15,1024,1116,1166,1159,142,43,bowl
9249,16,window,17,0,7211,70,361,107,603,590,242,483,window
9250,19,chair,20,1,7211,20,451,631,636,737,185,106,chair
9251,21,chair,22,1,7211,46,760,708,1051,1200,291,492,chair
9252,22,chair,23,1,7211,33,507,779,841,1200,334,421,chair
9253,23,chair,24,1,7211,30,4,850,437,1196,433,346,chair
9254,24,table,25,1,7211,58,67,676,1074,1193,1007,517,dining table
9255,20,door,21,0,7212,39,1146,763,1909,1535,763,772,door
9256,30,chair,31,1,7212,17,1644,1331,1905,1650,261,319,chair
9257,36,table,37,1,7212,33,718,1416,1785,1617,1067,201,dining table
9258,42,chair,43,1,7213,26,1049,1224,1150,1377,101,153,chair
9259,43,chair,44,1,7213,50,1304,1248,1444,1545,140,297,chair
9260,45,chair,46,1,7213,40,1423,1259,1640,1598,217,339,chair
9261,46,chair,47,1,7213,37,481,1186,645,1385,164,199,chair
9262,49,table,50,1,7213,108,553,1379,1648,2196,1095,817,dining table
9263,51,bowl,52,0,7213,23,1476,1620,1578,1695,102,75,bowl
9264,58,chair,59,1,7213,67,449,1307,1055,2198,606,891,chair
9265,59,chair,60,1,7213,81,361,1268,820,2185,459,917,chair
9266,60,chair,61,1,7213,52,299,1243,663,1986,364,743,chair
9267,61,chair,62,1,7213,42,233,1228,325,1848,92,620,chair
9268,62,chair,63,1,7213,36,183,1210,261,1754,78,544,chair
9269,63,chair,64,1,7213,18,158,1205,199,1673,41,468,chair
9270,8,door,9,0,7214,19,721,231,897,971,176,740,door
9271,28,window,29,0,7214,50,1408,36,2073,892,665,856,window
9272,30,chair,31,1,7214,21,1577,700,1774,858,197,158,chair
9273,31,chair,32,1,7214,42,1714,775,1896,1446,182,671,chair
9274,32,chair,33,1,7214,71,1246,824,1806,1626,560,802,chair
9275,33,chair,34,1,7214,18,1076,729,1225,927,149,198,chair
9276,34,chair,35,1,7214,42,866,763,1184,1280,318,517,chair
9277,35,chair,36,1,7214,61,585,939,1275,1650,690,711,chair
9278,39,bowl,40,0,7214,27,1345,849,1465,970,120,121,bowl
9279,1,chair,2,0,7215,17,301,546,673,898,372,352,chair
9280,2,chair,3,0,7215,20,290,439,527,818,237,379,chair
9281,7,sofa,7,0,7215,19,700,365,1054,463,354,98,couch
9282,27,chair,27,1,7215,19,919,413,998,721,79,308,chair
9283,28,chair,28,0,7215,28,694,479,938,864,244,385,chair
9284,0,chair,1,0,7216,33,555,357,849,814,294,457,chair
9285,1,table,2,0,7216,46,78,362,727,809,649,447,dining table
9286,11,person,12,0,7216,15,640,286,759,544,119,258,person
9287,14,person,15,0,7216,18,406,147,482,380,76,233,person
9288,17,chair,18,1,7216,44,47,348,206,720,159,372,chair
9289,32,person,33,1,7216,110,475,232,675,664,200,432,person
9290,33,door,34,1,7216,42,567,85,706,363,139,278,door
9291,34,vase,35,0,7216,29,310,306,361,418,51,112,vase
9292,38,chair,39,0,7216,105,139,375,437,799,298,424,chair
9293,19,chair,20,1,7217,15,257,541,376,789,119,248,chair
9294,20,chair,21,1,7217,17,279,554,450,837,171,283,chair
9295,22,chair,23,1,7217,16,612,543,685,804,73,261,chair
9296,23,chair,24,0,7217,24,430,581,614,890,184,309,chair
9297,16,table,17,1,7218,17,404,1144,1071,1919,667,775,dining table
9298,23,window,24,0,7219,26,1900,3,2198,1299,298,1296,window
9299,25,mirror,26,0,7219,44,1539,443,1792,729,253,286,mirror
9300,26,mirror,27,0,7219,49,318,435,599,729,281,294,mirror
9301,31,chair,32,1,7219,43,1166,842,1422,1013,256,171,chair
9302,32,chair,33,0,7219,60,754,840,1031,1013,277,173,chair
9303,33,chair,34,1,7219,52,251,798,542,1225,291,427,chair
9304,34,chair,35,1,7219,76,173,893,664,1477,491,584,chair
9305,35,chair,36,1,7219,70,1576,895,2039,1477,463,582,chair
9306,42,plate,43,0,7219,15,1525,1067,1648,1110,123,43,plate
9307,44,chair,45,1,7219,29,1092,1035,1610,1474,518,439,chair
9308,45,table,46,1,7219,160,397,1008,1794,1477,1397,469,dining table
9309,49,plate,50,0,7219,17,798,1119,964,1175,166,56,plate
9310,50,plate,51,1,7219,31,770,1124,991,1200,221,76,plate
9311,56,plate,57,1,7219,15,798,659,889,749,91,90,plate
9312,23,plate,24,0,7220,24,907,491,996,578,89,87,plate
9313,26,plate,27,1,7220,20,717,487,799,564,82,77,plate
9314,34,chair,35,1,7220,23,745,711,909,844,164,133,chair
9315,35,chair,36,1,7220,47,822,766,1028,1288,206,522,chair
9316,36,chair,37,1,7220,55,635,817,986,1286,351,469,chair
9317,37,chair,38,1,7220,20,383,735,509,907,126,172,chair
9318,38,chair,39,1,7220,45,229,784,630,1288,401,504,chair
9319,39,chair,40,1,7220,49,256,920,737,1286,481,366,chair
9320,42,table,43,1,7220,47,356,829,948,1286,592,457,dining table
9321,45,vase,46,0,7220,15,376,290,423,366,47,76,vase
9322,46,vase,47,0,7220,18,447,282,494,366,47,84,vase
9323,48,vase,49,0,7220,15,345,285,381,363,36,78,vase
9324,13,window,14,0,7221,26,1675,367,2045,1362,370,995,window
9325,14,chair,15,1,7221,46,1425,922,1645,1109,220,187,chair
9326,15,chair,16,0,7221,26,1109,895,1312,1089,203,194,chair
9327,16,chair,17,1,7221,41,661,917,833,1313,172,396,chair
9328,17,chair,18,1,7221,47,506,960,809,1536,303,576,chair
9329,18,chair,19,1,7221,40,738,1041,1240,1536,502,495,chair
9330,19,chair,20,1,7221,47,1202,999,1628,1534,426,535,chair
9331,20,chair,21,1,7221,33,1607,975,1919,1534,312,559,chair
9332,21,table,22,0,7221,61,1026,1084,1668,1462,642,378,dining table
9333,11,chair,12,1,7222,19,254,1589,548,1809,294,220,chair
9334,13,chair,14,1,7222,18,1025,1713,1647,2196,622,483,chair
9335,14,chair,15,1,7222,17,430,1889,970,2197,540,308,chair
9336,15,table,16,1,7222,44,79,1768,1393,2200,1314,432,dining table
9337,20,window,21,0,7223,26,1472,148,2196,1050,724,902,window
9338,23,chair,24,1,7223,62,1018,541,1264,915,246,374,chair
9339,24,chair,25,1,7223,27,641,639,848,927,207,288,chair
9340,26,chair,27,1,7223,21,1334,708,1494,1008,160,300,chair
9341,27,chair,28,1,7223,26,1492,759,1709,1102,217,343,chair
9342,29,chair,30,1,7223,18,1774,1139,2096,1467,322,328,chair
9343,30,chair,31,1,7223,32,573,828,781,1467,208,639,chair
9344,31,chair,32,1,7223,24,700,904,975,1465,275,561,chair
9345,34,table,35,1,7223,46,677,871,1858,1462,1181,591,dining table
9346,11,table,12,0,7224,19,338,555,746,826,408,271,dining table
9347,12,chair,13,0,7224,36,474,533,712,885,238,352,chair
9348,13,chair,14,0,7224,25,204,520,461,826,257,306,chair
9349,18,chair,18,0,7224,21,699,491,841,807,142,316,chair
9350,24,flowerpot,24,0,7224,17,1156,615,1231,732,75,117,potted plant
9351,25,chair,25,1,7224,33,1210,501,1285,888,75,387,chair
9352,26,chair,26,0,7224,42,1265,532,1532,890,267,358,chair
9353,3,table,3,0,7225,17,260,1026,614,1317,354,291,dining table
9354,4,table,4,0,7225,23,562,1026,1732,1645,1170,619,dining table
9355,34,desk,34,0,7225,30,1236,867,1765,1214,529,347,desk
9356,40,door,41,0,7226,23,1112,536,1327,882,215,346,door
9357,42,chair,42,0,7226,90,847,836,1167,1380,320,544,chair
9358,43,chair,43,1,7226,84,1108,835,1465,1447,357,612,chair
9359,44,chair,44,1,7226,52,1285,826,1480,1345,195,519,chair
9360,46,table,46,1,7226,59,934,962,1703,1427,769,465,dining table
9361,49,sofa,49,1,7226,16,1861,1311,2201,1650,340,339,couch
9362,30,chair,31,1,7227,58,1133,499,1458,960,325,461,chair
9363,31,chair,32,0,7227,60,1017,542,1412,1090,395,548,chair
9364,39,chair,40,0,7227,52,527,581,905,1153,378,572,chair
9365,46,chair,47,1,7227,51,689,463,964,835,275,372,chair
9366,47,chair,48,1,7227,33,486,487,637,941,151,454,chair
9367,48,table,49,1,7227,72,785,564,1284,977,499,413,dining table
9368,49,chair,50,1,7227,17,1076,453,1230,573,154,120,chair
9369,51,chair,52,1,7227,50,883,426,1063,580,180,154,chair
9370,52,chair,53,1,7227,21,1466,452,1599,763,133,311,chair
9371,53,vase,54,0,7227,24,1316,389,1364,450,48,61,vase
9372,54,mirror,55,0,7227,33,1171,109,1401,424,230,315,mirror
9373,32,flowerpot,33,0,7228,16,378,788,522,888,144,100,potted plant
9374,40,bottle,41,0,7228,22,1634,598,1670,686,36,88,bottle
9375,41,coffee pot,42,0,7228,33,1348,600,1398,650,50,50,potted plant
9376,42,table,43,1,7228,77,751,695,1519,1414,768,719,dining table
9377,44,chair,45,1,7228,26,781,651,896,714,115,63,chair
9378,46,door,47,1,7228,50,872,388,1031,704,159,316,door
9379,47,mirror,48,0,7228,26,1347,340,1561,659,214,319,mirror
9380,48,chair,49,1,7228,18,1093,662,1191,743,98,81,chair
9381,49,chair,50,1,7228,25,1251,687,1394,793,143,106,chair
9382,50,chair,51,1,7228,46,1229,810,1579,1453,350,643,chair
9383,51,chair,52,0,7228,64,817,750,1116,1316,299,566,chair
9384,52,chair,53,1,7228,39,700,704,836,1124,136,420,chair
9385,56,plate,57,0,7228,18,802,736,896,767,94,31,plate
9386,57,plate,58,0,7228,18,933,794,1062,838,129,44,plate
9387,58,plate,59,0,7228,18,1291,834,1428,895,137,61,plate
9388,59,plate,60,0,7228,16,1196,752,1302,792,106,40,plate
9389,74,fork,75,0,7228,16,1268,868,1368,917,100,49,fork
9390,16,door,17,1,7229,43,1221,412,1536,1337,315,925,door
9391,21,chair,22,1,7229,46,776,851,1081,1089,305,238,chair
9392,22,chair,23,1,7229,39,968,905,1351,1409,383,504,chair
9393,23,chair,24,0,7229,93,924,944,1421,1879,497,935,chair
9394,25,chair,26,1,7229,19,312,874,458,1017,146,143,chair
9395,26,chair,27,1,7229,63,76,901,412,1730,336,829,chair
9396,28,table,29,1,7229,45,313,1084,1223,1366,910,282,dining table
9397,33,window,34,0,7229,16,48,281,213,1107,165,826,window
9398,17,window,18,1,7230,25,883,635,1195,979,312,344,window
9399,20,chair,21,1,7230,37,870,926,999,1076,129,150,chair
9400,22,chair,23,1,7230,38,1122,954,1337,1434,215,480,chair
9401,27,chair,28,1,7230,38,1064,981,1300,1518,236,537,chair
9402,32,chair,33,0,7230,135,1004,1014,1308,1628,304,614,chair
9403,39,chair,40,1,7230,28,452,954,515,1116,63,162,chair
9404,41,chair,42,1,7230,64,345,972,443,1466,98,494,chair
9405,44,chair,45,1,7230,131,212,998,413,1541,201,543,chair
9406,49,chair,50,0,7230,277,427,1082,795,1831,368,749,chair
9407,56,table,57,1,7230,120,387,1061,1114,1708,727,647,dining table
9408,62,plate,63,0,7230,21,775,1251,851,1273,76,22,plate
9409,64,plate,65,1,7230,16,675,1239,743,1262,68,23,plate
9410,65,plate,66,1,7230,21,673,1236,769,1270,96,34,plate
9411,91,bowl,92,0,7230,16,752,1138,791,1193,39,55,bowl
9412,95,bowl,96,0,7230,16,835,1121,875,1171,40,50,bowl
9413,11,window,12,0,7231,55,479,524,1127,1141,648,617,window
9414,15,chair,16,1,7231,22,261,848,378,1189,117,341,chair
9415,16,chair,17,1,7231,63,120,890,466,1803,346,913,chair
9416,17,chair,18,1,7231,32,648,813,855,1020,207,207,chair
9417,20,chair,21,1,7231,54,874,914,1258,1816,384,902,chair
9418,21,chair,22,1,7231,20,1090,865,1189,1228,99,363,chair
9419,22,table,23,1,7231,103,210,1011,1163,1930,953,919,dining table
9420,16,window,17,0,7232,39,1333,323,1624,1035,291,712,window
9421,18,window,19,0,7232,16,1660,288,1959,1135,299,847,window
9422,39,chair,40,1,7232,24,1313,878,1449,1029,136,151,chair
9423,40,chair,41,1,7232,16,1476,892,1637,1064,161,172,chair
9424,42,chair,43,1,7232,49,902,866,1091,1258,189,392,chair
9425,43,chair,44,1,7232,50,918,921,1170,1395,252,474,chair
9426,44,chair,45,0,7232,71,1130,957,1458,1484,328,527,chair
9427,45,table,46,1,7232,128,836,994,1746,1473,910,479,dining table
9428,14,chair,15,0,7233,25,358,542,595,899,237,357,chair
9429,20,chair,21,0,7233,22,309,512,529,797,220,285,chair
9430,20,chair,21,1,7234,26,916,1121,1099,1616,183,495,chair
9431,21,chair,22,1,7234,34,847,886,1000,1062,153,176,chair
9432,22,chair,23,1,7234,42,685,879,810,1033,125,154,chair
9433,23,chair,24,1,7234,70,228,876,410,1258,182,382,chair
9434,24,window,25,1,7234,17,240,313,362,555,122,242,window
9435,29,chair,30,1,7234,38,229,892,424,1416,195,524,chair
9436,30,chair,31,1,7234,76,378,906,734,1523,356,617,chair
9437,31,table,32,1,7234,51,195,994,1100,1551,905,557,dining table
9438,13,chair,14,1,7235,20,299,931,631,1529,332,598,chair
9439,14,chair,15,1,7235,21,42,881,358,1567,316,686,chair
9440,15,chair,16,1,7235,25,608,992,1062,1605,454,613,chair
9441,12,chair,13,1,7236,26,1133,732,1334,1017,201,285,chair
9442,13,chair,14,1,7236,15,898,769,1052,943,154,174,chair
9443,14,window,15,1,7236,44,725,480,990,911,265,431,window
9444,16,window,17,1,7236,75,1,326,627,948,626,622,window
9445,18,chair,19,1,7236,20,1305,824,1532,1061,227,237,chair
9446,19,chair,20,1,7236,21,332,754,540,886,208,132,chair
9447,20,chair,21,1,7236,42,208,805,483,1510,275,705,chair
9448,21,chair,22,1,7236,45,415,895,802,1536,387,641,chair
9449,22,chair,23,1,7236,31,1240,1038,1691,1536,451,498,chair
9450,23,table,24,1,7236,118,211,865,1411,1536,1200,671,dining table
9451,26,bowl,27,0,7236,30,734,872,884,1024,150,152,bowl
9452,1,table,2,0,7237,20,27,594,792,958,765,364,dining table
9453,20,chair,18,0,7237,19,271,500,432,638,161,138,chair
9454,21,chair,19,1,7237,19,128,529,287,704,159,175,chair
9455,22,chair,20,1,7237,16,0,561,182,736,182,175,chair
9456,23,chair,21,1,7237,17,2,728,383,959,381,231,chair
9457,24,chair,22,1,7237,23,761,529,898,793,137,264,chair
9458,25,chair,23,1,7237,27,737,551,988,840,251,289,chair
9459,26,chair,24,1,7237,27,591,607,1032,958,441,351,chair
9460,20,window,21,0,7238,38,827,98,996,218,169,120,window
9461,26,table,27,1,7238,131,560,641,1225,1117,665,476,dining table
9462,27,bowl,28,0,7238,15,1013,651,1088,700,75,49,bowl
9463,28,plate,29,1,7238,16,1007,683,1101,705,94,22,plate
9464,29,plate,30,1,7238,27,993,684,1121,718,128,34,plate
9465,30,bowl,31,0,7238,19,1038,721,1128,783,90,62,bowl
9466,31,plate,32,1,7238,19,1025,760,1140,792,115,32,plate
9467,32,plate,33,1,7238,31,1002,756,1164,801,162,45,plate
9468,37,bowl,38,0,7238,22,853,792,963,872,110,80,bowl
9469,38,plate,39,1,7238,25,836,843,975,884,139,41,plate
9470,39,plate,40,1,7238,34,805,839,1001,898,196,59,plate
9471,40,bowl,41,1,7238,19,857,609,926,648,69,39,bowl
9472,44,bowl,45,0,7238,16,676,653,750,703,74,50,bowl
9473,45,plate,46,1,7238,17,666,686,762,711,96,25,plate
9474,46,plate,47,1,7238,26,645,683,781,720,136,37,plate
9475,47,bowl,48,0,7238,17,646,726,738,790,92,64,bowl
9476,48,plate,49,1,7238,21,635,764,753,796,118,32,plate
9477,49,plate,50,1,7238,29,614,759,781,806,167,47,plate
9478,52,fork,53,0,7238,17,777,844,798,903,21,59,fork
9479,66,vase,67,0,7238,16,1754,983,1855,1154,101,171,vase
9480,17,chair,18,1,7239,31,873,509,1041,784,168,275,chair
9481,18,chair,19,1,7239,18,847,573,1041,761,194,188,chair
9482,19,chair,20,1,7239,17,381,555,575,691,194,136,chair
9483,20,chair,21,1,7239,28,62,630,322,981,260,351,chair
9484,21,chair,22,1,7239,58,20,693,551,1382,531,689,chair
9485,22,chair,23,0,7239,74,531,804,1132,1599,601,795,chair
9486,23,chair,24,1,7239,41,1017,626,1199,1268,182,642,chair
9487,24,table,25,1,7239,40,228,665,1198,1115,970,450,dining table
9488,7,mirror,8,0,7240,59,718,96,2166,1033,1448,937,mirror
9489,20,table,21,0,7240,22,312,1053,1444,1519,1132,466,dining table
9490,13,door,14,0,7241,23,1319,151,1602,1122,283,971,door
9491,14,door,15,0,7241,30,784,161,1047,974,263,813,door
9492,18,chair,19,1,7241,37,1316,787,1799,1615,483,828,chair
9493,20,chair,21,1,7241,29,544,795,909,1603,365,808,chair
9494,21,chair,22,0,7241,27,873,928,1366,1650,493,722,chair
9495,22,table,23,1,7241,24,665,904,1597,1650,932,746,dining table
9496,28,chair,29,1,7241,21,8,1351,589,1648,581,297,chair
9497,38,plate,39,0,7241,15,70,505,146,649,76,144,plate
9498,4,table,5,0,7242,26,481,1350,1358,1815,877,465,dining table
9499,9,chair,10,1,7242,20,457,1281,591,1551,134,270,chair
9500,10,chair,11,0,7242,21,392,1331,542,1822,150,491,chair
9501,18,chair,19,1,7242,20,1239,1293,1372,1576,133,283,chair
9502,20,chair,21,1,7242,29,1216,1363,1470,1879,254,516,chair
9503,26,chair,27,0,7242,33,893,1448,1255,2018,362,570,chair
9504,33,chair,34,0,7242,33,497,1409,893,1986,396,577,chair
9505,43,chair,44,1,7242,20,5,1446,197,2016,192,570,chair
9506,11,chair,12,0,7243,32,1031,1137,1288,1532,257,395,chair
9507,20,chair,21,1,7243,28,350,1259,659,1394,309,135,chair
9508,21,door,22,1,7243,18,294,657,643,1403,349,746,door
9509,24,chair,25,1,7243,36,1,1409,142,2197,141,788,chair
9510,25,chair,26,1,7243,25,465,1661,1044,2200,579,539,chair
9511,26,table,27,1,7243,103,43,1380,1216,2200,1173,820,dining table
9512,27,plate,28,0,7243,20,783,1465,999,1535,216,70,plate
9513,33,plate,34,1,7243,18,508,1361,642,1409,134,48,plate
9514,42,plate,43,0,7243,19,118,1500,350,1573,232,73,plate
9515,45,knife,46,0,7243,17,428,1722,472,1828,44,106,knife
9516,47,fork,48,0,7243,15,132,1593,314,1626,182,33,fork
9517,49,clock,50,0,7243,81,4,640,127,986,123,346,clock
9518,25,chair,26,1,7244,21,626,1065,872,1172,246,107,chair
9519,26,chair,27,1,7244,16,354,1093,461,1303,107,210,chair
9520,27,chair,28,1,7244,42,287,1135,547,1854,260,719,chair
9521,28,chair,29,1,7244,50,958,1146,1234,1890,276,744,chair
9522,34,chair,35,1,7244,89,516,1296,1009,2048,493,752,chair
9523,35,table,36,1,7244,53,371,1171,1171,1956,800,785,dining table
9524,41,flowerpot,42,0,7244,20,711,1158,824,1264,113,106,potted plant
9525,45,pot,46,0,7244,16,209,884,243,943,34,59,potted plant
9526,46,pot,47,0,7244,15,240,886,271,945,31,59,potted plant
9527,47,pot,48,0,7244,18,945,883,1016,950,71,67,potted plant
9528,48,window,49,0,7244,48,518,700,909,1171,391,471,window
9529,16,sofa,17,0,7245,43,49,656,1058,1199,1009,543,couch
9530,29,sofa,30,1,7245,17,1158,741,1600,1199,442,458,couch
9531,33,window,34,0,7245,30,601,130,826,587,225,457,window
9532,36,window,37,0,7245,54,102,119,457,552,355,433,window
9533,40,chair,41,1,7245,25,326,412,409,461,83,49,chair
9534,41,chair,42,1,7245,16,565,418,643,482,78,64,chair
9535,42,chair,43,1,7245,28,490,472,649,723,159,251,chair
9536,43,chair,44,0,7245,31,323,489,502,768,179,279,chair
9537,44,chair,45,1,7245,37,128,461,328,799,200,338,chair
9538,45,table,46,1,7245,41,151,445,680,780,529,335,dining table
9539,59,chair,60,1,7245,19,196,420,312,475,116,55,chair
9540,14,vase,15,0,7246,18,597,680,680,756,83,76,vase
9541,18,chair,19,0,7246,41,127,522,307,908,180,386,chair
9542,19,chair,20,1,7246,37,271,609,448,1153,177,544,chair
9543,20,chair,21,1,7246,25,720,562,761,704,41,142,chair
9544,21,chair,22,1,7246,56,687,616,980,1166,293,550,chair
9545,22,chair,23,1,7246,46,406,751,748,1242,342,491,chair
9546,23,table,24,1,7246,85,265,688,903,1241,638,553,dining table
9547,68,plate,69,0,7246,16,1360,786,1463,827,103,41,plate
9548,86,vase,87,0,7246,16,879,674,928,717,49,43,vase
9549,16,chair,13,0,7247,18,314,489,508,757,194,268,chair
9550,18,table,15,0,7247,16,0,609,103,722,103,113,dining table
9551,37,television,33,1,7247,15,875,448,1022,571,147,123,tv
9552,38,chair,34,1,7247,18,172,428,234,524,62,96,chair
9553,42,chair,38,1,7247,16,227,451,256,580,29,129,chair
9554,44,chair,40,1,7247,21,563,478,698,681,135,203,chair
9555,45,chair,41,1,7247,22,571,537,718,743,147,206,chair
9556,46,chair,42,1,7247,22,579,670,762,855,183,185,chair
9557,47,chair,43,1,7247,15,577,791,781,860,204,69,chair
9558,6,table,7,0,7248,34,266,698,1130,1253,864,555,dining table
9559,9,chair,10,1,7248,24,239,721,430,1173,191,452,chair
9560,10,chair,11,1,7248,32,309,796,516,1353,207,557,chair
9561,13,chair,14,0,7248,42,662,805,1167,1583,505,778,chair
9562,11,table,12,0,7249,33,400,777,848,1171,448,394,dining table
9563,12,chair,13,1,7249,20,406,696,603,942,197,246,chair
9564,13,chair,14,1,7249,21,817,707,928,1112,111,405,chair
9565,14,chair,15,1,7249,22,386,752,598,1195,212,443,chair
9566,15,chair,16,0,7249,33,582,735,887,1202,305,467,chair
9567,20,chair,21,1,7250,15,956,683,1238,924,282,241,chair
9568,21,chair,22,1,7250,15,3,915,542,1492,539,577,chair
9569,23,chair,24,1,7250,35,643,811,1141,1537,498,726,chair
9570,24,chair,25,1,7250,37,1039,750,1328,1539,289,789,chair
9571,5,chair,6,0,7251,40,607,971,1162,1649,555,678,chair
9572,6,chair,7,1,7251,25,839,912,1241,1344,402,432,chair
9573,7,chair,8,1,7251,21,1111,895,1459,1319,348,424,chair
9574,8,chair,9,0,7251,17,1775,908,2018,1138,243,230,chair
9575,9,chair,10,1,7251,34,1718,974,2093,1649,375,675,chair
9576,10,chair,11,0,7251,37,1198,993,1794,1649,596,656,chair
9577,11,table,12,1,7251,19,830,1008,1780,1419,950,411,dining table
9578,13,vase,14,0,7251,20,1288,1001,1529,1131,241,130,vase
9579,6,table,7,0,7252,58,133,464,638,885,505,421,dining table
9580,15,chair,16,1,7252,35,61,450,367,898,306,448,chair
9581,16,table,17,0,7253,37,104,117,202,213,98,96,dining table
9582,19,chair,20,0,7253,33,85,124,151,225,66,101,chair
9583,20,chair,21,1,7253,30,156,124,216,222,60,98,chair
9584,13,chair,14,1,7254,19,773,454,856,781,83,327,chair
9585,14,chair,15,1,7254,25,710,475,815,839,105,364,chair
9586,15,chair,16,1,7254,34,544,496,762,908,218,412,chair
9587,5,table,6,1,7255,40,236,419,605,743,369,324,dining table
9588,8,chair,9,1,7255,23,576,380,669,554,93,174,chair
9589,9,chair,10,0,7255,30,184,414,391,719,207,305,chair
9590,10,chair,11,0,7255,29,398,418,644,798,246,380,chair
9591,14,window,15,0,7255,17,425,84,618,205,193,121,window
9592,16,window,17,0,7255,18,100,213,360,543,260,330,window
9593,5,table,5,1,7256,31,2,984,827,1596,825,612,dining table
9594,8,chair,8,1,7256,16,781,872,1014,1311,233,439,chair
9595,9,chair,9,1,7256,24,560,939,1048,1598,488,659,chair
9596,10,chair,10,1,7256,17,2,1201,541,1600,539,399,chair
9597,24,mirror,24,1,7256,32,430,377,781,827,351,450,mirror
9598,25,plate,25,0,7256,18,637,724,809,904,172,180,plate
9599,10,table,11,0,20616,26,134,487,359,745,225,258,dining table
9600,11,chair,12,1,20616,25,341,502,410,691,69,189,chair
9601,12,chair,13,1,20616,29,68,506,151,692,83,186,chair
9602,9,table,10,1,20617,34,306,291,521,364,215,73,dining table
9603,10,chair,11,0,20617,43,451,282,584,477,133,195,chair
9604,11,chair,12,0,20617,37,336,284,458,493,122,209,chair
9605,12,chair,13,1,20617,34,281,275,346,427,65,152,chair
9606,14,bowl,15,0,20617,22,408,272,463,309,55,37,bowl
9607,16,window,17,0,20617,28,234,182,368,329,134,147,window
9608,22,bottle,23,0,20617,17,99,362,127,461,28,99,bottle
9609,23,bottle,24,0,20617,17,42,351,79,448,37,97,bottle
9610,25,chair,26,1,20617,19,468,272,575,353,107,81,chair
9611,30,table,31,0,20618,26,1068,973,1409,1435,341,462,dining table
9612,31,chair,32,1,20618,28,900,866,1185,1186,285,320,chair
9613,32,chair,33,0,20618,43,849,915,1190,1474,341,559,chair
9614,33,chair,34,1,20618,24,1248,845,1435,1132,187,287,chair
9615,34,chair,35,1,20618,34,1232,880,1496,1380,264,500,chair
9616,19,chair,20,1,20619,23,1227,583,1367,673,140,90,chair
9617,21,chair,22,1,20619,17,1640,656,1789,862,149,206,chair
9618,22,chair,23,1,20619,17,1481,705,1687,872,206,167,chair
9619,23,table,24,0,20619,32,1229,659,1670,824,441,165,dining table
9620,24,table,25,0,20619,57,886,810,1656,1489,770,679,dining table
9621,27,chair,28,1,20619,17,447,583,576,733,129,150,chair
9622,28,table,29,0,20619,42,569,598,1002,754,433,156,dining table
9623,29,chair,30,1,20619,38,454,634,667,1126,213,492,chair
9624,31,chair,32,1,20619,54,71,715,490,1282,419,567,chair
9625,33,table,34,0,20619,51,0,708,678,1082,678,374,dining table
9626,34,chair,35,1,20619,21,645,597,817,948,172,351,chair
9627,35,chair,36,1,20619,22,808,712,1005,940,197,228,chair
9628,36,chair,37,1,20619,40,1390,850,1802,1496,412,646,chair
9629,37,chair,38,1,20619,40,730,832,1107,1496,377,664,chair
9630,46,plate,47,0,20619,20,1157,856,1348,921,191,65,plate
9631,47,plate,48,0,20619,16,299,747,444,784,145,37,plate
9632,58,plant pot,59,0,20619,18,496,287,580,361,84,74,potted plant
9633,19,table,20,0,20620,45,775,645,1633,1274,858,629,dining table
9634,21,chair,22,0,20620,32,483,563,1003,1288,520,725,chair
9635,22,chair,23,1,20620,27,1573,527,1854,1194,281,667,chair
9636,23,chair,24,0,20620,39,1125,710,1620,1492,495,782,chair
9637,10,table,11,0,20621,40,1125,865,2117,1463,992,598,dining table
9638,11,chair,12,1,20621,22,1748,826,2035,1169,287,343,chair
9639,12,chair,13,1,20621,17,1035,825,1272,1363,237,538,chair
9640,13,chair,14,1,20621,44,1089,935,1635,1463,546,528,chair
9641,14,chair,15,1,20621,50,1672,911,2184,1463,512,552,chair
9642,17,chair,18,1,20621,34,549,729,862,1088,313,359,chair
9643,20,table,21,1,20621,34,132,768,819,1115,687,347,dining table
9644,21,table,22,1,20621,21,3,802,378,998,375,196,dining table
9645,22,chair,23,1,20621,32,53,743,377,1086,324,343,chair
9646,26,chair,27,1,20621,15,473,974,780,1463,307,489,chair
9647,28,table,29,1,20621,29,1,1035,749,1447,748,412,dining table
9648,14,plant pot,15,0,20622,20,1845,1226,2031,1411,186,185,potted plant
9649,20,window,21,0,20622,52,492,374,1257,980,765,606,window
9650,29,table,30,1,20622,70,794,897,1367,1395,573,498,dining table
9651,30,chair,31,1,20622,46,1274,845,1413,1280,139,435,chair
9652,31,chair,32,0,20622,55,987,910,1328,1482,341,572,chair
9653,32,chair,33,0,20622,33,704,848,957,1314,253,466,chair
9654,38,plate,39,0,20622,16,943,958,1029,989,86,31,plate
9655,39,plate,40,0,20622,16,874,979,970,1004,96,25,plate
9656,19,window,20,0,20623,16,1711,48,1966,832,255,784,window
9657,24,window,25,0,20623,23,284,48,753,831,469,783,window
9658,25,chair,26,1,20623,37,575,670,912,1208,337,538,chair
9659,27,mirror,28,0,20623,104,1081,286,1415,599,334,313,mirror
9660,29,table,30,0,20623,84,559,722,1559,1213,1000,491,dining table
9661,36,chair,37,0,20623,50,799,698,1256,1311,457,613,chair
9662,37,chair,38,0,20623,46,1265,679,1711,1288,446,609,chair
9663,5,window,6,0,20624,29,1285,294,1732,897,447,603,window
9664,8,vase,9,0,20624,29,1240,730,1349,947,109,217,vase
9665,11,chair,12,1,20624,25,1368,723,1612,914,244,191,chair
9666,12,chair,13,0,20624,54,1371,864,1941,1473,570,609,chair
9667,13,chair,14,0,20624,56,840,864,1376,1473,536,609,chair
9668,14,table,15,0,20624,59,1037,865,1691,1354,654,489,dining table
9669,17,chair,18,1,20624,15,830,715,990,885,160,170,chair
9670,13,chair,14,1,20625,15,1053,832,1176,948,123,116,chair
9671,14,chair,15,1,20625,35,576,818,725,1308,149,490,chair
9672,15,chair,16,1,20625,35,682,887,945,1460,263,573,chair
9673,16,chair,17,1,20625,45,1299,895,1566,1494,267,599,chair
9674,17,chair,18,1,20625,44,911,914,1215,1512,304,598,chair
9675,18,table,19,0,20625,90,532,911,1543,1535,1011,624,dining table
9676,23,mirror,24,0,20625,15,1622,414,1867,794,245,380,mirror
9677,12,plate,13,0,20626,16,764,294,850,385,86,91,plate
9678,13,plate,14,0,20626,15,852,254,968,367,116,113,plate
9679,14,plate,15,0,20626,17,968,208,1104,347,136,139,plate
9680,15,plate,16,0,20626,17,1111,182,1273,324,162,142,plate
9681,16,plate,17,0,20626,17,1277,123,1492,296,215,173,plate
9682,27,chair,28,1,20626,17,658,1154,873,1258,215,104,chair
9683,31,chair,32,1,20626,15,64,1136,309,1682,245,546,chair
9684,32,chair,33,1,20626,32,74,1240,483,1937,409,697,chair
9685,33,chair,34,1,20626,39,409,1339,926,2184,517,845,chair
9686,34,chair,35,0,20626,68,993,1390,1648,2198,655,808,chair
9687,35,table,36,0,20626,104,0,1177,1646,2182,1646,1005,dining table
9688,38,bowl,39,0,20626,25,632,1198,799,1328,167,130,bowl
9689,9,bed,10,1,20627,18,514,710,656,1098,142,388,bed
9690,13,bed,14,0,20627,17,1825,840,2091,1106,266,266,bed
9691,21,pot,21,0,20627,16,14,1081,137,1190,123,109,potted plant
9692,22,chair,22,1,20627,16,1000,1089,1305,1268,305,179,chair
9693,23,table,23,0,20627,21,35,1221,1437,1648,1402,427,dining table
9694,24,bowl,24,0,20627,17,603,1343,900,1503,297,160,bowl
9695,6,window,7,0,20628,17,1291,317,1818,845,527,528,window
9696,14,chair,14,1,20628,26,1500,999,1881,1650,381,651,chair
9697,15,chair,15,1,20628,41,467,1073,1038,1650,571,577,chair
9698,16,chair,16,1,20628,27,1015,1111,1542,1650,527,539,chair
9699,17,chair,17,1,20628,30,929,985,1179,1493,250,508,chair
9700,18,table,18,0,20628,61,624,1109,1887,1650,1263,541,dining table
9701,5,window,6,0,20629,100,710,195,1900,1202,1190,1007,window
9702,20,chair,21,1,20629,41,1188,767,1432,918,244,151,chair
9703,21,chair,22,1,20629,40,855,771,1086,913,231,142,chair
9704,22,chair,23,1,20629,27,389,802,540,980,151,178,chair
9705,25,bowl,26,1,20629,21,945,877,1142,952,197,75,bowl
9706,30,plate,31,0,20629,18,696,976,938,1029,242,53,plate
9707,32,table,33,1,20629,143,465,898,1707,1515,1242,617,dining table
9708,33,chair,34,0,20629,73,326,887,947,1648,621,761,chair
9709,34,chair,35,0,20629,66,962,898,1548,1648,586,750,chair
9710,35,chair,36,1,20629,55,1522,779,1838,1563,316,784,chair
9711,24,chair,24,1,20630,17,1281,913,1400,1138,119,225,chair
9712,25,chair,25,1,20630,43,1492,995,1846,1371,354,376,chair
9713,26,chair,26,1,20630,42,1640,914,1906,1385,266,471,chair
9714,27,chair,27,1,20630,33,1257,1086,1653,1338,396,252,chair
9715,28,table,28,1,20630,35,1316,1012,2032,1354,716,342,dining table
9716,29,chair,29,1,20630,27,1864,1246,2022,1422,158,176,chair
9717,32,chair,32,1,20630,33,552,819,831,1091,279,272,chair
9718,33,chair,33,1,20630,56,271,810,446,1293,175,483,chair
9719,34,table,34,0,20630,49,253,902,813,1277,560,375,dining table
9720,35,chair,35,1,20630,62,349,864,576,1375,227,511,chair
9721,36,chair,36,1,20630,49,706,868,939,1281,233,413,chair
9722,37,chair,37,1,20630,30,511,1063,782,1388,271,325,chair
9723,38,chair,38,1,20630,17,780,1305,1310,1523,530,218,chair
9724,39,table,39,1,20630,33,538,1218,1964,1523,1426,305,dining table
9725,41,plate,41,1,20630,16,910,1223,1066,1281,156,58,plate
9726,44,plate,44,0,20630,18,656,1330,810,1388,154,58,plate
9727,49,plate,49,1,20630,18,1508,1334,1708,1409,200,75,plate
9728,52,plate,52,1,20630,20,1732,1386,1903,1458,171,72,plate
9729,58,fork,58,1,20630,15,1431,1334,1536,1386,105,52,fork
9730,28,vase,29,0,20631,32,645,598,699,751,54,153,vase
9731,31,table,32,1,20631,121,895,765,1417,1040,522,275,dining table
9732,32,chair,33,1,20631,36,1085,707,1202,888,117,181,chair
9733,33,chair,34,0,20631,62,1277,714,1493,1022,216,308,chair
9734,34,chair,35,0,20631,41,1074,750,1249,1072,175,322,chair
9735,35,chair,36,0,20631,45,837,727,1042,1031,205,304,chair
9736,37,vase,38,1,20631,19,1455,783,1511,879,56,96,vase
9737,38,vase,39,0,20631,22,1458,655,1506,727,48,72,vase
9738,3,door,4,0,20632,20,1047,169,1220,914,173,745,door
9739,14,vase,15,0,20632,17,1190,443,1236,548,46,105,vase
9740,17,window,18,0,20632,41,190,98,543,757,353,659,window
9741,20,chair,21,1,20632,21,402,661,544,751,142,90,chair
9742,21,chair,22,1,20632,28,840,687,963,1128,123,441,chair
9743,22,chair,23,1,20632,36,227,716,453,1199,226,483,chair
9744,23,chair,24,1,20632,34,555,777,848,1199,293,422,chair
9745,24,table,25,1,20632,92,311,731,906,1198,595,467,dining table
9746,30,plate,31,0,20632,20,352,778,484,810,132,32,plate
9747,8,window,9,0,20633,37,1108,313,1940,1178,832,865,window
9748,9,chair,10,1,20633,25,786,945,1226,1431,440,486,chair
9749,10,chair,11,1,20633,45,1536,948,1818,1595,282,647,chair
9750,11,table,12,1,20633,64,684,1106,1790,1650,1106,544,dining table
9751,12,chair,13,1,20633,47,489,1015,1090,1650,601,635,chair
9752,13,chair,14,1,20633,34,1039,1043,1606,1650,567,607,chair
9753,17,table,18,0,20633,15,2,1073,327,1627,325,554,dining table
9754,3,refrigerator,4,1,20634,16,759,40,881,240,122,200,refrigerator
9755,4,door,5,0,20634,19,891,0,1011,267,120,267,door
9756,6,window,7,0,20634,21,116,1,250,271,134,270,window
9757,9,chair,9,1,20634,22,651,194,768,309,117,115,chair
9758,10,chair,10,1,20634,21,449,197,576,303,127,106,chair
9759,21,chair,21,1,20634,33,436,204,564,309,128,105,chair
9760,22,chair,22,1,20634,35,596,198,735,310,139,112,chair
9761,23,chair,23,1,20634,47,184,231,452,501,268,270,chair
9762,24,chair,24,1,20634,82,198,286,494,760,296,474,chair
9763,25,chair,25,1,20634,91,463,288,731,768,268,480,chair
9764,26,chair,26,1,20634,43,690,222,903,650,213,428,chair
9765,27,table,27,0,20634,112,175,305,801,751,626,446,dining table
9766,8,table,9,0,20635,42,96,144,227,225,131,81,dining table
9767,10,chair,11,1,20635,18,96,129,130,158,34,29,chair
9768,11,chair,12,1,20635,38,154,114,184,145,30,31,chair
9769,12,chair,13,1,20635,18,168,132,196,153,28,21,chair
9770,13,chair,14,1,20635,19,199,139,232,174,33,35,chair
9771,14,chair,15,1,20635,26,79,145,108,225,29,80,chair
9772,15,chair,16,1,20635,21,100,160,131,225,31,65,chair
9773,16,chair,17,1,20635,35,173,172,257,225,84,53,chair
9774,4,sofa,5,1,20636,17,1452,947,1598,1199,146,252,couch
9775,6,window,7,0,20636,30,1068,205,1256,761,188,556,window
9776,10,chair,11,1,20636,27,578,583,722,831,144,248,chair
9777,11,chair,12,1,20636,30,417,588,576,940,159,352,chair
9778,12,chair,13,1,20636,51,179,616,424,1060,245,444,chair
9779,13,chair,14,1,20636,42,854,589,1027,979,173,390,chair
9780,14,chair,15,0,20636,34,640,630,888,1069,248,439,chair
9781,15,chair,16,0,20636,32,435,640,659,1083,224,443,chair
9782,16,table,17,1,20636,77,265,666,952,1038,687,372,dining table
9783,18,chair,19,1,20636,35,1,765,369,1200,368,435,chair
9784,3,chair,4,1,20637,19,268,110,302,206,34,96,chair
9785,5,chair,6,1,20637,18,7,114,47,210,40,96,chair
9786,6,chair,7,0,20637,24,62,162,143,239,81,77,chair
9787,7,chair,8,1,20637,24,175,161,249,240,74,79,chair
9788,8,table,9,0,20637,52,28,106,291,199,263,93,dining table
9789,22,sofa,23,0,20638,49,896,683,1388,939,492,256,couch
9790,26,chair,27,1,20638,16,1762,973,2028,1169,266,196,chair
9791,27,table,28,0,20638,51,915,961,2090,1650,1175,689,dining table
9792,28,table,29,0,20639,23,112,890,1789,1341,1677,451,dining table
9793,29,chair,30,1,20639,19,26,964,388,1341,362,377,chair
9794,20,vase,21,0,20640,31,1136,836,1275,969,139,133,vase
9795,24,plate,25,0,20640,18,1153,987,1261,1018,108,31,plate
9796,25,plate,26,1,20640,21,1128,987,1261,1030,133,43,plate
9797,28,plate,29,0,20640,22,760,984,885,1018,125,34,plate
9798,29,plate,30,1,20640,24,739,987,910,1032,171,45,plate
9799,32,plate,33,0,20640,21,873,918,974,947,101,29,plate
9800,33,plate,34,1,20640,21,850,925,995,958,145,33,plate
9801,35,chair,36,1,20640,28,960,768,1147,920,187,152,chair
9802,36,chair,37,1,20640,57,701,785,946,1424,245,639,chair
9803,37,chair,38,0,20640,78,513,875,1070,1586,557,711,chair
9804,38,chair,39,1,20640,58,1029,884,1506,1550,477,666,chair
9805,39,chair,40,1,20640,47,1393,848,1715,1431,322,583,chair
9806,40,chair,41,1,20640,40,1443,766,1681,1312,238,546,chair
9807,41,table,42,1,20640,97,552,870,1732,1624,1180,754,dining table
9808,20,bench,21,0,20641,33,168,480,529,736,361,256,bench
9809,26,chair,27,1,20641,19,999,471,1057,564,58,93,chair
9810,27,chair,28,1,20641,28,971,487,1064,580,93,93,chair
9811,28,table,29,0,20641,17,982,482,1088,581,106,99,dining table
9812,30,table,31,1,20641,16,863,593,1085,666,222,73,dining table
9813,31,chair,32,1,20641,18,798,570,878,669,80,99,chair
9814,32,chair,33,1,20641,60,930,677,1167,1025,237,348,chair
9815,33,chair,34,1,20641,53,844,724,1125,1025,281,301,chair
9816,34,chair,35,1,20641,24,674,641,800,736,126,95,chair
9817,35,chair,36,1,20641,30,575,698,709,1025,134,327,chair
9818,36,table,37,1,20641,21,740,664,1069,758,329,94,dining table
9819,37,table,38,1,20641,30,612,726,1025,878,413,152,dining table
9820,38,table,39,0,20641,71,286,541,590,837,304,296,dining table
9821,39,chair,40,1,20641,47,371,564,549,842,178,278,chair
9822,40,chair,41,1,20641,40,534,539,626,753,92,214,chair
9823,43,chair,44,1,20641,37,623,494,732,669,109,175,chair
9824,48,chair,49,1,20641,32,618,819,924,1025,306,206,chair
9825,30,bowl,31,0,20642,36,709,1419,973,1667,264,248,bowl
9826,32,chair,33,1,20642,25,885,1187,1209,1522,324,335,chair
9827,33,chair,34,1,20642,20,1258,1203,1631,1575,373,372,chair
9828,34,table,35,0,20642,61,101,1499,1727,1963,1626,464,dining table
9829,35,chair,36,1,20642,28,1381,1326,2195,1976,814,650,chair
9830,12,table,13,0,20643,78,384,805,1441,1455,1057,650,dining table
9831,15,mirror,16,0,20643,55,1247,270,1423,682,176,412,mirror
9832,25,chair,26,1,20643,20,375,708,505,839,130,131,chair
9833,28,chair,29,1,20643,15,1074,830,1222,989,148,159,chair
9834,29,chair,30,1,20643,22,369,799,498,1224,129,425,chair
9835,30,chair,31,1,20643,29,444,852,606,1350,162,498,chair
9836,31,chair,32,1,20643,29,542,923,744,1455,202,532,chair
9837,32,window,33,0,20643,34,133,273,771,390,638,117,window
9838,33,chair,34,0,20643,46,89,722,304,1075,215,353,chair
9839,34,chair,35,0,20643,41,1430,801,1722,1271,292,470,chair
9840,35,chair,36,0,20643,44,1631,839,1981,1372,350,533,chair
9841,42,chair,43,1,20643,17,19,1015,94,1282,75,267,chair
9842,9,door,10,0,20644,24,822,1,971,710,149,709,door
9843,10,door,11,0,20644,25,1251,3,1420,542,169,539,door
9844,11,table,12,0,20644,64,982,515,1584,1035,602,520,dining table
9845,12,chair,13,1,20644,29,1009,435,1302,734,293,299,chair
9846,13,chair,14,1,20644,98,822,506,1187,1022,365,516,chair
9847,14,chair,15,0,20644,69,1190,566,1600,1099,410,533,chair
9848,15,chair,16,1,20644,30,1312,449,1600,850,288,401,chair
9849,20,plant pot,21,0,20644,15,269,686,392,856,123,170,potted plant
9850,18,chair,19,1,20645,17,842,707,906,978,64,271,chair
9851,19,chair,20,1,20645,17,1179,690,1240,920,61,230,chair
9852,20,chair,21,1,20645,20,1139,726,1207,988,68,262,chair
9853,21,chair,22,1,20645,29,995,760,1175,1040,180,280,chair
9854,22,chair,23,0,20645,34,863,793,1040,1075,177,282,chair
9855,23,table,24,0,20645,26,823,694,1206,898,383,204,dining table
9856,14,bed,15,1,20646,45,0,57,567,339,567,282,bed
9857,22,door,23,0,20646,23,787,428,1513,1202,726,774,door
9858,39,sofa,40,0,20646,22,1376,1021,2044,1536,668,515,couch
9859,41,chair,42,1,20646,38,1143,876,1308,1259,165,383,chair
9860,42,chair,43,0,20646,49,762,893,959,1357,197,464,chair
9861,43,chair,44,1,20646,57,899,901,1235,1442,336,541,chair
9862,44,chair,45,0,20646,48,1244,881,1520,1385,276,504,chair
9863,45,chair,46,0,20646,45,586,886,819,1272,233,386,chair
9864,46,chair,47,1,20646,64,852,966,1396,1396,544,430,chair
9865,7,chair,8,1,20647,22,392,652,612,806,220,154,chair
9866,8,chair,9,1,20647,25,285,723,688,1199,403,476,chair
9867,9,chair,10,1,20647,21,998,636,1219,776,221,140,chair
9868,10,chair,11,1,20647,20,968,724,1257,1200,289,476,chair
9869,11,table,12,0,20647,44,193,756,1339,1200,1146,444,dining table
9870,17,window,18,0,20647,16,1177,95,1483,743,306,648,window
9871,20,vase,21,0,20647,17,736,705,793,822,57,117,vase
9872,10,door,11,0,20648,16,1,0,1600,1200,1599,1200,door
9873,16,chair,17,1,20648,16,645,462,711,615,66,153,chair
9874,19,chair,20,0,20648,30,831,476,1060,977,229,501,chair
9875,20,chair,21,1,20648,32,688,462,906,968,218,506,chair
9876,21,chair,22,0,20648,27,557,506,844,1013,287,507,chair
9877,22,chair,23,1,20648,28,356,506,583,984,227,478,chair
9878,23,chair,24,1,20648,20,288,481,388,895,100,414,chair
9879,24,table,25,1,20648,19,209,601,1074,723,865,122,dining table
9880,17,chair,18,0,20649,32,795,784,1008,1024,213,240,chair
9881,22,chair,23,1,20649,26,1020,903,1186,1186,166,283,chair
9882,23,chair,24,1,20649,18,1248,868,1400,1127,152,259,chair
9883,24,chair,25,1,20649,42,1254,912,1445,1193,191,281,chair
9884,5,chair,6,1,20650,18,490,456,741,698,251,242,chair
9885,7,chair,8,1,20650,28,871,477,1134,699,263,222,chair
9886,8,chair,9,0,20650,48,823,563,1143,988,320,425,chair
9887,9,chair,10,1,20650,42,482,555,797,996,315,441,chair
9888,10,chair,11,0,20650,51,399,526,683,895,284,369,chair
9889,15,table,16,0,20650,33,468,495,1089,964,621,469,dining table
9890,16,vase,17,0,20650,21,689,441,785,562,96,121,vase
9891,28,chair,29,1,20651,16,994,784,1166,975,172,191,chair
9892,29,chair,30,0,20651,29,629,819,890,1480,261,661,chair
9893,30,chair,31,1,20651,27,1529,824,1867,1471,338,647,chair
9894,31,chair,32,1,20651,42,1302,873,1844,1646,542,773,chair
9895,32,chair,33,0,20651,36,676,960,1321,1649,645,689,chair
9896,33,table,34,0,20651,23,742,875,1734,1649,992,774,dining table
9897,38,plant pot,39,0,20651,15,1280,952,1397,1020,117,68,potted plant
9898,16,refrigerator,17,0,20652,24,726,480,1176,1054,450,574,refrigerator
9899,34,chair,33,1,20652,33,1476,931,1941,1467,465,536,chair
9900,35,chair,34,1,20652,17,1561,989,1803,1467,242,478,chair
9901,36,chair,35,1,20652,20,501,1047,1191,1466,690,419,chair
9902,37,table,36,1,20652,34,350,950,1769,1464,1419,514,dining table
9903,40,plate,39,0,20652,17,1235,979,1556,1060,321,81,plate
9904,41,plate,40,0,20652,22,1017,1039,1406,1147,389,108,plate
9905,16,window,17,0,20653,69,486,303,1024,1060,538,757,window
9906,22,table,23,0,20653,30,170,1230,1421,2000,1251,770,dining table
9907,25,chair,26,1,20653,26,1241,1025,1496,1343,255,318,chair
9908,26,chair,27,1,20653,17,1084,1181,1249,1475,165,294,chair
9909,27,chair,28,1,20653,16,1166,1294,1413,1708,247,414,chair
9910,28,chair,29,1,20653,32,7,1022,269,1498,262,476,chair
9911,29,chair,30,1,20653,16,226,1169,404,1535,178,366,chair
9912,30,chair,31,1,20653,16,102,1302,322,1760,220,458,chair
9913,33,plate,34,0,20653,15,676,1226,792,1262,116,36,plate
9914,34,plate,35,1,20653,26,659,1231,805,1268,146,37,plate
9915,41,plate,42,0,20653,16,420,1325,558,1374,138,49,plate
9916,42,plate,43,1,20653,25,403,1330,580,1387,177,57,plate
9917,43,plate,44,1,20653,15,942,1324,1063,1369,121,45,plate
9918,44,plate,45,0,20653,24,933,1329,1082,1378,149,49,plate
9919,47,plate,48,0,20653,20,984,1473,1152,1551,168,78,plate
9920,48,plate,49,0,20653,17,357,1506,532,1589,175,83,plate
9921,49,plate,50,1,20653,35,331,1506,560,1607,229,101,plate
9922,50,plate,51,1,20653,16,674,1723,897,1795,223,72,plate
9923,51,plate,52,1,20653,27,643,1708,928,1787,285,79,plate
9924,61,fork,62,0,20653,16,1048,1586,1183,1603,135,17,fork
9925,66,fork,67,0,20653,16,680,1656,807,1687,127,31,fork
9926,67,spoon,68,0,20653,16,729,1662,848,1691,119,29,spoon
9927,73,knife,74,0,20653,15,410,1393,563,1406,153,13,knife
9928,75,fork,76,0,20653,16,372,1485,506,1509,134,24,fork
9929,76,fork,77,0,20653,19,642,1520,668,1595,26,75,fork
9930,77,knife,78,0,20653,17,315,1617,519,1633,204,16,knife
9931,78,spoon,79,0,20653,17,310,1628,466,1650,156,22,spoon
9932,83,chair,84,1,20653,19,404,1751,1109,1999,705,248,chair
9933,9,chair,10,1,20654,28,3,927,225,1223,222,296,chair
9934,10,chair,11,1,20654,24,1081,535,1264,605,183,70,chair
9935,11,plate,12,0,20654,19,1459,186,1564,289,105,103,plate
9936,17,chair,18,1,20654,24,563,495,725,790,162,295,chair
9937,18,chair,19,1,20654,18,710,563,810,748,100,185,chair
9938,20,chair,21,1,20654,26,1302,644,1577,1223,275,579,chair
9939,23,table,24,0,20654,69,452,632,1578,1223,1126,591,dining table
9940,42,spoon,43,0,20654,16,1180,890,1208,946,28,56,spoon
9941,44,spoon,45,0,20654,15,696,796,805,812,109,16,spoon
9942,47,plate,48,0,20654,15,422,128,489,224,67,96,plate
9943,48,plate,49,0,20654,16,417,223,500,340,83,117,plate
9944,49,plate,50,0,20654,15,279,101,341,213,62,112,plate
9945,50,plate,51,0,20654,16,197,75,274,206,77,131,plate
9946,51,plate,52,0,20654,17,114,65,195,196,81,131,plate
9947,53,plate,54,1,20654,16,677,118,724,163,47,45,plate
9948,73,plate,74,0,20654,19,114,585,190,613,76,28,plate
9949,20,table,21,0,20655,20,860,825,1390,1200,530,375,dining table
9950,23,mirror,24,0,20655,54,972,202,1253,456,281,254,mirror
9951,24,plate,25,0,20655,15,1247,728,1335,822,88,94,plate
9952,25,plate,26,1,20655,16,926,728,1003,821,77,93,plate
9953,28,plate,29,1,20655,17,1184,828,1263,851,79,23,plate
9954,34,chair,35,1,20655,27,600,677,712,1018,112,341,chair
9955,35,chair,36,0,20655,57,395,703,624,1130,229,427,chair
9956,36,chair,37,0,20655,51,38,700,247,1086,209,386,chair
9957,37,chair,38,1,20655,35,181,675,361,1004,180,329,chair
9958,38,table,39,0,20655,129,135,749,471,1079,336,330,dining table
9959,25,window,26,0,20656,16,406,277,582,756,176,479,window
9960,27,plant pot,28,0,20656,17,366,858,475,957,109,99,potted plant
9961,38,bench,39,1,20656,15,928,851,1063,1136,135,285,bench
9962,40,chair,41,1,20656,35,444,678,688,1107,244,429,chair
9963,41,chair,42,1,20656,27,664,697,940,1200,276,503,chair
9964,42,table,43,1,20656,20,526,723,1023,1190,497,467,dining table
9965,12,mirror,13,0,20657,19,217,523,563,800,346,277,mirror
9966,14,chair,15,1,20657,22,554,862,811,1174,257,312,chair
9967,15,chair,16,1,20657,32,774,819,903,952,129,133,chair
9968,16,chair,17,1,20657,37,826,874,1181,1307,355,433,chair
9969,17,chair,18,1,20657,33,1017,939,1358,1535,341,596,chair
9970,18,chair,19,0,20657,53,523,909,896,1467,373,558,chair
9971,19,vase,20,0,20657,17,880,924,920,1011,40,87,vase
9972,24,table,25,0,20657,68,450,941,1422,1530,972,589,dining table
9973,26,bottle,27,0,20657,38,221,721,305,888,84,167,bottle
9974,30,sofa,31,1,20657,18,0,1251,297,1535,297,284,couch
9975,30,table,31,1,20658,27,1,877,257,1040,256,163,dining table
9976,31,table,32,1,20658,35,383,816,805,979,422,163,dining table
9977,32,table,33,0,20658,22,1396,804,1511,942,115,138,dining table
9978,34,table,35,1,20658,40,1211,788,1406,833,195,45,dining table
9979,35,chair,36,0,20658,25,1312,792,1379,890,67,98,chair
9980,36,chair,37,0,20658,26,1245,789,1313,886,68,97,chair
9981,37,table,38,1,20658,39,945,811,1215,862,270,51,dining table
9982,41,chair,42,1,20658,19,1192,809,1247,937,55,128,chair
9983,42,chair,43,1,20658,17,1106,810,1167,886,61,76,chair
9984,49,table,50,1,20658,35,853,784,1058,828,205,44,dining table
9985,60,chair,61,1,20658,15,713,831,759,924,46,93,chair
9986,63,chair,64,1,20658,21,1091,854,1196,1044,105,190,chair
9987,64,table,65,1,20658,45,777,861,1131,943,354,82,dining table
9988,65,chair,66,1,20658,26,917,864,1037,1023,120,159,chair
9989,66,chair,67,1,20658,25,992,935,1137,1046,145,111,chair
9990,67,chair,68,1,20658,20,1310,982,1476,1225,166,243,chair
9991,68,chair,69,1,20658,23,365,967,514,1098,149,131,chair
9992,69,chair,70,1,20658,29,2,1055,255,1481,253,426,chair
9993,70,chair,71,1,20658,22,0,894,91,1036,91,142,chair
9994,71,chair,72,1,20658,21,99,943,205,1231,106,288,chair
9995,72,chair,73,1,20658,23,80,907,200,1077,120,170,chair
9996,73,table,74,1,20658,18,1,944,88,1094,87,150,dining table
9997,76,chair,77,1,20658,17,1,1249,324,1520,323,271,chair
9998,78,table,79,0,20658,58,213,1018,1492,1522,1279,504,dining table
9999,90,fork,91,0,20658,16,1074,1288,1223,1386,149,98,fork
10000,103,spoon,104,0,20658,18,875,1334,918,1434,43,100,spoon
10001,105,plate,106,0,20658,17,674,1315,839,1428,165,113,plate
10002,114,cake,115,0,20658,31,716,748,755,804,39,56,cake
10003,9,chair,10,1,20659,24,1183,608,1328,739,145,131,chair
10004,10,chair,11,1,20659,50,1231,656,1512,1267,281,611,chair
10005,13,chair,12,1,20659,27,661,656,800,1194,139,538,chair
10006,14,chair,13,1,20659,19,555,583,682,831,127,248,chair
10007,18,table,17,1,20659,109,518,736,1520,1406,1002,670,dining table
10008,19,chair,18,0,20659,56,717,743,1126,1406,409,663,chair
10009,15,window,16,0,20660,36,835,118,1093,539,258,421,window
10010,16,window,17,0,20660,46,324,122,581,539,257,417,window
10011,17,chair,18,1,20660,17,663,403,763,440,100,37,chair
10012,18,chair,19,1,20660,42,760,408,950,785,190,377,chair
10013,19,chair,20,1,20660,58,764,412,1016,865,252,453,chair
10014,21,chair,22,1,20660,35,441,409,636,642,195,233,chair
10015,22,chair,23,1,20660,51,364,417,634,857,270,440,chair
10016,32,bottle,33,1,20660,17,37,403,82,480,45,77,bottle
10017,13,chair,14,1,20661,19,1851,1211,2199,1650,348,439,chair
10018,14,chair,15,0,20661,56,1475,768,1835,1374,360,606,chair
10019,15,chair,16,1,20661,32,919,784,1160,932,241,148,chair
10020,16,chair,17,1,20661,49,589,872,875,1596,286,724,chair
10021,17,chair,18,1,20661,40,833,1015,1263,1650,430,635,chair
10022,18,chair,19,1,20661,41,1239,866,1492,1588,253,722,chair
10023,19,table,20,0,20661,31,621,929,1473,1650,852,721,dining table
10024,22,plate,23,0,20661,17,1152,976,1333,1031,181,55,plate
10025,15,window,16,0,20662,39,1111,274,1398,912,287,638,window
10026,16,chair,17,1,20662,15,1105,815,1338,910,233,95,chair
10027,17,chair,18,1,20662,33,784,880,970,1402,186,522,chair
10028,19,chair,19,1,20662,39,931,1056,1338,1644,407,588,chair
10029,20,chair,20,1,20662,34,1295,927,1612,1531,317,604,chair
10030,21,table,21,0,20662,91,838,904,1526,1571,688,667,dining table
10031,11,table,12,0,20663,17,1973,563,2199,751,226,188,dining table
10032,12,table,13,0,20663,26,1613,518,1854,711,241,193,dining table
10033,13,chair,14,1,20663,27,1749,482,1915,728,166,246,chair
10034,22,vase,23,0,20663,23,1268,492,1385,582,117,90,vase
10035,24,table,25,0,20663,48,1152,573,1615,714,463,141,dining table
10036,28,chair,29,1,20663,31,1327,600,1559,715,232,115,chair
10037,29,table,30,1,20663,38,1064,702,1852,841,788,139,dining table
10038,32,chair,33,1,20663,58,1602,648,1993,1230,391,582,chair
10039,33,chair,34,1,20663,37,1230,712,1607,1048,377,336,chair
10040,34,chair,35,1,20663,17,965,770,1197,840,232,70,chair
10041,37,vase,38,1,20663,15,771,473,881,550,110,77,vase
10042,38,chair,39,1,20663,22,634,491,773,546,139,55,chair
10043,39,chair,40,1,20663,45,757,505,965,818,208,313,chair
10044,40,chair,41,1,20663,48,802,834,1247,990,445,156,chair
10045,41,table,42,1,20663,16,397,498,645,600,248,102,dining table
10046,48,chair,49,1,20663,20,505,541,693,616,188,75,chair
10047,51,table,52,0,20663,39,678,543,916,754,238,211,dining table
10048,52,table,53,0,20663,68,241,608,802,958,561,350,dining table
10049,58,chair,59,0,20663,79,303,589,623,1040,320,451,chair
10050,59,chair,60,0,20663,17,149,551,260,801,111,250,chair
10051,60,chair,61,1,20663,24,30,479,198,662,168,183,chair
10052,63,chair,64,1,20663,15,2,659,248,801,246,142,chair
10053,64,table,65,0,20663,37,0,795,370,1315,370,520,dining table
10054,66,plate,67,0,20663,18,87,806,211,840,124,34,plate
10055,72,plate,73,0,20663,15,980,982,1083,1036,103,54,plate
10056,78,spoon,79,0,20663,15,1495,1095,1667,1118,172,23,spoon
10057,80,fork,81,0,20663,18,1434,1241,1716,1302,282,61,fork
10058,83,table,84,0,20663,40,68,986,1838,1390,1770,404,dining table
10059,86,plate,87,0,20663,21,394,1158,618,1239,224,81,plate
10060,87,fork,88,0,20663,19,331,1251,554,1367,223,116,fork
10061,90,fork,91,0,20663,16,388,1059,593,1083,205,24,fork
10062,7,chair,8,1,20664,20,1349,1005,1748,1243,399,238,chair
10063,8,chair,9,1,20664,16,880,924,1145,1161,265,237,chair
10064,15,table,16,0,20664,27,0,1078,2025,1536,2025,458,dining table
10065,17,bowl,18,0,20664,19,1723,738,1943,865,220,127,bowl
10066,22,bottle,23,0,20664,15,857,423,924,562,67,139,bottle
10067,7,table,8,0,20665,41,411,1227,1220,2037,809,810,dining table
10068,9,chair,10,1,20665,20,310,1122,672,1559,362,437,chair
10069,10,chair,11,1,20665,27,254,1162,679,1990,425,828,chair
10070,12,chair,13,1,20665,24,1076,1138,1283,1941,207,803,chair
10071,13,chair,14,0,20665,46,602,1271,1092,2200,490,929,chair
10072,10,chair,11,1,20666,24,952,1104,1139,1589,187,485,chair
10073,11,chair,12,1,20666,27,381,1139,567,1826,186,687,chair
10074,12,chair,13,1,20666,34,546,1286,1010,2160,464,874,chair
10075,13,chair,14,0,20666,41,982,1223,1453,1997,471,774,chair
10076,14,table,15,0,20666,30,509,1253,1295,1645,786,392,dining table
10077,7,chair,8,1,20667,19,713,805,943,1007,230,202,chair
10078,8,chair,9,1,20667,25,404,819,655,1044,251,225,chair
10079,9,table,10,1,20667,46,239,997,1391,1536,1152,539,dining table
10080,10,chair,11,1,20667,29,1256,909,1705,1536,449,627,chair
10081,11,chair,12,0,20667,29,696,933,1332,1536,636,603,chair
10082,12,chair,13,1,20667,29,138,1178,551,1536,413,358,chair
10083,8,chair,8,1,20668,18,8,99,85,223,77,124,chair
10084,9,chair,9,1,20668,21,29,103,117,225,88,122,chair
10085,11,chair,11,0,20668,22,105,106,199,225,94,119,chair
10086,12,table,12,1,20668,16,52,108,200,225,148,117,dining table
10087,12,chair,13,0,20669,52,1544,1009,1918,1764,374,755,chair
10088,13,chair,14,1,20669,55,19,1001,442,1774,423,773,chair
10089,14,chair,15,1,20669,45,613,1121,1036,1774,423,653,chair
10090,15,chair,16,1,20669,67,1059,1116,1539,1774,480,658,chair
10091,16,table,17,0,20669,118,296,1073,1674,1774,1378,701,dining table
10092,10,plate,11,0,20670,15,1238,285,1336,387,98,102,plate
10093,13,vase,14,0,20670,43,858,650,1005,870,147,220,vase
10094,20,chair,21,0,20670,80,1162,669,1557,1199,395,530,chair
10095,22,table,23,0,20670,89,320,790,1440,1199,1120,409,dining table
10096,23,chair,24,0,20670,57,162,675,546,1199,384,524,chair
10097,30,plate,31,1,20670,26,663,506,779,619,116,113,plate
10098,7,chair,8,1,20671,15,132,925,268,1184,136,259,chair
10099,8,chair,9,1,20671,16,7,940,192,1174,185,234,chair
10100,12,plate,13,0,20671,17,341,913,592,955,251,42,plate
10101,19,vase,20,0,20671,34,405,956,568,1253,163,297,vase
10102,20,chair,21,1,20671,16,664,904,914,1128,250,224,chair
10103,21,chair,22,1,20671,25,960,953,1108,1599,148,646,chair
10104,22,chair,23,1,20671,26,756,1043,1024,1599,268,556,chair
10105,25,table,26,0,20671,40,206,1099,925,1599,719,500,dining table
10106,14,window,15,0,20672,29,1757,315,1941,802,184,487,window
10107,21,chair,22,1,20672,45,580,749,798,1205,218,456,chair
10108,22,chair,23,1,20672,39,950,732,1196,1117,246,385,chair
10109,23,chair,24,1,20672,43,1360,739,1515,1077,155,338,chair
10110,24,chair,25,0,20672,62,1100,802,1427,1272,327,470,chair
10111,25,chair,26,0,20672,55,727,836,1048,1334,321,498,chair
10112,26,chair,27,0,20672,65,328,821,670,1317,342,496,chair
10113,27,table,28,1,20672,109,422,815,1477,1224,1055,409,dining table
10114,29,chair,30,1,20672,29,1414,957,1729,1523,315,566,chair
10115,34,plant pot,35,0,20672,16,1712,1008,1788,1129,76,121,potted plant
10116,34,chair,35,1,20673,34,1674,658,1876,1206,202,548,chair
10117,35,chair,36,1,20673,26,1065,625,1281,750,216,125,chair
10118,36,chair,37,1,20673,36,748,625,977,1198,229,573,chair
10119,37,chair,38,0,20673,59,263,672,754,1377,491,705,chair
10120,38,chair,39,0,20673,45,788,788,1300,1477,512,689,chair
10121,39,chair,40,0,20673,53,1206,764,1775,1477,569,713,chair
10122,40,table,41,1,20673,39,577,760,1766,1055,1189,295,dining table
10123,58,plate,59,1,20673,18,606,836,817,880,211,44,plate
10124,13,window,14,0,20674,47,98,238,661,782,563,544,window
10125,16,window,17,0,20674,21,994,222,1265,732,271,510,window
10126,17,mirror,18,0,20674,39,1324,215,1629,608,305,393,mirror
10127,22,chair,22,1,20674,50,1616,846,1926,1534,310,688,chair
10128,23,table,23,1,20674,22,1746,1023,2045,1534,299,511,dining table
10129,25,chair,25,1,20674,15,983,639,1135,785,152,146,chair
10130,26,chair,26,1,20674,38,911,656,1310,1225,399,569,chair
10131,27,chair,27,0,20674,60,889,721,1336,1361,447,640,chair
10132,28,chair,28,1,20674,26,415,606,592,865,177,259,chair
10133,29,chair,29,1,20674,42,245,640,521,1135,276,495,chair
10134,30,chair,30,1,20674,60,358,664,744,1205,386,541,chair
10135,31,chair,31,1,20674,56,473,688,844,1300,371,612,chair
10136,32,table,32,0,20674,94,348,711,1357,1337,1009,626,dining table
10137,13,chair,14,1,20675,23,1044,1018,1149,1353,105,335,chair
10138,14,chair,15,1,20675,45,836,1018,1095,1447,259,429,chair
10139,15,chair,16,1,20675,66,450,1045,841,1597,391,552,chair
10140,18,chair,19,1,20675,41,294,1028,516,1407,222,379,chair
10141,19,table,20,0,20675,55,424,1023,1002,1352,578,329,dining table
10142,16,window,17,0,20676,23,1348,712,1638,973,290,261,window
10143,17,window,18,0,20676,39,681,721,949,871,268,150,window
10144,21,chair,22,1,20676,46,809,731,1097,1213,288,482,chair
10145,22,chair,23,1,20676,33,1069,747,1265,1190,196,443,chair
10146,24,table,25,1,20676,23,626,865,1143,1221,517,356,dining table
10147,25,chair,26,1,20676,25,779,765,944,985,165,220,chair
10148,11,chair,12,1,20677,31,1091,797,1349,1210,258,413,chair
10149,12,chair,13,0,20677,49,1124,952,1463,1481,339,529,chair
10150,13,chair,14,0,20677,30,627,964,1121,1536,494,572,chair
10151,19,table,20,0,20677,57,673,876,1433,1497,760,621,dining table
10152,23,vase,24,0,20677,19,1541,893,1619,1003,78,110,vase
10153,33,plate,34,0,20677,30,1075,487,1180,594,105,107,plate
10154,34,plate,35,0,20677,25,1218,485,1322,590,104,105,plate
10155,39,bottle,40,0,20677,20,1055,372,1101,470,46,98,bottle
10156,12,door,13,0,20678,26,1329,7,1727,842,398,835,door
10157,15,chair,16,1,20678,25,877,553,1093,625,216,72,chair
10158,18,chair,19,1,20678,21,454,608,601,739,147,131,chair
10159,19,chair,20,1,20678,20,2,751,258,1002,256,251,chair
10160,20,chair,21,1,20678,31,1194,655,1361,1091,167,436,chair
10161,21,chair,22,1,20678,33,1176,798,1534,1152,358,354,chair
10162,22,table,23,0,20678,24,2,608,1234,1152,1232,544,dining table
10163,23,plate,24,0,20678,18,921,851,1075,916,154,65,plate
10164,24,plate,25,0,20678,16,871,837,1119,941,248,104,plate
10165,25,plate,26,0,20678,19,463,963,655,1057,192,94,plate
10166,26,plate,27,0,20678,22,396,947,705,1093,309,146,plate
10167,27,plate,28,0,20678,15,321,822,464,876,143,54,plate
10168,28,plate,29,0,20678,18,276,810,511,895,235,85,plate
10169,32,plate,33,0,20678,18,1007,661,1165,701,158,40,plate
10170,35,bottle,36,0,20678,47,786,490,876,732,90,242,bottle
10171,41,fork,42,0,20678,19,908,938,1121,983,213,45,fork
10172,42,fork,43,0,20678,17,281,966,425,1091,144,125,fork
10173,8,window,9,0,20679,23,0,357,641,1211,641,854,window
10174,12,chair,13,1,20679,22,989,994,1302,1703,313,709,chair
10175,13,chair,14,1,20679,47,549,1003,1073,1847,524,844,chair
10176,14,table,15,0,20679,43,0,1033,1337,1812,1337,779,dining table
10177,19,chair,20,1,20680,16,1444,808,1624,1083,180,275,chair
10178,21,chair,22,1,20680,17,994,821,1205,1062,211,241,chair
10179,22,chair,23,1,20680,30,926,838,1205,1297,279,459,chair
10180,23,table,24,0,20680,25,1007,889,1461,1335,454,446,dining table
10181,24,chair,25,0,20680,31,1177,873,1419,1378,242,505,chair
10182,18,window,19,0,20681,88,748,541,1204,746,456,205,window
10183,21,chair,22,1,20681,23,909,555,1014,654,105,99,chair
10184,22,chair,23,1,20681,36,1039,574,1190,966,151,392,chair
10185,23,chair,24,1,20681,51,883,593,1172,1025,289,432,chair
10186,25,chair,26,1,20681,40,557,579,691,1018,134,439,chair
10187,26,chair,27,1,20681,53,653,626,964,1025,311,399,chair
10188,27,table,28,0,20681,62,545,649,1127,1025,582,376,dining table
10189,33,mirror,34,0,20681,24,448,308,500,480,52,172,mirror
10190,7,window,8,0,20682,34,1295,236,1992,977,697,741,window
10191,13,chair,14,1,20682,30,833,744,1037,903,204,159,chair
10192,14,chair,15,0,20682,58,523,754,899,1320,376,566,chair
10193,15,chair,16,0,20682,19,1281,804,1579,1217,298,413,chair
10194,16,chair,17,0,20682,57,874,830,1369,1475,495,645,chair
10195,17,table,18,0,20682,41,584,890,1079,1378,495,488,dining table
10196,27,plate,28,1,20682,33,1712,1073,2005,1179,293,106,plate
10197,31,mirror,32,0,20682,24,620,103,913,451,293,348,mirror
10198,9,refrigerator,10,1,20683,23,1232,194,1475,761,243,567,refrigerator
10199,12,window,13,0,20683,16,688,131,905,465,217,334,window
10200,54,mirror,54,0,20683,32,164,238,402,553,238,315,mirror
10201,55,chair,55,1,20683,29,251,491,372,591,121,100,chair
10202,57,chair,57,1,20683,51,156,522,249,952,93,430,chair
10203,58,chair,58,1,20683,61,209,546,316,1040,107,494,chair
10204,59,chair,59,1,20683,88,270,582,551,1190,281,608,chair
10205,60,chair,60,1,20683,42,526,502,617,621,91,119,chair
10206,61,chair,61,1,20683,29,617,524,714,656,97,132,chair
10207,62,chair,62,1,20683,48,544,551,848,939,304,388,chair
10208,63,chair,63,0,20683,86,555,630,890,1199,335,569,chair
10209,65,vase,65,0,20683,20,425,555,514,659,89,104,vase
10210,67,table,67,0,20683,46,288,573,911,1199,623,626,dining table
10211,0,table,1,0,23260,16,336,322,639,479,303,157,dining table
10212,3,chair,4,0,23260,32,81,46,196,314,115,268,chair
10213,10,chair,11,1,23261,37,242,176,415,404,173,228,chair
10214,11,chair,12,1,23261,33,315,150,438,354,123,204,chair
10215,12,chair,13,1,23261,24,400,127,460,311,60,184,chair
10216,15,chair,16,1,23261,30,94,136,211,324,117,188,chair
10217,16,chair,17,0,23261,45,22,219,220,467,198,248,chair
10218,18,table,19,0,23261,15,84,129,423,403,339,274,dining table
10219,29,window,30,0,23261,15,0,1,70,282,70,281,window
10220,4,window,5,0,23262,16,539,28,640,240,101,212,window
10221,11,table,12,0,23262,73,247,267,477,469,230,202,dining table
10222,13,chair,14,1,23262,18,239,254,288,301,49,47,chair
10223,14,chair,15,0,23262,58,236,300,377,480,141,180,chair
10224,15,chair,16,1,23262,59,378,277,515,474,137,197,chair
10225,22,vase,23,0,23262,15,98,103,121,141,23,38,vase
10226,23,plate,24,0,23262,22,120,97,144,140,24,43,plate
10227,24,plate,25,0,23262,19,146,99,178,135,32,36,plate
10228,25,vase,26,0,23262,17,187,97,209,133,22,36,vase
10229,29,vase,30,0,23262,17,137,150,158,188,21,38,vase
10230,30,vase,31,0,23262,15,159,148,182,186,23,38,vase
10231,31,vase,32,0,23262,26,113,210,138,261,25,51,vase
10232,32,vase,33,0,23262,25,195,197,215,242,20,45,vase
10233,34,vase,35,0,23262,17,362,269,391,303,29,34,vase
10234,9,table,10,0,23263,155,55,317,734,623,679,306,dining table
10235,11,chair,12,0,23263,81,792,366,947,603,155,237,chair
10236,12,chair,13,1,23263,54,721,333,831,521,110,188,chair
10237,14,chair,15,1,23263,17,524,305,566,343,42,38,chair
10238,18,clock,19,1,23263,32,227,213,271,298,44,85,clock
10239,46,bowl,47,0,23263,15,378,355,430,377,52,22,bowl
10240,16,table,17,1,23264,46,208,286,424,391,216,105,dining table
10241,17,chair,18,1,23264,18,290,306,354,380,64,74,chair
10242,18,chair,19,1,23264,31,365,329,452,474,87,145,chair
10243,21,chair,22,1,23264,24,635,364,716,538,81,174,chair
10244,22,chair,23,0,23264,37,506,409,649,599,143,190,chair
10245,23,chair,24,0,23264,44,275,375,405,577,130,202,chair
10246,24,table,25,0,23264,58,326,343,664,551,338,208,dining table
10247,25,chair,26,1,23264,32,187,289,253,398,66,109,chair
10248,28,chair,29,1,23264,18,151,270,188,358,37,88,chair
10249,5,chair,6,1,23265,46,52,522,388,1024,336,502,chair
10250,7,table,8,0,23265,47,120,500,767,1024,647,524,dining table
10251,37,chair,38,1,23266,52,329,430,481,748,152,318,chair
10252,38,chair,39,0,23266,55,431,423,606,710,175,287,chair
10253,39,chair,40,0,23266,67,538,413,709,677,171,264,chair
10254,1,chair,2,1,23267,39,870,324,1023,754,153,430,chair
10255,2,chair,3,1,23267,23,470,722,847,768,377,46,chair
10256,3,chair,4,1,23267,72,1,334,314,768,313,434,chair
10257,7,table,8,0,23267,21,1,166,144,335,143,169,dining table
10258,9,chair,10,1,23267,19,165,231,211,349,46,118,chair
10259,10,chair,11,1,23267,24,817,220,906,326,89,106,chair
10260,11,table,12,0,23267,39,300,257,886,767,586,510,dining table
10261,12,person,13,1,23267,34,141,240,314,645,173,405,person
10262,13,person,14,1,23267,42,229,134,387,433,158,299,person
10263,14,person,15,1,23267,73,611,223,911,633,300,410,person
10264,15,person,16,1,23267,67,586,160,782,431,196,271,person
10265,16,sofa,17,0,23267,36,331,145,707,285,376,140,couch
10266,17,sofa,18,1,23267,30,554,35,792,169,238,134,couch
10267,24,bowl,25,0,23267,15,325,430,414,501,89,71,bowl
10268,27,bowl,28,0,23267,17,671,426,769,490,98,64,bowl
10269,30,bowl,31,0,23267,18,612,305,688,354,76,49,bowl
10270,32,bottle,33,0,23267,18,411,288,445,427,34,139,bottle
10271,35,bowl,36,0,23267,16,348,288,413,337,65,49,bowl
10272,38,vase,39,0,23267,21,477,223,504,294,27,71,vase
10273,7,table,8,0,23268,29,212,451,585,759,373,308,dining table
10274,9,chair,10,1,23268,44,532,482,643,711,111,229,chair
10275,10,chair,11,1,23268,43,199,463,318,689,119,226,chair
10276,11,chair,12,0,23268,43,304,569,472,768,168,199,chair
10277,4,sofa,5,1,23269,56,284,340,841,621,557,281,couch
10278,10,table,11,0,23269,54,116,444,600,767,484,323,dining table
10279,12,vase,13,0,23269,21,166,113,204,192,38,79,vase
10280,14,vase,15,0,23269,16,376,416,411,481,35,65,vase
10281,19,plate,20,0,23269,18,430,506,502,535,72,29,plate
10282,21,plate,22,0,23269,17,274,522,338,546,64,24,plate
10283,4,window,5,0,23270,16,5,5,236,1286,231,1281,window
10284,9,window,10,0,23270,21,354,97,759,912,405,815,window
10285,13,sofa,14,0,23270,30,12,778,479,1440,467,662,couch
10286,14,chair,15,1,23270,50,493,701,738,1309,245,608,chair
10287,15,chair,16,0,23270,33,636,775,1160,1445,524,670,chair
10288,16,table,17,0,23270,39,362,867,975,1443,613,576,dining table
10289,6,bottle,7,0,23271,15,909,300,937,403,28,103,bottle
10290,15,chair,16,0,23271,51,474,316,855,768,381,452,chair
10291,17,person,18,0,23271,59,440,368,671,743,231,375,person
10292,18,chair,19,0,23271,15,260,330,338,461,78,131,chair
10293,19,table,20,0,23271,69,166,459,500,735,334,276,dining table
10294,21,person,22,0,23271,102,2,88,457,768,455,680,person
10295,1,chair,2,1,23272,44,15,61,372,493,357,432,chair
10296,2,chair,3,1,23272,44,536,64,891,481,355,417,chair
10297,3,chair,4,0,23272,46,596,154,1020,712,424,558,chair
10298,4,chair,5,0,23272,45,43,183,506,757,463,574,chair
10299,5,table,6,0,23272,26,165,139,843,702,678,563,dining table
10300,6,plate,7,0,23272,18,575,166,718,210,143,44,plate
10301,8,plate,9,0,23272,20,327,179,477,219,150,40,plate
10302,10,plate,11,0,23272,18,311,138,423,174,112,36,plate
10303,11,plate,12,0,23272,15,335,142,419,160,84,18,plate
10304,17,plant pot,18,0,23272,16,524,128,558,187,34,59,potted plant
10305,3,table,4,1,23273,26,473,378,650,496,177,118,dining table
10306,4,table,5,0,23273,28,351,407,570,582,219,175,dining table
10307,5,chair,6,0,23273,20,186,407,392,725,206,318,chair
10308,6,chair,7,0,23273,23,381,482,593,767,212,285,chair
10309,7,chair,8,0,23273,20,606,447,841,765,235,318,chair
10310,8,chair,9,1,23273,15,624,385,803,543,179,158,chair
10311,9,chair,10,1,23273,17,1,401,189,684,188,283,chair
10312,2,bed,3,0,140,36,29,67,515,448,486,381,bed
10313,11,desk,12,1,140,16,430,332,599,450,169,118,desk
10314,14,person,15,0,140,75,190,205,465,450,275,245,person
10315,9,chair,10,1,7356,25,46,100,103,215,57,115,chair
10316,4,desk,5,0,7357,19,108,165,214,274,106,109,desk
10317,8,bed,9,1,7358,27,30,127,172,209,142,82,bed
10318,9,bed,10,1,7358,29,0,147,170,245,170,98,bed
10319,5,table,6,1,7359,30,2,308,113,525,111,217,dining table
10320,6,bed,7,0,7359,19,151,215,451,451,300,236,bed
10321,9,chair,10,1,7359,19,359,445,496,603,137,158,chair
10322,4,bed,5,1,7360,20,100,53,207,151,107,98,bed
10323,5,person,6,1,7360,24,148,80,182,141,34,61,person
10324,6,chair,7,1,7360,19,150,103,185,144,35,41,chair
10325,10,television,11,0,7360,16,3,73,64,134,61,61,tv
10326,14,chair,15,1,7360,15,186,137,234,192,48,55,chair
10327,15,person,16,0,7360,55,145,81,236,189,91,108,person
10328,3,bed,4,1,7361,15,2,129,213,214,211,85,bed
10329,5,bed,6,1,7361,26,0,135,394,299,394,164,bed
10330,10,chair,11,1,7363,24,124,100,208,227,84,127,chair
10331,11,table,12,0,7363,20,42,108,256,290,214,182,dining table
10332,12,chair,13,0,7363,32,9,108,124,282,115,174,chair
10333,5,desk,6,1,7364,21,60,162,122,249,62,87,desk
10334,6,bed,7,1,7364,16,101,158,204,299,103,141,bed
10335,7,person,8,0,7364,54,11,111,87,258,76,147,person
10336,8,desk,9,0,7365,18,8,179,157,300,149,121,desk
10337,9,chair,10,0,7365,37,79,192,153,300,74,108,chair
10338,16,chair,17,0,7366,24,109,160,167,239,58,79,chair
10339,9,bed,10,1,7367,20,0,168,145,265,145,97,bed
10340,5,bed,6,0,7368,38,16,98,367,598,351,500,bed
10341,10,bed,11,0,7369,28,117,126,321,268,204,142,bed
10342,13,bed,14,1,7370,65,2,256,413,444,411,188,bed
10343,15,person,16,0,7370,71,145,134,329,442,184,308,person
10344,7,chair,8,0,7371,31,426,386,576,532,150,146,chair
10345,8,bed,9,0,7372,27,231,110,377,254,146,144,bed
10346,9,desk,10,0,7372,17,84,137,152,253,68,116,desk
10347,10,chair,11,1,7372,29,97,139,160,255,63,116,chair
10348,13,person,14,1,7372,29,83,110,134,197,51,87,person
10349,2,person,3,1,7373,41,151,109,261,227,110,118,person
10350,11,person,12,0,7373,32,71,70,149,174,78,104,person
10351,12,person,13,0,7373,27,142,61,206,160,64,99,person
10352,5,bed,6,1,7374,16,320,345,620,504,300,159,bed
10353,9,chair,10,0,7374,22,169,363,285,503,116,140,chair
10354,9,desk,9,0,7375,18,1116,1294,1646,1960,530,666,desk
10355,11,backpack,11,0,7375,36,682,1574,988,1944,306,370,backpack
10356,14,bed,14,1,7375,32,0,1297,916,2199,916,902,bed
10357,6,bed,7,0,7376,60,605,411,1022,767,417,356,bed
10358,7,bed,8,1,7376,40,75,375,447,768,372,393,bed
10359,12,bed,13,0,7377,126,706,418,2066,1550,1360,1132,bed
10360,16,window,17,0,7377,16,1624,1,2199,454,575,453,window
10361,18,desk,19,1,7377,39,273,903,1444,1649,1171,746,desk
10362,25,chair,26,1,7377,37,212,1006,707,1649,495,643,chair
10363,8,door,9,1,7378,65,328,116,529,553,201,437,door
10364,9,bed,10,1,7378,43,595,399,817,734,222,335,bed
10365,13,desk,14,0,7378,20,0,372,247,765,247,393,desk
10366,15,backpack,16,1,7378,24,226,568,315,705,89,137,backpack
10367,16,chair,17,0,7378,60,202,515,438,767,236,252,chair
10368,17,person,18,0,7378,89,400,181,508,631,108,450,person
10369,18,person,19,0,7378,90,490,164,610,628,120,464,person
10370,28,desk,29,1,7379,28,323,732,689,948,366,216,desk
10371,32,bed,33,0,7379,52,704,720,1391,1162,687,442,bed
10372,37,desk,38,1,7379,39,1331,762,2047,1062,716,300,desk
10373,58,chair,59,0,7379,69,383,845,825,1388,442,543,chair
10374,60,suitcase,61,1,7379,28,577,1274,1240,1534,663,260,suitcase
10375,5,bed,6,1,7380,35,796,427,1531,838,735,411,bed
10376,8,bed,9,0,7380,27,0,561,793,1198,793,637,bed
10377,3,bed,4,1,7382,50,0,361,921,1530,921,1169,bed
10378,10,chair,11,0,7382,46,1056,364,1629,1229,573,865,chair
10379,12,bed,13,0,7383,68,820,296,1597,1196,777,900,bed
10380,13,chair,14,0,7383,49,973,615,1499,1200,526,585,chair
10381,14,bed,15,0,7383,15,1,653,724,1200,723,547,bed
10382,15,desk,16,1,7383,41,286,537,1123,1200,837,663,desk
10383,4,bed,5,0,7384,51,314,653,1044,1473,730,820,bed
10384,10,desk,11,1,7384,21,833,719,1197,1383,364,664,desk
10385,16,chair,17,1,7384,18,607,1271,941,1596,334,325,chair
10386,3,bed,4,1,7385,57,472,443,2198,1649,1726,1206,bed
10387,1,desk,2,0,7386,16,0,768,948,1538,948,770,desk
10388,2,chair,3,1,7386,26,695,818,1029,1321,334,503,chair
10389,8,bed,9,1,7388,23,253,529,1534,1021,1281,492,bed
10390,4,bed,5,0,7389,34,347,4,1406,997,1059,993,bed
10391,5,person,6,1,7389,53,546,244,852,997,306,753,person
10392,10,desk,11,0,7390,86,784,838,2199,1493,1415,655,desk
10393,12,bottle,13,0,7390,18,1052,885,1089,975,37,90,bottle
10394,14,backpack,15,0,7390,32,1011,831,1252,972,241,141,backpack
10395,15,bottle,16,0,7390,15,1569,785,1620,931,51,146,bottle
10396,16,laptop,17,1,7390,17,1266,724,1535,950,269,226,laptop
10397,4,chair,5,1,7391,16,682,1311,940,1715,258,404,chair
10398,6,window,7,0,7391,25,699,271,1376,1361,677,1090,window
10399,10,desk,11,0,7391,18,1261,1297,1598,1547,337,250,desk
10400,12,refrigerator,12,1,7391,18,1543,872,1646,2199,103,1327,refrigerator
10401,13,bed,13,1,7391,49,1143,1448,1587,2199,444,751,bed
10402,16,mirror,16,0,7391,17,1523,1204,1606,1347,83,143,mirror
10403,17,backpack,17,0,7391,22,935,1523,1152,1714,217,191,backpack
10404,26,bed,24,1,7391,31,0,1688,497,2197,497,509,bed
10405,27,backpack,25,0,7391,27,2,1692,292,1862,290,170,backpack
10406,2,desk,3,0,7392,23,1159,0,2199,1464,1040,1464,desk
10407,20,bed,21,0,7392,16,0,804,944,1463,944,659,bed
10408,3,bed,4,0,7393,32,684,727,1509,1533,825,806,bed
10409,8,suitcase,9,0,7393,39,841,697,1143,925,302,228,suitcase
10410,15,chair,16,0,7393,39,293,784,693,1311,400,527,chair
10411,7,bed,8,0,7394,27,376,433,1014,767,638,334,bed
10412,1,bed,2,1,7396,119,525,671,1910,1515,1385,844,bed
10413,2,chair,3,1,7396,52,858,1032,1686,1648,828,616,chair
10414,3,person,4,1,7396,117,647,553,1419,1511,772,958,person
10415,4,desk,5,1,7396,46,1,904,901,1647,900,743,desk
10416,6,mouse,7,1,7396,19,626,942,747,993,121,51,mouse
10417,7,bowl,8,1,7396,19,497,1104,752,1286,255,182,bowl
10418,3,desk,4,1,7397,17,492,507,995,913,503,406,desk
10419,5,chair,6,0,7397,53,908,521,1305,993,397,472,chair
10420,1,bed,2,1,7398,42,0,450,675,1196,675,746,bed
10421,2,bottle,3,0,7398,15,627,662,692,828,65,166,bottle
10422,3,desk,4,0,7398,95,565,301,1535,1199,970,898,desk
10423,4,person,5,1,7398,52,1019,697,1520,1189,501,492,person
10424,5,chair,6,1,7398,15,1015,1123,1599,1199,584,76,chair
10425,20,scissors,21,1,7398,17,855,657,910,724,55,67,scissors
10426,5,window,6,0,7399,23,140,46,459,311,319,265,window
10427,16,chair,17,0,7399,36,359,682,718,1075,359,393,chair
10428,17,bed,18,1,7399,19,0,822,442,1596,442,774,bed
10429,22,bed,23,1,7399,34,1009,684,1199,1361,190,677,bed
10430,2,suitcase,3,0,7400,24,669,443,813,681,144,238,suitcase
10431,3,chair,4,0,7400,36,754,490,967,828,213,338,chair
10432,4,table,5,0,7400,23,905,485,1248,855,343,370,dining table
10433,11,chair,12,1,7400,18,2,492,168,824,166,332,chair
10434,12,bed,13,0,7400,19,97,542,683,958,586,416,bed
10435,13,backpack,14,0,7400,21,368,656,636,822,268,166,backpack
10436,6,desk,7,0,7401,34,422,490,929,1023,507,533,desk
10437,20,chair,21,0,7401,39,3,502,362,1009,359,507,chair
10438,1,window,2,1,7402,34,196,173,1033,1165,837,992,window
10439,2,door,3,0,7402,17,1009,0,1649,2199,640,2199,door
10440,4,bed,5,1,7402,60,0,972,999,1723,999,751,bed
10441,5,chair,6,0,7402,51,3,1306,579,2199,576,893,chair
10442,6,desk,7,0,7402,43,367,369,1126,2197,759,1828,desk
10443,17,bottle,18,1,7402,20,780,1455,863,1659,83,204,bottle
10444,22,glasses,23,0,7402,37,498,1552,677,1636,179,84,eye glasses
10445,5,desk,6,1,7403,37,711,919,1199,1455,488,536,desk
10446,7,bed,8,1,7403,34,2,670,722,1434,720,764,bed
10447,13,chair,14,0,7403,39,782,962,1118,1410,336,448,chair
10448,4,desk,5,1,7404,34,1104,822,1308,957,204,135,desk
10449,11,bed,12,1,7404,62,165,789,1221,1199,1056,410,bed
10450,15,person,16,0,7404,86,1169,655,1488,1195,319,540,person
10451,16,chair,17,1,7404,25,1348,834,1523,1199,175,365,chair
10452,2,bed,3,0,7405,37,0,141,1535,1198,1535,1057,bed
10453,7,bed,8,0,7406,28,155,520,622,1424,467,904,bed
10454,3,television,4,0,7407,17,0,181,198,433,198,252,tv
10455,4,refrigerator,5,0,7407,21,2,402,215,871,213,469,refrigerator
10456,7,bed,8,0,7407,62,615,475,1279,957,664,482,bed
10457,2,window,3,0,7408,15,1574,0,2042,687,468,687,window
10458,6,desk,7,1,7408,36,1212,872,2046,1457,834,585,desk
10459,15,hairbrush,16,0,7408,19,75,225,227,263,152,38,hair brush
10460,49,bed,50,1,7408,41,2,965,1510,1535,1508,570,bed
10461,53,chair,54,0,7408,28,1541,964,2045,1535,504,571,chair
10462,1,bed,2,0,7409,43,2,248,1132,1649,1130,1401,bed
10463,8,suitcase,9,1,7409,26,1435,1098,1991,1329,556,231,suitcase
10464,9,desk,10,1,7409,43,1098,887,1944,1500,846,613,desk
10465,15,chair,16,1,7409,53,1219,922,1547,1526,328,604,chair
10466,8,bed,9,1,7410,35,0,325,347,665,347,340,bed
10467,4,window,5,0,7411,17,0,436,360,1349,360,913,window
10468,9,bed,10,1,7411,30,496,519,2030,1349,1534,830,bed
10469,9,mirror,10,0,7412,21,524,278,573,354,49,76,mirror
10470,11,bed,12,1,7412,42,527,412,1278,959,751,547,bed
10471,10,person,11,1,7413,69,251,474,653,1327,402,853,person
10472,11,person,12,1,7413,48,287,1037,691,1599,404,562,person
10473,12,bed,13,1,7413,15,556,1139,1090,1597,534,458,bed
10474,22,door,23,0,7413,37,492,128,760,1078,268,950,door
10475,46,glasses,47,0,7413,17,594,1092,657,1172,63,80,eye glasses
10476,15,bed,16,1,7414,16,2,1126,807,1649,805,523,bed
10477,16,desk,17,1,7415,17,1257,941,1951,1465,694,524,desk
10478,22,sofa,23,0,7415,54,3,789,1234,1464,1231,675,couch
10479,23,refrigerator,24,1,7415,24,814,486,1202,1007,388,521,refrigerator
10480,3,window,4,0,7416,22,123,1,1471,780,1348,779,window
10481,5,bed,6,1,7416,26,1217,751,2044,1534,827,783,bed
10482,8,suitcase,9,0,7416,42,1633,983,2046,1347,413,364,suitcase
10483,9,desk,10,0,7416,33,108,826,1306,1533,1198,707,desk
10484,12,bottle,13,1,7416,19,27,848,140,1135,113,287,bottle
10485,17,chair,18,1,7416,20,611,924,1019,1533,408,609,chair
10486,7,bed,8,0,20703,20,1699,805,2196,1649,497,844,bed
10487,8,bed,9,0,20703,30,0,768,684,1649,684,881,bed
10488,9,person,10,0,20703,47,1298,303,1667,1325,369,1022,person
10489,14,desk,15,0,20703,28,1599,743,1897,1279,298,536,desk
10490,10,desk,11,0,20704,39,844,181,1485,1040,641,859,desk
10491,12,chair,13,1,20704,44,862,638,1136,1052,274,414,chair
10492,13,chair,14,1,20704,46,760,778,1317,1200,557,422,chair
10493,17,chair,18,1,20704,19,1397,1046,1598,1200,201,154,chair
10494,20,blender,21,0,20704,18,1335,73,1414,249,79,176,blender
10495,10,table,11,1,20705,24,1551,1133,2199,1648,648,515,dining table
10496,11,chair,12,1,20705,18,1614,1257,2079,1648,465,391,chair
10497,19,bed,20,0,20705,28,217,1188,1230,1650,1013,462,bed
10498,46,clock,47,1,20705,18,1907,1059,2022,1158,115,99,clock
10499,10,desk,11,0,20706,18,80,904,553,1169,473,265,desk
10500,12,bed,13,0,20706,27,884,1015,1198,1598,314,583,bed
10501,13,bed,14,0,20706,29,37,1015,480,1600,443,585,bed
10502,16,chair,17,1,20706,18,268,974,480,1145,212,171,chair
10503,17,chair,18,1,20706,18,862,943,1049,1125,187,182,chair
10504,6,bed,7,0,20707,44,2,227,740,1650,738,1423,bed
10505,7,bed,8,0,20707,50,1449,330,2198,1604,749,1274,bed
10506,12,refrigerator,13,0,20708,25,1290,1425,1626,1878,336,453,refrigerator
10507,13,desk,14,0,20708,42,422,810,1266,1636,844,826,desk
10508,21,backpack,22,1,20708,22,975,1407,1318,1862,343,455,backpack
10509,22,backpack,23,0,20708,16,749,1503,978,1673,229,170,backpack
10510,15,mirror,16,0,20709,29,1801,17,2198,1440,397,1423,mirror
10511,18,desk,19,0,20709,26,1358,639,1830,1083,472,444,desk
10512,19,desk,20,0,20709,37,0,118,560,1339,560,1221,desk
10513,27,bed,28,0,20709,42,1212,417,1724,928,512,511,bed
10514,28,bed,29,0,20709,28,435,389,932,907,497,518,bed
10515,29,chair,30,1,20709,33,594,697,962,1288,368,591,chair
10516,30,chair,31,0,20709,40,1200,735,1628,1386,428,651,chair
10517,41,chair,42,0,20709,28,0,935,836,1467,836,532,chair
10518,4,bed,5,0,23275,28,201,68,1022,768,821,700,bed
10519,11,chair,12,1,23275,26,320,583,461,762,141,179,chair
10520,12,desk,13,0,23275,17,114,555,447,768,333,213,desk
10521,20,person,21,1,23275,67,512,352,660,767,148,415,person
10522,3,bed,4,0,23276,72,10,221,555,560,545,339,bed
10523,12,table,13,0,23276,22,567,272,784,559,217,287,dining table
10524,13,chair,14,1,23276,30,651,247,774,448,123,201,chair
10525,14,chair,15,1,23276,65,536,245,750,559,214,314,chair
10526,15,chair,16,1,23277,57,293,347,478,665,185,318,chair
10527,16,person,17,0,23277,79,234,168,498,583,264,415,person
10528,17,table,18,1,23277,16,64,357,337,654,273,297,dining table
10529,23,sofa,24,1,23277,16,1,452,162,766,161,314,couch
10530,2,bed,3,0,23278,17,2,114,887,720,885,606,bed
10531,5,shoe,6,0,23278,19,389,298,467,370,78,72,shoe
10532,3,door,4,0,23279,21,474,157,680,599,206,442,door
10533,9,chair,10,1,23279,19,642,357,663,536,21,179,chair
10534,18,chair,19,0,23279,26,269,434,554,599,285,165,chair
10535,19,bed,20,1,23279,30,1,460,261,599,260,139,bed
10536,10,person,11,1,23280,61,76,198,504,1023,428,825,person
10537,1,window,2,0,23281,42,0,0,161,279,161,279,window
10538,12,table,13,0,23281,37,117,253,374,369,257,116,dining table
10539,18,chair,19,0,23281,49,260,257,351,401,91,144,chair
10540,5,bed,6,0,23282,19,2,624,405,992,403,368,bed
10541,21,backpack,22,0,23282,16,493,685,587,812,94,127,backpack
10542,22,person,23,0,23282,54,587,583,767,883,180,300,person
10543,26,suitcase,27,0,23282,24,332,708,491,868,159,160,suitcase
10544,27,person,28,0,23282,67,76,444,190,634,114,190,person
10545,29,suitcase,30,0,23282,16,258,635,375,718,117,83,suitcase
10546,31,window,32,0,23282,22,79,158,338,424,259,266,window
10547,3,table,4,0,23283,18,462,491,600,859,138,368,dining table
10548,6,chair,7,1,23283,26,282,512,445,657,163,145,chair
10549,7,motorbike,8,0,23283,65,55,469,543,900,488,431,motorcycle
10550,18,person,19,1,8334,23,69,618,140,885,71,267,person
10551,19,person,20,1,8334,32,0,485,95,980,95,495,person
10552,20,sofa,21,0,8335,25,46,98,166,205,120,107,couch
10553,5,chair,6,1,8337,15,4,363,214,476,210,113,chair
10554,17,sofa,18,1,8339,21,71,179,156,272,85,93,couch
10555,24,table,25,1,8339,27,59,269,338,412,279,143,dining table
10556,13,chair,13,0,8341,27,465,135,538,272,73,137,chair
10557,4,sofa,5,1,8342,29,114,142,273,220,159,78,couch
10558,6,chair,7,0,8342,23,9,206,131,296,122,90,chair
10559,8,chair,9,1,8342,16,279,141,313,205,34,64,chair
10560,27,sofa,28,0,8344,22,2,210,418,453,416,243,couch
10561,14,sofa,15,1,8345,27,2,225,78,409,76,184,couch
10562,16,chair,17,1,8345,19,206,138,254,204,48,66,chair
10563,5,chair,6,0,8346,51,280,574,481,829,201,255,chair
10564,3,person,4,1,8347,40,371,135,456,236,85,101,person
10565,4,person,5,1,8347,70,68,38,297,438,229,400,person
10566,9,person,10,1,8347,20,250,130,306,204,56,74,person
10567,14,sofa,15,0,8349,20,401,260,690,460,289,200,couch
10568,24,chair,25,1,8349,25,153,220,216,311,63,91,chair
10569,20,balls,21,0,8350,24,243,241,316,274,73,33,sports ball
10570,3,chair,4,1,8352,20,171,206,232,313,61,107,chair
10571,4,sofa,5,1,8352,22,37,298,263,479,226,181,couch
10572,21,sofa,22,1,8353,21,2,319,295,458,293,139,couch
10573,31,chair,32,1,8353,46,564,324,683,459,119,135,chair
10574,8,chair,9,0,8354,18,171,100,228,166,57,66,chair
10575,9,table,10,1,8354,16,205,98,277,141,72,43,dining table
10576,10,chair,11,1,8354,17,265,96,301,132,36,36,chair
10577,19,sofa,20,1,8354,18,495,113,639,206,144,93,couch
10578,6,chair,7,0,8356,32,305,171,381,280,76,109,chair
10579,13,sofa,14,1,8356,23,33,236,237,448,204,212,couch
10580,15,chair,16,1,8357,15,540,314,586,354,46,40,chair
10581,16,chair,17,1,8357,26,568,315,633,380,65,65,chair
10582,7,chair,8,0,8359,17,45,166,80,228,35,62,chair
10583,9,chair,10,0,8359,19,308,164,349,247,41,83,chair
10584,8,chair,9,1,8360,28,194,173,261,246,67,73,chair
10585,9,chair,10,1,8360,18,96,187,154,245,58,58,chair
10586,9,person,10,1,8362,34,330,160,392,198,62,38,person
10587,12,person,13,1,8362,28,93,139,109,191,16,52,person
10588,13,person,14,0,8362,30,143,152,177,207,34,55,person
10589,15,person,16,1,8362,28,29,177,123,237,94,60,person
10590,17,person,18,1,8362,35,22,170,83,233,61,63,person
10591,5,person,6,1,8364,57,162,232,479,639,317,407,person
10592,6,person,7,1,8364,30,2,259,118,639,116,380,person
10593,2,sofa,3,0,8365,24,0,102,80,183,80,81,couch
10594,11,chair,12,1,8365,23,54,89,88,130,34,41,chair
10595,6,table,7,0,8366,17,118,98,163,116,45,18,dining table
10596,7,person,8,1,8367,24,475,97,505,160,30,63,person
10597,8,person,9,1,8367,32,334,68,368,205,34,137,person
10598,9,person,10,1,8367,48,365,46,439,210,74,164,person
10599,10,person,11,1,8367,54,135,77,244,195,109,118,person
10600,12,chair,13,1,8367,22,323,129,345,200,22,71,chair
10601,13,chair,14,1,8367,31,212,135,275,194,63,59,chair
10602,23,balls,24,0,8367,17,436,294,502,334,66,40,sports ball
10603,24,television,25,1,8367,15,446,24,507,64,61,40,tv
10604,7,chair,8,1,8369,16,507,286,551,345,44,59,chair
10605,8,chair,9,1,8369,27,650,301,707,440,57,139,chair
10606,4,chair,5,1,8371,18,48,135,145,221,97,86,chair
10607,5,chair,6,1,8371,20,159,141,242,230,83,89,chair
10608,6,chair,7,1,8371,22,259,122,340,275,81,153,chair
10609,8,table,9,1,8371,43,69,141,270,221,201,80,dining table
10610,15,chair,16,0,8372,32,1642,599,1866,986,224,387,chair
10611,20,table,21,0,8374,67,159,775,533,1294,374,519,dining table
10612,14,balls,15,0,8376,24,1408,1144,1639,1223,231,79,sports ball
10613,21,table,22,1,8377,36,1270,544,1554,751,284,207,dining table
10614,23,chair,24,1,8377,17,1416,582,1554,771,138,189,chair
10615,25,balls,26,0,8377,21,498,702,647,762,149,60,sports ball
10616,8,person,9,1,8379,25,87,72,106,121,19,49,person
10617,9,person,10,0,8379,40,196,89,245,155,49,66,person
10618,14,window,15,1,8379,15,189,73,226,117,37,44,window
10619,4,window,5,0,8384,26,972,397,1758,712,786,315,window
10620,8,chair,9,1,8384,18,1681,531,1759,867,78,336,chair
10621,9,chair,10,1,8384,26,1488,514,1759,1166,271,652,chair
10622,2,sofa,3,1,8385,53,1,1061,793,1649,792,588,couch
10623,13,toilet,14,0,8385,17,1668,1051,1768,1147,100,96,toilet
10624,47,bowl,48,0,8385,16,1672,1063,1769,1147,97,84,bowl
10625,1,window,2,0,8386,18,779,56,884,330,105,274,window
10626,2,door,3,1,8386,17,652,66,788,268,136,202,door
10627,7,person,8,1,8386,56,317,131,539,816,222,685,person
10628,8,person,9,0,8386,48,529,140,673,664,144,524,person
10629,9,person,10,0,8386,61,636,128,816,749,180,621,person
10630,10,person,11,1,8386,59,730,156,981,868,251,712,person
10631,11,person,12,1,8386,43,20,119,163,538,143,419,person
10632,12,person,13,1,8386,23,4,197,74,702,70,505,person
10633,17,chair,18,1,8386,103,7,493,328,1241,321,748,chair
10634,18,chair,19,1,8386,90,690,575,999,1208,309,633,chair
10635,19,chair,20,1,8386,19,571,1191,998,1492,427,301,chair
10636,20,chair,21,1,8386,16,0,1319,408,1492,408,173,chair
10637,21,table,22,0,8386,42,0,748,937,1442,937,694,dining table
10638,33,window,34,0,8386,17,17,0,137,225,120,225,window
10639,11,table,12,1,8387,17,276,682,744,855,468,173,dining table
10640,12,chair,13,1,8387,15,281,736,438,959,157,223,chair
10641,7,chair,8,1,8389,15,281,906,349,1026,68,120,chair
10642,10,chair,11,1,8389,17,621,880,738,1031,117,151,chair
10643,11,chair,12,0,8389,23,487,877,608,1046,121,169,chair
10644,12,chair,13,0,8389,23,520,857,647,1046,127,189,chair
10645,15,chair,16,1,8389,15,903,805,989,911,86,106,chair
10646,21,sofa,22,0,8389,22,685,904,1198,1161,513,257,couch
10647,7,chair,8,1,8391,19,197,96,243,173,46,77,chair
10648,8,chair,9,1,8391,22,238,110,300,182,62,72,chair
10649,8,chair,9,1,8392,15,145,143,167,166,22,23,chair
10650,9,chair,10,0,8392,21,229,149,256,200,27,51,chair
10651,11,table,12,0,8392,15,245,150,280,201,35,51,dining table
10652,12,vase,13,1,8393,18,2047,870,2199,1188,152,318,vase
10653,18,chair,19,1,8393,23,559,590,720,773,161,183,chair
10654,19,chair,20,1,8393,15,870,588,986,787,116,199,chair
10655,21,table,22,1,8393,20,565,630,861,776,296,146,dining table
10656,23,sofa,24,0,8394,27,2,355,489,610,487,255,couch
10657,5,chair,6,1,8395,27,31,429,328,724,297,295,chair
10658,20,sofa,21,1,8395,17,0,672,316,1198,316,526,couch
10659,4,bed,5,1,8396,18,83,164,119,350,36,186,bed
10660,5,bed,6,0,8396,29,111,153,286,390,175,237,bed
10661,11,sofa,12,1,8398,53,660,349,1279,678,619,329,couch
10662,16,chair,17,1,8398,54,135,511,300,884,165,373,chair
10663,13,chair,14,0,8400,29,43,127,89,193,46,66,chair
10664,5,sofa,6,1,8401,17,206,38,291,111,85,73,couch
10665,6,table,7,0,8404,29,1352,742,1555,937,203,195,dining table
10666,7,chair,8,1,8404,19,1528,739,1665,899,137,160,chair
10667,8,chair,9,1,8404,15,1847,809,1989,955,142,146,chair
10668,14,chair,15,1,8404,28,1266,737,1384,1027,118,290,chair
10669,19,balls,20,0,8404,17,1963,1006,2065,1047,102,41,sports ball
10670,24,sofa,25,0,8404,39,684,1034,1229,1649,545,615,couch
10671,9,door,10,1,8405,18,313,229,375,433,62,204,door
10672,21,person,22,1,8405,42,777,284,888,472,111,188,person
10673,22,person,23,0,8405,56,283,312,373,544,90,232,person
10674,4,person,5,1,8408,73,590,261,827,696,237,435,person
10675,5,person,6,1,8408,72,875,232,1002,802,127,570,person
10676,6,person,7,1,8408,44,621,435,976,814,355,379,person
10677,16,person,17,1,8408,37,171,247,326,494,155,247,person
10678,7,chair,8,0,8409,16,3,125,62,220,59,95,chair
10679,8,chair,9,1,8410,16,2,95,35,136,33,41,chair
10680,9,chair,10,1,8410,17,32,94,61,121,29,27,chair
10681,10,chair,11,1,8410,27,9,108,48,230,39,122,chair
10682,11,chair,12,1,8410,21,37,114,68,190,31,76,chair
10683,12,chair,13,1,8410,27,62,134,116,239,54,105,chair
10684,13,chair,14,1,8410,20,109,157,239,240,130,83,chair
10685,8,sofa,9,0,8411,22,113,108,213,175,100,67,couch
10686,7,sofa,8,1,8413,22,179,109,242,148,63,39,couch
10687,8,sofa,9,1,8416,27,152,93,248,146,96,53,couch
10688,7,table,8,1,8418,31,480,403,851,659,371,256,dining table
10689,9,sofa,10,1,8418,21,583,428,1326,660,743,232,couch
10690,24,bed,25,0,8418,22,300,569,1596,1121,1296,552,bed
10691,21,chair,22,1,8419,35,224,915,914,1266,690,351,chair
10692,7,toilet,8,1,8420,18,847,554,917,700,70,146,toilet
10693,26,chair,27,1,8420,34,896,536,1033,755,137,219,chair
10694,28,table,29,1,8421,43,95,686,550,929,455,243,dining table
10695,29,chair,30,1,8421,17,63,713,205,797,142,84,chair
10696,30,chair,31,0,8421,23,9,774,229,920,220,146,chair
10697,31,chair,32,1,8421,15,244,777,454,886,210,109,chair
10698,32,chair,33,0,8421,29,433,738,630,968,197,230,chair
10699,67,balls,67,0,8421,29,1372,724,1474,756,102,32,sports ball
10700,20,bicycle,21,0,8422,37,1831,592,2021,865,190,273,bicycle
10701,22,chair,23,1,8422,28,1724,941,2031,1326,307,385,chair
10702,24,chair,25,1,8422,20,724,702,842,955,118,253,chair
10703,25,chair,26,1,8422,21,597,779,839,1092,242,313,chair
10704,26,chair,27,0,8422,30,496,805,755,1157,259,352,chair
10705,27,chair,28,1,8422,17,248,830,498,1024,250,194,chair
10706,31,chair,32,1,8422,38,192,1132,636,1534,444,402,chair
10707,32,chair,33,1,8422,19,0,1380,118,1534,118,154,chair
10708,2,chair,3,0,8423,25,50,76,109,176,59,100,chair
10709,6,window,7,1,8423,15,94,30,129,93,35,63,window
10710,7,window,8,1,8423,17,182,22,232,105,50,83,window
10711,6,window,7,0,8424,16,28,26,111,120,83,94,window
10712,15,sofa,16,0,8424,37,208,107,286,163,78,56,couch
10713,16,sofa,17,1,8424,22,32,110,130,167,98,57,couch
10714,8,sofa,9,0,8425,23,801,835,1231,1145,430,310,couch
10715,7,chair,8,1,8426,19,889,759,1023,956,134,197,chair
10716,8,sofa,9,1,8429,20,930,512,1279,957,349,445,couch
10717,5,table,6,1,8431,22,2,79,101,161,99,82,dining table
10718,6,chair,7,0,8431,29,34,60,88,159,54,99,chair
10719,10,chair,11,1,8431,16,293,160,360,225,67,65,chair
10720,5,motorbike,6,1,8439,45,9,126,112,271,103,145,motorcycle
10721,6,car,7,0,8439,36,126,135,294,201,168,66,car
10722,4,chair,5,1,8440,26,354,182,423,295,69,113,chair
10723,40,bicycle,41,0,8440,69,56,158,234,281,178,123,bicycle
10724,41,chair,42,0,8440,17,182,50,229,150,47,100,chair
10725,42,chair,43,0,8440,15,130,71,186,156,56,85,chair
10726,3,car,4,1,8444,38,178,133,400,272,222,139,car
10727,9,bicycle,10,1,8444,52,228,37,295,97,67,60,bicycle
10728,11,door,12,0,8444,19,211,139,298,225,87,86,door
10729,0,motorbike,1,0,8446,42,91,108,170,242,79,134,motorcycle
10730,10,motorbike,11,0,8446,43,10,96,86,192,76,96,motorcycle
10731,11,motorbike,12,1,8446,22,0,91,36,124,36,33,motorcycle
10732,1,car,2,1,8448,25,30,119,105,191,75,72,car
10733,2,car,3,1,8448,21,47,134,255,256,208,122,car
10734,4,dog,5,0,8449,55,161,177,241,239,80,62,dog
10735,2,bicycle,3,0,8450,75,206,139,351,233,145,94,bicycle
10736,4,table,5,1,8451,19,409,203,490,283,81,80,dining table
10737,9,bicycle,10,0,8451,52,459,207,519,314,60,107,bicycle
10738,10,bicycle,11,0,8451,80,298,185,412,267,114,82,bicycle
10739,16,table,17,0,8451,27,150,222,250,333,100,111,dining table
10740,10,chair,11,0,8452,19,305,194,366,285,61,91,chair
10741,12,table,13,0,8452,15,2,178,110,298,108,120,dining table
10742,14,motorbike,15,0,8452,70,172,128,243,275,71,147,motorcycle
10743,7,car,8,1,8453,21,167,98,302,183,135,85,car
10744,8,car,9,0,8453,40,280,102,481,243,201,141,car
10745,9,car,10,0,8453,30,41,118,226,266,185,148,car
10746,14,motorbike,15,1,8454,54,0,148,95,280,95,132,motorcycle
10747,8,bicycle,9,0,8455,41,1652,628,1945,1154,293,526,bicycle
10748,9,bicycle,10,0,8455,47,1598,268,1891,648,293,380,bicycle
10749,10,bicycle,11,0,8455,38,1601,574,1741,874,140,300,bicycle
10750,1,bicycle,2,0,8456,120,19,19,223,181,204,162,bicycle
10751,5,bicycle,6,0,8456,60,235,33,371,250,136,217,bicycle
10752,9,car,10,1,8456,29,132,189,709,570,577,381,car
10753,16,door,17,0,8456,24,226,206,422,457,196,251,door
10754,18,door,19,0,8456,25,356,205,585,490,229,285,door
10755,1,bicycle,2,1,8458,73,294,176,608,455,314,279,bicycle
10756,25,hat,26,0,8458,18,394,176,454,232,60,56,hat
10757,4,car,5,0,8460,32,81,107,278,203,197,96,car
10758,7,bicycle,8,0,8461,64,2,116,218,439,216,323,bicycle
10759,8,bicycle,9,0,8461,41,81,3,231,186,150,183,bicycle
10760,5,car,6,1,8463,24,428,94,536,178,108,84,car
10761,6,car,7,1,8463,37,335,113,525,252,190,139,car
10762,7,car,8,0,8463,54,31,168,488,477,457,309,car
10763,12,car,13,1,8465,36,367,159,640,373,273,214,car
10764,27,table,28,0,8467,21,281,103,391,158,110,55,dining table
10765,23,bicycle,24,0,8468,35,89,94,129,192,40,98,bicycle
10766,24,bicycle,25,1,8468,33,68,110,112,205,44,95,bicycle
10767,3,boat,4,1,8470,19,161,118,256,201,95,83,boat
10768,27,table,28,0,8471,20,735,711,914,936,179,225,dining table
10769,2,racket,3,0,8472,15,205,7,224,52,19,45,tennis racket
10770,3,bicycle,4,0,8472,66,161,62,255,136,94,74,bicycle
10771,3,bicycle,4,1,8474,42,549,168,630,278,81,110,bicycle
10772,3,refrigerator,4,0,8475,23,318,136,475,388,157,252,refrigerator
10773,2,bicycle,3,0,8476,46,133,176,191,254,58,78,bicycle
10774,4,dog,5,0,8476,25,81,258,115,312,34,54,dog
10775,8,car,8,0,8478,39,210,228,607,537,397,309,car
10776,6,skateboard,7,0,8479,26,1330,481,1418,927,88,446,skateboard
10777,26,skis,27,0,8479,28,1446,488,1505,917,59,429,skis
10778,31,rackets,32,1,8479,18,1634,485,1703,694,69,209,tennis racket
10779,38,car,39,1,8479,45,1639,711,2198,1350,559,639,car
10780,11,flowerpot,12,0,8481,15,609,1081,724,1195,115,114,potted plant
10781,5,ball,6,0,8482,15,356,671,432,750,76,79,sports ball
10782,14,bicycle,15,0,8482,77,115,2,294,405,179,403,bicycle
10783,15,bicycle,16,1,8482,56,2,0,138,734,136,734,bicycle
10784,2,car,3,0,8483,71,121,31,942,737,821,706,car
10785,10,door,11,0,8483,19,177,78,313,455,136,377,door
10786,6,refrigerator,7,0,8484,23,168,64,215,145,47,81,refrigerator
10787,7,car,8,1,8485,38,553,433,957,765,404,332,car
10788,8,car,9,1,8485,34,59,452,457,766,398,314,car
10789,0,car,1,0,8486,43,69,352,1839,963,1770,611,car
10790,15,door,16,0,8486,18,866,386,1378,840,512,454,door
10791,19,door,20,0,8486,21,465,380,927,840,462,460,door
10792,12,bottle,13,0,8487,16,1018,1091,1127,1283,109,192,bottle
10793,18,bicycle,19,1,8488,27,751,346,860,476,109,130,bicycle
10794,1,car,2,0,8490,40,75,42,214,192,139,150,car
10795,11,person,12,1,8492,18,2,432,46,715,44,283,person
10796,12,person,13,0,8492,35,2,413,113,741,111,328,person
10797,1,car,2,1,8495,42,0,103,1103,1533,1103,1430,car
10798,17,suitcase,18,0,8495,18,1278,1013,1514,1341,236,328,suitcase
10799,19,person,20,0,8495,144,1387,390,1839,1458,452,1068,person
10800,27,door,28,0,8495,22,0,241,857,1531,857,1290,door
10801,28,window,29,0,8495,19,97,311,757,956,660,645,window
10802,4,car,5,1,8496,42,1309,747,2196,1465,887,718,car
10803,17,door,18,0,8496,24,1393,780,1717,1225,324,445,door
10804,2,car,3,1,8497,46,139,373,1278,958,1139,585,car
10805,18,door,19,0,8497,20,312,406,567,772,255,366,door
10806,24,door,25,0,8497,21,529,404,827,815,298,411,door
10807,0,car,1,0,25005,57,105,95,977,710,872,615,car
10808,1,person,2,1,180,105,68,10,613,440,545,430,person
10809,13,table,14,1,180,26,1,336,424,440,423,104,dining table
10810,14,laptop,15,1,180,24,1,300,254,416,253,116,laptop
10811,1,chair,2,0,9314,36,399,405,729,763,330,358,chair
10812,39,pot,31,0,9314,16,702,311,744,338,42,27,potted plant
10813,56,desk,47,0,9314,40,177,1,560,701,383,700,desk
10814,59,chair,50,0,9314,22,2,589,135,769,133,180,chair
10815,99,flowerpot,63,0,9314,33,35,525,177,681,142,156,potted plant
10816,105,door,69,0,9314,25,225,48,381,399,156,351,door
10817,4,desk,5,0,9315,24,151,862,2200,1267,2049,405,desk
10818,4,chair,5,0,9316,80,547,292,886,768,339,476,chair
10819,28,chair,28,0,9316,21,2,407,320,768,318,361,chair
10820,5,table,6,0,9317,35,204,163,419,375,215,212,dining table
10821,12,desk,13,1,9318,18,195,221,354,400,159,179,desk
10822,14,bottle,14,0,9320,15,507,190,541,311,34,121,bottle
10823,37,table,29,0,9320,37,836,397,1150,794,314,397,dining table
10824,1,person,2,1,9321,17,1501,579,1598,1167,97,588,person
10825,3,chair,4,0,9321,20,682,1082,1181,1602,499,520,chair
10826,11,desk,12,1,9321,15,324,1123,1589,1650,1265,527,desk
10827,4,chair,5,0,9322,26,361,919,795,1526,434,607,chair
10828,13,chair,14,0,9324,27,600,345,916,769,316,424,chair
10829,7,chair,8,0,9325,87,709,365,991,746,282,381,chair
10830,8,chair,9,0,9325,99,218,296,373,548,155,252,chair
10831,3,table,4,0,9327,17,217,267,728,581,511,314,dining table
10832,0,chair,1,0,9329,16,126,169,193,252,67,83,chair
10833,9,desk,10,0,9329,17,27,151,166,223,139,72,desk
10834,0,table,1,0,9330,16,79,50,294,194,215,144,dining table
10835,5,table,6,0,9330,27,27,89,96,205,69,116,dining table
10836,7,desk,8,0,9331,19,28,112,172,201,144,89,desk
10837,9,chair,10,0,9331,24,46,100,123,224,77,124,chair
10838,12,hat,13,0,9331,15,190,174,226,193,36,19,hat
10839,15,chair,15,0,9332,43,244,264,408,481,164,217,chair
10840,8,desk,9,0,9333,43,2,185,189,391,187,206,desk
10841,10,table,11,1,9333,15,0,197,65,397,65,200,dining table
10842,6,desk,7,0,9334,22,331,341,572,540,241,199,desk
10843,9,chair,10,1,9334,19,637,328,791,583,154,255,chair
10844,7,desk,8,1,9335,19,0,409,759,664,759,255,desk
10845,9,chair,10,1,9335,24,334,350,577,662,243,312,chair
10846,5,desk,6,0,9336,46,0,74,526,449,526,375,desk
10847,4,desk,5,0,9337,35,2,182,327,263,325,81,desk
10848,17,chair,18,0,9337,28,145,205,251,352,106,147,chair
10849,23,window,24,1,9337,15,2,55,91,206,89,151,window
10850,24,window,25,0,9337,27,172,93,305,190,133,97,window
10851,7,chair,7,0,9338,34,412,293,678,737,266,444,chair
10852,17,desk,17,0,9338,39,295,189,806,615,511,426,desk
10853,18,desk,18,0,9338,27,769,269,1181,723,412,454,desk
10854,24,eyeglasses,24,0,9338,15,971,337,1021,358,50,21,eye glasses
10855,28,door,29,0,9339,20,764,18,956,713,192,695,door
10856,4,chair,5,0,9340,27,111,375,219,531,108,156,chair
10857,5,desk,6,1,9340,58,293,360,624,602,331,242,desk
10858,14,backpack,15,0,9340,23,414,526,539,631,125,105,backpack
10859,16,bottle,17,0,9340,16,628,541,672,620,44,79,bottle
10860,38,person,39,0,9340,58,232,292,396,565,164,273,person
10861,3,chair,4,0,9341,27,539,661,938,1329,399,668,chair
10862,10,desk,11,0,9341,19,0,669,991,1179,991,510,desk
10863,4,window,5,1,9342,16,365,2,397,126,32,124,window
10864,15,desk,16,0,9342,41,119,150,448,353,329,203,desk
10865,1,keyboard,2,0,9343,25,76,74,143,101,67,27,keyboard
10866,5,desk,6,0,9343,25,0,49,270,207,270,158,desk
10867,1,chair,2,0,9344,23,127,112,227,251,100,139,chair
10868,14,sofa,15,1,9344,20,0,165,45,242,45,77,couch
10869,1,desk,2,0,9345,21,79,153,188,254,109,101,desk
10870,10,window,11,0,9345,30,137,94,197,187,60,93,window
10871,8,chair,9,0,9348,29,191,169,321,367,130,198,chair
10872,19,desk,20,0,9348,21,108,197,458,378,350,181,desk
10873,2,desk,3,1,9349,18,95,137,348,223,253,86,desk
10874,11,chair,12,1,9349,21,0,99,187,223,187,124,chair
10875,7,desk,8,0,9350,35,31,175,238,260,207,85,desk
10876,9,chair,10,1,9350,23,140,178,229,259,89,81,chair
10877,9,desk,10,0,9351,32,105,217,424,386,319,169,desk
10878,23,clock,24,0,9351,16,48,122,70,152,22,30,clock
10879,2,desk,3,0,9352,56,133,185,553,390,420,205,desk
10880,3,chair,4,0,9352,57,266,184,383,359,117,175,chair
10881,10,window,11,0,9352,22,122,0,330,190,208,190,window
10882,4,desk,5,0,9353,41,32,159,251,239,219,80,desk
10883,3,desk,4,0,9354,51,174,261,847,814,673,553,desk
10884,26,keyboard,26,0,9355,17,737,1040,1026,1153,289,113,keyboard
10885,28,keyboard,28,1,9355,18,1021,943,1219,1013,198,70,keyboard
10886,29,desk,29,0,9355,58,308,938,1390,1649,1082,711,desk
10887,35,chair,35,1,9355,36,2,1222,627,1649,625,427,chair
10888,3,window,4,1,9356,18,681,0,1234,232,553,232,window
10889,4,desk,5,0,9356,37,561,327,2195,1630,1634,1303,desk
10890,15,scissors,16,0,9356,17,873,41,947,172,74,131,scissors
10891,7,desk,8,0,9357,24,519,362,847,679,328,317,desk
10892,29,desk,30,0,9357,37,0,522,436,959,436,437,desk
10893,46,window,47,0,9357,17,937,63,1156,264,219,201,window
10894,49,chair,50,1,9357,29,1195,517,1279,959,84,442,chair
10895,2,sofa,3,1,9358,18,1395,956,2198,1513,803,557,couch
10896,8,desk,9,0,9358,90,143,476,1939,1510,1796,1034,desk
10897,4,sofa,5,1,9359,37,1522,730,2198,1654,676,924,couch
10898,16,desk,17,1,9359,74,306,667,974,945,668,278,desk
10899,23,backpack,23,0,9359,33,816,841,1009,1068,193,227,backpack
10900,28,chair,28,0,9359,40,185,727,475,1163,290,436,chair
10901,20,bottle,21,1,9360,15,612,489,679,655,67,166,bottle
10902,31,desk,32,1,9360,57,171,635,839,1124,668,489,desk
10903,9,desk,10,0,9361,41,526,1223,1438,1918,912,695,desk
10904,12,chair,13,1,9361,42,4,1131,716,1918,712,787,chair
10905,13,window,14,0,9361,18,0,276,1168,1336,1168,1060,window
10906,15,clock,15,0,9361,18,377,21,628,274,251,253,clock
10907,4,desk,5,0,9362,26,1461,750,2046,1150,585,400,desk
10908,5,desk,6,0,9362,113,241,501,1587,1532,1346,1031,desk
10909,13,keyboard,14,0,9363,18,568,487,1140,734,572,247,keyboard
10910,14,desk,15,0,9363,75,283,331,1276,959,993,628,desk
10911,15,chair,16,1,9363,33,515,430,1278,959,763,529,chair
10912,17,mouse,18,0,9363,17,1066,407,1180,511,114,104,mouse
10913,2,desk,3,0,9364,44,0,216,1594,1044,1594,828,desk
10914,16,window,17,0,9364,33,0,2,309,264,309,262,window
10915,20,window,21,1,9364,18,1261,2,1599,426,338,424,window
10916,4,vase,5,0,9365,18,946,607,1095,705,149,98,vase
10917,10,window,11,1,9365,30,205,45,683,559,478,514,window
10918,8,table,8,0,9366,30,688,829,1301,1301,613,472,dining table
10919,11,chair,11,0,9366,63,483,833,849,1324,366,491,chair
10920,51,chair,50,1,9366,40,1571,676,2046,1136,475,460,chair
10921,6,desk,7,1,9367,54,314,1122,2195,1647,1881,525,desk
10922,7,keyboard,8,1,9367,19,804,1338,1170,1540,366,202,keyboard
10923,12,chair,13,1,9367,30,1107,1260,1876,1649,769,389,chair
10924,21,desk,22,1,9368,75,543,718,2100,1541,1557,823,desk
10925,23,chair,24,0,9368,40,1032,613,1604,1604,572,991,chair
10926,4,chair,5,1,9369,23,121,158,180,254,59,96,chair
10927,11,desk,12,0,9369,29,85,173,221,282,136,109,desk
10928,5,desk,6,0,9370,27,56,386,1020,767,964,381,desk
10929,3,chair,4,1,9371,63,893,320,1596,1198,703,878,chair
10930,8,desk,9,0,9371,42,0,727,998,1198,998,471,desk
10931,9,desk,10,0,9372,35,0,336,689,999,689,663,desk
10932,27,keyboard,28,0,9372,18,20,686,209,779,189,93,keyboard
10933,6,desk,7,0,9373,46,1067,122,2046,1183,979,1061,desk
10934,28,chair,29,0,9373,45,779,534,1324,1419,545,885,chair
10935,32,table,33,0,9373,70,470,983,850,1531,380,548,dining table
10936,12,bowl,13,0,9374,18,85,509,186,572,101,63,bowl
10937,21,desk,22,0,9374,27,537,679,796,1164,259,485,desk
10938,17,chair,18,1,9375,42,1,540,308,974,307,434,chair
10939,24,chair,25,1,9375,34,337,433,499,814,162,381,chair
10940,25,chair,26,0,9375,28,474,559,776,988,302,429,chair
10941,26,chair,27,1,9375,39,958,531,1282,1017,324,486,chair
10942,27,desk,28,0,9375,48,440,215,835,609,395,394,desk
10943,28,chair,29,1,9375,18,692,378,787,535,95,157,chair
10944,38,table,39,1,9375,74,475,557,1207,1050,732,493,dining table
10945,47,chair,48,1,9375,21,1460,497,1599,862,139,365,chair
10946,60,clock,61,0,9375,16,739,198,803,266,64,68,clock
10947,5,door,6,1,9376,21,52,366,373,1039,321,673,door
10948,16,desk,17,0,9376,42,532,747,990,1072,458,325,desk
10949,20,window,21,0,9376,26,1310,243,1598,686,288,443,window
10950,22,television,23,0,9376,15,1044,745,1283,982,239,237,tv
10951,10,desk,11,0,9377,57,597,377,1023,767,426,390,desk
10952,11,desk,12,0,9377,29,389,380,629,642,240,262,desk
10953,15,desk,16,0,9378,53,99,346,863,896,764,550,desk
10954,14,chair,15,1,9379,16,978,413,1106,492,128,79,chair
10955,18,desk,19,1,9379,66,711,480,1403,763,692,283,desk
10956,22,glasses,23,0,9379,22,945,717,1013,757,68,40,eye glasses
10957,4,desk,5,0,9380,59,0,293,903,767,903,474,desk
10958,5,keyboard,6,0,9380,24,253,389,497,516,244,127,keyboard
10959,4,desk,5,0,9381,46,0,610,898,1127,898,517,desk
10960,38,chair,39,0,9381,60,453,764,838,1196,385,432,chair
10961,2,desk,3,0,9382,93,14,77,310,188,296,111,desk
10962,3,desk,4,0,9383,78,71,130,1801,1194,1730,1064,desk
10963,4,person,5,1,9383,42,801,296,1165,804,364,508,person
10964,5,desk,6,0,9384,20,934,806,1376,1158,442,352,desk
10965,9,desk,10,1,9384,23,33,880,415,1368,382,488,desk
10966,7,desk,8,1,9385,56,662,302,1019,688,357,386,desk
10967,8,desk,9,1,9385,35,341,455,670,691,329,236,desk
10968,17,chair,18,0,9385,52,794,464,954,709,160,245,chair
10969,23,desk,24,0,9386,66,2,499,1021,766,1019,267,desk
10970,1,desk,2,0,9387,51,2,198,274,633,272,435,desk
10971,2,desk,3,1,9387,53,391,218,641,638,250,420,desk
10972,3,desk,4,1,9387,60,630,221,907,660,277,439,desk
10973,55,chair,56,0,9387,21,404,537,570,755,166,218,chair
10974,56,chair,57,0,9387,21,666,548,863,765,197,217,chair
10975,3,window,4,1,9388,23,405,1,905,204,500,203,window
10976,14,desk,15,0,9388,42,394,430,1007,848,613,418,desk
10977,18,chair,19,0,9388,93,955,370,1278,897,323,527,chair
10978,19,sofa,20,1,9388,27,0,246,385,743,385,497,couch
10979,21,chair,22,1,9388,23,117,576,419,914,302,338,chair
10980,10,desk,10,0,9389,60,105,329,1213,847,1108,518,desk
10981,6,keyboard,7,0,9390,17,527,766,906,898,379,132,keyboard
10982,11,desk,12,0,9390,85,3,666,1407,1054,1404,388,desk
10983,14,chair,15,1,9390,21,859,806,1405,1054,546,248,chair
10984,2,desk,3,0,9391,34,390,363,1243,1481,853,1118,desk
10985,21,window,21,0,9391,27,0,331,328,1106,328,775,window
10986,25,chair,25,1,9391,77,1813,788,2082,1051,269,263,chair
10987,26,chair,26,1,9391,130,1535,791,1818,1434,283,643,chair
10988,27,bed,27,1,9391,26,1741,1038,2104,1703,363,665,bed
10989,2,desk,3,0,9392,53,2,229,1023,767,1021,538,desk
10990,5,keyboard,6,0,9393,15,745,520,1045,648,300,128,keyboard
10991,8,desk,9,0,9393,60,527,456,1276,959,749,503,desk
10992,9,chair,10,0,9393,37,2,436,367,957,365,521,chair
10993,3,keyboard,4,0,9394,16,473,489,694,549,221,60,keyboard
10994,4,desk,5,0,9394,54,2,152,1020,767,1018,615,desk
10995,7,desk,8,1,9395,48,315,404,1278,958,963,554,desk
10996,11,chair,12,0,9395,42,254,426,500,773,246,347,chair
10997,12,chair,13,1,9395,22,574,663,991,959,417,296,chair
10998,4,desk,5,1,9396,99,1379,578,2133,1562,754,984,desk
10999,13,bottle,14,0,9396,20,1778,649,1861,867,83,218,bottle
11000,14,bottle,15,1,9396,17,1824,540,1890,688,66,148,bottle
11001,26,window,27,0,9396,31,715,1,1685,697,970,696,window
11002,40,sofa,41,1,9396,18,0,759,345,1339,345,580,couch
11003,2,window,3,0,9397,18,1750,0,2197,878,447,878,window
11004,32,desk,32,1,9397,84,417,673,1565,1173,1148,500,desk
11005,43,glasses,42,0,9397,17,973,741,1107,774,134,33,eye glasses
11006,53,table,52,1,9397,29,1,1029,2180,1647,2179,618,dining table
11007,4,desk,5,0,9398,25,216,427,664,753,448,326,desk
11008,14,flowerpot,15,1,9398,19,772,497,861,584,89,87,potted plant
11009,16,desk,17,1,9398,62,910,414,1393,800,483,386,desk
11010,1,desk,2,0,9399,43,111,342,919,796,808,454,desk
11011,4,window,5,0,9400,38,163,21,223,143,60,122,window
11012,6,person,7,0,9400,49,197,63,236,216,39,153,person
11013,11,desk,12,0,9400,49,36,141,207,227,171,86,desk
11014,21,desk,22,0,9401,41,21,216,760,1099,739,883,desk
11015,26,book,27,0,9401,19,475,622,623,655,148,33,book
11016,9,desk,10,0,9402,60,149,329,659,670,510,341,desk
11017,12,cup,13,0,9402,17,1060,502,1199,576,139,74,cup
11018,17,desk,18,1,9403,80,191,1064,2198,1650,2007,586,desk
11019,18,chair,19,1,9403,19,1471,1425,2093,1650,622,225,chair
11020,6,desk,7,0,9404,31,394,839,1060,1407,666,568,desk
11021,24,window,25,0,9404,27,984,0,1555,910,571,910,window
11022,43,chair,44,1,9404,27,451,968,958,1468,507,500,chair
11023,7,desk,8,0,9405,31,541,507,2003,1214,1462,707,desk
11024,16,glasses,17,0,9405,22,1909,686,1986,745,77,59,eye glasses
11025,19,laptop,20,0,9405,25,864,403,1316,709,452,306,laptop
11026,32,bowl,33,0,9405,17,667,458,815,551,148,93,bowl
11027,9,chair,10,1,9406,32,1188,1078,1649,2005,461,927,chair
11028,10,desk,11,0,9406,40,49,1077,1402,2197,1353,1120,desk
11029,19,mirror,19,0,9406,16,155,245,972,1136,817,891,mirror
11030,7,desk,8,0,9407,27,347,975,1473,1649,1126,674,desk
11031,14,window,15,1,9407,24,0,0,468,1158,468,1158,window
11032,15,chair,16,1,9407,58,0,787,754,1647,754,860,chair
11033,12,suitcase,13,1,9408,26,1174,1086,1330,1339,156,253,suitcase
11034,13,desk,14,0,9408,85,231,896,1183,1537,952,641,desk
11035,14,bottle,15,0,9408,15,1139,1230,1192,1416,53,186,bottle
11036,20,backpack,21,1,9408,18,541,1021,613,1208,72,187,backpack
11037,22,keyboard,23,0,9408,19,463,939,761,1001,298,62,keyboard
11038,6,plant pot,7,0,20905,15,724,279,808,360,84,81,potted plant
11039,7,window,8,0,20905,19,818,0,1055,342,237,342,window
11040,10,door,11,0,20905,27,1371,0,1600,957,229,957,door
11041,18,laptop,19,0,20905,20,303,338,640,662,337,324,laptop
11042,19,vase,20,0,20905,18,197,487,304,593,107,106,vase
11043,22,chair,23,0,20905,20,84,856,625,1199,541,343,chair
11044,23,table,24,0,20905,45,1,526,1022,1200,1021,674,dining table
11045,28,bottle,29,1,20906,23,973,264,1039,433,66,169,bottle
11046,5,desk,6,0,20907,30,875,531,1797,1037,922,506,desk
11047,7,chair,8,0,20907,86,966,404,1244,956,278,552,chair
11048,8,chair,9,1,20908,33,0,1166,1174,2200,1174,1034,chair
11049,12,desk,12,0,20908,45,602,1157,1649,2050,1047,893,desk
11050,7,window,8,0,20909,17,1186,84,1523,985,337,901,window
11051,10,desk,11,0,20909,41,562,855,1980,1648,1418,793,desk
11052,11,laptop,12,0,20909,17,974,758,1451,1166,477,408,laptop
11053,17,table,18,0,20909,26,3,994,766,1458,763,464,dining table
11054,22,bowl,23,0,20909,24,306,959,614,1111,308,152,bowl
11055,25,chair,26,0,20909,44,670,977,1388,1650,718,673,chair
11056,6,desk,7,0,20910,73,459,728,1351,1200,892,472,desk
11057,18,chair,19,0,20910,95,277,671,709,1200,432,529,chair
11058,19,chair,20,0,20910,57,691,844,963,1200,272,356,chair
11059,1,chair,2,1,23532,32,992,854,1552,1674,560,820,chair
11060,3,person,4,1,23532,82,0,463,1638,2200,1638,1737,person
11061,4,desk,5,0,23533,34,117,311,510,567,393,256,desk
11062,5,book,6,0,23533,20,256,343,407,375,151,32,book
11063,11,glasses,12,0,23533,19,208,358,240,371,32,13,eye glasses
11064,12,chair,13,0,23533,34,218,375,367,602,149,227,chair
11065,1,sofa,2,1,23536,18,937,253,1198,1600,261,1347,couch
11066,2,person,3,1,23537,26,1,0,266,682,265,682,person
11067,7,desk,8,0,23537,48,216,317,974,683,758,366,desk
11068,13,chair,14,1,23537,18,960,392,1022,682,62,290,chair
11069,14,chair,15,1,23537,23,290,333,438,530,148,197,chair
11070,0,desk,1,0,23538,20,16,195,1022,680,1006,485,desk
11071,4,sofa,5,1,23539,22,474,259,612,372,138,113,couch
11072,6,chair,7,0,23539,46,456,283,546,395,90,112,chair
11073,12,chair,13,1,23539,28,44,280,254,396,210,116,chair
11074,13,table,14,0,23539,18,1,357,393,611,392,254,dining table
11075,14,person,15,1,23539,19,355,552,425,612,70,60,person
11076,8,chair,9,0,9411,25,123,563,253,681,130,118,chair
11077,7,sofa,8,0,9417,22,366,967,1538,1453,1172,486,couch
11078,6,sofa,7,1,9418,25,259,599,733,841,474,242,couch
11079,7,sofa,8,1,9418,23,486,614,985,975,499,361,couch
11080,6,chair,7,1,9419,19,491,568,557,655,66,87,chair
11081,7,chair,8,1,9419,41,357,591,509,756,152,165,chair
11082,15,remote control,16,0,9420,26,1152,1227,1266,1292,114,65,remote
11083,15,sofa,16,0,9423,16,935,764,1596,1198,661,434,couch
11084,8,person,9,1,9424,20,43,107,94,141,51,34,person
11085,9,person,10,1,9424,18,111,128,154,170,43,42,person
11086,10,person,11,1,9424,23,2,150,67,223,65,73,person
11087,11,person,12,1,9424,32,48,173,116,269,68,96,person
11088,15,sofa,16,0,9425,29,862,730,1683,1259,821,529,couch
11089,13,sofa,14,1,9428,27,27,796,1278,959,1251,163,couch
11090,7,sofa,8,1,9429,28,1,823,496,1247,495,424,couch
11091,5,chair,6,1,9430,39,100,1037,665,1697,565,660,chair
11092,6,chair,7,1,9430,19,627,997,1008,1342,381,345,chair
11093,8,chair,9,1,9430,19,1220,901,1503,1168,283,267,chair
11094,9,chair,10,1,9430,28,1110,1037,1637,1760,527,723,chair
11095,7,sofa,8,0,9431,61,414,553,1469,1051,1055,498,couch
11096,7,sofa,8,0,23540,20,603,542,1061,716,458,174,couch
11097,14,suitcase,15,0,23541,30,334,308,466,439,132,131,suitcase
11098,19,chair,20,0,23541,22,641,498,964,683,323,185,chair
11099,9,bottle,10,0,23543,16,388,463,417,561,29,98,bottle
11100,9,bed,10,1,185,81,188,202,852,480,664,278,bed
11101,12,person,13,1,185,74,179,19,383,478,204,459,person
11102,14,plate,11,0,9520,29,1294,878,1656,1169,362,291,plate
11103,20,bowl,17,0,9520,15,917,654,1159,857,242,203,bowl
11104,22,bed,19,1,9520,25,1777,438,2197,1294,420,856,bed
11105,23,table,20,0,9520,20,340,514,1987,1645,1647,1131,dining table
11106,29,bowl,26,0,9520,16,1388,842,1622,1092,234,250,bowl
11107,6,backpack,7,0,9523,49,1372,767,1791,1451,419,684,backpack
11108,7,chair,8,0,9523,23,1300,940,1932,1537,632,597,chair
11109,9,desk,10,0,9523,30,173,641,1865,1252,1692,611,desk
11110,0,television,1,0,9525,16,109,803,707,1359,598,556,tv
11111,4,bottle,5,0,9525,17,1641,1213,1731,1492,90,279,bottle
11112,0,mirror,1,0,9526,15,1256,138,1619,863,363,725,mirror
11113,1,television,2,0,9526,22,318,521,771,940,453,419,tv
11114,12,remote control,13,0,9526,18,434,464,570,521,136,57,remote
11115,13,keyboard,14,0,9526,21,365,1034,642,1103,277,69,keyboard
11116,0,television,1,0,9527,16,1371,460,1879,944,508,484,tv
11117,6,suitcase,7,0,9527,18,237,947,420,1169,183,222,suitcase
11118,7,chair,8,0,9527,34,529,790,802,1140,273,350,chair
11119,8,table,9,1,9527,18,667,793,1032,1155,365,362,dining table
11120,9,chair,10,1,9527,18,834,867,971,1104,137,237,chair
11121,2,bed,3,0,9529,34,747,591,1935,1515,1188,924,bed
11122,5,bed,6,0,9529,36,2,587,1066,1257,1064,670,bed
11123,23,bed,24,1,9530,26,1418,322,2044,1534,626,1212,bed
11124,1,table,2,0,9532,59,237,196,510,427,273,231,dining table
11125,2,chair,3,0,9532,73,321,215,432,423,111,208,chair
11126,5,sofa,6,1,9532,16,97,124,176,196,79,72,couch
11127,7,bed,8,0,9534,23,961,656,2197,1428,1236,772,bed
11128,15,chair,16,0,9534,18,600,523,754,822,154,299,chair
11129,20,chair,20,0,9534,16,828,509,1002,689,174,180,chair
11130,4,bed,5,0,9535,31,106,111,233,187,127,76,bed
11131,6,bed,7,1,9535,20,184,115,312,234,128,119,bed
11132,8,bed,9,0,9536,15,58,107,277,225,219,118,bed
11133,6,bed,7,1,9537,34,0,383,1027,897,1027,514,bed
11134,7,bed,8,0,9537,26,506,302,1292,758,786,456,bed
11135,11,bed,12,0,9538,21,237,248,639,510,402,262,bed
11136,4,bed,5,0,9539,62,0,265,1012,952,1012,687,bed
11137,2,bed,3,0,9540,46,785,535,2197,1649,1412,1114,bed
11138,10,backpack,11,0,9540,27,774,1037,1030,1316,256,279,backpack
11139,11,desk,12,0,9540,18,31,782,905,1117,874,335,desk
11140,11,bed,12,0,9541,18,125,119,292,191,167,72,bed
11141,15,bed,16,0,9541,18,0,141,261,240,261,99,bed
11142,12,bed,13,0,9542,52,111,580,798,1141,687,561,bed
11143,10,bed,11,0,9543,32,156,126,340,225,184,99,bed
11144,18,television,19,0,9543,19,192,36,225,75,33,39,tv
11145,9,bed,10,0,9544,30,12,143,221,272,209,129,bed
11146,12,bed,13,0,9544,19,26,140,273,299,247,159,bed
11147,6,chair,7,1,9545,15,354,198,408,270,54,72,chair
11148,11,bed,12,0,9545,30,106,210,323,330,217,120,bed
11149,2,bed,3,0,9546,24,3,547,1992,1509,1989,962,bed
11150,4,bed,5,0,9547,53,825,422,1704,1180,879,758,bed
11151,10,desk,11,0,9547,16,791,503,1009,647,218,144,desk
11152,15,suitcase,16,1,9547,16,3,881,502,1197,499,316,suitcase
11153,21,chair,22,1,9547,19,860,510,1002,634,142,124,chair
11154,20,window,21,0,9548,18,1597,661,1783,973,186,312,window
11155,23,bed,24,1,9548,39,1170,656,2047,1536,877,880,bed
11156,24,bed,25,0,9548,97,374,751,1157,1533,783,782,bed
11157,5,bed,6,0,9549,15,3,471,1681,1288,1678,817,bed
11158,8,chair,9,1,9550,20,29,125,67,234,38,109,chair
11159,14,bed,15,0,9550,34,115,97,289,223,174,126,bed
11160,15,bed,16,1,9550,17,139,125,312,235,173,110,bed
11161,5,bed,6,0,9551,16,147,81,302,202,155,121,bed
11162,1,bed,2,0,9552,24,52,151,299,300,247,149,bed
11163,3,bed,4,1,9553,72,0,0,1049,958,1049,958,bed
11164,7,bed,8,0,9554,27,22,123,133,198,111,75,bed
11165,20,television,21,1,9554,20,282,0,336,42,54,42,tv
11166,1,bed,2,1,9555,24,0,183,1151,862,1151,679,bed
11167,4,bed,5,0,9556,33,179,120,288,188,109,68,bed
11168,10,sofa,11,0,9556,17,0,154,171,257,171,103,couch
11169,5,sofa,6,0,9557,17,549,379,1241,758,692,379,couch
11170,7,bed,8,1,9557,28,0,358,1533,1530,1533,1172,bed
11171,3,bed,4,0,9558,23,97,59,319,240,222,181,bed
11172,5,chair,6,1,9559,19,218,105,256,151,38,46,chair
11173,11,bed,12,0,9559,47,96,94,235,185,139,91,bed
11174,12,bed,13,0,9559,27,0,103,170,246,170,143,bed
11175,16,bed,17,1,9560,20,209,137,300,177,91,40,bed
11176,6,bed,7,0,9561,25,28,128,331,256,303,128,bed
11177,4,bed,5,1,9562,31,56,105,331,255,275,150,bed
11178,12,chair,13,1,9562,18,117,123,147,159,30,36,chair
11179,13,person,14,1,9562,62,32,94,134,254,102,160,person
11180,3,chair,4,0,9563,18,34,112,96,258,62,146,chair
11181,9,bed,10,1,9563,26,22,111,282,299,260,188,bed
11182,2,bed,3,0,9564,20,40,114,225,225,185,111,bed
11183,3,bed,4,0,9564,36,39,91,186,169,147,78,bed
11184,9,chair,10,0,9564,17,8,98,44,150,36,52,chair
11185,5,bed,6,0,9565,30,12,151,202,278,190,127,bed
11186,2,bed,3,0,9566,26,0,132,274,258,274,126,bed
11187,13,bed,14,0,9567,92,210,388,1745,1474,1535,1086,bed
11188,15,bed,16,1,9567,28,759,440,2166,1646,1407,1206,bed
11189,17,suitcase,18,0,9567,17,1433,1067,2100,1643,667,576,suitcase
11190,27,glasses,28,0,9567,26,1108,1213,1308,1335,200,122,eye glasses
11191,8,bed,9,1,9568,19,144,125,238,213,94,88,bed
11192,5,bed,6,0,9569,23,80,103,173,161,93,58,bed
11193,6,sofa,7,1,9569,25,152,102,251,258,99,156,couch
11194,7,bed,8,1,9570,47,1148,1371,1648,2009,500,638,bed
11195,9,desk,10,0,9570,19,2,1234,362,2163,360,929,desk
11196,11,chair,12,0,9570,66,105,1197,659,2066,554,869,chair
11197,13,chair,14,1,9570,59,446,1072,867,1527,421,455,chair
11198,15,chair,16,1,9570,38,1099,1083,1505,1524,406,441,chair
11199,24,backpack,25,0,9570,17,1348,1130,1487,1331,139,201,backpack
11200,11,person,12,0,9571,81,415,320,572,676,157,356,person
11201,13,suitcase,14,0,9571,19,846,553,1022,710,176,157,suitcase
11202,6,bed,7,0,9572,54,30,396,2099,1649,2069,1253,bed
11203,15,desk,16,0,9573,33,1773,765,2199,1650,426,885,desk
11204,26,bed,27,1,9573,55,1,590,1379,1648,1378,1058,bed
11205,9,chair,10,1,9574,21,56,115,95,176,39,61,chair
11206,14,bed,15,0,9574,26,75,116,312,235,237,119,bed
11207,7,bed,8,0,9575,38,84,88,226,181,142,93,bed
11208,9,bed,10,1,9575,21,151,103,299,199,148,96,bed
11209,7,bed,8,0,9576,88,368,350,1349,1028,981,678,bed
11210,9,bed,10,1,9577,26,2,549,675,939,673,390,bed
11211,13,chair,14,1,9578,17,167,190,231,281,64,91,chair
11212,17,bed,18,0,9579,56,617,212,2199,1649,1582,1437,bed
11213,12,television,13,0,9580,20,245,84,348,205,103,121,tv
11214,13,table,14,1,9580,16,172,137,347,232,175,95,dining table
11215,16,bed,17,1,9580,20,3,85,114,187,111,102,bed
11216,7,bed,8,0,9581,17,400,208,601,336,201,128,bed
11217,9,desk,10,0,9581,15,2,214,180,362,178,148,desk
11218,10,chair,11,0,9581,42,104,207,191,345,87,138,chair
11219,18,bed,19,0,9582,55,536,474,1722,1158,1186,684,bed
11220,16,chair,17,0,9583,26,780,568,1031,886,251,318,chair
11221,17,chair,18,0,9583,15,1085,631,1359,972,274,341,chair
11222,18,table,19,1,9583,21,993,603,1411,653,418,50,dining table
11223,28,bed,29,0,9583,30,1,690,1621,1536,1620,846,bed
11224,19,bed,20,1,9584,17,1,271,998,960,997,689,bed
11225,20,bed,21,0,9584,47,492,233,1279,958,787,725,bed
11226,3,bed,4,0,9586,64,113,23,307,210,194,187,bed
11227,7,bed,8,0,9586,62,5,29,164,174,159,145,bed
11228,5,bed,6,1,9587,18,0,1008,812,1521,812,513,bed
11229,9,bed,10,0,9587,66,208,740,1219,1275,1011,535,bed
11230,10,sofa,11,1,9587,21,690,758,1114,924,424,166,couch
11231,20,chair,18,0,9587,27,1487,818,1712,1067,225,249,chair
11232,3,bed,4,0,9588,38,181,192,508,362,327,170,bed
11233,5,bed,6,0,9588,28,0,211,329,444,329,233,bed
11234,14,table,15,0,9589,20,2,126,53,169,51,43,dining table
11235,15,chair,16,0,9589,17,34,125,60,171,26,46,chair
11236,16,chair,17,0,9589,22,4,129,34,176,30,47,chair
11237,11,bed,12,1,9590,15,54,141,314,238,260,97,bed
11238,6,bed,7,0,9591,36,0,599,1117,1348,1117,749,bed
11239,11,bed,12,1,9591,18,326,691,2021,1348,1695,657,bed
11240,6,desk,6,0,9592,15,2,491,461,837,459,346,desk
11241,13,bed,12,1,9592,16,915,418,1602,839,687,421,bed
11242,2,bed,3,1,9593,38,0,252,796,943,796,691,bed
11243,15,chair,14,1,9593,27,318,581,798,1064,480,483,chair
11244,3,chair,4,0,9594,15,176,133,235,215,59,82,chair
11245,6,table,7,0,9594,32,210,143,283,222,73,79,dining table
11246,9,bed,10,1,9594,41,0,152,199,257,199,105,bed
11247,10,bed,11,1,9594,24,2,211,94,323,92,112,bed
11248,4,bed,4,1,9595,53,62,625,1639,1471,1577,846,bed
11249,6,bed,6,0,9595,60,982,582,2053,1354,1071,772,bed
11250,6,bed,6,0,9596,42,0,379,549,737,549,358,bed
11251,7,bed,7,1,9596,23,323,433,1193,796,870,363,bed
11252,16,bed,17,0,9597,75,292,491,2199,1649,1907,1158,bed
11253,19,sofa,20,0,9597,31,1528,478,2198,1102,670,624,couch
11254,9,bed,9,0,9598,53,284,318,946,776,662,458,bed
11255,16,bed,15,1,9598,25,0,355,652,862,652,507,bed
11256,9,bed,10,0,9599,41,122,85,280,172,158,87,bed
11257,10,bed,11,1,9599,22,153,120,302,202,149,82,bed
11258,11,chair,12,0,9599,24,73,95,109,153,36,58,chair
11259,14,table,15,1,9599,19,32,110,67,156,35,46,dining table
11260,7,bed,8,0,9600,27,0,411,772,1032,772,621,bed
11261,8,person,9,0,9600,46,215,500,487,981,272,481,person
11262,14,bed,15,1,9600,18,433,423,1450,1036,1017,613,bed
11263,3,bed,4,0,9601,37,163,508,1133,1198,970,690,bed
11264,4,backpack,5,0,9601,20,540,743,750,878,210,135,backpack
11265,3,bed,4,0,9602,23,0,555,1757,1425,1757,870,bed
11266,6,table,7,1,9602,17,1321,1220,2043,1424,722,204,dining table
11267,0,window,1,0,9603,16,0,15,63,138,63,123,window
11268,4,sofa,5,1,9603,31,52,81,139,135,87,54,couch
11269,10,bed,11,0,9603,58,48,68,299,213,251,145,bed
11270,6,bed,7,0,9604,24,216,344,1017,767,801,423,bed
11271,7,suitcase,8,0,9604,28,275,475,614,657,339,182,suitcase
11272,3,bed,4,1,9605,19,0,257,305,460,305,203,bed
11273,6,mirror,7,0,9605,41,55,128,128,263,73,135,mirror
11274,7,bed,8,1,9605,30,122,225,307,379,185,154,bed
11275,5,bed,6,0,9606,35,829,573,1935,1035,1106,462,bed
11276,6,bed,7,0,9606,31,3,672,1740,1357,1737,685,bed
11277,2,bed,3,0,9607,34,100,185,581,400,481,215,bed
11278,4,table,5,0,9607,17,126,183,200,239,74,56,dining table
11279,20,suitcase,21,0,9608,22,265,713,559,852,294,139,suitcase
11280,23,bed,24,0,9608,57,466,119,1160,823,694,704,bed
11281,34,suitcase,35,1,9608,30,1146,455,1225,601,79,146,suitcase
11282,18,bed,19,0,9609,74,117,515,2199,1650,2082,1135,bed
11283,26,bed,27,1,9610,35,1,1251,878,1650,877,399,bed
11284,32,bed,33,0,9610,100,463,561,2189,1650,1726,1089,bed
11285,41,vase,42,0,9610,26,254,1195,385,1342,131,147,vase
11286,5,bed,6,0,9611,83,27,57,255,211,228,154,bed
11287,25,desk,26,0,9612,37,101,629,298,812,197,183,desk
11288,29,suitcase,30,1,9612,38,306,582,391,675,85,93,suitcase
11289,41,bed,42,0,9612,82,233,471,880,934,647,463,bed
11290,43,bed,44,0,9612,55,286,737,960,1280,674,543,bed
11291,44,clock,45,0,9612,16,818,697,887,726,69,29,clock
11292,56,television,57,0,9612,16,53,340,90,517,37,177,tv
11293,16,bed,17,1,9613,76,572,827,2199,1650,1627,823,bed
11294,26,sofa,27,1,9613,142,634,826,1411,1176,777,350,couch
11295,27,person,28,1,9613,43,1064,821,1265,1045,201,224,person
11296,28,person,29,0,9613,55,1040,863,1316,1090,276,227,person
11297,29,person,30,1,9613,38,905,854,1072,1162,167,308,person
11298,23,table,24,0,9614,28,736,961,1009,1108,273,147,dining table
11299,28,chair,29,1,9614,27,76,915,328,1485,252,570,chair
11300,31,bed,32,0,9614,71,746,754,2197,1653,1451,899,bed
11301,33,backpack,34,0,9614,26,863,1070,1176,1207,313,137,backpack
11302,39,bed,40,1,9614,25,1021,1282,2199,1653,1178,371,bed
11303,20,bed,21,0,9615,163,303,445,1895,1649,1592,1204,bed
11304,5,bed,6,0,9616,36,68,218,512,415,444,197,bed
11305,7,bed,8,0,9616,16,277,130,394,187,117,57,bed
11306,8,bed,9,0,9616,17,391,133,472,226,81,93,bed
11307,9,bed,10,0,9616,23,479,132,584,228,105,96,bed
11308,10,bed,11,0,9616,18,559,139,707,232,148,93,bed
11309,1,bed,2,0,9617,18,63,157,255,256,192,99,bed
11310,8,chair,9,0,9618,19,342,219,401,309,59,90,chair
11311,9,bed,10,0,9618,48,11,85,298,348,287,263,bed
11312,14,table,15,0,9618,26,130,326,275,399,145,73,dining table
11313,10,bed,11,0,9620,32,471,199,1689,1110,1218,911,bed
11314,15,desk,16,1,9620,16,2,771,668,1109,666,338,desk
11315,7,bed,8,0,9621,28,58,38,254,212,196,174,bed
11316,15,chair,16,0,9623,15,366,151,407,220,41,69,chair
11317,5,bed,5,1,9624,47,919,389,2199,1646,1280,1257,bed
11318,6,bed,6,0,9624,60,394,334,1688,1177,1294,843,bed
11319,6,bed,7,1,9625,85,905,2,2198,1649,1293,1647,bed
11320,13,suitcase,13,0,9625,24,107,842,509,1172,402,330,suitcase
11321,14,chair,14,1,9625,32,2,314,205,1014,203,700,chair
11322,11,window,12,0,9628,29,203,91,432,447,229,356,window
11323,16,table,17,0,9628,54,39,425,206,615,167,190,dining table
11324,19,bed,20,0,9628,106,349,333,835,652,486,319,bed
11325,29,bed,30,1,9628,61,577,363,1024,767,447,404,bed
11326,36,chair,37,1,9628,40,2,438,114,656,112,218,chair
11327,8,table,9,0,9629,28,329,312,414,412,85,100,dining table
11328,11,sofa,12,0,9629,17,411,308,556,397,145,89,couch
11329,14,bed,15,0,9629,26,309,355,682,572,373,217,bed
11330,6,bed,7,0,9630,48,157,170,477,376,320,206,bed
11331,8,bed,9,1,9630,26,265,173,638,425,373,252,bed
11332,4,bed,5,0,9631,32,0,98,195,248,195,150,bed
11333,5,bed,6,0,9631,26,80,103,299,299,219,196,bed
11334,6,bed,7,1,9633,23,533,660,2114,1646,1581,986,bed
11335,7,bed,8,0,9633,55,15,593,1555,1649,1540,1056,bed
11336,11,chair,11,1,9633,15,557,653,836,942,279,289,chair
11337,5,bed,5,0,9634,45,139,353,1116,916,977,563,bed
11338,26,television,27,0,9635,28,98,760,518,1210,420,450,tv
11339,29,table,30,1,9635,39,492,755,773,1294,281,539,dining table
11340,30,chair,31,1,9635,42,550,712,822,1179,272,467,chair
11341,32,chair,33,1,9635,24,1819,689,2132,896,313,207,chair
11342,33,chair,34,0,9635,45,1173,667,1497,1059,324,392,chair
11343,34,bed,35,1,9635,50,1490,869,2197,1540,707,671,bed
11344,36,window,37,0,9635,25,1389,188,1931,753,542,565,window
11345,38,bed,39,1,9635,16,1799,1284,2198,1650,399,366,bed
11346,7,bed,7,0,9636,37,0,478,664,842,664,364,bed
11347,8,bed,8,0,9636,49,253,505,1270,959,1017,454,bed
11348,14,bed,15,0,9637,51,181,447,1483,1199,1302,752,bed
11349,5,bed,6,1,9638,27,0,93,162,206,162,113,bed
11350,6,bed,7,0,9638,27,143,88,275,196,132,108,bed
11351,3,bed,4,0,9639,34,788,762,2046,1530,1258,768,bed
11352,3,bed,4,1,9640,39,0,695,1829,1530,1829,835,bed
11353,18,bed,19,0,9641,30,2,104,777,768,775,664,bed
11354,1,bed,2,0,9642,75,259,258,1204,908,945,650,bed
11355,6,bed,7,1,9642,33,517,327,1596,1199,1079,872,bed
11356,10,person,11,0,9642,106,503,595,1575,1165,1072,570,person
11357,11,backpack,12,0,9642,27,188,665,302,843,114,178,backpack
11358,14,chair,15,1,9643,29,963,378,1112,489,149,111,chair
11359,15,bed,16,0,9643,48,603,348,1270,818,667,470,bed
11360,17,bed,18,1,9643,19,1,393,801,817,800,424,bed
11361,20,table,21,1,9643,21,1043,420,1227,491,184,71,dining table
11362,22,chair,23,1,9643,15,1155,416,1271,520,116,104,chair
11363,17,bed,18,0,9644,58,1272,836,2200,1440,928,604,bed
11364,31,sink,32,0,9644,20,752,709,920,851,168,142,sink
11365,39,bed,40,1,9644,21,101,1053,851,1650,750,597,bed
11366,10,bed,11,0,9645,74,65,387,2201,1648,2136,1261,bed
11367,2,bed,3,0,9646,25,6,251,2046,1534,2040,1283,bed
11368,8,bed,9,0,9647,17,0,105,294,225,294,120,bed
11369,22,bed,23,0,9648,144,114,259,862,767,748,508,bed
11370,43,sofa,44,1,9648,24,1,379,141,623,140,244,couch
11371,29,bed,30,0,9649,73,217,811,1824,1535,1607,724,bed
11372,33,bed,34,1,9649,28,1,1201,980,1536,979,335,bed
11373,17,microwave,18,1,9650,28,1400,506,1584,614,184,108,microwave
11374,18,chair,19,1,9650,23,1398,548,1561,798,163,250,chair
11375,21,bed,22,0,9650,110,215,526,2136,1649,1921,1123,bed
11376,22,clock,23,0,9650,21,273,930,375,1039,102,109,clock
11377,22,television,23,0,9651,39,1855,779,2200,1118,345,339,tv
11378,25,chair,26,1,9651,15,1655,894,1693,1180,38,286,chair
11379,27,chair,28,1,9651,24,1728,1114,2154,1649,426,535,chair
11380,30,bed,31,1,9651,54,1,774,1250,1648,1249,874,bed
11381,17,window,18,1,9652,15,917,207,969,332,52,125,window
11382,34,refrigerator,35,1,9652,17,717,284,810,474,93,190,refrigerator
11383,44,bowl,45,0,9652,16,1132,362,1169,393,37,31,bowl
11384,46,plate,47,0,9652,19,1122,387,1172,399,50,12,plate
11385,56,chair,57,1,9652,22,1,639,80,960,79,321,chair
11386,57,table,58,1,9652,20,558,422,648,584,90,162,dining table
11387,65,chair,66,1,9652,42,569,406,642,573,73,167,chair
11388,66,bed,67,0,9652,72,727,410,1252,576,525,166,bed
11389,67,bed,68,0,9652,112,423,537,1280,960,857,423,bed
11390,27,bed,27,0,9653,66,658,712,1872,1357,1214,645,bed
11391,28,bed,28,1,9653,25,1291,997,2046,1536,755,539,bed
11392,17,bed,18,0,9654,55,386,638,1535,1297,1149,659,bed
11393,18,bed,19,0,9654,17,1097,706,2159,1438,1062,732,bed
11394,11,bed,12,0,9655,61,852,676,1989,1349,1137,673,bed
11395,13,bed,14,0,9655,39,2,569,1325,1650,1323,1081,bed
11396,21,chair,22,1,9655,15,2043,1057,2199,1653,156,596,chair
11397,29,bed,30,0,9656,89,231,741,2015,1650,1784,909,bed
11398,33,sofa,34,1,9656,23,2,1272,996,1648,994,376,couch
11399,9,bed,10,0,9657,51,4,155,1541,1313,1537,1158,bed
11400,10,bed,11,0,9657,32,441,339,2196,1650,1755,1311,bed
11401,23,television,24,0,9658,37,1126,445,1236,585,110,140,tv
11402,25,chair,25,1,9658,31,1090,554,1279,812,189,258,chair
11403,26,table,26,1,9658,23,1089,609,1279,754,190,145,dining table
11404,29,bed,29,0,9658,69,152,459,886,878,734,419,bed
11405,32,bed,32,0,9658,24,1,648,745,959,744,311,bed
11406,9,chair,10,1,9659,25,1,326,199,485,198,159,chair
11407,10,chair,11,1,9659,39,260,252,451,423,191,171,chair
11408,14,bed,15,0,9659,64,1,180,1023,767,1022,587,bed
11409,10,bed,11,0,9660,79,284,577,1350,1232,1066,655,bed
11410,18,bed,19,0,9660,68,548,651,2197,1646,1649,995,bed
11411,16,bed,17,0,9661,39,635,368,1023,686,388,318,bed
11412,18,bed,19,1,9661,55,105,442,1023,767,918,325,bed
11413,4,bed,5,0,9662,21,210,1153,1466,2009,1256,856,bed
11414,7,bed,8,0,9663,50,489,333,1278,872,789,539,bed
11415,8,bed,9,0,9663,43,0,353,1211,959,1211,606,bed
11416,16,chair,17,1,9664,16,1519,604,1660,841,141,237,chair
11417,17,table,18,1,9664,20,1336,700,1691,844,355,144,dining table
11418,18,bed,19,0,9664,102,598,555,2198,1644,1600,1089,bed
11419,1,bed,2,1,9665,17,2,65,210,299,208,234,bed
11420,2,person,3,1,9665,46,2,46,116,298,114,252,person
11421,34,bed,35,0,9666,99,1,698,2196,1466,2195,768,bed
11422,19,bed,20,0,9667,59,38,51,1119,933,1081,882,bed
11423,24,sofa,25,0,9667,44,1023,353,1399,690,376,337,couch
11424,3,television,4,0,9668,16,1638,340,1999,640,361,300,tv
11425,9,bed,9,1,9668,35,0,463,2124,1464,2124,1001,bed
11426,6,bed,6,0,9669,62,0,246,2082,1648,2082,1402,bed
11427,2,person,3,1,9670,29,525,525,973,1080,448,555,person
11428,7,bed,8,1,9671,34,0,130,298,233,298,103,bed
11429,4,bed,5,0,9672,41,0,348,869,1023,869,675,bed
11430,5,bed,6,0,9672,40,472,266,1036,606,564,340,bed
11431,16,television,17,0,9672,19,1317,311,1501,523,184,212,tv
11432,20,chair,21,1,9672,27,1223,506,1359,947,136,441,chair
11433,26,chair,27,1,9672,15,1205,405,1319,602,114,197,chair
11434,4,bed,5,0,9673,17,0,465,2046,1533,2046,1068,bed
11435,5,person,6,0,9673,71,932,625,1599,1316,667,691,person
11436,15,bed,15,0,9674,27,268,320,1168,911,900,591,bed
11437,28,mirror,28,0,9674,25,827,15,1076,284,249,269,mirror
11438,17,chair,18,1,9675,27,865,563,1259,959,394,396,chair
11439,19,bed,20,0,9675,113,1,42,746,960,745,918,bed
11440,8,bed,9,0,9676,70,2,497,1570,1650,1568,1153,bed
11441,16,sofa,17,1,9676,32,1210,1176,2199,1650,989,474,couch
11442,16,bed,17,1,9677,55,1,113,680,601,679,488,bed
11443,23,bed,24,1,9677,43,398,160,1146,768,748,608,bed
11444,21,window,22,1,9678,18,453,290,480,545,27,255,window
11445,26,desk,27,0,9678,15,65,627,485,899,420,272,desk
11446,32,chair,33,1,9678,15,390,659,530,875,140,216,chair
11447,33,bed,34,0,9678,64,486,440,1052,898,566,458,bed
11448,42,bed,43,0,9678,33,741,434,1398,898,657,464,bed
11449,54,television,55,0,9678,19,4,142,139,532,135,390,tv
11450,12,bed,12,0,9679,36,369,297,968,723,599,426,bed
11451,29,sofa,30,0,20916,39,661,649,1495,1287,834,638,couch
11452,6,bed,7,0,20917,20,1065,811,2046,1534,981,723,bed
11453,7,bed,8,0,20917,38,679,801,1718,1520,1039,719,bed
11454,15,chair,16,1,20917,21,104,1044,567,1536,463,492,chair
11455,18,person,19,0,20918,35,581,380,727,532,146,152,person
11456,19,person,20,1,20918,20,658,410,809,629,151,219,person
11457,20,bed,21,1,20918,46,409,373,811,686,402,313,bed
11458,21,bed,22,1,20918,19,467,587,801,768,334,181,bed
11459,29,television,30,0,20918,17,48,377,191,517,143,140,tv
11460,30,backpack,31,0,20918,19,72,515,214,625,142,110,backpack
11461,9,bed,10,0,20919,206,437,138,1154,811,717,673,bed
11462,21,sofa,22,1,20919,25,142,597,440,959,298,362,couch
11463,13,table,14,1,20920,18,0,605,240,960,240,355,dining table
11464,14,chair,15,1,20920,19,8,518,166,619,158,101,chair
11465,17,chair,18,1,20920,44,339,476,551,833,212,357,chair
11466,9,television,9,0,20921,19,0,300,163,460,163,160,tv
11467,12,table,12,0,20921,51,524,377,747,631,223,254,dining table
11468,19,window,19,0,20921,15,764,0,973,365,209,365,window
11469,21,mirror,21,0,20921,42,147,46,338,381,191,335,mirror
11470,12,bed,13,0,20922,22,2,840,1750,1650,1748,810,bed
11471,14,bed,15,0,20922,64,557,732,1767,1464,1210,732,bed
11472,15,person,16,0,20922,75,714,618,1702,1081,988,463,person
11473,17,chair,18,1,20922,27,2058,897,2198,1459,140,562,chair
11474,15,bed,16,0,20923,34,208,915,2046,1536,1838,621,bed
11475,20,bed,21,0,20924,34,495,346,714,513,219,167,bed
11476,21,bed,22,0,20924,39,746,366,910,534,164,168,bed
11477,25,table,26,0,20924,18,995,453,1185,738,190,285,dining table
11478,27,chair,28,0,20924,16,884,409,1003,662,119,253,chair
11479,28,chair,29,0,20924,22,791,418,929,704,138,286,chair
11480,31,backpack,32,0,20924,22,390,594,512,751,122,157,backpack
11481,33,suitcase,34,0,20924,26,119,617,391,806,272,189,suitcase
11482,37,television,38,0,20924,15,95,278,174,436,79,158,tv
11483,12,bed,13,0,20925,99,0,483,2150,1650,2150,1167,bed
11484,16,table,17,0,20925,38,5,793,525,969,520,176,dining table
11485,9,bed,10,0,20926,99,280,801,2161,1650,1881,849,bed
11486,25,bed,26,0,20927,36,402,649,1813,1463,1411,814,bed
11487,22,chair,22,1,20928,35,1092,324,1200,663,108,339,chair
11488,27,table,27,0,20928,123,236,359,470,531,234,172,dining table
11489,30,bed,30,0,20928,26,1,500,1198,799,1197,299,bed
11490,10,chair,11,1,20929,26,1676,236,2013,686,337,450,chair
11491,13,bed,14,0,20929,42,266,274,2046,1536,1780,1262,bed
11492,17,bed,18,0,20930,52,759,525,1701,1038,942,513,bed
11493,18,bed,19,0,20930,53,1121,567,2198,1397,1077,830,bed
11494,7,bed,8,0,20931,139,52,481,1671,1534,1619,1053,bed
11495,15,bed,16,0,20932,17,742,1036,1649,1362,907,326,bed
11496,17,bed,18,0,20932,15,2,1283,1647,2200,1645,917,bed
11497,8,sink,9,0,20933,16,937,691,1166,818,229,127,sink
11498,17,bed,18,0,20933,25,0,862,1795,1536,1795,674,bed
11499,9,sofa,10,1,20934,27,257,432,915,749,658,317,couch
11500,13,television,14,0,20934,19,1552,590,1966,1015,414,425,tv
11501,17,bed,18,1,20934,36,1,512,553,1090,552,578,bed
11502,18,bed,19,1,20934,27,0,797,463,1535,463,738,bed
11503,20,chair,21,1,20934,25,1798,1165,2048,1535,250,370,chair
11504,24,window,25,0,20934,37,106,2,594,516,488,514,window
11505,13,bed,14,0,20935,72,263,324,826,768,563,444,bed
11506,14,bed,15,0,20935,67,524,323,1024,768,500,445,bed
11507,11,bed,12,0,20936,17,421,373,1199,826,778,453,bed
11508,12,bed,13,0,20936,31,0,314,401,645,401,331,bed
11509,7,bed,8,0,20937,43,795,722,1691,1202,896,480,bed
11510,10,bed,11,0,20937,42,8,731,1067,1385,1059,654,bed
11511,16,table,17,1,20937,25,1761,1085,2046,1536,285,451,dining table
11512,17,chair,18,1,20937,72,1634,1049,2020,1536,386,487,chair
11513,19,chair,20,1,20937,21,0,1176,207,1536,207,360,chair
11514,10,chair,11,1,20938,28,704,559,1122,848,418,289,chair
11515,11,bed,12,0,20938,58,4,634,1503,1646,1499,1012,bed
11516,12,bed,13,0,20938,53,1044,610,2198,1310,1154,700,bed
11517,9,bed,10,0,20939,43,956,416,2198,1650,1242,1234,bed
11518,11,bed,12,0,20939,69,321,412,1589,1321,1268,909,bed
11519,19,door,20,0,20940,20,134,125,456,660,322,535,door
11520,32,bed,33,0,20940,49,514,521,1280,876,766,355,bed
11521,9,bed,10,0,20941,50,1039,639,2047,1489,1008,850,bed
11522,14,bed,15,0,20941,32,23,704,1733,1536,1710,832,bed
11523,6,door,7,0,20942,20,1335,19,1904,1102,569,1083,door
11524,9,bed,10,0,20942,63,0,628,1335,1537,1335,909,bed
11525,10,bed,11,0,20942,29,1145,789,2198,1650,1053,861,bed
11526,13,chair,14,1,20942,47,1190,777,1676,1295,486,518,chair
11527,9,bed,10,1,20943,66,1192,468,2197,1650,1005,1182,bed
11528,14,bed,15,0,20943,107,0,490,1307,1650,1307,1160,bed
11529,23,plant pot,24,0,20943,38,1517,1192,1799,1493,282,301,potted plant
11530,8,bed,9,1,20944,55,1,399,872,937,871,538,bed
11531,13,bed,14,1,20945,29,0,717,1956,1650,1956,933,bed
11532,14,bed,15,0,20945,53,929,648,2197,1498,1268,850,bed
11533,29,desk,30,0,20946,46,1557,753,2196,1465,639,712,desk
11534,30,chair,31,1,20946,44,1557,757,1793,1406,236,649,chair
11535,36,bed,37,0,20946,62,36,595,1306,1365,1270,770,bed
11536,9,bed,10,0,20947,63,710,570,2114,1417,1404,847,bed
11537,11,bed,12,0,20947,35,71,670,1498,1650,1427,980,bed
11538,7,sofa,8,1,20948,35,1007,430,2046,1536,1039,1106,couch
11539,8,bed,9,0,20948,48,0,236,1336,1248,1336,1012,bed
11540,7,bed,8,1,20949,29,0,560,1755,1650,1755,1090,bed
11541,21,bed,22,0,20950,38,1,387,2020,1649,2019,1262,bed
11542,11,bed,12,1,20951,48,3,590,769,1334,766,744,bed
11543,12,bed,13,0,20952,22,499,661,2199,1467,1700,806,bed
11544,14,bed,15,0,20952,36,2,619,1314,1406,1312,787,bed
11545,15,chair,16,1,20952,29,445,636,731,883,286,247,chair
11546,17,chair,18,1,20952,37,233,622,498,927,265,305,chair
11547,21,bed,22,1,20953,18,611,459,1024,768,413,309,bed
11548,22,bed,23,0,20953,44,404,371,1024,726,620,355,bed
11549,24,bed,25,0,20953,44,223,330,687,567,464,237,bed
11550,28,television,29,0,20953,17,0,293,57,413,57,120,tv
11551,32,table,33,1,20953,24,0,471,219,551,219,80,dining table
11552,33,chair,34,1,20953,17,1,502,185,767,184,265,chair
11553,17,bed,18,0,20954,80,2,753,1413,1640,1411,887,bed
11554,18,bed,19,0,20954,52,831,781,2198,1640,1367,859,bed
11555,13,bed,14,0,20955,20,956,941,2047,1536,1091,595,bed
11556,14,bed,15,0,20955,47,67,867,1290,1534,1223,667,bed
11557,12,bed,13,1,20956,29,868,563,2048,1536,1180,973,bed
11558,13,bed,14,0,20956,61,64,500,1419,1373,1355,873,bed
11559,15,mirror,16,0,20956,31,4,317,472,686,468,369,mirror
11560,14,bed,15,0,20957,44,529,585,1906,1572,1377,987,bed
11561,13,bed,14,0,20958,50,0,218,838,784,838,566,bed
11562,14,bed,15,0,20958,41,196,227,1280,960,1084,733,bed
11563,10,table,11,0,20959,35,515,546,760,702,245,156,dining table
11564,11,chair,12,1,20959,34,663,523,799,762,136,239,chair
11565,12,bed,13,0,20959,46,0,529,783,1054,783,525,bed
11566,12,bed,13,0,20960,34,2,1095,754,1643,752,548,bed
11567,13,bed,14,0,20960,51,349,1112,1467,1910,1118,798,bed
11568,14,chair,15,0,20961,39,1546,784,1909,1273,363,489,chair
11569,17,bed,18,0,20961,146,278,458,1550,1613,1272,1155,bed
11570,18,bed,19,0,20962,53,0,671,1627,1536,1627,865,bed
11571,18,chair,19,1,20963,28,581,425,726,643,145,218,chair
11572,20,television,21,0,20963,15,141,400,385,632,244,232,tv
11573,21,table,22,0,20963,44,433,453,703,711,270,258,dining table
11574,22,chair,23,0,20963,39,377,464,554,751,177,287,chair
11575,29,bed,30,0,20963,20,605,562,1199,902,594,340,bed
11576,20,bed,21,0,20964,71,277,537,2058,1648,1781,1111,bed
11577,9,bed,10,0,20965,70,336,609,1820,1498,1484,889,bed
11578,14,chair,15,1,20965,32,262,915,712,1650,450,735,chair
11579,15,bed,16,0,20966,46,155,427,1283,1010,1128,583,bed
11580,17,bed,18,0,20967,40,2,153,768,768,766,615,bed
11581,18,suitcase,19,0,20967,23,218,459,589,682,371,223,suitcase
11582,9,door,10,0,20968,16,2,452,150,1136,148,684,door
11583,13,refrigerator,14,0,20968,18,945,1010,1213,1265,268,255,refrigerator
11584,14,table,15,1,20968,37,781,892,1204,1272,423,380,dining table
11585,18,mirror,19,0,20968,19,836,479,1072,836,236,357,mirror
11586,20,chair,21,0,20968,30,621,882,950,1274,329,392,chair
11587,25,plate,26,0,20968,17,1808,516,1972,675,164,159,plate
11588,32,bed,33,1,20968,32,1,1182,1403,1649,1402,467,bed
11589,33,bed,34,1,20968,16,0,1090,214,1277,214,187,bed
11590,11,window,12,0,20969,25,740,296,996,625,256,329,window
11591,17,bed,18,0,20969,50,751,540,1311,830,560,290,bed
11592,25,window,26,0,20969,37,1594,195,1990,681,396,486,window
11593,26,window,27,0,20969,18,1413,366,1536,627,123,261,window
11594,27,table,28,0,20969,48,1398,653,1774,966,376,313,dining table
11595,28,chair,29,1,20969,59,1275,525,1507,865,232,340,chair
11596,29,chair,30,0,20969,98,1649,560,2001,1073,352,513,chair
11597,30,bed,31,0,20969,73,72,661,1107,952,1035,291,bed
11598,31,bed,32,0,20969,89,1,744,1804,1461,1803,717,bed
11599,32,door,33,0,20969,28,2,765,169,1461,167,696,door
11600,5,bed,6,1,20970,34,693,359,2197,1238,1504,879,bed
11601,7,bed,8,0,20971,26,0,639,1750,1500,1750,861,bed
11602,11,table,12,0,20971,37,887,733,1932,951,1045,218,dining table
11603,26,chair,27,0,20971,32,1506,780,1836,1166,330,386,chair
11604,27,chair,28,1,20971,20,896,756,1176,939,280,183,chair
11605,10,bed,11,1,20972,29,0,775,1170,1536,1170,761,bed
11606,11,bed,12,1,20972,49,298,647,1378,1176,1080,529,bed
11607,13,window,14,0,20972,19,875,0,1699,718,824,718,window
11608,12,bed,13,1,20973,22,184,819,1837,1534,1653,715,bed
11609,15,table,16,0,20973,23,34,982,547,1445,513,463,dining table
11610,11,window,12,0,20974,24,188,371,557,1130,369,759,window
11611,15,television,16,0,20974,17,1442,312,1935,756,493,444,tv
11612,16,chair,17,1,20974,53,873,771,1287,1257,414,486,chair
11613,17,desk,18,0,20974,51,867,822,1364,1257,497,435,desk
11614,30,bed,31,1,20974,27,0,1074,1799,1440,1799,366,bed
11615,9,bed,10,1,20975,86,28,402,1428,1127,1400,725,bed
11616,10,bed,11,1,20975,74,938,439,2066,1001,1128,562,bed
11617,13,chair,14,1,20975,17,2031,551,2199,1030,168,479,chair
11618,15,table,16,1,20975,31,0,736,513,1648,513,912,dining table
11619,16,chair,17,1,20975,54,0,601,649,1545,649,944,chair
11620,8,bed,9,0,20976,36,300,585,2199,1467,1899,882,bed
11621,20,chair,21,1,20976,20,784,673,1078,880,294,207,chair
11622,21,chair,22,0,20976,20,512,691,807,891,295,200,chair
11623,24,table,25,0,20976,22,591,680,994,891,403,211,dining table
11624,5,bed,6,0,20977,78,9,230,840,768,831,538,bed
11625,8,bed,9,0,20978,45,2,294,1125,1062,1123,768,bed
11626,12,table,13,0,20978,46,1488,875,2197,1650,709,775,dining table
11627,13,chair,14,0,20978,17,1337,1246,2199,1650,862,404,chair
11628,14,bed,15,1,20979,34,0,311,556,767,556,456,bed
11629,15,sofa,16,0,20979,82,421,421,1022,767,601,346,couch
11630,16,table,17,0,20979,38,492,548,930,767,438,219,dining table
11631,11,bed,12,0,20980,29,2,651,1930,1440,1928,789,bed
11632,6,bed,7,1,20981,25,1256,941,2199,1650,943,709,bed
11633,10,television,11,0,20981,21,399,539,802,948,403,409,tv
11634,6,window,7,0,20982,31,629,38,771,353,142,315,window
11635,9,table,10,0,20982,31,624,271,758,428,134,157,dining table
11636,10,chair,11,0,20982,29,724,272,836,437,112,165,chair
11637,11,chair,12,0,20982,28,556,254,656,410,100,156,chair
11638,15,bed,16,1,20982,44,86,244,580,652,494,408,bed
11639,6,door,7,0,20983,15,19,730,422,1904,403,1174,door
11640,9,chair,10,0,20983,28,432,1505,852,1871,420,366,chair
11641,11,television,12,0,20983,18,768,1146,1025,1367,257,221,tv
11642,6,bed,7,0,23555,55,292,221,745,465,453,244,bed
11643,14,chair,15,1,23555,24,264,211,316,346,52,135,chair
11644,4,bed,5,0,23556,23,118,345,856,683,738,338,bed
11645,5,bed,6,1,23557,50,380,219,1024,767,644,548,bed
11646,11,chair,12,1,23557,17,579,233,752,368,173,135,chair
11647,13,backpack,14,0,23557,17,617,234,737,306,120,72,backpack
11648,15,table,16,0,23557,36,2,300,249,570,247,270,dining table
11649,16,chair,17,1,23557,33,1,267,198,511,197,244,chair
11650,4,window,5,0,23558,16,1,0,300,164,299,164,window
11651,6,chair,7,0,23558,64,84,106,268,302,184,196,chair
11652,8,bed,9,0,23558,147,46,39,957,630,911,591,bed
11653,4,bed,5,0,23559,41,2,465,681,1024,679,559,bed
11654,3,bed,4,0,23560,24,0,371,683,1022,683,651,bed
11655,7,chair,8,0,23560,20,260,475,425,653,165,178,chair
11656,7,bed,8,0,23561,34,302,349,1024,768,722,419,bed
11657,16,suitcase,17,0,23561,25,0,440,217,768,217,328,suitcase
11658,6,bed,7,0,23562,104,94,293,746,683,652,390,bed
11659,1,sofa,2,0,23563,61,2,12,1023,767,1021,755,couch
11660,4,window,5,0,23564,18,156,169,319,339,163,170,window
11661,9,chair,10,0,23564,17,295,278,344,315,49,37,chair
11662,10,bed,11,0,23564,97,271,35,612,480,341,445,bed
11663,21,chair,22,0,23564,22,81,287,112,443,31,156,chair
11664,0,bed,1,0,23565,52,179,43,850,682,671,639,bed
11665,4,window,5,0,23565,19,80,219,244,593,164,374,window
11666,21,chair,22,0,23565,20,311,367,434,538,123,171,chair
11667,3,bed,4,0,23566,36,165,188,800,532,635,344,bed
11668,4,sofa,5,0,23566,42,190,244,415,357,225,113,couch
11669,14,sofa,15,1,9731,20,174,212,294,294,120,82,couch
11670,17,table,18,0,9731,16,64,252,167,312,103,60,dining table
11671,20,person,20,1,9731,22,46,169,76,269,30,100,person
11672,21,person,21,0,9731,24,102,172,134,253,32,81,person
11673,22,person,22,0,9731,32,148,171,184,283,36,112,person
11674,23,person,23,0,9731,45,175,159,224,311,49,152,person
11675,11,chair,12,0,9732,28,318,154,392,259,74,105,chair
11676,12,chair,13,0,9732,15,173,123,198,163,25,40,chair
11677,15,mirror,16,0,9732,15,97,63,122,100,25,37,mirror
11678,9,sofa,10,0,9733,19,2,203,44,259,42,56,couch
11679,9,chair,10,1,9734,21,2,104,49,175,47,71,chair
11680,11,chair,12,1,9734,20,26,139,62,223,36,84,chair
11681,12,table,13,0,9734,16,178,126,279,222,101,96,dining table
11682,13,chair,14,0,9734,21,153,129,197,207,44,78,chair
11683,14,chair,15,0,9734,23,199,151,257,222,58,71,chair
11684,19,chair,20,1,9734,16,250,136,279,206,29,70,chair
11685,11,sofa,12,0,9736,16,98,157,199,207,101,50,couch
11686,14,chair,15,1,9736,18,75,172,135,261,60,89,chair
11687,18,chair,19,0,9736,26,273,160,332,258,59,98,chair
11688,65,door,66,0,193,22,325,105,428,369,103,264,door
11689,69,door,70,0,193,30,535,105,665,368,130,263,door
11690,82,person,83,0,193,128,316,261,491,930,175,669,person
11691,96,person,97,0,193,127,477,279,667,979,190,700,person
11692,11,door,8,1,594,15,948,391,1072,605,124,214,door
11693,24,chair,20,1,594,15,487,685,668,857,181,172,chair
11694,35,chair,31,1,594,18,130,615,243,680,113,65,chair
11695,37,table,33,1,594,23,0,746,715,1002,715,256,dining table
11696,16,chair,15,1,596,18,1131,905,1207,1027,76,122,chair
11697,17,table,16,1,596,23,1139,937,1346,979,207,42,dining table
11698,18,chair,17,1,596,15,1157,948,1263,1024,106,76,chair
11699,50,chair,49,1,596,24,1894,985,2147,1104,253,119,chair
11700,51,chair,50,1,596,15,1571,960,1802,1080,231,120,chair
11701,52,chair,51,1,596,15,1295,939,1485,1050,190,111,chair
11702,65,clock,64,0,596,19,1403,593,1488,678,85,85,clock
11703,147,door,146,0,596,16,1774,562,2040,1089,266,527,door
11704,6,refrigerator,7,0,597,17,1075,279,1385,954,310,675,refrigerator
11705,32,window,33,0,597,32,382,216,745,506,363,290,window
11706,113,pot,111,0,597,16,811,484,862,522,51,38,potted plant
11707,28,sink,27,0,598,49,956,1342,1952,1637,996,295,sink
11708,29,window,30,0,599,15,21,158,353,609,332,451,window
11709,37,chair,38,1,600,23,913,350,957,423,44,73,chair
11710,104,bowl,104,0,600,21,38,31,100,70,62,39,bowl
11711,20,refrigerator,19,1,601,20,923,245,1024,609,101,364,refrigerator
11712,35,chair,33,1,601,29,865,418,971,683,106,265,chair
11713,36,chair,34,1,601,75,673,439,922,683,249,244,chair
11714,37,chair,35,1,601,49,522,471,853,683,331,212,chair
11715,78,door,76,0,601,15,680,203,739,336,59,133,door
11716,88,door,86,0,601,20,924,246,1022,597,98,351,door
11717,13,flowerpot,7,0,602,19,411,330,438,375,27,45,potted plant
11718,15,window,9,0,602,19,164,260,306,378,142,118,window
11719,19,table,13,1,602,21,146,381,238,462,92,81,dining table
11720,20,chair,14,1,602,29,180,362,231,453,51,91,chair
11721,21,chair,15,1,602,16,109,363,179,462,70,99,chair
11722,22,chair,16,0,602,26,114,372,188,487,74,115,chair
11723,23,chair,17,1,602,34,213,369,279,483,66,114,chair
11724,28,bowl,22,0,602,56,508,323,603,493,95,170,bowl
11725,2,window,3,1,605,21,106,248,202,414,96,166,window
11726,4,chair,5,1,605,37,162,379,212,491,50,112,chair
11727,6,table,7,1,605,18,167,396,213,496,46,100,dining table
11728,16,refrigerator,11,1,605,15,318,181,469,574,151,393,refrigerator
11729,47,chair,42,1,605,37,359,412,537,663,178,251,chair
11730,48,chair,43,1,605,24,430,441,630,663,200,222,chair
11731,125,bowl,119,0,605,16,783,576,818,623,35,47,bowl
11732,128,bowl,122,0,605,19,817,568,852,615,35,47,bowl
11733,131,bowl,125,0,605,22,851,562,885,608,34,46,bowl
11734,134,bowl,128,0,605,19,884,557,919,598,35,41,bowl
11735,137,bowl,131,0,605,19,924,551,958,593,34,42,bowl
11736,8,window,9,1,608,32,49,161,338,510,289,349,window
11737,21,chair,21,1,608,18,464,367,531,479,67,112,chair
11738,22,chair,22,1,608,26,129,372,178,563,49,191,chair
11739,23,chair,23,1,608,30,153,380,210,609,57,229,chair
11740,24,chair,24,1,608,58,180,390,369,680,189,290,chair
11741,25,chair,25,0,608,64,360,387,525,658,165,271,chair
11742,26,table,26,1,608,88,185,376,558,678,373,302,dining table
11743,26,refrigerator,19,1,609,18,765,216,854,482,89,266,refrigerator
11744,14,refrigerator,15,1,611,19,925,124,1106,713,181,589,refrigerator
11745,17,chair,18,1,611,19,517,564,1002,776,485,212,chair
11746,52,clock,52,0,612,17,448,190,489,277,41,87,clock
11747,54,sofa,54,1,612,35,194,288,361,350,167,62,couch
11748,70,sink,70,0,612,24,40,335,156,365,116,30,sink
11749,74,bottle,74,0,612,24,45,335,109,533,64,198,bottle
11750,6,table,7,1,613,19,1035,432,1200,549,165,117,dining table
11751,13,chair,14,1,613,20,798,409,896,606,98,197,chair
11752,14,chair,15,1,613,25,880,415,1001,638,121,223,chair
11753,15,chair,16,0,613,25,1033,418,1199,666,166,248,chair
11754,16,table,17,1,613,35,696,437,1141,645,445,208,dining table
11755,24,refrigerator,25,0,614,15,1669,463,1825,968,156,505,refrigerator
11756,18,window,19,1,615,20,130,254,209,400,79,146,window
11757,85,door,79,0,615,16,383,212,448,327,65,115,door
11758,6,refrigerator,7,0,616,25,310,519,791,1412,481,893,refrigerator
11759,20,blender,21,0,616,25,998,862,1175,1177,177,315,blender
11760,31,refrigerator,32,1,617,15,1223,412,1665,1165,442,753,refrigerator
11761,36,chair,37,1,617,28,19,679,262,918,243,239,chair
11762,37,chair,38,0,617,41,1,741,332,1165,331,424,chair
11763,58,door,56,0,617,19,394,252,507,397,113,145,door
11764,2,window,3,0,618,20,126,424,480,773,354,349,window
11765,6,window,7,0,618,17,1384,399,2000,631,616,232,window
11766,30,television,28,0,618,15,0,657,208,957,208,300,tv
11767,38,table,36,1,618,43,1080,910,1692,1464,612,554,dining table
11768,39,chair,37,1,618,34,1519,1045,1937,1464,418,419,chair
11769,5,window,6,0,619,15,560,365,649,497,89,132,window
11770,6,window,7,0,619,16,989,312,1195,441,206,129,window
11771,11,window,12,0,619,17,361,367,470,497,109,130,window
11772,13,chair,14,0,619,25,309,477,432,575,123,98,chair
11773,14,chair,15,1,619,28,490,466,575,555,85,89,chair
11774,16,chair,17,1,619,15,551,508,655,584,104,76,chair
11775,17,desk,18,0,619,23,149,484,298,595,149,111,desk
11776,18,chair,19,0,619,24,181,458,273,593,92,135,chair
11777,10,blender,11,0,620,17,466,345,495,402,29,57,blender
11778,51,vase,48,0,621,15,383,535,423,703,40,168,vase
11779,55,vase,52,0,621,16,258,505,299,650,41,145,vase
11780,58,table,55,0,621,33,470,469,752,722,282,253,dining table
11781,64,plate,61,1,621,17,662,511,746,541,84,30,plate
11782,66,plate,63,1,621,19,534,523,615,555,81,32,plate
11783,19,window,20,0,622,51,468,182,778,362,310,180,window
11784,21,chair,22,1,622,26,583,302,633,334,50,32,chair
11785,23,chair,24,1,622,31,692,305,762,472,70,167,chair
11786,24,table,25,1,622,31,523,334,728,434,205,100,dining table
11787,25,chair,26,1,622,38,599,315,696,498,97,183,chair
11788,26,chair,27,0,622,16,504,298,576,449,72,151,chair
11789,8,bowl,6,0,623,22,1169,1040,1343,1166,174,126,bowl
11790,12,pot,10,0,623,18,886,1047,987,1203,101,156,potted plant
11791,13,vase,11,0,623,16,698,1079,815,1204,117,125,vase
11792,18,sofa,15,1,623,18,11,1034,371,1223,360,189,couch
11793,23,pot,20,0,623,16,2,1100,143,1381,141,281,potted plant
11794,24,flowerpot,21,0,623,18,13,1071,170,1313,157,242,potted plant
11795,29,window,26,1,623,36,1604,471,2054,1246,450,775,window
11796,38,bowl,35,0,623,21,1766,1381,2193,1554,427,173,bowl
11797,50,door,46,0,623,22,1069,297,1229,907,160,610,door
11798,1,refrigerator,2,0,625,36,0,208,348,794,348,586,refrigerator
11799,7,window,8,0,625,21,794,160,1070,388,276,228,window
11800,25,pot,26,0,625,21,364,353,428,428,64,75,potted plant
11801,55,chair,56,1,625,17,1237,557,1279,911,42,354,chair
11802,58,bowl,59,0,625,22,716,337,768,428,52,91,bowl
11803,26,bowl,27,0,626,31,116,1057,435,1222,319,165,bowl
11804,2,window,3,1,627,21,294,0,547,297,253,297,window
11805,10,microwave,11,0,627,20,776,100,984,228,208,128,microwave
11806,18,sink,19,0,627,23,362,305,828,414,466,109,sink
11807,7,window,8,0,628,15,80,307,251,428,171,121,window
11808,26,table,27,1,628,21,30,425,250,486,220,61,dining table
11809,5,door,6,1,629,24,835,101,978,476,143,375,door
11810,11,table,12,1,629,68,546,460,1062,796,516,336,dining table
11811,12,bowl,13,0,629,33,778,429,881,523,103,94,bowl
11812,20,bottle,21,1,629,18,545,274,563,389,18,115,bottle
11813,21,bottle,22,1,629,15,564,276,583,365,19,89,bottle
11814,29,spoon,30,0,629,19,777,113,813,281,36,168,spoon
11815,31,chair,32,1,629,33,321,533,718,796,397,263,chair
11816,37,oven,38,0,629,21,719,395,875,480,156,85,oven
11817,4,window,5,0,630,16,95,300,419,1046,324,746,window
11818,57,door,53,0,630,17,1676,716,1876,1348,200,632,door
11819,74,door,70,0,630,15,889,448,1018,861,129,413,door
11820,84,door,80,0,630,15,1456,435,1664,865,208,430,door
11821,86,door,82,0,630,19,1680,432,1852,680,172,248,door
11822,2,window,3,0,631,22,0,146,438,854,438,708,window
11823,20,table,21,1,631,30,296,589,644,685,348,96,dining table
11824,23,chair,24,0,631,38,218,578,404,934,186,356,chair
11825,27,chair,28,0,631,42,388,681,722,1199,334,518,chair
11826,28,chair,29,0,631,52,627,720,978,1199,351,479,chair
11827,35,refrigerator,36,1,632,16,2,402,497,1255,495,853,refrigerator
11828,36,chair,37,1,632,26,141,964,757,1534,616,570,chair
11829,103,door,104,0,632,17,819,912,1040,1284,221,372,door
11830,6,window,7,1,633,24,1072,231,1236,546,164,315,window
11831,10,chair,11,1,633,26,1034,449,1157,681,123,232,chair
11832,12,chair,13,1,633,23,1167,447,1277,668,110,221,chair
11833,13,table,14,1,633,15,1146,494,1235,672,89,178,dining table
11834,20,pot,21,1,633,15,705,348,732,397,27,49,potted plant
11835,21,pot,22,0,633,19,610,430,660,493,50,63,potted plant
11836,22,pot,23,0,633,19,662,433,709,493,47,60,potted plant
11837,25,window,26,0,633,44,191,90,556,484,365,394,window
11838,35,chair,36,1,635,39,454,732,712,863,258,131,chair
11839,37,refrigerator,38,0,635,20,2,263,274,911,272,648,refrigerator
11840,97,door,98,0,635,19,147,273,275,880,128,607,door
11841,13,blender,14,0,636,24,1027,76,1110,202,83,126,blender
11842,15,refrigerator,16,1,640,19,0,155,180,768,180,613,refrigerator
11843,12,pot,13,0,641,20,595,227,635,281,40,54,potted plant
11844,13,pot,14,1,641,19,556,232,582,277,26,45,potted plant
11845,14,pot,15,0,641,18,567,246,594,280,27,34,potted plant
11846,16,bowl,17,0,641,27,101,264,157,299,56,35,bowl
11847,26,oven,27,1,641,16,7,243,116,343,109,100,oven
11848,10,chair,11,1,642,23,158,452,209,576,51,124,chair
11849,19,chair,20,1,642,24,231,477,304,609,73,132,chair
11850,20,table,21,1,642,33,172,480,401,625,229,145,dining table
11851,21,chair,22,0,642,25,69,473,166,625,97,152,chair
11852,31,window,32,0,642,51,732,266,1158,507,426,241,window
11853,104,door,104,0,642,16,674,255,731,434,57,179,door
11854,179,keyboard,179,0,642,15,180,490,223,507,43,17,keyboard
11855,26,refrigerator,27,1,643,28,0,207,435,982,435,775,refrigerator
11856,60,door,61,0,643,25,84,468,434,978,350,510,door
11857,8,refrigerator,9,1,644,20,1087,605,1373,1391,286,786,refrigerator
11858,21,table,20,0,644,30,617,884,2046,1534,1429,650,dining table
11859,25,plate,24,0,644,17,1213,980,1355,1027,142,47,plate
11860,27,plate,26,0,644,16,1072,1048,1243,1098,171,50,plate
11861,29,plate,28,0,644,19,786,1007,1059,1087,273,80,plate
11862,32,bowl,31,0,644,21,1719,286,1975,374,256,88,bowl
11863,25,table,24,1,646,31,142,1085,820,1551,678,466,dining table
11864,27,bed,26,1,646,27,0,1134,1647,1649,1647,515,bed
11865,2,window,3,0,647,18,307,336,555,502,248,166,window
11866,3,sofa,4,1,647,27,385,478,553,566,168,88,couch
11867,10,chair,11,1,647,16,283,454,380,530,97,76,chair
11868,14,table,15,1,647,27,252,522,496,572,244,50,dining table
11869,43,sink,44,0,647,24,351,642,728,725,377,83,sink
11870,52,flowerpot,53,0,647,72,290,338,417,429,127,91,potted plant
11871,0,plate,1,0,10149,19,142,610,388,673,246,63,plate
11872,9,bowl,8,0,10149,17,1597,753,1924,915,327,162,bowl
11873,12,chair,11,0,10149,143,863,926,1506,1534,643,608,chair
11874,21,table,17,0,10149,99,1210,753,2048,1526,838,773,dining table
11875,32,chair,24,1,10149,40,1126,728,1421,1103,295,375,chair
11876,57,window,49,0,10149,26,1476,13,1996,777,520,764,window
11877,5,sink,5,0,10156,15,599,1120,1854,1343,1255,223,sink
11878,13,pot,12,0,10156,15,1199,820,1325,1035,126,215,potted plant
11879,14,pot,13,0,10156,15,1322,846,1447,1048,125,202,potted plant
11880,2,blender,3,0,10157,16,205,152,311,272,106,120,blender
11881,3,blender,4,0,10157,32,109,127,207,283,98,156,blender
11882,0,person,1,0,10158,18,1515,730,1759,1420,244,690,person
11883,18,sink,16,0,10161,16,1255,783,1434,811,179,28,sink
11884,24,table,24,0,10164,30,391,437,477,558,86,121,dining table
11885,25,chair,25,1,10164,29,276,382,376,552,100,170,chair
11886,26,chair,26,1,10164,17,435,425,503,521,68,96,chair
11887,9,table,10,0,10165,32,163,145,319,303,156,158,dining table
11888,10,chair,11,1,10165,34,138,147,234,273,96,126,chair
11889,15,table,15,1,10165,20,2,217,186,364,184,147,dining table
11890,27,chair,27,0,10165,50,271,149,369,305,98,156,chair
11891,27,table,26,0,10168,22,102,693,896,1336,794,643,dining table
11892,28,bench,27,0,10168,46,543,863,1031,1337,488,474,bench
11893,29,bench,28,0,10168,24,20,895,408,1213,388,318,bench
11894,13,clock,14,0,10169,16,184,38,229,85,45,47,clock
11895,28,chair,29,1,10172,17,247,280,302,372,55,92,chair
11896,29,chair,30,1,10172,18,199,280,246,383,47,103,chair
11897,31,chair,32,1,10172,16,78,283,132,303,54,20,chair
11898,3,door,4,0,10176,21,210,42,623,1457,413,1415,door
11899,21,flowerpot,21,0,10176,15,1429,707,1509,772,80,65,potted plant
11900,36,chair,36,1,10176,26,122,1260,552,1645,430,385,chair
11901,14,refrigerator,15,0,10177,20,218,286,434,1292,216,1006,refrigerator
11902,46,door,47,0,10177,17,301,289,437,1267,136,978,door
11903,49,plate,50,0,10177,16,905,499,932,538,27,39,plate
11904,4,window,5,0,10179,15,155,294,536,630,381,336,window
11905,12,refrigerator,13,1,10179,23,1062,387,1425,1064,363,677,refrigerator
11906,26,bottle,27,0,10179,16,697,598,727,661,30,63,bottle
11907,29,table,26,1,10180,17,783,604,1260,957,477,353,dining table
11908,30,chair,27,1,10180,23,788,531,1108,959,320,428,chair
11909,24,chair,25,0,10181,37,12,176,81,256,69,80,chair
11910,25,chair,26,0,10181,41,73,184,145,256,72,72,chair
11911,26,chair,27,1,10181,30,136,195,205,255,69,60,chair
11912,9,refrigerator,10,0,10182,16,1790,156,2199,1648,409,1492,refrigerator
11913,3,table,4,0,10186,29,335,387,1025,768,690,381,dining table
11914,31,door,31,0,10187,23,955,381,1312,659,357,278,door
11915,2,sink,3,0,10190,15,0,752,797,980,797,228,sink
11916,7,blender,8,1,10190,17,782,663,885,855,103,192,blender
11917,30,chair,31,1,10191,17,0,408,799,532,799,124,chair
11918,18,clock,19,0,10193,15,377,104,420,165,43,61,clock
11919,37,plate,38,0,10195,15,458,63,516,140,58,77,plate
11920,74,refrigerator,75,1,10195,19,139,228,299,428,160,200,refrigerator
11921,3,window,4,0,10197,16,102,40,237,142,135,102,window
11922,20,table,21,1,10197,15,0,207,61,300,61,93,dining table
11923,11,refrigerator,12,0,10199,18,407,219,497,361,90,142,refrigerator
11924,20,chair,21,1,10199,24,407,283,437,375,30,92,chair
11925,21,chair,22,1,10199,19,370,284,414,385,44,101,chair
11926,22,chair,23,1,10199,17,352,286,375,383,23,97,chair
11927,26,chair,27,1,10199,23,325,277,369,448,44,171,chair
11928,27,chair,28,1,10199,35,224,279,349,482,125,203,chair
11929,28,chair,29,0,10199,36,172,280,324,532,152,252,chair
11930,29,chair,30,0,10199,37,59,277,186,499,127,222,chair
11931,30,table,31,1,10199,22,58,309,286,392,228,83,dining table
11932,31,vase,32,0,10199,18,216,267,259,328,43,61,vase
11933,38,chair,33,1,10199,16,508,298,526,402,18,104,chair
11934,6,refrigerator,7,1,10202,15,588,192,737,488,149,296,refrigerator
11935,7,refrigerator,8,1,10202,25,468,201,588,361,120,160,refrigerator
11936,26,plate,27,0,10202,15,570,135,632,194,62,59,plate
11937,17,pot,18,0,10203,15,1301,589,1349,657,48,68,potted plant
11938,22,chair,23,1,10203,19,644,924,1080,1234,436,310,chair
11939,23,chair,24,1,10203,32,44,869,482,1323,438,454,chair
11940,24,refrigerator,25,1,10203,27,0,384,454,1332,454,948,refrigerator
11941,89,door,90,0,10203,16,419,584,678,1240,259,656,door
11942,5,desk,6,0,10204,18,2,144,304,393,302,249,desk
11943,8,chair,9,1,10204,25,255,152,297,293,42,141,chair
11944,10,chair,11,1,10204,27,168,216,246,393,78,177,chair
11945,5,window,6,0,10205,17,183,69,206,158,23,89,window
11946,6,sofa,7,0,10205,15,193,156,229,167,36,11,couch
11947,14,table,15,0,10205,27,22,161,79,205,57,44,dining table
11948,9,refrigerator,10,1,10206,22,0,200,165,1374,165,1174,refrigerator
11949,12,toaster,13,0,10206,17,387,634,524,735,137,101,toaster
11950,17,bottle,18,0,10206,15,988,592,1045,721,57,129,bottle
11951,74,bowl,75,0,10206,20,1586,832,1944,884,358,52,bowl
11952,4,plate,5,0,10207,15,560,215,626,267,66,52,plate
11953,7,plate,8,1,10207,18,601,325,704,422,103,97,plate
11954,16,bowl,16,0,10209,25,516,548,650,602,134,54,bowl
11955,0,door,1,1,10210,17,2,1,282,678,280,677,door
11956,6,sink,7,1,10210,25,515,484,915,654,400,170,sink
11957,20,bowl,21,0,10210,19,1082,490,1277,718,195,228,bowl
11958,22,person,23,1,10210,71,197,8,756,719,559,711,person
11959,1,window,2,0,10211,16,48,97,305,376,257,279,window
11960,1,refrigerator,2,0,10213,23,263,136,372,328,109,192,refrigerator
11961,7,vase,7,0,10213,15,2,138,38,227,36,89,vase
11962,72,bowl,72,0,10213,17,82,185,115,216,33,31,bowl
11963,77,window,77,0,10213,27,428,91,524,209,96,118,window
11964,81,plate,81,1,10213,17,510,147,544,164,34,17,plate
11965,4,window,5,1,10215,18,323,171,373,252,50,81,window
11966,26,bowl,27,0,10215,17,323,226,358,257,35,31,bowl
11967,7,chair,7,1,10216,19,193,285,335,384,142,99,chair
11968,45,plate,45,1,10216,16,104,162,132,184,28,22,plate
11969,46,plate,46,1,10216,20,100,157,136,183,36,26,plate
11970,47,plate,47,1,10216,15,97,151,128,182,31,31,plate
11971,49,table,49,1,10216,17,224,236,512,384,288,148,dining table
11972,15,window,16,0,10219,16,697,162,1021,452,324,290,window
11973,20,chair,21,0,10219,46,763,441,963,765,200,324,chair
11974,20,blender,21,0,10220,15,881,587,978,762,97,175,blender
11975,11,chair,12,0,10221,24,88,104,127,174,39,70,chair
11976,7,person,8,1,10222,39,356,482,572,822,216,340,person
11977,20,cup,21,0,10222,18,535,782,585,928,50,146,cup
11978,23,refrigerator,24,1,10223,16,1035,205,1171,467,136,262,refrigerator
11979,9,window,10,0,10224,19,81,68,168,304,87,236,window
11980,47,chair,45,1,10224,18,117,277,171,421,54,144,chair
11981,48,table,46,1,10224,39,50,289,266,450,216,161,dining table
11982,50,chair,48,0,10224,28,129,318,231,502,102,184,chair
11983,51,chair,49,0,10224,23,17,300,123,471,106,171,chair
11984,24,refrigerator,24,1,10226,30,78,360,529,1222,451,862,refrigerator
11985,43,chair,43,1,10226,32,178,1187,672,1648,494,461,chair
11986,7,flowerpot,8,0,10227,19,1286,1161,1440,1323,154,162,potted plant
11987,10,refrigerator,11,0,10227,18,306,597,1115,2041,809,1444,refrigerator
11988,0,chair,1,0,10228,15,1,154,62,250,61,96,chair
11989,38,table,39,1,10228,23,0,154,80,223,80,69,dining table
11990,14,flowerpot,15,0,10230,15,751,828,900,910,149,82,potted plant
11991,15,window,16,0,10230,20,636,180,957,908,321,728,window
11992,3,window,4,0,10231,22,470,150,694,437,224,287,window
11993,8,refrigerator,9,0,10231,18,0,229,208,767,208,538,refrigerator
11994,31,door,32,0,10231,19,17,410,208,765,191,355,door
11995,7,window,8,0,10233,35,837,287,1199,567,362,280,window
11996,10,chair,11,1,10233,20,1073,441,1153,614,80,173,chair
11997,15,table,16,1,10233,32,853,458,1120,627,267,169,dining table
11998,18,chair,19,1,10233,19,996,480,1080,590,84,110,chair
11999,19,chair,20,1,10233,49,925,489,1080,799,155,310,chair
12000,31,sofa,32,1,10234,19,899,545,1134,851,235,306,couch
12001,14,table,14,1,10235,15,710,312,795,406,85,94,dining table
12002,16,chair,16,1,10235,24,664,292,746,423,82,131,chair
12003,17,window,17,1,10235,15,455,192,589,272,134,80,window
12004,33,chair,33,1,10235,15,326,311,383,339,57,28,chair
12005,35,chair,35,1,10235,27,367,313,468,432,101,119,chair
12006,36,chair,36,1,10235,35,169,337,273,532,104,195,chair
12007,38,table,38,1,10235,46,229,335,508,430,279,95,dining table
12008,39,chair,39,0,10235,39,262,346,420,533,158,187,chair
12009,40,chair,40,0,10235,51,418,332,555,533,137,201,chair
12010,6,chair,7,0,10236,32,192,540,406,938,214,398,chair
12011,13,chair,14,1,10237,16,92,137,142,179,50,42,chair
12012,14,chair,15,0,10237,29,92,146,157,247,65,101,chair
12013,15,chair,16,1,10237,23,22,134,82,184,60,50,chair
12014,16,chair,17,0,10237,32,14,143,88,248,74,105,chair
12015,17,table,18,1,10237,24,29,142,135,245,106,103,dining table
12016,16,plate,17,0,10242,16,31,140,68,147,37,7,plate
12017,31,chair,32,1,10243,24,362,369,517,444,155,75,chair
12018,36,table,37,1,10243,38,126,428,666,507,540,79,dining table
12019,38,bowl,39,0,10243,30,313,445,464,506,151,61,bowl
12020,1,chair,2,0,10245,18,1274,756,1476,1425,202,669,chair
12021,22,table,23,1,10245,15,1372,853,2043,1224,671,371,dining table
12022,24,chair,25,0,10245,35,1426,910,1905,1533,479,623,chair
12023,37,chair,35,1,10245,46,1790,1219,2047,1533,257,314,chair
12024,3,window,4,0,10246,15,40,6,174,104,134,98,window
12025,30,sink,31,0,10248,16,614,442,781,486,167,44,sink
12026,41,chair,42,1,10248,35,64,431,249,767,185,336,chair
12027,43,chair,44,1,10248,29,127,556,431,767,304,211,chair
12028,44,chair,45,1,10248,23,452,558,751,767,299,209,chair
12029,45,chair,46,1,10248,22,710,545,1023,767,313,222,chair
12030,28,window,29,1,10250,15,2,282,726,959,724,677,window
12031,14,pot,12,1,10253,19,122,152,152,167,30,15,potted plant
12032,17,table,14,0,10253,30,185,169,300,300,115,131,dining table
12033,33,book,30,1,10253,16,224,137,251,156,27,19,book
12034,34,bowl,31,0,10253,25,241,142,261,161,20,19,bowl
12035,53,vase,50,0,10253,19,12,146,50,179,38,33,vase
12036,23,table,24,0,10255,45,86,269,375,479,289,210,dining table
12037,36,chair,37,1,10255,31,30,303,171,478,141,175,chair
12038,37,chair,38,1,10255,28,83,330,275,479,192,149,chair
12039,22,oven,23,0,10260,17,859,664,1050,1145,191,481,oven
12040,29,chair,30,1,10260,18,0,763,104,921,104,158,chair
12041,30,table,31,1,10260,40,61,915,294,1498,233,583,dining table
12042,31,chair,32,1,10260,22,0,864,114,1364,114,500,chair
12043,6,window,5,0,10261,26,1011,210,1198,398,187,188,window
12044,12,vase,11,0,10261,19,1036,307,1111,397,75,90,vase
12045,39,blender,38,0,10261,19,245,352,294,457,49,105,blender
12046,16,chair,17,1,10263,17,960,833,1098,935,138,102,chair
12047,18,chair,19,1,10263,16,1419,888,1597,976,178,88,chair
12048,19,table,20,1,10263,37,801,869,1599,1198,798,329,dining table
12049,20,bowl,21,0,10263,17,897,915,1042,1013,145,98,bowl
12050,21,bowl,22,1,10263,16,1334,960,1484,1041,150,81,bowl
12051,22,bowl,23,0,10263,19,1304,1013,1465,1126,161,113,bowl
12052,26,plate,27,1,10263,27,1041,907,1295,997,254,90,plate
12053,27,plate,28,0,10263,17,1063,870,1273,968,210,98,plate
12054,28,plate,29,1,10263,29,941,1037,1248,1158,307,121,plate
12055,29,plate,30,0,10263,22,967,989,1218,1121,251,132,plate
12056,30,plate,31,1,10263,15,1521,963,1597,1053,76,90,plate
12057,39,sink,40,0,10263,19,2,557,299,621,297,64,sink
12058,41,toaster,42,0,10263,19,405,419,562,531,157,112,toaster
12059,6,refrigerator,7,1,10266,16,219,465,493,767,274,302,refrigerator
12060,12,refrigerator,13,0,10267,16,683,203,891,594,208,391,refrigerator
12061,41,sofa,42,0,10268,32,1707,802,2013,1138,306,336,couch
12062,48,refrigerator,49,1,10268,55,0,391,113,1609,113,1218,refrigerator
12063,60,door,61,0,10268,33,1360,596,1457,942,97,346,door
12064,87,chair,88,1,10268,26,1156,822,1269,958,113,136,chair
12065,88,chair,89,1,10268,87,1388,855,1587,1522,199,667,chair
12066,89,chair,90,1,10268,21,1469,1103,1914,1517,445,414,chair
12067,95,chair,96,1,10268,41,1,1210,109,1642,108,432,chair
12068,99,mirror,100,0,10268,20,1091,554,1161,800,70,246,mirror
12069,0,person,1,1,10269,107,66,55,159,239,93,184,person
12070,2,chair,3,0,10269,16,6,169,64,239,58,70,chair
12071,68,oven,69,1,10271,42,1204,1275,1512,1487,308,212,oven
12072,89,bowl,90,0,10271,23,1867,1218,1994,1321,127,103,bowl
12073,97,sink,98,0,10271,18,836,1483,1414,1590,578,107,sink
12074,10,sink,11,0,10272,22,203,271,484,394,281,123,sink
12075,22,table,23,1,10274,55,0,492,738,711,738,219,dining table
12076,23,chair,24,1,10274,16,159,333,306,505,147,172,chair
12077,35,chair,36,1,10274,26,589,485,829,712,240,227,chair
12078,36,vase,37,1,10274,32,0,425,99,627,99,202,vase
12079,14,table,15,1,10276,37,1650,989,2194,1461,544,472,dining table
12080,15,chair,16,1,10276,48,1436,824,2046,1461,610,637,chair
12081,30,door,31,1,10277,16,271,163,333,329,62,166,door
12082,49,bowl,50,1,10277,17,620,440,679,482,59,42,bowl
12083,62,door,60,0,10277,34,366,170,405,269,39,99,door
12084,15,chair,16,1,10280,25,523,236,600,463,77,227,chair
12085,16,chair,17,0,10280,45,393,243,543,479,150,236,chair
12086,31,bottle,32,0,10280,16,26,215,46,256,20,41,bottle
12087,54,door,55,0,10280,17,544,142,600,246,56,104,door
12088,11,chair,12,1,10281,24,107,102,146,186,39,84,chair
12089,12,table,13,1,10281,19,62,113,161,142,99,29,dining table
12090,13,chair,14,0,10281,38,134,109,190,211,56,102,chair
12091,14,chair,15,1,10281,20,41,108,74,203,33,95,chair
12092,15,chair,16,0,10281,37,64,133,126,225,62,92,chair
12093,13,vegetables,14,0,10283,20,2,492,71,572,69,80,carrot
12094,5,refrigerator,6,0,10287,19,649,565,932,1081,283,516,refrigerator
12095,17,clock,18,0,10288,17,176,206,298,320,122,114,clock
12096,22,bowl,23,0,10288,26,388,535,662,661,274,126,bowl
12097,28,blender,29,0,10288,16,178,383,226,474,48,91,blender
12098,14,window,15,0,10289,19,201,144,420,477,219,333,window
12099,35,bench,36,1,10289,15,0,578,255,683,255,105,bench
12100,8,window,9,0,10291,15,0,0,173,373,173,373,window
12101,13,chair,14,0,10294,24,81,157,144,255,63,98,chair
12102,3,flowerpot,4,0,10296,15,294,804,450,947,156,143,potted plant
12103,14,window,15,0,10298,30,577,247,662,414,85,167,window
12104,15,window,16,0,10298,16,392,247,471,414,79,167,window
12105,17,chair,18,1,10298,15,659,408,691,449,32,41,chair
12106,10,chair,11,0,10299,15,10,137,92,256,82,119,chair
12107,26,chair,26,0,10299,16,0,119,17,231,17,112,chair
12108,42,chair,43,1,10300,43,1729,687,2006,1148,277,461,chair
12109,46,dog,46,1,10300,66,1592,947,1858,1402,266,455,dog
12110,5,window,6,0,10303,20,2,206,272,491,270,285,window
12111,7,refrigerator,8,1,10303,16,272,217,393,400,121,183,refrigerator
12112,10,chair,11,1,10303,21,194,377,307,475,113,98,chair
12113,11,chair,12,1,10303,26,301,378,417,531,116,153,chair
12114,12,chair,13,0,10303,32,305,408,449,601,144,193,chair
12115,13,chair,14,0,10303,40,123,413,286,601,163,188,chair
12116,14,table,15,0,10303,26,181,389,397,601,216,212,dining table
12117,29,chair,28,1,10304,21,450,337,527,392,77,55,chair
12118,31,chair,30,1,10304,37,244,359,371,638,127,279,chair
12119,32,chair,31,1,10304,41,343,384,565,639,222,255,chair
12120,33,table,32,1,10304,32,317,371,704,639,387,268,dining table
12121,46,bowl,45,0,10304,18,406,376,489,416,83,40,bowl
12122,52,oven,51,0,10304,17,516,338,625,396,109,58,oven
12123,57,door,56,0,10304,20,182,142,303,479,121,337,door
12124,42,chair,43,0,10305,25,26,126,76,225,50,99,chair
12125,17,chair,18,1,10306,15,88,190,166,224,78,34,chair
12126,30,table,31,1,10307,41,28,139,243,216,215,77,dining table
12127,23,chair,24,1,10312,23,257,744,594,905,337,161,chair
12128,24,chair,25,1,10312,19,783,847,1033,999,250,152,chair
12129,25,table,26,1,10312,16,109,857,882,999,773,142,dining table
12130,29,vase,29,0,10314,20,130,99,145,132,15,33,vase
12131,12,bowl,12,0,10315,16,242,819,1376,1286,1134,467,bowl
12132,32,chair,30,1,10316,17,734,629,896,767,162,138,chair
12133,14,table,15,1,10317,32,1249,1076,2199,1649,950,573,dining table
12134,17,chair,18,1,10318,32,21,152,86,251,65,99,chair
12135,19,oven,20,1,10319,21,384,486,470,576,86,90,oven
12136,26,chair,27,0,10319,28,872,568,965,735,93,167,chair
12137,27,chair,28,1,10319,23,945,578,1023,785,78,207,chair
12138,38,table,39,0,10319,56,191,576,877,936,686,360,dining table
12139,67,door,68,0,10319,28,476,499,529,579,53,80,door
12140,123,door,124,0,10319,24,417,688,528,813,111,125,door
12141,125,door,126,0,10319,40,526,688,637,814,111,126,door
12142,17,chair,18,1,10320,44,1900,971,2197,1593,297,622,chair
12143,34,bowl,35,0,10320,21,719,227,865,345,146,118,bowl
12144,45,plate,46,0,10320,24,1040,804,1077,863,37,59,plate
12145,23,clock,24,0,10321,15,1257,100,1431,259,174,159,clock
12146,33,flowerpot,31,0,10323,22,1038,323,1085,497,47,174,potted plant
12147,94,oven,89,0,10323,16,359,639,506,891,147,252,oven
12148,10,vase,11,0,10324,16,287,308,328,394,41,86,vase
12149,17,sink,18,0,10327,16,82,172,126,180,44,8,sink
12150,47,bowl,48,0,10327,21,14,156,40,173,26,17,bowl
12151,29,bowl,30,0,10328,67,627,334,725,499,98,165,bowl
12152,42,window,43,0,10328,34,353,211,569,383,216,172,window
12153,56,pot,57,1,10328,15,144,386,167,432,23,46,potted plant
12154,11,table,12,0,10329,20,43,131,160,214,117,83,dining table
12155,12,bench,13,0,10329,16,38,159,87,218,49,59,bench
12156,13,bench,14,1,10329,21,119,153,166,195,47,42,bench
12157,2,sink,3,0,10330,23,338,322,643,480,305,158,sink
12158,38,door,39,0,10330,16,261,360,290,488,29,128,door
12159,25,door,26,0,10331,18,417,360,493,457,76,97,door
12160,26,window,27,0,10331,16,430,377,470,438,40,61,window
12161,45,pot,46,0,10331,17,561,247,595,270,34,23,potted plant
12162,26,table,27,0,10332,34,707,843,2066,1464,1359,621,dining table
12163,28,chair,29,1,10332,30,1757,967,2198,1461,441,494,chair
12164,29,chair,30,1,10332,25,1545,1025,2142,1440,597,415,chair
12165,30,chair,31,1,10332,19,1344,1173,1957,1457,613,284,chair
12166,32,vase,33,0,10332,18,1295,767,1373,960,78,193,vase
12167,159,pot,160,0,10332,17,47,715,145,780,98,65,potted plant
12168,39,refrigerator,39,0,10333,18,347,232,408,526,61,294,refrigerator
12169,90,sink,90,0,10333,15,672,426,895,460,223,34,sink
12170,9,chair,10,1,10334,21,82,175,148,255,66,80,chair
12171,10,chair,11,0,10334,21,163,120,206,193,43,73,chair
12172,13,table,14,0,10334,17,151,222,255,255,104,33,dining table
12173,19,bowl,20,0,10336,15,224,120,241,140,17,20,bowl
12174,14,chair,14,1,10337,33,70,768,344,1280,274,512,chair
12175,15,bottle,16,1,10338,17,53,294,88,376,35,82,bottle
12176,42,plate,43,0,10341,20,1766,592,1811,658,45,66,plate
12177,22,chair,23,1,10343,26,625,353,780,664,155,311,chair
12178,23,chair,24,1,10343,27,397,358,670,662,273,304,chair
12179,24,chair,25,1,10343,35,14,375,443,663,429,288,chair
12180,25,window,26,0,10343,22,366,170,468,372,102,202,window
12181,26,refrigerator,27,0,10343,22,734,180,999,661,265,481,refrigerator
12182,56,oven,57,1,10344,29,82,207,174,372,92,165,oven
12183,69,chair,70,0,10344,77,80,281,200,485,120,204,chair
12184,70,chair,71,0,10344,74,236,288,338,520,102,232,chair
12185,71,chair,72,0,10344,68,360,286,455,515,95,229,chair
12186,72,chair,73,0,10344,92,468,284,574,513,106,229,chair
12187,73,chair,74,0,10344,76,585,277,700,481,115,204,chair
12188,74,chair,75,1,10344,45,668,268,733,437,65,169,chair
12189,19,pot,20,1,10345,18,1140,709,1191,804,51,95,potted plant
12190,20,pot,21,0,10345,20,1187,724,1236,814,49,90,potted plant
12191,22,book,23,0,10345,18,507,795,715,894,208,99,book
12192,24,bowl,25,1,10345,19,432,819,525,910,93,91,bowl
12193,30,bowl,31,0,10345,116,899,686,1342,1475,443,789,bowl
12194,38,oven,39,1,10345,24,0,539,437,1345,437,806,oven
12195,39,bottle,40,1,10345,15,397,966,482,1086,85,120,bottle
12196,40,bottle,41,1,10345,15,476,988,541,1096,65,108,bottle
12197,43,bowl,44,0,10345,55,387,1005,755,1260,368,255,bowl
12198,48,chair,49,1,10345,21,1554,875,1601,1034,47,159,chair
12199,55,vase,56,1,10345,15,1855,943,1969,1070,114,127,vase
12200,60,refrigerator,61,0,10345,27,1300,539,1535,1129,235,590,refrigerator
12201,66,plate,67,0,10345,34,1698,1200,2148,1393,450,193,plate
12202,68,plate,68,1,10345,22,1952,1067,2197,1192,245,125,plate
12203,11,chair,10,1,10348,18,226,329,451,538,225,209,chair
12204,12,chair,11,1,10348,22,434,310,538,538,104,228,chair
12205,15,table,14,0,10348,16,3,334,359,538,356,204,dining table
12206,91,umbrella,90,1,10351,16,455,380,471,437,16,57,umbrella
12207,34,oven,35,0,10354,15,105,390,303,545,198,155,oven
12208,41,door,42,0,10354,15,11,422,109,592,98,170,door
12209,50,door,51,0,10355,20,286,451,414,574,128,123,door
12210,51,window,52,0,10355,17,304,467,393,559,89,92,window
12211,28,refrigerator,29,0,10356,17,790,429,951,604,161,175,refrigerator
12212,35,bowl,36,0,10356,24,440,482,510,573,70,91,bowl
12213,46,bottle,47,1,10356,19,1067,175,1097,267,30,92,bottle
12214,63,sofa,64,1,10356,31,430,836,1401,933,971,97,couch
12215,65,window,66,0,10356,26,3,351,165,603,162,252,window
12216,66,chair,67,1,10356,23,79,528,171,603,92,75,chair
12217,67,chair,68,1,10356,28,58,538,201,707,143,169,chair
12218,68,table,69,1,10356,18,3,601,134,750,131,149,dining table
12219,10,table,11,1,10357,16,153,132,213,159,60,27,dining table
12220,11,chair,12,0,10357,17,136,121,175,179,39,58,chair
12221,53,door,54,0,10358,27,292,363,355,545,63,182,door
12222,78,chair,79,1,10358,18,292,448,332,625,40,177,chair
12223,80,chair,80,0,10358,30,347,484,501,730,154,246,chair
12224,81,chair,81,0,10358,33,325,463,435,680,110,217,chair
12225,82,chair,82,1,10358,24,810,573,960,629,150,56,chair
12226,83,chair,83,1,10358,27,541,620,770,692,229,72,chair
12227,87,bowl,87,0,10358,22,915,643,1141,757,226,114,bowl
12228,7,bottle,8,0,10360,15,424,224,478,366,54,142,bottle
12229,11,chair,12,1,10360,40,80,383,381,600,301,217,chair
12230,22,chair,20,1,10361,28,508,339,640,532,132,193,chair
12231,23,table,21,1,10361,18,531,355,800,533,269,178,dining table
12232,16,bottle,17,0,10364,15,867,273,891,352,24,79,bottle
12233,20,microwave,21,0,10364,21,873,456,1057,622,184,166,microwave
12234,21,bowl,22,0,10364,95,1000,399,1147,682,147,283,bowl
12235,26,door,27,1,10364,16,343,195,512,743,169,548,door
12236,7,pot,7,0,10365,15,2,211,40,318,38,107,potted plant
12237,8,bowl,8,0,10365,24,536,582,685,673,149,91,bowl
12238,50,table,46,0,10365,28,248,582,1200,900,952,318,dining table
12239,56,chair,51,1,10365,17,282,638,493,900,211,262,chair
12240,58,chair,53,1,10365,15,458,717,667,900,209,183,chair
12241,82,door,76,0,10365,19,728,405,926,666,198,261,door
12242,16,sink,17,0,10366,19,1185,807,1525,890,340,83,sink
12243,40,bowl,40,0,10366,19,1206,815,1503,884,297,69,bowl
12244,4,window,4,1,10368,20,686,197,822,484,136,287,window
12245,10,bowl,10,0,10368,22,950,396,1079,456,129,60,bowl
12246,7,chair,8,1,10371,25,478,260,556,358,78,98,chair
12247,8,chair,9,1,10371,43,426,270,531,479,105,209,chair
12248,9,table,10,1,10371,16,453,297,576,345,123,48,dining table
12249,10,chair,11,1,10371,38,500,290,639,479,139,189,chair
12250,17,table,18,1,10378,15,143,322,314,468,171,146,dining table
12251,19,sofa,20,1,10378,17,2,290,228,480,226,190,couch
12252,7,window,8,1,10379,23,1602,176,1893,728,291,552,window
12253,12,refrigerator,13,0,10379,36,1566,723,2045,1466,479,743,refrigerator
12254,42,door,42,0,10379,18,1177,926,1348,1095,171,169,door
12255,43,window,43,0,10379,15,1206,952,1309,1069,103,117,window
12256,23,chair,24,1,10381,24,0,392,156,671,156,279,chair
12257,24,chair,25,1,10381,30,2,378,160,719,158,341,chair
12258,25,chair,26,0,10381,21,152,394,328,760,176,366,chair
12259,26,table,27,1,10381,22,28,401,385,750,357,349,dining table
12260,1,refrigerator,2,0,10382,15,228,100,256,179,28,79,refrigerator
12261,37,sofa,38,1,10383,16,583,268,672,312,89,44,couch
12262,43,sofa,44,0,10383,40,554,288,770,416,216,128,couch
12263,63,plate,64,0,10383,15,744,243,796,284,52,41,plate
12264,68,sofa,69,1,10383,27,621,346,798,531,177,185,couch
12265,12,chair,13,0,10384,22,934,317,1000,413,66,96,chair
12266,40,sofa,41,1,10384,20,253,286,441,372,188,86,couch
12267,42,chair,43,1,10384,21,314,338,454,485,140,147,chair
12268,44,chair,45,1,10384,49,482,375,645,647,163,272,chair
12269,45,table,46,1,10384,19,337,369,589,654,252,285,dining table
12270,47,chair,48,0,10384,44,288,384,480,685,192,301,chair
12271,17,refrigerator,18,0,10385,20,1578,180,2024,1643,446,1463,refrigerator
12272,40,chair,41,1,10385,16,599,1360,1341,1645,742,285,chair
12273,87,window,88,0,10385,16,894,844,1088,932,194,88,window
12274,5,table,6,1,10388,22,495,313,640,479,145,166,dining table
12275,6,chair,7,0,10388,46,465,250,582,479,117,229,chair
12276,26,chair,22,0,10390,22,507,639,711,1022,204,383,chair
12277,51,flowerpot,47,0,10390,15,16,454,54,490,38,36,potted plant
12278,12,refrigerator,13,1,10392,20,7,72,97,175,90,103,refrigerator
12279,15,table,14,1,10394,16,2044,1266,2197,1647,153,381,dining table
12280,44,window,43,0,10396,15,467,493,550,570,83,77,window
12281,7,sink,8,0,10398,17,225,792,623,838,398,46,sink
12282,13,bowl,14,0,10399,15,121,290,197,320,76,30,bowl
12283,67,door,68,0,10400,21,191,202,223,282,32,80,door
12284,13,vase,14,0,10401,18,348,308,407,380,59,72,vase
12285,14,vase,15,0,10401,17,399,274,454,381,55,107,vase
12286,10,table,11,1,10402,17,170,111,224,150,54,39,dining table
12287,12,chair,13,0,10402,21,177,141,224,232,47,91,chair
12288,10,window,9,1,10403,53,46,167,371,628,325,461,window
12289,11,chair,10,1,10403,18,209,371,293,459,84,88,chair
12290,14,chair,13,1,10403,23,470,368,532,608,62,240,chair
12291,15,chair,14,1,10403,50,82,383,314,708,232,325,chair
12292,16,table,15,1,10403,46,160,432,523,708,363,276,dining table
12293,17,cup,16,0,10403,16,280,410,307,473,27,63,cup
12294,20,chair,19,0,10403,34,307,381,502,708,195,327,chair
12295,23,chair,24,1,10405,46,738,422,880,697,142,275,chair
12296,24,chair,25,1,10405,55,682,447,860,760,178,313,chair
12297,25,chair,26,0,10405,61,605,480,833,767,228,287,chair
12298,26,chair,27,0,10405,64,339,482,558,767,219,285,chair
12299,36,vase,37,0,10405,15,78,462,131,536,53,74,vase
12300,14,window,15,0,10407,15,296,181,398,426,102,245,window
12301,17,window,18,1,10407,54,409,229,612,389,203,160,window
12302,21,pot,21,0,10407,19,15,387,57,462,42,75,potted plant
12303,25,chair,25,0,10407,45,271,373,381,585,110,212,chair
12304,26,chair,26,1,10407,50,607,372,734,589,127,217,chair
12305,29,table,29,0,10407,15,346,388,640,590,294,202,dining table
12306,5,blender,6,0,10408,20,380,123,418,201,38,78,blender
12307,10,bowl,11,0,10409,21,692,438,810,470,118,32,bowl
12308,8,window,9,0,10413,32,1455,1,2039,888,584,887,window
12309,11,sink,12,0,10413,22,1116,808,1777,920,661,112,sink
12310,26,plate,27,0,10414,23,232,318,309,330,77,12,plate
12311,33,chair,34,1,10414,78,378,312,505,446,127,134,chair
12312,35,door,36,0,10414,94,491,153,614,440,123,287,door
12313,37,door,38,1,10414,65,611,124,797,488,186,364,door
12314,39,chair,40,1,10414,33,725,334,800,528,75,194,chair
12315,44,refrigerator,45,0,10414,15,79,205,220,436,141,231,refrigerator
12316,53,chair,54,1,10414,86,21,343,258,535,237,192,chair
12317,55,table,56,1,10414,119,251,437,800,536,549,99,dining table
12318,24,bowl,25,0,10415,15,482,343,554,377,72,34,bowl
12319,0,bowl,1,0,10416,15,108,204,156,237,48,33,bowl
12320,5,plate,6,0,10416,16,146,226,240,255,94,29,plate
12321,32,pots,33,0,10416,16,53,96,81,121,28,25,potted plant
12322,15,chair,16,1,10417,37,386,716,909,959,523,243,chair
12323,16,table,17,1,10417,19,861,668,1278,957,417,289,dining table
12324,18,bowl,19,1,10417,16,1110,729,1257,809,147,80,bowl
12325,28,chair,29,1,10420,17,217,406,257,525,40,119,chair
12326,29,chair,30,1,10420,23,249,418,323,549,74,131,chair
12327,30,chair,31,0,10420,30,275,428,371,589,96,161,chair
12328,0,plate,1,0,10422,18,66,652,367,761,301,109,plate
12329,13,vase,14,0,10423,19,345,157,378,224,33,67,vase
12330,23,refrigerator,24,0,10425,24,1362,187,1494,1040,132,853,refrigerator
12331,33,chair,34,1,10425,17,58,999,468,1128,410,129,chair
12332,31,chair,32,1,10426,31,241,379,324,533,83,154,chair
12333,32,chair,33,1,10426,32,394,380,504,532,110,152,chair
12334,33,chair,34,0,10426,85,96,418,313,681,217,263,chair
12335,34,chair,35,0,10426,59,358,413,537,681,179,268,chair
12336,35,table,36,0,10426,64,187,425,464,622,277,197,dining table
12337,39,window,39,0,10426,22,336,250,418,419,82,169,window
12338,66,door,62,0,10426,25,89,183,210,535,121,352,door
12339,48,window,49,0,10428,19,270,269,335,429,65,160,window
12340,71,sink,72,0,10428,22,457,393,578,414,121,21,sink
12341,79,oven,80,0,10428,18,60,419,239,682,179,263,oven
12342,93,table,94,1,10428,18,247,381,342,397,95,16,dining table
12343,94,sofa,95,1,10428,33,233,383,323,498,90,115,couch
12344,95,vase,96,0,10428,20,167,367,201,414,34,47,vase
12345,27,chair,28,1,10429,35,383,210,434,340,51,130,chair
12346,28,chair,29,1,10429,56,325,222,406,376,81,154,chair
12347,43,chair,44,0,10429,75,225,243,354,400,129,157,chair
12348,31,vase,31,0,10430,23,520,339,628,459,108,120,vase
12349,35,bowl,35,0,10430,16,361,420,495,468,134,48,bowl
12350,37,window,38,0,10434,19,1563,658,1815,841,252,183,window
12351,103,chair,103,1,10434,15,2048,828,2199,968,151,140,chair
12352,15,chair,16,1,10435,18,65,187,93,252,28,65,chair
12353,16,chair,17,1,10435,20,164,188,190,253,26,65,chair
12354,12,pot,13,0,10437,15,105,73,125,97,20,24,potted plant
12355,20,window,21,0,10439,18,1495,424,1785,775,290,351,window
12356,21,window,22,1,10439,24,1213,472,1490,753,277,281,window
12357,24,refrigerator,25,1,10439,21,977,550,1237,992,260,442,refrigerator
12358,33,window,34,0,10439,19,61,320,526,929,465,609,window
12359,36,chair,37,1,10439,41,925,830,1226,1415,301,585,chair
12360,37,chair,38,0,10439,66,984,858,1387,1480,403,622,chair
12361,38,bowl,39,0,10439,15,1237,814,1475,883,238,69,bowl
12362,44,chair,45,1,10439,26,1,825,175,1334,174,509,chair
12363,103,door,99,0,10439,17,985,718,1232,985,247,267,door
12364,106,plate,102,0,10439,25,1494,1093,1540,1185,46,92,plate
12365,27,pot,28,0,10440,16,526,804,598,891,72,87,potted plant
12366,28,pot,29,0,10440,16,593,785,662,885,69,100,potted plant
12367,29,pot,30,0,10440,15,659,768,729,883,70,115,potted plant
12368,39,microwave,40,0,10440,22,1493,817,1972,1098,479,281,microwave
12369,44,window,45,0,10440,22,1055,325,1550,843,495,518,window
12370,79,bottle,80,0,10440,16,1084,615,1131,774,47,159,bottle
12371,0,clock,1,0,10441,18,745,109,860,264,115,155,clock
12372,8,bowl,7,0,10441,15,491,584,653,655,162,71,bowl
12373,122,flowerpot,119,0,10441,16,19,523,77,559,58,36,potted plant
12374,123,flowerpot,120,0,10441,15,418,493,468,533,50,40,potted plant
12375,124,flowerpot,121,0,10441,20,834,814,896,883,62,69,potted plant
12376,20,table,19,1,10442,34,111,1036,876,1327,765,291,dining table
12377,21,chair,20,1,10442,15,641,920,795,1076,154,156,chair
12378,24,bottle,22,0,10442,22,649,1048,825,1294,176,246,bottle
12379,43,refrigerator,41,0,10442,20,1582,486,1983,1439,401,953,refrigerator
12380,0,chair,1,1,10444,19,189,134,277,225,88,91,chair
12381,14,table,15,1,10446,56,37,144,269,240,232,96,dining table
12382,15,chair,16,1,10446,23,201,158,259,240,58,82,chair
12383,16,chair,17,1,10446,16,131,170,210,240,79,70,chair
12384,36,table,37,1,10449,15,372,774,1039,957,667,183,dining table
12385,15,refrigerator,16,0,10452,15,410,141,608,502,198,361,refrigerator
12386,63,pot,64,0,10452,18,108,287,127,305,19,18,potted plant
12387,21,table,22,1,10453,17,185,771,824,931,639,160,dining table
12388,37,refrigerator,38,1,10453,24,1560,479,1890,834,330,355,refrigerator
12389,10,sink,11,0,10455,15,390,382,725,462,335,80,sink
12390,4,pot,5,0,10457,15,841,500,899,598,58,98,potted plant
12391,5,pot,6,1,10457,17,894,484,957,590,63,106,potted plant
12392,22,microwave,23,1,10457,28,463,231,794,445,331,214,microwave
12393,146,door,143,0,10457,46,1657,909,1855,1280,198,371,door
12394,12,toaster,13,0,10458,30,1268,479,1454,593,186,114,toaster
12395,31,refrigerator,32,0,10458,20,440,104,836,1022,396,918,refrigerator
12396,41,plate,42,0,10458,16,1350,292,1482,421,132,129,plate
12397,18,chair,19,1,10459,34,902,949,1106,1199,204,250,chair
12398,19,chair,20,1,10459,37,2,914,390,1105,388,191,chair
12399,35,bowl,34,0,10460,25,649,1157,1040,1257,391,100,bowl
12400,53,pot,54,0,10463,15,501,308,532,329,31,21,potted plant
12401,9,refrigerator,10,0,10464,24,1226,569,1572,1367,346,798,refrigerator
12402,20,door,21,1,10464,15,805,495,1084,1164,279,669,door
12403,23,window,24,1,10464,15,98,400,709,1025,611,625,window
12404,27,chair,28,1,10464,58,306,914,581,1331,275,417,chair
12405,28,chair,29,0,10464,51,603,958,870,1435,267,477,chair
12406,29,chair,30,0,10464,57,82,1040,497,1457,415,417,chair
12407,35,table,36,1,10464,60,226,1001,701,1456,475,455,dining table
12408,24,table,25,0,10465,31,6,203,192,243,186,40,dining table
12409,2,table,3,0,10466,28,1107,872,1956,1655,849,783,dining table
12410,29,refrigerator,23,1,10467,16,197,122,388,591,191,469,refrigerator
12411,31,chair,25,1,10467,36,138,556,316,946,178,390,chair
12412,32,chair,26,1,10467,41,618,577,758,951,140,374,chair
12413,33,chair,27,0,10467,46,415,623,673,960,258,337,chair
12414,86,door,80,0,10467,15,290,215,389,582,99,367,door
12415,17,vase,18,0,10468,26,63,256,99,315,36,59,vase
12416,27,table,18,1,10469,16,195,461,471,504,276,43,dining table
12417,36,ball,27,0,10469,16,227,547,304,608,77,61,sports ball
12418,38,ball,29,1,10469,24,172,507,282,581,110,74,sports ball
12419,39,window,30,0,10469,17,30,279,387,521,357,242,window
12420,40,window,31,0,10469,16,393,308,519,473,126,165,window
12421,3,chair,4,1,10470,48,18,423,201,710,183,287,chair
12422,5,window,6,0,10470,24,2,164,248,550,246,386,window
12423,13,window,13,0,10470,29,620,216,842,405,222,189,window
12424,27,chair,27,1,10470,50,652,485,921,709,269,224,chair
12425,28,table,28,0,10470,41,26,444,740,710,714,266,dining table
12426,29,chair,29,1,10470,28,382,534,844,710,462,176,chair
12427,14,chair,11,0,10471,28,297,375,353,505,56,130,chair
12428,31,refrigerator,26,1,10471,34,754,252,970,589,216,337,refrigerator
12429,75,flowerpot,70,0,10471,29,677,550,798,675,121,125,potted plant
12430,7,door,8,1,10473,20,190,62,245,214,55,152,door
12431,6,chair,7,1,10474,19,262,126,300,183,38,57,chair
12432,7,chair,8,1,10474,37,219,136,263,224,44,88,chair
12433,8,chair,9,0,10474,24,167,148,213,224,46,76,chair
12434,9,table,10,1,10474,47,150,131,254,224,104,93,dining table
12435,34,table,29,0,10475,15,0,163,165,256,165,93,dining table
12436,3,chair,4,1,10476,16,882,720,1055,907,173,187,chair
12437,4,chair,5,1,10476,15,1052,426,1253,540,201,114,chair
12438,5,chair,6,1,10476,49,963,543,1436,1023,473,480,chair
12439,6,chair,7,1,10476,30,550,410,771,949,221,539,chair
12440,7,table,8,1,10476,26,550,449,1385,1023,835,574,dining table
12441,0,chair,1,0,10477,20,80,246,190,431,110,185,chair
12442,3,table,4,0,10477,16,160,221,363,412,203,191,dining table
12443,10,chair,11,0,10477,17,457,222,567,374,110,152,chair
12444,26,chair,27,0,10477,25,244,247,353,415,109,168,chair
12445,45,chair,45,1,10477,46,159,217,257,377,98,160,chair
12446,20,chair,21,1,10479,30,0,716,113,1151,113,435,chair
12447,21,chair,22,1,10479,28,33,757,236,1151,203,394,chair
12448,22,chair,23,1,10479,34,426,803,808,1150,382,347,chair
12449,23,table,24,0,10479,56,2,663,807,1151,805,488,dining table
12450,29,flowerpot,30,0,10479,15,290,54,361,253,71,199,potted plant
12451,31,flowerpot,32,1,10479,16,0,6,49,267,49,261,potted plant
12452,32,plate,33,1,10480,16,582,401,663,431,81,30,plate
12453,38,refrigerator,39,1,10480,29,7,102,222,466,215,364,refrigerator
12454,59,door,60,0,10480,21,105,160,208,431,103,271,door
12455,6,sofa,7,0,10482,16,67,100,182,141,115,41,couch
12456,11,plate,12,0,10482,15,0,157,79,180,79,23,plate
12457,19,bottle,20,0,10483,16,196,921,235,1039,39,118,bottle
12458,20,bottle,21,0,10483,17,231,927,284,1056,53,129,bottle
12459,21,bottle,22,1,10483,16,274,919,305,1052,31,133,bottle
12460,30,refrigerator,31,0,10484,17,86,273,352,922,266,649,refrigerator
12461,40,refrigerator,41,0,10484,20,467,308,654,696,187,388,refrigerator
12462,44,window,45,0,10484,17,646,302,797,500,151,198,window
12463,68,vase,69,0,10484,33,880,502,952,611,72,109,vase
12464,71,chair,72,1,10484,36,681,689,1046,1002,365,313,chair
12465,72,chair,73,1,10484,40,364,611,589,1002,225,391,chair
12466,20,vase,21,0,10487,19,208,385,260,467,52,82,vase
12467,61,bottle,62,0,10487,19,259,409,279,444,20,35,bottle
12468,78,bowl,79,0,10487,25,810,389,870,440,60,51,bowl
12469,81,flowerpot,82,1,10487,39,859,704,1023,747,164,43,potted plant
12470,42,sink,43,0,10488,30,254,472,457,552,203,80,sink
12471,49,plate,50,0,10488,30,246,590,355,675,109,85,plate
12472,55,bowl,56,0,10488,18,31,454,145,500,114,46,bowl
12473,58,bowl,59,0,10488,15,129,390,187,414,58,24,bowl
12474,65,plate,66,1,10488,20,0,466,156,521,156,55,plate
12475,66,spoon,67,0,10488,15,1,514,130,547,129,33,spoon
12476,47,plate,48,0,10490,28,245,294,340,315,95,21,plate
12477,72,chair,73,1,10495,23,256,322,285,452,29,130,chair
12478,73,chair,74,1,10495,20,275,334,322,474,47,140,chair
12479,74,chair,75,1,10495,27,312,345,359,543,47,198,chair
12480,75,chair,76,1,10495,30,346,364,426,606,80,242,chair
12481,44,window,45,1,10496,21,781,409,1091,739,310,330,window
12482,47,door,48,1,10496,15,141,84,370,599,229,515,door
12483,49,door,50,0,10496,24,402,80,686,597,284,517,door
12484,84,chair,84,1,10496,93,367,882,933,1646,566,764,chair
12485,85,chair,85,0,10496,65,125,828,553,1650,428,822,chair
12486,86,chair,86,1,10496,89,2,813,271,1501,269,688,chair
12487,31,blender,32,0,10497,21,727,603,800,765,73,162,blender
12488,65,plate,66,0,10497,25,626,1291,880,1375,254,84,plate
12489,68,plate,69,1,10497,22,318,1118,542,1188,224,70,plate
12490,3,table,4,0,10499,16,74,115,199,210,125,95,dining table
12491,4,chair,5,0,10499,28,147,117,251,238,104,121,chair
12492,5,chair,6,0,10499,30,17,115,107,230,90,115,chair
12493,16,vase,17,0,10500,16,367,308,405,371,38,63,vase
12494,0,chair,1,0,10501,30,246,588,481,900,235,312,chair
12495,58,bowl,54,0,10501,18,766,239,808,280,42,41,bowl
12496,72,book,65,0,10501,16,1002,537,1098,571,96,34,book
12497,81,bowl,74,0,10501,18,55,428,113,486,58,58,bowl
12498,87,vase,80,0,10501,15,255,431,282,475,27,44,vase
12499,90,table,83,0,10501,20,0,536,615,898,615,362,dining table
12500,164,bottle,157,1,10501,17,971,478,993,537,22,59,bottle
12501,3,blender,4,0,10506,16,189,99,215,145,26,46,blender
12502,9,chair,10,1,10507,16,1568,994,2009,1307,441,313,chair
12503,30,door,31,0,10507,15,469,940,1108,1455,639,515,door
12504,23,window,24,0,10508,38,598,220,674,290,76,70,window
12505,26,chair,27,1,10508,25,633,275,682,365,49,90,chair
12506,29,plate,30,0,10508,15,345,249,376,281,31,32,plate
12507,46,vase,47,0,10508,27,295,219,340,310,45,91,vase
12508,48,bottle,49,0,10508,17,268,240,283,279,15,39,bottle
12509,63,bottle,64,0,10508,18,143,256,167,287,24,31,bottle
12510,64,chair,65,1,10508,38,543,268,614,532,71,264,chair
12511,65,chair,66,0,10508,42,336,268,586,533,250,265,chair
12512,67,flowerpot,68,0,10509,21,893,427,951,473,58,46,potted plant
12513,23,door,24,0,10511,18,485,288,542,349,57,61,door
12514,24,window,25,0,10511,16,494,295,531,339,37,44,window
12515,0,chair,1,0,10513,20,166,495,474,768,308,273,chair
12516,43,window,44,0,10514,31,1509,436,1880,825,371,389,window
12517,94,chair,95,1,10514,65,336,1121,877,1649,541,528,chair
12518,95,chair,96,0,10514,78,864,1052,1373,1650,509,598,chair
12519,96,chair,97,0,10514,57,1300,1009,1713,1649,413,640,chair
12520,56,table,49,0,10515,33,1014,576,1200,753,186,177,dining table
12521,59,chair,51,0,10515,33,930,508,1078,732,148,224,chair
12522,82,chair,83,0,10518,88,224,346,344,518,120,172,chair
12523,83,chair,84,0,10518,83,320,354,438,533,118,179,chair
12524,84,chair,85,0,10518,84,427,362,543,533,116,171,chair
12525,31,chair,32,1,10519,25,661,463,709,568,48,105,chair
12526,33,table,34,1,10519,20,582,487,704,579,122,92,dining table
12527,35,chair,36,0,10519,27,596,464,664,588,68,124,chair
12528,1,chair,2,0,10523,22,33,169,104,255,71,86,chair
12529,4,table,5,0,10523,19,86,169,255,232,169,63,dining table
12530,7,chair,7,0,10525,17,74,441,293,640,219,199,chair
12531,42,chair,40,1,10526,20,49,374,103,428,54,54,chair
12532,43,chair,41,1,10526,16,0,353,37,394,37,41,chair
12533,38,chair,34,0,10529,27,419,794,739,1224,320,430,chair
12534,75,bowl,71,0,10529,16,274,688,353,720,79,32,bowl
12535,0,cat,1,0,10531,53,321,21,727,362,406,341,cat
12536,2,oven,3,1,10531,20,192,1,438,270,246,269,oven
12537,22,window,23,0,10532,66,495,581,816,934,321,353,window
12538,44,refrigerator,45,0,10532,16,1668,136,1998,1526,330,1390,refrigerator
12539,56,pot,57,0,10532,22,524,985,583,1192,59,207,potted plant
12540,60,chair,61,1,10532,24,445,1110,1109,1535,664,425,chair
12541,61,chair,62,1,10532,23,1010,1051,1419,1536,409,485,chair
12542,62,chair,63,1,10532,42,1116,1009,1621,1536,505,527,chair
12543,64,toaster,65,0,10532,22,1083,820,1301,951,218,131,toaster
12544,10,table,11,0,10533,20,225,156,255,242,30,86,dining table
12545,11,chair,12,0,10533,15,233,158,256,254,23,96,chair
12546,9,blender,9,0,10535,25,232,119,276,196,44,77,blender
12547,76,door,77,0,10537,17,1219,947,1535,1196,316,249,door
12548,98,plate,99,0,10537,19,1760,1422,2051,1548,291,126,plate
12549,99,plate,100,0,10537,23,1866,1308,2144,1427,278,119,plate
12550,102,plate,103,1,10537,17,1748,1051,1879,1098,131,47,plate
12551,104,plate,105,1,10537,18,1451,1123,1639,1182,188,59,plate
12552,105,plate,106,1,10537,25,1313,1131,1518,1209,205,78,plate
12553,106,knife,107,0,10537,19,1737,1447,2051,1502,314,55,knife
12554,108,spoon,109,0,10537,21,1915,1343,2160,1388,245,45,spoon
12555,13,chair,14,0,10538,40,370,478,570,898,200,420,chair
12556,14,chair,15,0,10538,51,595,497,802,899,207,402,chair
12557,13,chair,14,0,10540,23,82,116,122,185,40,69,chair
12558,14,chair,15,0,10540,19,17,125,52,200,35,75,chair
12559,15,chair,16,0,10540,20,50,125,80,192,30,67,chair
12560,9,blender,10,0,10541,15,314,262,354,337,40,75,blender
12561,29,door,30,0,10547,19,723,403,928,769,205,366,door
12562,34,bananas,35,0,10547,22,1390,702,1481,748,91,46,banana
12563,13,chair,14,0,10548,27,118,258,249,449,131,191,chair
12564,3,table,4,1,10555,23,381,388,769,600,388,212,dining table
12565,6,chair,7,1,10555,52,233,445,384,598,151,153,chair
12566,12,chair,12,0,10558,18,703,544,925,764,222,220,chair
12567,22,bowl,22,0,10558,20,321,359,415,410,94,51,bowl
12568,28,table,28,1,10558,22,2,466,186,767,184,301,dining table
12569,35,bowl,35,0,10558,17,322,559,394,598,72,39,bowl
12570,0,chair,1,1,10561,26,398,404,1140,1293,742,889,chair
12571,14,umbrella,15,0,10564,15,350,201,375,257,25,56,umbrella
12572,15,umbrella,16,0,10564,17,329,210,350,257,21,47,umbrella
12573,104,table,105,1,10565,111,238,991,1429,1613,1191,622,dining table
12574,105,chair,106,1,10565,58,227,993,581,1546,354,553,chair
12575,107,chair,108,1,10565,43,627,1035,1154,1650,527,615,chair
12576,108,chair,109,1,10565,41,1122,977,1300,1649,178,672,chair
12577,109,chair,110,1,10565,55,1156,923,1428,1610,272,687,chair
12578,110,chair,111,1,10565,40,1153,847,1372,1226,219,379,chair
12579,112,chair,113,1,10565,20,487,950,674,1119,187,169,chair
12580,113,chair,114,1,10565,23,676,910,847,1065,171,155,chair
12581,6,table,7,0,10566,27,28,177,77,225,49,48,dining table
12582,36,bowl,37,0,10568,17,1204,601,1442,691,238,90,bowl
12583,37,bowl,38,0,10568,17,1258,698,1549,825,291,127,bowl
12584,50,plate,51,0,10568,19,1129,392,1157,435,28,43,plate
12585,20,chair,21,1,10569,15,176,292,212,476,36,184,chair
12586,4,table,5,0,10572,15,159,347,407,573,248,226,dining table
12587,5,chair,6,1,10572,16,197,456,378,575,181,119,chair
12588,2,table,3,0,10573,30,392,274,555,450,163,176,dining table
12589,4,chair,5,0,10573,31,303,256,388,430,85,174,chair
12590,5,chair,6,0,10573,30,442,277,536,464,94,187,chair
12591,9,refrigerator,10,1,10573,16,35,54,311,600,276,546,refrigerator
12592,18,door,19,0,10573,15,233,240,311,599,78,359,door
12593,21,plate,22,0,10575,16,216,9,246,26,30,17,plate
12594,3,bowl,4,0,10576,25,4,386,137,446,133,60,bowl
12595,0,table,1,0,10578,41,719,526,1210,799,491,273,dining table
12596,2,chair,3,0,10578,17,978,631,1278,799,300,168,chair
12597,47,refrigerator,48,0,10579,27,1320,485,1661,1148,341,663,refrigerator
12598,27,refrigerator,28,0,10581,27,704,250,1097,974,393,724,refrigerator
12599,7,chair,8,0,10583,18,0,731,210,1467,210,736,chair
12600,72,door,73,1,10583,15,1626,299,1818,1088,192,789,door
12601,23,chair,24,1,10590,15,183,188,202,279,19,91,chair
12602,0,chair,1,0,10597,24,188,153,252,255,64,102,chair
12603,2,person,3,0,10599,19,1124,567,1277,1202,153,635,person
12604,72,chair,73,1,10600,18,1821,1168,2079,1444,258,276,chair
12605,5,table,6,1,10601,21,47,154,215,198,168,44,dining table
12606,6,chair,7,1,10601,21,72,137,132,160,60,23,chair
12607,7,chair,8,0,10601,34,21,148,97,255,76,107,chair
12608,8,chair,9,1,10601,30,128,155,224,255,96,100,chair
12609,12,chair,13,1,10601,16,197,136,240,196,43,60,chair
12610,16,window,17,1,10602,61,736,282,857,618,121,336,window
12611,61,oven,59,0,10603,18,766,326,1024,768,258,442,oven
12612,72,vase,70,0,10603,24,634,359,682,413,48,54,vase
12613,35,toaster,36,0,10604,20,332,848,535,995,203,147,toaster
12614,43,chair,44,1,10604,24,2,1286,220,1531,218,245,chair
12615,44,chair,45,1,10604,16,1,1478,352,1641,351,163,chair
12616,6,table,7,1,10605,16,481,1042,1499,1338,1018,296,dining table
12617,60,plate,58,0,10605,18,705,1149,823,1209,118,60,plate
12618,6,sofa,7,1,10608,15,44,80,77,124,33,44,couch
12619,7,chair,8,1,10608,16,2,127,33,210,31,83,chair
12620,0,person,1,0,10609,24,579,1192,925,1729,346,537,person
12621,1,dog,2,0,10609,15,713,1329,988,1521,275,192,dog
12622,16,chair,17,0,10610,18,109,149,160,216,51,67,chair
12623,20,chair,21,1,10612,15,6,1298,604,1530,598,232,chair
12624,8,chair,9,0,10613,33,342,392,663,1023,321,631,chair
12625,9,chair,10,0,10613,30,619,384,847,887,228,503,chair
12626,12,window,13,0,10613,15,221,7,695,463,474,456,window
12627,86,bowl,87,0,10613,19,941,457,1048,513,107,56,bowl
12628,37,pot,35,1,10614,27,375,571,416,624,41,53,potted plant
12629,38,pot,36,1,10614,20,356,580,385,625,29,45,potted plant
12630,39,pot,37,0,10614,19,337,589,361,627,24,38,potted plant
12631,40,pot,38,0,10614,19,316,596,341,629,25,33,potted plant
12632,72,bottle,70,1,10614,18,48,555,80,654,32,99,bottle
12633,80,sink,78,0,10614,16,881,650,1068,670,187,20,sink
12634,5,chair,6,1,10620,17,156,588,436,766,280,178,chair
12635,26,bowl,26,0,10620,15,451,299,510,352,59,53,bowl
12636,10,table,11,0,10623,27,36,153,152,263,116,110,dining table
12637,11,chair,12,0,10623,19,112,144,165,240,53,96,chair
12638,12,chair,13,0,10623,16,36,179,91,289,55,110,chair
12639,1,sink,2,0,10624,16,358,228,406,261,48,33,sink
12640,16,table,13,0,10624,15,131,244,276,345,145,101,dining table
12641,30,bowl,30,0,10628,19,598,564,698,666,100,102,bowl
12642,31,bowl,31,0,10628,15,170,621,310,675,140,54,bowl
12643,67,oven,68,0,10631,31,55,762,574,1389,519,627,oven
12644,5,bottle,6,0,10632,20,401,324,449,453,48,129,bottle
12645,21,door,21,1,10633,24,1,172,183,631,182,459,door
12646,29,window,29,0,10633,16,358,227,554,394,196,167,window
12647,35,vase,35,0,10633,16,334,369,365,422,31,53,vase
12648,60,chair,60,0,10633,62,1122,597,1289,887,167,290,chair
12649,67,chair,67,1,10633,18,21,404,171,524,150,120,chair
12650,68,chair,68,1,10633,24,2,462,203,736,201,274,chair
12651,69,chair,69,1,10633,30,1,698,484,1203,483,505,chair
12652,73,pot,73,0,10633,20,1178,120,1253,168,75,48,potted plant
12653,0,sink,1,0,10634,17,64,548,754,721,690,173,sink
12654,53,pot,54,0,10634,15,129,225,197,352,68,127,potted plant
12655,58,window,59,0,10634,26,820,1,1024,450,204,449,window
12656,76,table,75,0,10634,73,413,320,991,586,578,266,dining table
12657,10,pots,11,0,10635,24,1225,166,1402,386,177,220,potted plant
12658,36,plate,33,0,10635,16,761,483,870,584,109,101,plate
12659,9,blender,10,0,10636,22,241,181,272,244,31,63,blender
12660,22,door,23,0,10637,19,1523,466,1848,1258,325,792,door
12661,3,bowl,4,0,10639,15,897,547,979,582,82,35,bowl
12662,37,pot,36,0,10640,16,204,635,297,800,93,165,potted plant
12663,46,pot,45,0,10640,15,610,542,661,632,51,90,potted plant
12664,52,cup,51,0,10640,19,1578,169,1656,194,78,25,cup
12665,145,clock,144,0,10640,27,813,54,908,179,95,125,clock
12666,148,cup,147,0,10640,17,1751,135,1826,167,75,32,cup
12667,150,plate,149,0,10640,15,1742,165,1823,181,81,16,plate
12668,151,plate,150,1,10640,21,1574,121,1656,173,82,52,plate
12669,170,pot,169,0,10640,25,1036,589,1102,631,66,42,potted plant
12670,173,vase,172,1,10640,19,1082,564,1118,610,36,46,vase
12671,177,pot,176,0,10640,22,621,62,706,136,85,74,potted plant
12672,28,chair,26,0,10642,23,355,378,471,590,116,212,chair
12673,29,chair,27,0,10642,25,189,392,308,599,119,207,chair
12674,30,chair,28,1,10642,18,304,391,359,532,55,141,chair
12675,12,chair,13,1,10643,26,517,283,666,532,149,249,chair
12676,30,window,31,0,10645,18,725,500,1003,743,278,243,window
12677,29,chair,29,0,10647,19,15,172,112,256,97,84,chair
12678,2,dog,3,0,10648,24,255,246,328,296,73,50,dog
12679,11,plate,12,0,10649,21,877,1123,1119,1264,242,141,plate
12680,47,bottle,48,0,10649,18,808,547,849,652,41,105,bottle
12681,11,chair,12,0,10650,31,510,451,688,761,178,310,chair
12682,12,chair,13,0,10650,27,365,435,526,720,161,285,chair
12683,48,pot,48,0,10650,17,98,300,161,343,63,43,potted plant
12684,56,plate,56,0,10650,15,871,283,924,343,53,60,plate
12685,59,flowerpot,59,0,10650,30,214,453,314,539,100,86,potted plant
12686,3,refrigerator,4,0,10651,15,15,2,235,385,220,383,refrigerator
12687,0,blender,1,1,10652,29,2,96,62,277,60,181,blender
12688,10,table,11,0,10654,29,0,147,81,198,81,51,dining table
12689,11,chair,12,0,10654,21,31,141,65,204,34,63,chair
12690,2,chair,3,0,10655,15,72,160,159,257,87,97,chair
12691,3,chair,4,0,10655,31,244,162,307,281,63,119,chair
12692,4,chair,5,0,10655,22,147,170,221,293,74,123,chair
12693,13,sink,14,0,10656,27,437,959,852,1089,415,130,sink
12694,21,pot,22,0,10656,33,849,947,1040,1090,191,143,potted plant
12695,71,pot,72,0,10656,24,572,785,679,922,107,137,potted plant
12696,16,chair,17,0,10657,46,617,497,1003,1130,386,633,chair
12697,17,table,18,1,10657,36,848,599,1295,1149,447,550,dining table
12698,18,chair,19,1,10657,20,1088,839,1292,1364,204,525,chair
12699,57,plate,58,0,10657,18,1131,656,1229,682,98,26,plate
12700,58,plate,59,0,10657,17,1103,607,1182,630,79,23,plate
12701,70,plate,69,0,10660,16,2,415,99,508,97,93,plate
12702,32,dog,33,1,10661,22,336,306,399,354,63,48,dog
12703,10,chair,11,1,10662,16,13,180,97,239,84,59,chair
12704,17,chair,18,1,10663,18,313,234,380,303,67,69,chair
12705,19,sink,20,0,10664,21,868,754,1475,1010,607,256,sink
12706,139,bowl,140,0,10664,19,893,763,1166,841,273,78,bowl
12707,140,bowl,141,0,10664,23,1095,830,1467,994,372,164,bowl
12708,61,pot,62,0,10665,16,101,579,149,621,48,42,potted plant
12709,5,bowl,6,0,10666,16,72,125,91,138,19,13,bowl
12710,17,window,18,0,10666,22,0,62,29,133,29,71,window
12711,47,window,48,0,10667,19,1785,330,2147,785,362,455,window
12712,79,window,78,0,10667,15,1094,987,1328,1084,234,97,window
12713,5,bowl,6,0,10668,16,108,491,334,545,226,54,bowl
12714,15,chair,16,0,10668,23,1032,426,1200,863,168,437,chair
12715,13,refrigerator,14,1,10670,19,565,435,1048,949,483,514,refrigerator
12716,34,umbrella,35,0,10670,21,26,791,332,917,306,126,umbrella
12717,25,chair,26,1,10673,31,492,301,622,499,130,198,chair
12718,26,chair,27,1,10673,32,370,316,508,499,138,183,chair
12719,27,chair,28,0,10673,39,217,310,370,499,153,189,chair
12720,28,chair,29,1,10673,24,146,291,240,499,94,208,chair
12721,47,door,48,0,10673,18,72,216,132,374,60,158,door
12722,14,pot,14,0,10676,15,574,764,652,894,78,130,potted plant
12723,123,dog,122,0,10676,36,222,1268,658,1499,436,231,dog
12724,1,clock,2,0,10677,15,195,62,249,118,54,56,clock
12725,10,chair,11,1,10680,17,253,227,303,404,50,177,chair
12726,11,chair,12,1,10680,19,7,241,135,454,128,213,chair
12727,12,chair,13,1,10680,24,146,253,252,483,106,230,chair
12728,16,table,17,0,10680,26,46,254,282,476,236,222,dining table
12729,3,chair,4,0,10682,56,137,264,395,480,258,216,chair
12730,8,chair,9,0,10682,21,2,248,165,479,163,231,chair
12731,6,vase,7,0,10683,32,64,349,143,459,79,110,vase
12732,12,chair,13,1,10683,18,162,371,340,586,178,215,chair
12733,13,chair,14,1,10683,36,0,536,275,597,275,61,chair
12734,14,table,15,1,10683,54,2,411,432,570,430,159,dining table
12735,20,vase,21,0,10683,16,468,281,502,334,34,53,vase
12736,21,pot,22,0,10683,21,499,300,545,337,46,37,potted plant
12737,31,door,32,0,10683,18,409,379,464,481,55,102,door
12738,35,chair,36,0,10683,32,413,421,715,600,302,179,chair
12739,39,door,40,0,10683,15,615,407,713,557,98,150,door
12740,70,door,71,1,10683,24,93,142,188,413,95,271,door
12741,61,bed,62,0,10684,23,660,604,853,731,193,127,bed
12742,66,window,67,0,10684,29,1249,534,1641,712,392,178,window
12743,70,sofa,71,1,10684,29,1367,652,1602,715,235,63,couch
12744,72,sofa,73,1,10684,41,1132,676,1706,861,574,185,couch
12745,115,sofa,116,1,10684,33,1,676,492,923,491,247,couch
12746,198,pot,199,1,10684,24,1113,604,1148,642,35,38,potted plant
12747,199,pot,200,1,10684,21,1104,612,1131,644,27,32,potted plant
12748,201,bottle,202,0,10684,16,1012,635,1034,661,22,26,bottle
12749,53,oven,54,1,10686,22,1218,758,1502,1157,284,399,oven
12750,83,refrigerator,84,1,10686,42,335,586,759,1231,424,645,refrigerator
12751,86,chair,87,1,10686,47,685,899,974,1399,289,500,chair
12752,87,chair,88,0,10686,64,930,932,1261,1459,331,527,chair
12753,90,table,91,1,10686,24,2,923,457,1228,455,305,dining table
12754,97,table,98,1,10686,16,2,1198,887,1466,885,268,dining table
12755,100,chair,101,1,10686,17,463,1042,725,1318,262,276,chair
12756,123,door,124,0,10686,21,624,599,759,1148,135,549,door
12757,125,door,126,0,10686,20,481,587,634,1148,153,561,door
12758,12,table,13,0,10690,17,409,266,587,449,178,183,dining table
12759,5,chair,6,0,10691,25,53,268,188,427,135,159,chair
12760,8,chair,9,0,10691,20,2,258,97,411,95,153,chair
12761,1,pot,2,0,10696,17,6,122,35,146,29,24,potted plant
12762,18,chair,19,1,10697,23,182,333,316,510,134,177,chair
12763,4,chair,5,0,10701,30,158,201,206,300,48,99,chair
12764,5,chair,6,0,10701,34,128,214,174,299,46,85,chair
12765,53,bottle,35,0,10704,15,1023,403,1049,466,26,63,bottle
12766,55,plate,37,0,10704,20,1060,418,1116,491,56,73,plate
12767,71,vegetables,53,0,10704,50,295,497,475,587,180,90,carrot
12768,74,plate,56,0,10704,18,87,189,163,255,76,66,plate
12769,75,plate,57,0,10704,18,2,186,58,253,56,67,plate
12770,101,bowl,83,0,10704,19,297,558,453,601,156,43,bowl
12771,18,table,19,0,10705,18,4,139,148,225,144,86,dining table
12772,20,chair,21,0,10705,31,97,151,152,225,55,74,chair
12773,6,chair,7,1,10706,15,96,108,133,146,37,38,chair
12774,7,chair,8,0,10706,15,161,102,206,159,45,57,chair
12775,12,table,13,0,10706,20,216,112,297,191,81,79,dining table
12776,3,table,4,0,10709,33,451,559,926,897,475,338,dining table
12777,71,refrigerator,40,0,10709,15,668,118,910,619,242,501,refrigerator
12778,132,flowerpot,97,0,10709,16,170,445,208,495,38,50,potted plant
12779,8,table,9,0,10715,21,89,185,227,272,138,87,dining table
12780,9,chair,10,1,10715,18,171,179,261,261,90,82,chair
12781,10,chair,11,1,10715,23,42,200,142,276,100,76,chair
12782,15,sofa,16,1,10715,15,31,226,510,360,479,134,couch
12783,23,chair,24,0,10716,16,1,159,32,250,31,91,chair
12784,38,vase,38,0,10719,16,525,531,554,571,29,40,vase
12785,39,vase,39,0,10719,29,600,519,638,585,38,66,vase
12786,13,oven,14,0,10724,15,201,354,368,575,167,221,oven
12787,34,plate,35,0,10725,17,112,142,153,156,41,14,plate
12788,40,plate,40,0,10726,17,777,525,842,547,65,22,plate
12789,107,plate,107,0,10726,23,330,344,367,377,37,33,plate
12790,0,bowl,1,0,10727,17,784,577,917,676,133,99,bowl
12791,16,chair,17,1,10727,15,508,515,702,768,194,253,chair
12792,21,chair,22,1,10727,17,845,407,965,582,120,175,chair
12793,25,table,26,0,10728,23,581,845,1696,1646,1115,801,dining table
12794,37,coffee pot,38,0,10728,17,1481,135,1547,216,66,81,potted plant
12795,40,chair,41,1,10728,30,904,994,1287,1645,383,651,chair
12796,72,window,73,0,10728,17,1504,25,1775,224,271,199,window
12797,82,plate,83,0,10728,26,866,530,927,565,61,35,plate
12798,105,door,106,0,10728,28,672,741,934,995,262,254,door
12799,108,door,109,0,10728,16,1506,667,1646,974,140,307,door
12800,12,microwave,10,1,10729,40,456,745,831,987,375,242,microwave
12801,37,vase,35,1,10729,17,901,85,960,209,59,124,vase
12802,72,plate,71,0,10730,23,811,921,841,988,30,67,plate
12803,8,door,7,0,10732,16,164,151,295,617,131,466,door
12804,53,chair,52,1,10732,19,1338,394,1375,558,37,164,chair
12805,12,chair,13,1,10734,17,173,261,247,396,74,135,chair
12806,14,chair,15,0,10734,16,120,283,194,427,74,144,chair
12807,16,table,17,0,10734,17,89,262,220,432,131,170,dining table
12808,1,chair,2,0,10735,18,258,159,321,279,63,120,chair
12809,2,table,3,0,10735,21,178,179,301,290,123,111,dining table
12810,21,chair,22,1,10735,29,199,156,256,259,57,103,chair
12811,12,blender,13,0,10737,27,314,66,354,138,40,72,blender
12812,45,sink,43,0,10742,16,2,750,150,889,148,139,sink
12813,81,bowl,79,0,10742,16,732,518,919,552,187,34,bowl
12814,93,door,91,0,10742,15,77,386,268,564,191,178,door
12815,7,refrigerator,8,0,10743,26,732,198,1156,733,424,535,refrigerator
12816,12,person,13,0,10743,57,1032,257,1275,751,243,494,person
12817,18,refrigerator,19,1,10745,15,0,564,199,1643,199,1079,refrigerator
12818,18,oven,19,1,21021,18,868,733,1064,1053,196,320,oven
12819,41,table,42,0,21021,18,97,723,566,1140,469,417,dining table
12820,45,chair,46,1,21021,32,1271,1300,1754,1464,483,164,chair
12821,47,vase,48,0,21021,32,886,887,1039,1161,153,274,vase
12822,9,window,10,0,21022,17,922,311,1471,862,549,551,window
12823,16,bottle,17,0,21022,17,1034,807,1076,934,42,127,bottle
12824,26,refrigerator,27,1,21023,18,1465,398,1776,1093,311,695,refrigerator
12825,39,pot,40,0,21023,18,1036,652,1103,725,67,73,potted plant
12826,49,bowl,50,0,21023,26,1079,735,1241,847,162,112,bowl
12827,52,chair,53,1,21023,31,1397,1023,1842,1384,445,361,chair
12828,14,door,15,0,21024,35,1528,222,1881,895,353,673,door
12829,18,window,19,0,21024,37,961,387,1545,773,584,386,window
12830,24,hat,25,1,21024,21,130,586,255,857,125,271,hat
12831,25,hat,26,0,21024,17,3,588,183,889,180,301,hat
12832,42,table,43,0,21024,25,1055,727,1536,880,481,153,dining table
12833,44,chair,45,1,21024,16,1223,699,1375,862,152,163,chair
12834,46,plate,47,0,21024,23,1195,816,1378,989,183,173,plate
12835,34,backpack,35,0,21025,21,110,815,261,993,151,178,backpack
12836,59,bottle,60,0,21025,18,189,326,264,423,75,97,bottle
12837,64,shoe,65,0,21025,16,1908,1211,2047,1296,139,85,shoe
12838,6,window,7,0,21026,23,588,57,831,375,243,318,window
12839,22,plant pot,23,0,21026,22,610,254,686,317,76,63,potted plant
12840,37,clock,38,0,21026,18,834,105,920,206,86,101,clock
12841,48,oven,49,1,21027,15,452,526,567,609,115,83,oven
12842,20,window,21,0,21028,17,511,481,1033,1138,522,657,window
12843,14,bowl,15,0,21029,17,1862,911,2000,995,138,84,bowl
12844,16,spoon,17,0,21029,15,1455,966,1572,1036,117,70,spoon
12845,18,toaster,19,0,21029,19,109,723,287,930,178,207,toaster
12846,24,sink,25,0,21029,24,599,876,1349,1064,750,188,sink
12847,21,refrigerator,22,0,21031,17,275,443,420,1326,145,883,refrigerator
12848,25,pot,26,0,21031,20,622,786,717,896,95,110,potted plant
12849,30,pot,31,0,21031,16,1528,765,1662,868,134,103,potted plant
12850,32,bowl,33,0,21031,18,757,878,925,984,168,106,bowl
12851,21,refrigerator,22,0,21032,15,259,249,350,461,91,212,refrigerator
12852,33,chair,33,1,21032,18,16,319,44,391,28,72,chair
12853,43,bowl,43,0,21032,20,620,360,687,393,67,33,bowl
12854,15,window,16,0,21033,17,170,168,324,320,154,152,window
12855,27,window,28,0,21033,24,553,196,646,309,93,113,window
12856,28,window,29,0,21033,22,437,199,539,332,102,133,window
12857,32,table,33,1,21033,24,479,309,596,332,117,23,dining table
12858,34,chair,35,1,21033,16,459,304,502,346,43,42,chair
12859,44,bowl,45,0,21033,32,634,376,763,432,129,56,bowl
12860,46,bowl,47,0,21033,20,609,317,687,345,78,28,bowl
12861,15,table,16,0,21034,88,1,316,304,532,303,216,dining table
12862,16,chair,17,1,21034,30,0,379,68,533,68,154,chair
12863,17,chair,18,1,21034,60,101,304,380,533,279,229,chair
12864,18,chair,19,1,21034,70,99,293,256,470,157,177,chair
12865,42,sink,43,0,21035,20,492,1209,992,1265,500,56,sink
12866,43,plate,44,1,21035,21,985,1052,1253,1214,268,162,plate
12867,56,vase,57,0,21035,19,14,1260,139,1484,125,224,vase
12868,23,vase,24,1,21036,28,726,0,823,72,97,72,vase
12869,31,chair,32,1,21036,31,59,476,244,768,185,292,chair
12870,32,chair,33,1,21036,17,316,425,428,516,112,91,chair
12871,15,chair,16,1,21037,16,408,634,477,794,69,160,chair
12872,45,chair,46,1,21037,26,357,1008,479,1199,122,191,chair
12873,46,chair,47,1,21037,41,1150,992,1343,1199,193,207,chair
12874,48,table,49,0,21037,19,550,1027,1126,1199,576,172,dining table
12875,19,chair,20,1,21038,20,695,286,739,384,44,98,chair
12876,20,chair,21,1,21038,23,660,293,710,402,50,109,chair
12877,21,mirror,22,0,21038,24,658,198,681,254,23,56,mirror
12878,20,refrigerator,21,0,21039,15,861,196,1104,773,243,577,refrigerator
12879,21,chair,22,0,21039,57,730,556,975,959,245,403,chair
12880,22,chair,23,0,21039,41,568,566,830,960,262,394,chair
12881,41,table,42,1,21039,17,1113,716,1215,960,102,244,dining table
12882,43,chair,44,1,21039,19,1113,603,1260,732,147,129,chair
12883,44,chair,45,1,21039,15,1160,683,1280,960,120,277,chair
12884,58,plate,59,0,21039,15,529,453,573,496,44,43,plate
12885,46,chair,47,1,21040,36,0,355,71,533,71,178,chair
12886,47,chair,48,1,21040,39,23,356,183,533,160,177,chair
12887,49,bowl,50,0,21040,16,231,319,273,343,42,24,bowl
12888,55,chair,56,1,21041,28,716,348,799,519,83,171,chair
12889,56,chair,57,0,21041,64,560,335,756,533,196,198,chair
12890,57,chair,58,0,21041,16,0,375,114,529,114,154,chair
12891,59,chair,60,1,21041,16,132,424,211,533,79,109,chair
12892,62,bowl,63,0,21041,19,675,308,719,347,44,39,bowl
12893,20,refrigerator,21,0,21043,25,1049,422,1255,838,206,416,refrigerator
12894,21,door,22,0,21043,21,848,274,1021,648,173,374,door
12895,58,plate,59,0,21043,17,1289,539,1371,621,82,82,plate
12896,33,window,34,0,21044,21,113,201,201,345,88,144,window
12897,7,door,8,0,21045,27,145,280,551,1150,406,870,door
12898,34,refrigerator,35,0,21045,23,0,581,312,1372,312,791,refrigerator
12899,35,table,36,0,21045,78,185,1129,837,1631,652,502,dining table
12900,39,chair,40,1,21045,22,0,1075,216,1648,216,573,chair
12901,40,chair,41,0,21045,26,148,1246,656,1648,508,402,chair
12902,42,bowl,43,0,21046,17,155,366,199,412,44,46,bowl
12903,43,bowl,44,0,21046,26,22,380,135,426,113,46,bowl
12904,15,chair,16,1,21047,27,2059,866,2199,1293,140,427,chair
12905,35,chair,36,0,21047,48,1503,1081,2052,1650,549,569,chair
12906,36,chair,37,1,21047,44,1706,998,2107,1650,401,652,chair
12907,37,chair,38,1,21047,32,1820,950,2156,1648,336,698,chair
12908,19,window,20,0,21049,16,329,195,482,362,153,167,window
12909,27,refrigerator,28,0,21049,16,715,216,859,693,144,477,refrigerator
12910,43,door,44,0,21049,15,856,25,937,770,81,745,door
12911,31,window,32,0,21050,31,589,220,731,337,142,117,window
12912,32,window,33,0,21050,22,746,216,800,363,54,147,window
12913,42,plate,43,0,21050,17,553,310,617,321,64,11,plate
12914,64,plant pot,65,0,21050,19,390,350,419,375,29,25,potted plant
12915,67,plant pot,68,0,21050,20,432,339,467,372,35,33,potted plant
12916,69,plant pot,70,1,21050,27,466,333,497,365,31,32,potted plant
12917,73,sink,74,0,21050,15,398,375,651,419,253,44,sink
12918,30,refrigerator,31,1,21051,42,678,259,811,486,133,227,refrigerator
12919,43,chair,44,0,21051,56,640,372,806,623,166,251,chair
12920,44,chair,45,1,21051,38,710,361,844,610,134,249,chair
12921,53,blender,54,0,21051,17,245,309,270,369,25,60,blender
12922,44,plate,45,0,21052,21,1152,894,1332,954,180,60,plate
12923,45,plate,46,0,21052,21,1391,859,1557,909,166,50,plate
12924,10,door,11,0,21053,25,1856,572,2170,1490,314,918,door
12925,11,refrigerator,12,0,21053,20,1987,655,2198,1646,211,991,refrigerator
12926,5,clock,6,0,21054,16,4,148,78,231,74,83,clock
12927,23,refrigerator,24,0,21054,22,811,355,1084,826,273,471,refrigerator
12928,32,vase,33,0,21054,16,704,217,749,277,45,60,vase
12929,36,chair,37,0,21056,80,552,405,676,608,124,203,chair
12930,37,chair,38,0,21056,80,412,401,529,578,117,177,chair
12931,38,chair,39,0,21056,61,321,398,422,556,101,158,chair
12932,50,table,51,0,21056,39,87,392,318,516,231,124,dining table
12933,53,chair,54,0,21056,25,65,384,160,520,95,136,chair
12934,54,chair,55,0,21056,28,175,376,267,505,92,129,chair
12935,55,chair,56,1,21056,18,255,372,315,487,60,115,chair
12936,15,oven,16,0,21057,23,637,689,823,776,186,87,oven
12937,40,bottle,41,1,21057,18,765,698,807,789,42,91,bottle
12938,41,bottle,42,0,21057,18,750,756,796,886,46,130,bottle
12939,42,bottle,43,0,21057,19,793,716,854,834,61,118,bottle
12940,39,book,40,0,21059,17,297,1449,733,1648,436,199,book
12941,9,door,10,0,21063,23,0,183,86,395,86,212,door
12942,11,plant pot,12,0,21063,16,0,383,27,468,27,85,potted plant
12943,39,bowl,40,0,21063,17,88,342,198,385,110,43,bowl
12944,40,table,41,0,21063,33,67,369,348,533,281,164,dining table
12945,11,refrigerator,12,1,21064,20,823,332,1040,540,217,208,refrigerator
12946,22,sink,23,0,21064,21,73,539,301,665,228,126,sink
12947,32,chair,33,1,21064,15,965,450,1025,522,60,72,chair
12948,33,chair,34,1,21064,44,1025,486,1121,783,96,297,chair
12949,28,oven,29,0,21065,16,504,756,784,964,280,208,oven
12950,56,chair,57,1,21065,17,1804,1284,2199,1648,395,364,chair
12951,21,oven,22,0,21067,17,1,244,68,646,67,402,oven
12952,7,door,8,0,21068,18,1703,2,2199,1405,496,1403,door
12953,13,window,14,0,21068,15,1298,422,1498,765,200,343,window
12954,28,refrigerator,29,1,21068,34,358,545,722,1221,364,676,refrigerator
12955,38,window,39,0,21068,24,212,680,304,906,92,226,window
12956,34,chair,35,0,21070,53,124,356,427,667,303,311,chair
12957,35,chair,36,1,21070,40,83,352,311,667,228,315,chair
12958,36,chair,37,1,21070,30,73,350,244,663,171,313,chair
12959,37,chair,38,1,21070,22,62,344,108,612,46,268,chair
12960,17,window,18,0,21072,49,1,75,265,310,264,235,window
12961,70,bowl,68,0,21072,28,141,277,186,332,45,55,bowl
12962,72,chair,70,1,21072,41,0,343,40,499,40,156,chair
12963,73,chair,71,0,21072,60,136,341,259,518,123,177,chair
12964,74,chair,72,1,21072,35,98,291,159,422,61,131,chair
12965,75,table,73,1,21072,71,24,306,294,467,270,161,dining table
12966,76,chair,74,0,21072,63,266,296,354,433,88,137,chair
12967,29,refrigerator,30,1,21073,48,864,207,1024,548,160,341,refrigerator
12968,41,oven,42,1,21073,20,663,326,744,377,81,51,oven
12969,55,chair,56,1,21073,90,764,346,987,684,223,338,chair
12970,56,chair,57,0,21073,70,608,359,869,684,261,325,chair
12971,16,bowl,17,0,21074,29,880,386,986,447,106,61,bowl
12972,18,chair,19,1,21074,20,847,447,925,686,78,239,chair
12973,20,refrigerator,21,0,21074,17,836,103,864,647,28,544,refrigerator
12974,26,window,27,0,21074,22,278,253,418,359,140,106,window
12975,45,table,46,0,21074,49,1,380,486,685,485,305,dining table
12976,48,chair,49,1,21074,41,1,478,108,644,107,166,chair
12977,49,chair,50,0,21074,98,39,438,231,685,192,247,chair
12978,50,pot,51,0,21074,17,377,464,416,532,39,68,potted plant
12979,56,bowl,57,0,21074,15,479,487,517,512,38,25,bowl
12980,45,chair,46,1,21075,40,563,291,660,456,97,165,chair
12981,46,chair,47,0,21075,43,503,293,611,475,108,182,chair
12982,47,chair,48,1,21075,44,85,298,184,511,99,213,chair
12983,48,chair,49,0,21075,50,89,305,207,533,118,228,chair
12984,57,table,58,1,21075,16,69,324,135,373,66,49,dining table
12985,15,window,16,0,21076,28,360,262,682,593,322,331,window
12986,32,bowl,33,0,21076,15,588,571,706,657,118,86,bowl
12987,42,table,43,0,21076,89,400,552,567,714,167,162,dining table
12988,45,chair,46,1,21076,40,328,529,413,708,85,179,chair
12989,48,chair,49,1,21076,30,41,798,277,1199,236,401,chair
12990,14,blender,15,0,21078,22,348,251,382,313,34,62,blender
12991,20,blender,21,0,21079,17,962,768,1037,939,75,171,blender
12992,24,vegetables,25,0,21079,22,1051,933,1198,1056,147,123,carrot
12993,35,bowl,36,0,21080,79,717,635,805,773,88,138,bowl
12994,38,chair,39,1,21080,22,1962,820,2047,1105,85,285,chair
12995,39,chair,40,1,21080,15,1808,934,1974,1167,166,233,chair
12996,40,chair,41,1,21080,26,1608,978,2047,1535,439,557,chair
12997,41,table,42,1,21080,30,1580,1079,2047,1535,467,456,dining table
12998,11,vase,12,0,21082,25,328,920,519,1118,191,198,vase
12999,16,window,17,0,21082,20,534,561,856,1114,322,553,window
13000,38,bottle,39,1,21082,15,940,872,984,1004,44,132,bottle
13001,48,chair,49,0,21083,77,103,214,218,434,115,220,chair
13002,49,chair,50,1,21083,81,81,189,164,383,83,194,chair
13003,50,chair,51,1,21083,79,59,175,133,344,74,169,chair
13004,51,chair,52,1,21083,70,40,163,106,310,66,147,chair
13005,9,window,10,0,21085,25,79,188,247,705,168,517,window
13006,47,chair,48,1,21085,16,427,660,524,721,97,61,chair
13007,48,table,49,1,21085,114,73,703,658,1104,585,401,dining table
13008,49,chair,50,0,21085,66,487,704,712,1087,225,383,chair
13009,50,chair,51,1,21085,45,108,661,237,967,129,306,chair
13010,51,chair,52,1,21085,61,162,726,422,1120,260,394,chair
13011,29,chair,30,0,21086,29,1006,539,1200,957,194,418,chair
13012,43,bottle,44,1,21086,18,765,113,817,233,52,120,bottle
13013,36,chair,37,1,21087,15,294,1084,472,1171,178,87,chair
13014,13,table,14,1,21089,16,1542,650,1598,863,56,213,dining table
13015,26,window,27,0,21091,25,380,321,603,576,223,255,window
13016,22,bowl,23,0,21093,15,597,749,724,805,127,56,bowl
13017,33,chair,34,0,21093,42,649,901,1070,1488,421,587,chair
13018,34,chair,35,0,21093,39,344,888,701,1488,357,600,chair
13019,35,chair,36,0,21093,48,98,873,483,1452,385,579,chair
13020,38,sofa,39,1,21094,16,4,1328,883,1648,879,320,couch
13021,15,window,16,0,21096,22,803,147,1237,776,434,629,window
13022,29,vase,30,0,21096,22,1059,609,1152,788,93,179,vase
13023,8,door,9,0,21097,18,1627,485,2046,1360,419,875,door
13024,29,chair,30,1,21098,35,1493,1027,1926,1461,433,434,chair
13025,30,chair,31,0,21098,44,1061,1085,1528,1463,467,378,chair
13026,24,microwave,25,0,21099,19,824,338,1162,536,338,198,microwave
13027,44,pot,45,0,21099,17,1366,623,1416,707,50,84,potted plant
13028,45,pot,46,0,21099,27,1316,592,1385,702,69,110,potted plant
13029,46,pot,47,0,21099,28,1254,603,1316,703,62,100,potted plant
13030,58,bowl,59,0,21099,23,693,901,918,1003,225,102,bowl
13031,33,refrigerator,33,0,21100,17,0,381,197,705,197,324,refrigerator
13032,35,vase,35,0,21100,18,76,660,154,791,78,131,vase
13033,39,microwave,39,0,21100,15,192,415,333,548,141,133,microwave
13034,16,glasses,17,0,21101,26,1594,1387,1774,1475,180,88,eye glasses
13035,33,refrigerator,34,0,21102,20,1,438,585,1309,584,871,refrigerator
13036,25,window,26,0,21103,20,944,566,1269,714,325,148,window
13037,26,window,27,0,21103,20,1324,558,1566,710,242,152,window
13038,15,bottle,16,0,21104,15,1882,832,1951,1013,69,181,bottle
13039,23,refrigerator,24,0,21104,15,662,329,1010,1603,348,1274,refrigerator
13040,31,bowl,32,0,21105,23,1145,530,1299,565,154,35,bowl
13041,36,refrigerator,37,1,21105,15,1555,287,1788,674,233,387,refrigerator
13042,38,bowl,39,0,21105,21,464,798,636,902,172,104,bowl
13043,39,plate,40,0,21105,22,190,839,360,889,170,50,plate
13044,40,bowl,41,0,21105,18,212,820,339,874,127,54,bowl
13045,44,plate,45,0,21105,26,338,965,552,1053,214,88,plate
13046,45,bowl,46,0,21105,19,379,938,523,1019,144,81,bowl
13047,46,bowl,47,0,21105,15,813,843,933,900,120,57,bowl
13048,47,plate,48,0,21105,23,790,864,951,919,161,55,plate
13049,50,plate,51,0,21105,24,581,777,705,813,124,36,plate
13050,53,plate,54,0,21105,16,323,751,436,784,113,33,plate
13051,11,sofa,12,1,21106,20,1040,778,1256,864,216,86,couch
13052,12,chair,13,1,21106,33,1073,789,1270,884,197,95,chair
13053,13,chair,14,1,21106,40,864,778,1043,864,179,86,chair
13054,18,sink,19,0,21106,20,858,860,1280,961,422,101,sink
13055,30,blender,31,0,21106,27,331,733,459,967,128,234,blender
13056,15,table,15,0,21108,16,1141,830,1606,1183,465,353,dining table
13057,37,microwave,37,0,21108,15,110,404,397,807,287,403,microwave
13058,44,bottle,44,0,21108,27,161,1024,206,1169,45,145,bottle
13059,47,bottle,47,0,21108,21,188,1005,231,1151,43,146,bottle
13060,53,bottle,53,0,21108,15,1063,672,1105,728,42,56,bottle
13061,54,bottle,54,0,21108,15,1136,635,1176,726,40,91,bottle
13062,4,refrigerator,5,1,21109,22,1437,156,1649,2200,212,2044,refrigerator
13063,12,refrigerator,13,0,21110,19,57,278,301,1071,244,793,refrigerator
13064,15,sofa,16,1,21110,20,342,457,488,567,146,110,couch
13065,18,chair,19,1,21110,17,443,488,488,564,45,76,chair
13066,21,chair,22,1,21110,24,295,608,416,779,121,171,chair
13067,25,chair,26,1,21110,16,452,512,490,791,38,279,chair
13068,26,chair,27,1,21110,48,230,722,322,1152,92,430,chair
13069,37,television,38,0,21110,20,1903,606,2086,813,183,207,tv
13070,38,window,39,0,21110,27,1852,172,2154,690,302,518,window
13071,52,chair,53,0,21110,41,1183,1039,1652,1532,469,493,chair
13072,53,chair,54,0,21110,72,1491,1004,1971,1535,480,531,chair
13073,54,chair,55,1,21110,56,1869,990,2155,1535,286,545,chair
13074,13,refrigerator,14,1,21111,16,1788,456,2047,1184,259,728,refrigerator
13075,33,chair,34,1,21111,15,145,1236,399,1536,254,300,chair
13076,6,window,7,0,21113,20,1823,0,2199,660,376,660,window
13077,7,window,8,0,21113,25,1,1,395,193,394,192,window
13078,23,television,24,0,21113,18,1227,98,1601,434,374,336,tv
13079,25,chair,26,1,21113,40,814,675,2166,1649,1352,974,chair
13080,26,chair,27,1,21113,42,1233,467,2138,1338,905,871,chair
13081,27,chair,28,1,21113,48,1692,491,2197,1459,505,968,chair
13082,5,door,6,0,21116,16,0,298,328,1529,328,1231,door
13083,31,sink,32,0,21116,16,929,998,1220,1066,291,68,sink
13084,45,chair,46,1,21117,58,836,1094,1268,1650,432,556,chair
13085,46,chair,47,1,21117,69,592,1041,912,1650,320,609,chair
13086,47,chair,48,1,21117,56,469,994,662,1603,193,609,chair
13087,48,chair,49,1,21117,33,463,952,623,1445,160,493,chair
13088,24,window,25,0,21118,28,2021,311,2199,745,178,434,window
13089,27,plant pot,28,0,21118,26,1837,696,1997,836,160,140,potted plant
13090,51,clock,52,0,21118,61,831,439,908,730,77,291,clock
13091,31,bowl,32,0,21119,24,591,591,753,738,162,147,bowl
13092,52,spoon,53,0,21119,15,774,871,850,913,76,42,spoon
13093,54,spoon,55,0,21119,15,1060,939,1139,985,79,46,spoon
13094,56,spoon,57,0,21119,15,1452,1007,1518,1067,66,60,spoon
13095,16,window,17,0,21120,31,78,68,793,976,715,908,window
13096,29,door,30,0,21120,19,1370,521,1479,852,109,331,door
13097,32,chair,33,1,21120,17,1311,814,1495,883,184,69,chair
13098,33,chair,34,1,21120,15,1562,811,1735,883,173,72,chair
13099,39,sofa,40,1,21120,26,1731,816,2044,893,313,77,couch
13100,41,chair,42,1,21120,17,1495,785,1626,883,131,98,chair
13101,59,pot,60,0,21120,20,995,733,1113,937,118,204,potted plant
13102,23,bowl,24,0,21122,40,963,692,1161,943,198,251,bowl
13103,31,plant pot,32,0,21122,18,31,1033,200,1215,169,182,potted plant
13104,37,window,38,0,21122,35,316,153,612,723,296,570,window
13105,22,glasses,23,0,21123,15,1153,1358,1267,1414,114,56,eye glasses
13106,37,bowl,38,1,21124,22,1580,812,1637,891,57,79,bowl
13107,13,window,14,0,21125,19,850,303,1171,742,321,439,window
13108,27,refrigerator,28,1,21125,15,1240,467,1571,943,331,476,refrigerator
13109,31,chair,32,1,21130,31,2023,607,2199,1228,176,621,chair
13110,40,table,41,1,21130,20,1,1462,1215,1649,1214,187,dining table
13111,43,backpack,44,1,21130,16,1,1321,149,1594,148,273,backpack
13112,5,clock,6,0,21132,17,674,383,788,503,114,120,clock
13113,9,refrigerator,10,1,21132,20,1224,735,1646,1466,422,731,refrigerator
13114,47,chair,48,1,21133,17,278,607,473,724,195,117,chair
13115,49,chair,50,1,21133,24,381,712,524,1078,143,366,chair
13116,50,chair,51,1,21133,17,181,793,440,1078,259,285,chair
13117,51,table,52,0,21133,19,1,697,450,1078,449,381,dining table
13118,5,door,6,0,21134,32,670,210,905,589,235,379,door
13119,10,refrigerator,11,0,21134,18,1,316,172,1027,171,711,refrigerator
13120,24,vase,25,0,21134,16,702,570,770,612,68,42,vase
13121,29,bowl,30,0,21134,16,402,806,472,880,70,74,bowl
13122,17,refrigerator,18,0,23674,23,416,205,522,654,106,449,refrigerator
13123,7,door,8,0,23677,19,759,232,876,428,117,196,door
13124,11,chair,12,0,23677,46,811,408,978,628,167,220,chair
13125,12,chair,13,1,23677,21,809,397,841,556,32,159,chair
13126,13,chair,14,1,23677,20,805,383,832,523,27,140,chair
13127,22,chair,23,0,23677,78,243,343,396,641,153,298,chair
13128,23,chair,24,0,23677,73,396,341,537,622,141,281,chair
13129,10,vase,11,0,23678,16,430,318,460,363,30,45,vase
13130,12,window,13,0,23680,15,3,150,343,579,340,429,window
13131,20,plant pot,21,0,23680,16,173,526,227,577,54,51,potted plant
13132,2,window,3,0,23681,43,537,27,1489,574,952,547,window
13133,8,plant pot,9,0,23681,17,627,532,696,612,69,80,potted plant
13134,10,bottle,11,0,23681,19,508,503,573,643,65,140,bottle
13135,14,bowl,15,0,23681,15,547,649,650,707,103,58,bowl
13136,20,plant pot,21,0,23681,17,1325,578,1389,667,64,89,potted plant
13137,35,chair,36,1,23682,19,617,449,715,623,98,174,chair
13138,39,table,40,0,23682,24,614,405,707,466,93,61,dining table
13139,11,person,12,0,23683,53,1085,174,1476,1451,391,1277,person
13140,12,bowl,13,0,23684,18,607,361,684,419,77,58,bowl
13141,13,vegetables,14,0,23684,33,677,353,790,407,113,54,carrot
13142,15,chair,16,1,23684,17,2,446,75,550,73,104,chair
13143,18,vegetables,19,0,23684,19,574,391,650,421,76,30,carrot
13144,10,table,11,0,23686,60,127,275,434,480,307,205,dining table
13145,11,person,12,1,23686,44,163,165,234,277,71,112,person
13146,12,person,13,1,23686,39,257,185,323,277,66,92,person
13147,13,person,14,1,23686,60,324,160,393,276,69,116,person
13148,14,person,15,1,23686,58,344,173,428,306,84,133,person
13149,15,person,16,1,23686,75,376,136,478,363,102,227,person
13150,16,person,17,1,23686,87,446,101,640,479,194,378,person
13151,17,person,18,1,23686,53,82,144,170,287,88,143,person
13152,18,person,19,1,23686,77,35,143,178,480,143,337,person
13153,19,table,20,0,23686,18,163,361,515,480,352,119,dining table
13154,20,bottle,21,0,23686,24,372,312,420,449,48,137,bottle
13155,21,bottle,22,0,23686,27,318,312,366,454,48,142,bottle
13156,30,bowl,31,0,23686,16,156,281,188,301,32,20,bowl
13157,6,chair,7,1,23687,23,171,383,238,469,67,86,chair
13158,17,bottle,17,0,23687,15,365,306,378,355,13,49,bottle
13159,4,window,5,0,23688,15,524,121,767,487,243,366,window
13160,27,table,28,0,23689,40,660,421,948,631,288,210,dining table
13161,28,chair,29,1,23689,17,903,359,948,433,45,74,chair
13162,29,chair,30,0,23689,18,647,357,737,450,90,93,chair
13163,30,chair,31,0,23689,24,652,433,924,631,272,198,chair
13164,31,plant pot,32,0,23689,16,873,430,922,470,49,40,potted plant
13165,10,refrigerator,11,0,23690,17,753,136,896,522,143,386,refrigerator
13166,22,pot,23,0,23690,16,662,373,722,424,60,51,potted plant
13167,24,bowl,25,0,23690,27,161,377,216,408,55,31,bowl
13168,30,sofa,31,1,23690,35,502,567,1024,683,522,116,couch
13169,31,chair,32,0,23690,98,142,479,375,682,233,203,chair
13170,32,chair,33,0,23690,64,0,460,178,682,178,222,chair
13171,1,table,2,0,23691,36,334,369,917,672,583,303,dining table
13172,12,chair,13,1,23691,18,749,319,848,392,99,73,chair
13173,16,bowl,17,0,23691,23,543,368,622,414,79,46,bowl
13174,17,bowl,18,1,23691,22,576,361,643,390,67,29,bowl
13175,19,plate,20,0,23691,16,762,395,834,414,72,19,plate
13176,13,oven,14,0,23695,15,266,206,389,303,123,97,oven
13177,27,pot,28,0,10747,16,727,985,879,1164,152,179,potted plant
13178,43,bowl,44,0,10747,16,230,974,470,1080,240,106,bowl
13179,12,suitcase,13,0,10749,28,2,513,271,1322,269,809,suitcase
13180,17,refrigerator,18,0,10749,19,458,421,1111,1546,653,1125,refrigerator
13181,22,sink,23,0,10749,23,837,787,1468,1009,631,222,sink
13182,24,bottle,25,1,10749,19,1570,683,1669,1013,99,330,bottle
13183,25,bottle,26,0,10749,20,1598,710,1719,1040,121,330,bottle
13184,4,sink,5,0,10755,17,469,310,582,343,113,33,sink
13185,14,sofa,15,1,10756,30,129,106,264,181,135,75,couch
13186,19,chair,20,1,10759,19,4,854,209,1459,205,605,chair
13187,87,plate,88,0,10759,17,1013,562,1057,609,44,47,plate
13188,89,plate,90,0,10759,16,956,563,998,612,42,49,plate
13189,15,blender,16,0,21135,22,599,845,685,1006,86,161,blender
13190,5,window,6,0,21136,17,275,593,859,1139,584,546,window
13191,8,window,9,0,21136,36,1256,252,1603,1325,347,1073,window
13192,28,refrigerator,29,1,21136,35,1,541,173,2080,172,1539,refrigerator
13193,6,door,7,0,21137,17,0,0,170,2200,170,2200,door
13194,19,microwave,20,1,21137,17,415,993,626,1199,211,206,microwave
13195,7,window,8,0,21139,40,746,188,1003,551,257,363,window
13196,18,refrigerator,19,0,21139,18,1131,337,1245,1149,114,812,refrigerator
13197,23,door,24,0,21139,21,481,112,583,697,102,585,door
13198,24,chair,25,1,21139,24,505,652,701,995,196,343,chair
13199,25,table,26,1,21139,50,303,720,733,1200,430,480,dining table
13200,28,chair,29,0,21139,57,246,793,631,1200,385,407,chair
13201,13,toaster,14,0,21140,15,751,725,936,886,185,161,toaster
13202,17,table,18,0,21140,21,359,903,1251,1648,892,745,dining table
13203,19,chair,20,1,21140,57,1055,828,1594,1645,539,817,chair
13204,20,chair,21,1,21140,50,810,840,1432,1650,622,810,chair
13205,18,desk,19,0,21141,20,796,1018,1200,1600,404,582,desk
13206,23,chair,24,1,21141,33,407,1040,884,1600,477,560,chair
13207,3,window,4,0,651,16,670,111,799,410,129,299,window
13208,5,window,6,0,651,46,236,156,599,338,363,182,window
13209,6,window,7,0,651,31,2,117,143,369,141,252,window
13210,15,bottle,16,0,651,15,416,315,434,384,18,69,bottle
13211,18,sofa,19,1,651,45,0,305,344,532,344,227,couch
13212,20,mirror,21,0,651,15,171,136,228,194,57,58,mirror
13213,22,mirror,23,0,651,15,168,276,229,334,61,58,mirror
13214,10,window,11,0,652,23,462,256,630,418,168,162,window
13215,15,sofa,14,0,652,77,370,396,705,581,335,185,couch
13216,30,pot,29,1,652,19,2,392,37,484,35,92,potted plant
13217,35,sofa,34,1,652,36,0,479,418,696,418,217,couch
13218,11,window,12,0,653,29,414,102,586,280,172,178,window
13219,16,sofa,17,0,653,55,464,233,720,451,256,218,couch
13220,18,door,19,1,653,21,46,152,142,292,96,140,door
13221,11,window,12,0,654,23,183,84,310,318,127,234,window
13222,12,table,13,0,654,80,366,289,459,427,93,138,dining table
13223,22,vase,23,0,654,15,394,269,422,296,28,27,vase
13224,10,window,11,0,655,32,0,121,284,313,284,192,window
13225,12,sofa,13,0,655,55,0,289,312,472,312,183,couch
13226,28,sofa,28,1,656,37,563,341,1022,685,459,344,couch
13227,4,window,4,0,657,18,401,195,584,406,183,211,window
13228,9,window,9,0,657,17,678,193,916,430,238,237,window
13229,21,sofa,20,0,657,47,2,365,581,564,579,199,couch
13230,7,sofa,8,0,658,43,63,205,250,313,187,108,couch
13231,8,vase,9,1,659,18,63,331,104,405,41,74,vase
13232,9,chair,10,1,659,35,73,270,140,466,67,196,chair
13233,21,window,21,0,659,24,748,173,783,311,35,138,window
13234,22,door,22,1,659,34,779,161,800,334,21,173,door
13235,28,sofa,28,1,659,81,497,294,757,531,260,237,couch
13236,6,television,7,0,660,17,317,196,409,265,92,69,tv
13237,11,sofa,12,0,660,38,2,342,301,583,299,241,couch
13238,12,sofa,13,1,660,40,441,369,798,583,357,214,couch
13239,6,vase,5,1,661,16,67,534,117,621,50,87,vase
13240,14,window,13,0,661,19,561,235,778,548,217,313,window
13241,15,window,14,0,661,50,812,95,1205,636,393,541,window
13242,16,window,15,0,661,56,136,182,544,574,408,392,window
13243,31,vase,27,0,661,17,1150,552,1244,663,94,111,vase
13244,35,sofa,31,0,661,45,469,537,795,730,326,193,couch
13245,4,sofa,5,0,662,56,496,440,941,673,445,233,couch
13246,5,sofa,6,0,662,55,2,395,515,636,513,241,couch
13247,7,window,8,0,662,24,25,197,279,419,254,222,window
13248,26,sofa,27,1,663,71,1107,794,1775,1257,668,463,couch
13249,34,vase,35,0,663,44,877,868,983,1117,106,249,vase
13250,39,pot,40,1,663,17,1456,722,1524,802,68,80,potted plant
13251,40,pot,41,0,663,18,2005,721,2101,1018,96,297,potted plant
13252,41,pot,42,1,663,51,1624,785,2101,1399,477,614,potted plant
13253,42,sofa,43,1,663,48,0,959,1167,1399,1167,440,couch
13254,79,door,80,0,663,17,876,836,954,901,78,65,door
13255,1,sofa,2,1,664,87,98,332,1090,688,992,356,couch
13256,2,bottle,3,1,664,31,683,378,823,646,140,268,bottle
13257,3,bottle,4,0,664,24,775,519,964,710,189,191,bottle
13258,4,bottle,5,0,664,23,627,546,760,694,133,148,bottle
13259,10,window,7,0,665,24,0,676,503,1175,503,499,window
13260,26,sofa,22,0,665,55,16,1055,1008,1743,992,688,couch
13261,47,clock,42,0,665,51,1344,774,1460,893,116,119,clock
13262,48,vase,43,0,665,21,1644,839,1703,928,59,89,vase
13263,13,sofa,14,1,666,37,117,208,270,325,153,117,couch
13264,16,window,17,0,666,19,100,99,186,325,86,226,window
13265,14,sofa,15,1,667,23,621,373,800,532,179,159,couch
13266,15,sofa,16,1,667,39,36,339,452,532,416,193,couch
13267,8,window,9,0,668,17,652,167,735,308,83,141,window
13268,13,chair,13,1,668,74,506,310,628,576,122,266,chair
13269,14,pot,14,1,668,17,684,282,710,351,26,69,potted plant
13270,15,pot,15,0,668,24,657,284,694,368,37,84,potted plant
13271,16,table,16,1,668,50,530,332,736,572,206,240,dining table
13272,25,mirror,24,0,668,22,122,184,285,285,163,101,mirror
13273,36,sofa,34,0,668,25,1,338,197,579,196,241,couch
13274,28,table,29,1,669,19,6,245,238,327,232,82,dining table
13275,39,sofa,39,0,669,28,452,283,800,556,348,273,couch
13276,8,chair,9,0,670,23,212,143,264,214,52,71,chair
13277,9,chair,10,0,670,24,259,142,307,209,48,67,chair
13278,10,chair,11,0,670,33,324,149,421,235,97,86,chair
13279,11,sofa,12,1,670,16,344,206,449,301,105,95,couch
13280,14,vase,15,0,671,15,460,102,490,140,30,38,vase
13281,23,sofa,24,0,671,46,0,200,180,349,180,149,couch
13282,15,sofa,12,1,672,68,228,359,506,499,278,140,couch
13283,7,chair,8,0,673,21,154,332,271,469,117,137,chair
13284,14,sofa,13,0,673,32,423,313,761,525,338,212,couch
13285,14,window,14,0,674,28,2,229,81,355,79,126,window
13286,19,table,19,1,674,25,29,311,113,350,84,39,dining table
13287,26,window,26,0,674,15,674,146,800,212,126,66,window
13288,6,window,7,0,675,15,491,108,625,296,134,188,window
13289,7,sofa,8,0,675,34,321,250,523,372,202,122,couch
13290,34,chair,35,1,675,26,0,260,86,331,86,71,chair
13291,12,window,13,0,676,21,719,209,942,401,223,192,window
13292,15,sofa,16,1,676,42,552,388,993,580,441,192,couch
13293,20,chair,21,1,676,22,474,386,533,482,59,96,chair
13294,21,chair,22,1,676,22,225,404,346,542,121,138,chair
13295,2,window,3,1,677,23,341,339,394,476,53,137,window
13296,43,sofa,38,0,677,45,266,462,425,588,159,126,couch
13297,9,plate,10,0,678,16,815,333,855,369,40,36,plate
13298,17,sofa,18,0,678,114,53,251,778,587,725,336,couch
13299,18,bottle,19,0,678,15,532,330,561,401,29,71,bottle
13300,19,bowl,20,0,678,20,572,343,669,381,97,38,bowl
13301,4,sofa,5,0,679,154,0,793,1321,1356,1321,563,couch
13302,12,flowerpot,13,0,679,40,565,1143,747,1270,182,127,potted plant
13303,15,window,16,0,679,19,536,103,1339,630,803,527,window
13304,21,chair,21,1,679,61,1376,827,2091,1465,715,638,chair
13305,10,sofa,10,0,680,29,565,377,988,623,423,246,couch
13306,20,sofa,20,1,681,29,665,441,1023,678,358,237,couch
13307,22,sofa,22,1,681,20,0,449,208,678,208,229,couch
13308,7,vase,8,1,682,23,660,308,711,406,51,98,vase
13309,17,sofa,17,0,682,85,111,293,412,445,301,152,couch
13310,23,table,21,0,682,36,287,371,515,532,228,161,dining table
13311,40,pot,37,0,682,19,703,261,724,297,21,36,potted plant
13312,44,mirror,41,0,682,17,514,120,606,215,92,95,mirror
13313,5,chair,6,1,683,28,1744,764,1873,950,129,186,chair
13314,6,chair,7,1,683,28,1585,765,1659,941,74,176,chair
13315,7,chair,8,0,683,30,1647,767,1757,960,110,193,chair
13316,8,table,9,1,683,39,1609,798,1811,953,202,155,dining table
13317,28,door,28,0,683,39,0,422,672,1228,672,806,door
13318,33,sofa,33,0,683,60,75,804,727,1296,652,492,couch
13319,8,mirror,8,0,684,90,253,162,329,367,76,205,mirror
13320,10,sofa,9,0,684,53,220,367,471,552,251,185,couch
13321,18,window,17,1,684,45,582,220,768,377,186,157,window
13322,32,chair,29,1,684,25,857,365,949,446,92,81,chair
13323,33,chair,30,1,684,31,919,371,1022,448,103,77,chair
13324,34,sofa,31,1,684,48,596,441,1023,684,427,243,couch
13325,36,table,33,1,684,29,506,530,758,684,252,154,dining table
13326,4,window,5,0,685,25,314,204,428,727,114,523,window
13327,14,window,15,0,685,18,594,286,755,587,161,301,window
13328,19,chair,20,1,685,36,1026,573,1248,746,222,173,chair
13329,20,chair,21,0,685,50,943,682,1293,998,350,316,chair
13330,21,sofa,22,0,685,35,601,551,951,704,350,153,couch
13331,26,chair,27,0,685,25,316,578,536,704,220,126,chair
13332,27,chair,28,0,685,49,341,667,664,998,323,331,chair
13333,10,sofa,7,0,686,69,353,322,662,524,309,202,couch
13334,15,window,12,1,686,16,405,221,504,338,99,117,window
13335,13,sofa,13,1,687,34,558,345,644,539,86,194,couch
13336,36,pot,36,0,687,16,145,422,174,444,29,22,potted plant
13337,7,window,8,0,688,28,258,227,323,391,65,164,window
13338,22,bowl,21,0,688,15,452,418,502,449,50,31,bowl
13339,26,desk,25,1,688,57,776,373,1021,533,245,160,desk
13340,38,sofa,35,0,688,32,2,356,363,703,361,347,couch
13341,44,chair,41,1,688,28,866,363,1005,539,139,176,chair
13342,10,table,10,1,689,17,629,277,798,383,169,106,dining table
13343,29,sofa,28,1,689,23,2,311,240,533,238,222,couch
13344,15,sofa,15,0,690,21,871,355,1023,473,152,118,couch
13345,22,sofa,21,0,690,40,491,358,780,526,289,168,couch
13346,23,sofa,22,1,690,49,149,355,488,504,339,149,couch
13347,15,window,16,0,691,26,676,117,758,411,82,294,window
13348,25,sofa,24,0,691,50,444,292,725,510,281,218,couch
13349,8,window,9,1,692,15,881,1,999,276,118,275,window
13350,9,sofa,10,1,692,42,641,308,999,666,358,358,couch
13351,16,window,17,0,692,34,46,70,264,359,218,289,window
13352,2,window,3,0,693,15,514,61,712,392,198,331,window
13353,7,sofa,8,0,693,37,466,364,1023,694,557,330,couch
13354,7,window,8,0,695,18,577,277,653,465,76,188,window
13355,8,window,9,0,695,30,678,280,752,468,74,188,window
13356,22,window,23,0,695,33,155,217,337,496,182,279,window
13357,20,sofa,19,1,696,71,120,304,296,402,176,98,couch
13358,2,window,3,0,697,32,697,182,1023,478,326,296,window
13359,3,chair,4,1,697,15,814,370,876,472,62,102,chair
13360,4,chair,5,1,697,22,947,380,1022,487,75,107,chair
13361,6,chair,7,0,697,37,721,388,857,537,136,149,chair
13362,7,door,8,1,697,18,644,108,699,567,55,459,door
13363,25,window,25,1,697,38,464,178,618,407,154,229,window
13364,3,window,4,0,698,22,244,192,494,453,250,261,window
13365,21,sofa,21,0,698,34,0,353,570,671,570,318,couch
13366,9,sofa,10,1,699,53,449,405,880,595,431,190,couch
13367,23,sofa,23,1,701,47,93,294,404,456,311,162,couch
13368,25,bowl,25,0,701,15,350,350,425,382,75,32,bowl
13369,26,sofa,26,1,701,32,374,345,799,530,425,185,couch
13370,3,window,4,0,702,20,93,150,336,335,243,185,window
13371,5,bed,6,1,702,18,581,360,656,441,75,81,bed
13372,15,door,16,1,702,18,674,98,734,599,60,501,door
13373,21,table,22,1,702,19,178,347,317,472,139,125,dining table
13374,22,chair,23,1,702,37,246,321,342,419,96,98,chair
13375,23,chair,24,1,702,41,143,321,248,471,105,150,chair
13376,25,vase,26,0,702,16,280,425,295,476,15,51,vase
13377,38,sofa,38,1,702,16,0,381,123,599,123,218,couch
13378,16,chair,17,1,703,19,640,385,681,437,41,52,chair
13379,23,sofa,23,0,703,28,479,426,720,584,241,158,couch
13380,17,sofa,17,0,704,38,643,419,1003,678,360,259,couch
13381,22,bowl,22,0,704,17,460,528,555,571,95,43,bowl
13382,10,table,10,0,705,28,89,369,195,448,106,79,dining table
13383,11,chair,11,0,705,22,195,353,261,440,66,87,chair
13384,12,chair,12,0,705,18,39,361,122,460,83,99,chair
13385,18,sofa,18,1,705,52,378,366,600,522,222,156,couch
13386,19,chair,19,0,705,48,639,382,802,519,163,137,chair
13387,20,table,20,0,705,52,567,406,691,550,124,144,dining table
13388,22,sofa,22,0,705,43,254,367,511,573,257,206,couch
13389,28,window,26,0,705,19,208,201,335,392,127,191,window
13390,29,window,27,0,705,25,3,166,195,412,192,246,window
13391,8,chair,9,1,706,17,6,409,27,480,21,71,chair
13392,9,chair,10,1,706,15,21,417,41,474,20,57,chair
13393,13,window,14,1,706,20,13,313,160,415,147,102,window
13394,22,door,21,1,706,26,333,247,424,510,91,263,door
13395,28,mirror,26,0,706,18,548,198,688,376,140,178,mirror
13396,32,vase,29,0,706,20,702,334,727,381,25,47,vase
13397,33,vase,30,0,706,15,523,339,540,373,17,34,vase
13398,40,sofa,37,0,706,68,9,417,387,658,378,241,couch
13399,11,sofa,12,0,707,43,0,337,594,683,594,346,couch
13400,9,window,10,0,708,15,500,210,723,373,223,163,window
13401,20,sofa,18,1,708,34,445,345,658,449,213,104,couch
13402,24,sofa,22,0,708,42,469,372,780,623,311,251,couch
13403,4,window,5,0,709,41,733,90,1011,482,278,392,window
13404,5,flowerpot,6,0,709,33,608,389,673,476,65,87,potted plant
13405,10,sofa,11,1,709,79,226,311,573,511,347,200,couch
13406,18,sofa,18,1,709,25,0,329,194,681,194,352,couch
13407,22,sofa,21,1,710,57,178,350,632,534,454,184,couch
13408,24,table,23,1,710,38,87,401,400,534,313,133,dining table
13409,43,door,40,0,710,19,331,214,364,319,33,105,door
13410,5,window,6,1,711,18,829,223,1076,468,247,245,window
13411,16,window,17,1,711,30,0,188,233,394,233,206,window
13412,21,sofa,22,1,712,33,641,338,900,535,259,197,couch
13413,10,door,11,1,713,16,865,164,1002,423,137,259,door
13414,22,sofa,21,1,713,51,181,321,609,563,428,242,couch
13415,64,window,63,0,713,34,141,99,548,374,407,275,window
13416,11,vase,12,0,714,29,839,849,928,1013,89,164,vase
13417,15,flowerpot,16,0,714,43,1119,1096,1335,1293,216,197,potted plant
13418,18,window,19,0,714,17,0,280,329,896,329,616,window
13419,19,window,20,1,714,31,704,403,947,978,243,575,window
13420,32,sofa,33,1,714,101,31,866,1167,1399,1136,533,couch
13421,35,table,36,1,714,44,0,984,187,1395,187,411,dining table
13422,74,door,75,0,714,27,340,338,525,977,185,639,door
13423,17,window,18,0,715,24,166,40,261,378,95,338,window
13424,19,window,20,0,715,18,0,1,149,354,149,353,window
13425,24,bowl,25,0,715,22,539,479,689,539,150,60,bowl
13426,25,sofa,26,1,715,34,0,331,326,663,326,332,couch
13427,56,bowl,57,0,715,19,756,150,799,206,43,56,bowl
13428,2,window,3,1,716,24,3,55,31,346,28,291,window
13429,11,sofa,12,0,716,35,80,252,243,395,163,143,couch
13430,4,window,5,1,717,15,555,240,617,401,62,161,window
13431,5,window,6,0,717,21,615,220,759,424,144,204,window
13432,6,window,7,0,717,20,750,195,960,438,210,243,window
13433,13,window,13,0,717,37,266,202,388,430,122,228,window
13434,14,window,14,0,717,21,94,186,266,435,172,249,window
13435,17,sofa,17,1,717,59,398,398,661,475,263,77,couch
13436,18,flowerpot,18,0,717,17,450,436,500,477,50,41,potted plant
13437,27,sofa,26,0,717,42,767,411,1014,597,247,186,couch
13438,28,sofa,27,0,717,43,316,443,781,671,465,228,couch
13439,5,door,6,1,718,25,614,233,673,449,59,216,door
13440,17,table,16,0,718,52,486,391,661,522,175,131,dining table
13441,18,chair,17,1,718,36,450,384,522,501,72,117,chair
13442,19,chair,18,0,718,44,460,398,551,533,91,135,chair
13443,20,chair,19,1,718,19,597,383,646,451,49,68,chair
13444,21,chair,20,0,718,45,600,389,684,528,84,139,chair
13445,25,sofa,24,1,718,17,766,431,1024,677,258,246,couch
13446,29,sofa,30,1,719,66,165,449,560,619,395,170,couch
13447,30,chair,31,1,719,15,394,523,557,584,163,61,chair
13448,31,chair,32,1,719,36,726,572,925,799,199,227,chair
13449,34,table,35,1,719,42,2,582,848,799,846,217,dining table
13450,6,window,4,0,720,17,904,229,1188,333,284,104,window
13451,8,window,6,1,720,20,764,292,849,543,85,251,window
13452,14,window,11,1,720,30,274,225,471,573,197,348,window
13453,15,window,12,1,720,20,98,383,174,586,76,203,window
13454,26,sofa,23,1,720,64,735,505,1166,765,431,260,couch
13455,38,plate,35,0,720,16,2,503,110,622,108,119,plate
13456,55,door,51,0,720,18,1035,316,1163,567,128,251,door
13457,13,window,13,0,721,16,15,62,173,376,158,314,window
13458,19,sofa,17,0,721,33,500,283,718,425,218,142,couch
13459,5,chair,6,1,722,47,710,444,855,775,145,331,chair
13460,8,chair,9,0,722,50,968,436,1147,752,179,316,chair
13461,9,table,10,1,722,51,795,491,1198,626,403,135,dining table
13462,11,bowl,12,0,722,15,950,479,1061,527,111,48,bowl
13463,12,chair,13,1,722,39,828,509,1112,798,284,289,chair
13464,13,chair,14,0,722,23,676,381,752,499,76,118,chair
13465,21,sofa,21,1,722,48,91,422,519,617,428,195,couch
13466,25,window,25,0,722,20,132,151,374,448,242,297,window
13467,8,window,9,0,723,17,561,144,669,348,108,204,window
13468,26,sofa,27,1,723,38,411,353,730,530,319,177,couch
13469,30,sofa,31,1,723,16,0,469,248,530,248,61,couch
13470,9,chair,10,0,724,34,265,296,391,456,126,160,chair
13471,25,sofa,24,1,725,41,145,388,447,480,302,92,couch
13472,17,window,18,0,726,16,784,102,1022,457,238,355,window
13473,18,sofa,19,0,726,63,559,367,904,588,345,221,couch
13474,14,flowerpot,15,0,727,15,676,532,737,576,61,44,potted plant
13475,21,sofa,22,1,727,28,2,542,363,719,361,177,couch
13476,22,sofa,23,1,727,19,283,693,1029,719,746,26,couch
13477,27,vase,28,0,727,17,504,272,547,331,43,59,vase
13478,4,surfboard,4,1,728,21,545,207,585,313,40,106,surfboard
13479,6,window,6,0,728,18,461,185,513,298,52,113,window
13480,12,desk,11,0,728,39,462,283,584,383,122,100,desk
13481,18,door,16,1,728,21,668,66,800,514,132,448,door
13482,28,chair,26,1,728,22,583,352,798,480,215,128,chair
13483,29,chair,27,1,728,24,310,465,717,538,407,73,chair
13484,2,window,3,0,729,24,419,56,699,381,280,325,window
13485,26,sofa,27,1,729,51,321,243,557,348,236,105,couch
13486,27,chair,28,1,729,32,443,277,641,465,198,188,chair
13487,36,sofa,37,1,729,26,2,251,244,465,242,214,couch
13488,19,chair,17,0,730,24,509,318,551,394,42,76,chair
13489,28,sofa,23,0,730,33,561,323,860,465,299,142,couch
13490,34,cat,29,0,730,16,356,409,397,446,41,37,cat
13491,14,chair,15,0,731,22,645,312,800,515,155,203,chair
13492,17,chair,18,0,731,50,545,285,662,478,117,193,chair
13493,18,chair,19,0,731,47,463,285,574,465,111,180,chair
13494,19,chair,20,0,731,40,399,286,499,467,100,181,chair
13495,20,sofa,21,1,731,25,317,297,416,393,99,96,couch
13496,27,clock,27,0,731,20,127,136,198,210,71,74,clock
13497,44,chair,37,1,731,20,2,317,153,533,151,216,chair
13498,45,table,38,1,731,29,88,462,799,533,711,71,dining table
13499,4,table,5,1,732,20,320,248,401,294,81,46,dining table
13500,16,chair,17,0,732,20,341,240,378,301,37,61,chair
13501,21,sofa,22,0,732,42,0,232,219,429,219,197,couch
13502,7,sofa,7,1,733,59,19,294,472,534,453,240,couch
13503,4,window,5,0,734,30,428,135,649,289,221,154,window
13504,20,sofa,21,0,734,45,116,238,393,411,277,173,couch
13505,3,sofa,4,1,735,88,185,300,604,519,419,219,couch
13506,9,window,10,0,735,29,710,113,859,376,149,263,window
13507,6,door,3,0,736,25,2,227,242,497,240,270,door
13508,31,sofa,28,0,736,63,33,402,1010,667,977,265,couch
13509,53,door,50,0,736,18,648,404,741,520,93,116,door
13510,13,pot,12,1,737,30,11,373,92,466,81,93,potted plant
13511,17,window,16,1,737,26,2,261,119,477,117,216,window
13512,30,sofa,26,1,737,54,217,401,543,604,326,203,couch
13513,31,sofa,27,1,737,37,606,434,1023,683,417,249,couch
13514,12,door,13,1,738,21,17,134,141,366,124,232,door
13515,23,sofa,24,0,738,40,114,266,341,448,227,182,couch
13516,17,sofa,18,0,739,62,126,202,403,408,277,206,couch
13517,18,table,19,0,739,42,51,220,247,421,196,201,dining table
13518,19,flowerpot,20,0,739,19,112,204,155,243,43,39,potted plant
13519,21,flowerpot,22,0,739,16,403,267,433,291,30,24,potted plant
13520,11,window,12,0,740,16,16,25,111,363,95,338,window
13521,12,sofa,13,1,740,29,17,286,295,479,278,193,couch
13522,8,window,9,0,741,29,407,145,535,372,128,227,window
13523,9,window,10,0,741,15,232,120,401,371,169,251,window
13524,10,window,11,0,741,29,2,89,221,392,219,303,window
13525,24,sofa,22,0,741,40,231,338,507,505,276,167,couch
13526,5,window,6,0,742,16,184,108,295,195,111,87,window
13527,13,sofa,14,1,742,43,183,178,298,231,115,53,couch
13528,21,vase,22,0,742,15,23,187,49,232,26,45,vase
13529,5,vase,6,0,743,41,36,636,142,784,106,148,vase
13530,6,vase,7,0,743,16,427,541,469,613,42,72,vase
13531,14,chair,14,1,743,18,613,423,739,527,126,104,chair
13532,15,chair,15,1,743,18,754,422,880,638,126,216,chair
13533,16,bowl,16,0,743,20,602,545,730,591,128,46,bowl
13534,21,sofa,21,1,743,18,893,454,1200,857,307,403,couch
13535,8,window,9,0,744,41,482,46,710,380,228,334,window
13536,18,chair,18,0,744,35,114,317,265,484,151,167,chair
13537,17,sofa,17,1,745,24,0,227,196,400,196,173,couch
13538,6,sofa,7,0,746,51,759,752,1732,1400,973,648,couch
13539,59,plate,59,0,746,23,394,939,423,980,29,41,plate
13540,7,table,8,1,747,25,39,315,290,433,251,118,dining table
13541,10,chair,11,0,747,25,97,325,187,433,90,108,chair
13542,11,chair,12,0,747,26,188,315,262,405,74,90,chair
13543,12,window,13,0,748,15,272,160,348,323,76,163,window
13544,13,sofa,14,1,748,36,316,263,527,349,211,86,couch
13545,20,sofa,21,0,748,45,79,269,318,431,239,162,couch
13546,21,sofa,22,0,748,22,581,300,799,533,218,233,couch
13547,6,sofa,6,0,749,37,421,277,714,440,293,163,couch
13548,5,television,4,0,750,19,802,315,959,462,157,147,tv
13549,17,vase,16,0,750,18,606,498,640,589,34,91,vase
13550,20,sofa,19,1,750,53,193,451,559,810,366,359,couch
13551,23,flowerpot,22,0,750,29,26,495,232,777,206,282,potted plant
13552,26,flowerpot,25,0,750,17,127,702,207,800,80,98,potted plant
13553,39,chair,40,1,751,22,277,428,343,481,66,53,chair
13554,40,chair,41,1,751,20,308,431,360,481,52,50,chair
13555,41,table,42,1,751,23,305,434,432,480,127,46,dining table
13556,43,sofa,44,0,751,77,175,431,835,749,660,318,couch
13557,4,sofa,4,1,752,49,609,347,936,498,327,151,couch
13558,7,window,7,0,752,15,458,198,592,409,134,211,window
13559,15,flowerpot,14,0,752,15,915,454,1002,511,87,57,potted plant
13560,11,table,12,1,753,30,94,256,331,292,237,36,dining table
13561,12,chair,13,0,753,23,316,245,354,322,38,77,chair
13562,13,chair,14,1,753,26,267,244,318,336,51,92,chair
13563,14,chair,15,1,753,22,208,247,270,345,62,98,chair
13564,15,chair,16,1,753,23,146,245,210,356,64,111,chair
13565,16,chair,17,0,753,21,65,248,146,359,81,111,chair
13566,19,sofa,20,1,753,29,528,252,799,438,271,186,couch
13567,20,bowl,21,0,753,25,470,328,601,386,131,58,bowl
13568,22,door,23,1,754,15,633,265,669,439,36,174,door
13569,24,door,25,1,754,19,890,228,968,421,78,193,door
13570,26,sofa,27,1,754,34,637,398,1023,658,386,260,couch
13571,7,window,8,0,755,36,1099,326,1253,505,154,179,window
13572,9,chair,9,1,755,23,1144,468,1266,635,122,167,chair
13573,11,chair,11,1,755,16,1216,557,1279,662,63,105,chair
13574,12,chair,12,1,755,32,1059,485,1181,663,122,178,chair
13575,33,sofa,28,0,755,29,557,439,791,603,234,164,couch
13576,21,door,18,1,756,41,312,217,674,469,362,252,door
13577,22,chair,19,1,756,25,379,398,476,535,97,137,chair
13578,23,flowerpot,20,0,756,15,277,409,329,438,52,29,potted plant
13579,25,chair,22,1,756,17,191,402,279,464,88,62,chair
13580,26,chair,23,0,756,41,84,437,242,637,158,200,chair
13581,27,table,24,1,756,42,191,424,387,519,196,95,dining table
13582,28,chair,25,0,756,27,257,432,420,631,163,199,chair
13583,53,door,50,0,756,15,1043,442,1143,541,100,99,door
13584,12,sofa,13,1,757,28,618,302,720,479,102,177,couch
13585,16,window,17,0,757,26,427,152,554,299,127,147,window
13586,18,sofa,19,0,757,49,392,275,563,369,171,94,couch
13587,19,sofa,20,1,758,47,0,909,1093,1399,1093,490,couch
13588,20,bed,21,1,758,16,1863,598,2018,1007,155,409,bed
13589,3,window,4,1,759,18,503,123,793,392,290,269,window
13590,4,sofa,5,1,759,41,398,287,745,496,347,209,couch
13591,11,bowl,12,0,759,23,386,341,464,397,78,56,bowl
13592,20,sofa,21,1,760,80,509,312,930,542,421,230,couch
13593,33,sofa,33,0,760,49,0,333,427,592,427,259,couch
13594,18,window,19,0,761,25,0,285,138,539,138,254,window
13595,19,chair,20,1,761,18,140,434,225,517,85,83,chair
13596,20,chair,21,1,761,27,51,442,145,574,94,132,chair
13597,21,table,22,1,761,21,115,450,279,481,164,31,dining table
13598,46,sofa,44,0,761,41,85,481,718,799,633,318,couch
13599,9,window,10,0,762,17,591,239,756,396,165,157,window
13600,17,vase,18,0,762,25,337,430,378,539,41,109,vase
13601,10,window,10,0,763,27,370,127,545,377,175,250,window
13602,11,window,11,0,763,48,604,103,922,435,318,332,window
13603,8,window,9,0,764,22,418,196,550,351,132,155,window
13604,16,sofa,16,1,764,32,202,290,451,436,249,146,couch
13605,74,door,73,0,764,24,737,129,782,381,45,252,door
13606,27,sofa,28,0,765,46,122,404,526,663,404,259,couch
13607,5,window,6,0,766,35,159,250,273,415,114,165,window
13608,32,sofa,31,1,766,57,2,399,275,592,273,193,couch
13609,40,chair,39,1,766,15,0,534,53,659,53,125,chair
13610,7,window,6,0,767,19,514,229,614,334,100,105,window
13611,10,sofa,9,1,767,54,503,326,922,439,419,113,couch
13612,10,window,10,1,768,25,906,151,961,400,55,249,window
13613,11,sofa,11,0,768,36,660,359,1023,664,363,305,couch
13614,15,sofa,15,0,768,56,12,348,461,610,449,262,couch
13615,16,window,16,1,768,36,176,186,261,371,85,185,window
13616,3,window,4,1,769,56,5,106,254,248,249,142,window
13617,4,sofa,5,1,769,49,2,227,286,425,284,198,couch
13618,14,window,15,0,769,24,339,138,488,246,149,108,window
13619,21,sofa,22,0,769,40,405,227,626,369,221,142,couch
13620,10,window,11,0,770,20,379,124,511,260,132,136,window
13621,12,sofa,13,0,770,48,345,238,719,479,374,241,couch
13622,15,sofa,15,1,771,69,25,312,370,532,345,220,couch
13623,17,vase,17,0,771,26,352,329,394,396,42,67,vase
13624,18,pot,18,0,771,16,275,380,302,415,27,35,potted plant
13625,20,pot,20,0,771,17,304,387,334,423,30,36,potted plant
13626,26,vase,26,0,771,27,87,216,125,274,38,58,vase
13627,31,mirror,31,0,771,33,658,140,778,286,120,146,mirror
13628,41,door,39,0,771,18,126,163,206,344,80,181,door
13629,122,door,119,0,771,23,2,144,75,379,73,235,door
13630,2,window,3,0,772,23,174,88,450,367,276,279,window
13631,3,door,4,0,772,16,2,84,188,495,186,411,door
13632,6,sofa,7,1,772,44,160,330,503,533,343,203,couch
13633,7,sofa,8,0,772,40,503,335,953,644,450,309,couch
13634,6,door,6,0,773,19,31,29,196,437,165,408,door
13635,7,sofa,7,1,773,23,0,329,311,533,311,204,couch
13636,8,sofa,8,1,773,50,508,268,799,533,291,265,couch
13637,11,vase,11,0,773,26,418,356,537,463,119,107,vase
13638,4,window,5,0,774,16,200,15,283,206,83,191,window
13639,17,sofa,18,1,774,39,329,232,639,425,310,193,couch
13640,1,window,2,0,775,17,154,188,318,406,164,218,window
13641,2,window,3,0,775,19,405,188,567,394,162,206,window
13642,5,chair,6,1,775,25,461,315,579,407,118,92,chair
13643,7,sofa,8,1,775,30,71,327,307,477,236,150,couch
13644,5,window,6,0,776,26,652,166,877,380,225,214,window
13645,9,sofa,9,1,776,36,210,322,513,428,303,106,couch
13646,9,window,10,0,777,38,456,290,655,455,199,165,window
13647,17,sofa,15,0,777,26,703,456,1110,739,407,283,couch
13648,28,chair,25,0,777,29,194,406,292,552,98,146,chair
13649,3,window,4,0,778,23,1721,236,2197,980,476,744,window
13650,5,window,6,0,778,36,1195,356,1697,937,502,581,window
13651,10,chair,10,1,778,36,1391,845,1570,1167,179,322,chair
13652,11,chair,11,0,778,37,1704,859,2061,1293,357,434,chair
13653,17,window,17,0,778,16,413,196,1047,738,634,542,window
13654,28,sofa,28,0,778,49,0,861,1241,1609,1241,748,couch
13655,25,boat,26,0,779,16,355,173,507,393,152,220,boat
13656,26,vase,27,0,779,24,349,501,384,585,35,84,vase
13657,40,sofa,40,1,779,51,704,533,999,743,295,210,couch
13658,41,sofa,41,1,779,25,2,597,734,799,732,202,couch
13659,51,bowl,51,0,779,17,554,431,639,459,85,28,bowl
13660,5,door,6,0,780,18,252,298,380,459,128,161,door
13661,19,sofa,20,0,780,24,29,402,329,589,300,187,couch
13662,30,sofa,30,1,781,28,459,442,1024,684,565,242,couch
13663,7,window,8,0,782,22,582,115,795,439,213,324,window
13664,10,chair,11,1,782,39,429,379,721,513,292,134,chair
13665,11,sofa,12,0,782,48,61,377,851,681,790,304,couch
13666,11,sofa,12,1,783,20,0,278,270,414,270,136,couch
13667,6,sofa,5,0,784,68,247,200,674,447,427,247,couch
13668,14,chair,13,1,784,16,667,318,783,468,116,150,chair
13669,15,chair,14,1,784,16,444,363,613,571,169,208,chair
13670,17,cup,16,0,784,22,644,466,704,613,60,147,cup
13671,19,plate,18,1,784,30,590,497,742,568,152,71,plate
13672,18,bowl,18,0,785,20,572,458,667,530,95,72,bowl
13673,21,sofa,21,1,785,62,185,442,623,682,438,240,couch
13674,24,chair,23,1,785,32,295,388,431,467,136,79,chair
13675,31,chair,30,0,785,70,762,419,975,682,213,263,chair
13676,3,window,4,0,786,23,126,84,349,298,223,214,window
13677,12,sofa,13,0,786,50,128,243,355,386,227,143,couch
13678,9,door,9,1,787,20,112,187,256,513,144,326,door
13679,13,door,13,1,787,48,390,205,503,475,113,270,door
13680,22,chair,22,1,787,23,749,432,847,622,98,190,chair
13681,18,desk,19,0,788,30,542,297,750,410,208,113,desk
13682,8,sofa,8,1,789,81,132,345,616,555,484,210,couch
13683,5,vase,6,0,790,16,350,246,386,358,36,112,vase
13684,10,sofa,11,0,790,23,208,283,367,417,159,134,couch
13685,11,sofa,12,0,790,24,570,293,735,462,165,169,couch
13686,18,mirror,19,0,790,16,715,155,769,269,54,114,mirror
13687,17,chair,17,1,791,21,347,295,402,386,55,91,chair
13688,18,chair,18,1,791,21,292,297,354,396,62,99,chair
13689,19,chair,19,1,791,16,201,296,240,396,39,100,chair
13690,22,sofa,22,1,791,47,507,294,768,409,261,115,couch
13691,14,sofa,15,1,792,34,180,277,444,479,264,202,couch
13692,18,window,19,0,792,21,432,140,651,298,219,158,window
13693,25,sofa,26,1,792,18,564,308,719,453,155,145,couch
13694,8,window,7,1,793,24,318,250,375,429,57,179,window
13695,3,window,4,1,794,23,638,123,738,306,100,183,window
13696,4,window,5,1,794,24,387,129,490,293,103,164,window
13697,8,sofa,9,1,794,67,12,259,416,474,404,215,couch
13698,11,window,12,1,794,16,2,110,42,310,40,200,window
13699,10,sofa,11,0,795,40,197,566,486,736,289,170,couch
13700,21,sofa,22,1,795,41,463,593,863,918,400,325,couch
13701,1,window,2,0,796,17,0,134,89,452,89,318,window
13702,9,chair,8,1,797,16,261,310,338,406,77,96,chair
13703,10,chair,9,1,797,28,465,337,693,520,228,183,chair
13704,11,sofa,10,1,797,50,367,309,641,432,274,123,couch
13705,25,mirror,26,0,798,32,2,138,191,293,189,155,mirror
13706,27,bottle,28,0,798,15,231,269,244,312,13,43,bottle
13707,29,sofa,30,0,798,40,0,292,274,449,274,157,couch
13708,3,window,4,0,799,24,157,110,454,344,297,234,window
13709,8,sofa,9,0,799,42,2,314,472,656,470,342,couch
13710,17,sofa,18,1,800,26,394,238,600,397,206,159,couch
13711,50,sofa,47,1,801,24,569,339,798,532,229,193,couch
13712,14,chair,15,1,802,26,194,289,273,396,79,107,chair
13713,15,chair,16,1,802,20,76,287,123,412,47,125,chair
13714,16,chair,17,1,802,21,106,291,161,423,55,132,chair
13715,17,table,18,1,802,26,71,304,291,427,220,123,dining table
13716,27,sofa,28,0,802,33,552,301,800,440,248,139,couch
13717,28,sofa,29,0,802,54,215,304,504,533,289,229,couch
13718,4,window,5,1,803,61,399,142,719,281,320,139,window
13719,17,sofa,18,0,803,40,485,234,719,408,234,174,couch
13720,5,window,6,0,804,58,490,27,1168,673,678,646,window
13721,30,sofa,27,1,804,73,0,490,373,759,373,269,couch
13722,37,door,34,0,804,30,225,322,315,525,90,203,door
13723,10,mirror,11,1,805,101,452,113,764,344,312,231,mirror
13724,12,window,12,0,805,24,2,187,260,334,258,147,window
13725,16,sofa,16,0,805,32,0,316,288,482,288,166,couch
13726,20,sofa,20,1,805,45,107,370,743,533,636,163,couch
13727,7,window,8,1,806,16,381,157,429,335,48,178,window
13728,12,flowerpot,13,0,806,18,216,310,260,353,44,43,potted plant
13729,15,window,16,1,806,18,441,201,468,261,27,60,window
13730,18,table,19,1,806,17,456,260,498,310,42,50,dining table
13731,21,chair,22,0,806,21,479,255,521,316,42,61,chair
13732,23,window,24,0,806,32,0,81,118,331,118,250,window
13733,8,sofa,8,1,807,44,504,366,852,552,348,186,couch
13734,13,window,12,0,807,42,18,180,435,508,417,328,window
13735,17,flowerpot,16,0,807,22,82,560,183,659,101,99,potted plant
13736,19,sofa,19,1,808,42,685,360,987,489,302,129,couch
13737,24,television,24,1,808,16,232,309,335,373,103,64,tv
13738,26,sofa,26,1,808,76,119,346,381,610,262,264,couch
13739,29,vase,29,0,808,16,542,407,567,435,25,28,vase
13740,36,window,36,1,808,83,0,0,215,511,215,511,window
13741,9,window,8,0,809,16,193,163,535,386,342,223,window
13742,23,pot,22,0,809,24,734,184,795,278,61,94,potted plant
13743,24,pot,23,0,809,16,931,225,976,270,45,45,potted plant
13744,25,flowerpot,24,0,809,15,786,235,834,277,48,42,potted plant
13745,5,window,5,1,810,27,120,119,216,437,96,318,window
13746,13,flowerpot,12,0,810,20,1006,584,1085,673,79,89,potted plant
13747,23,sofa,21,1,810,58,637,372,991,653,354,281,couch
13748,30,bowl,28,0,810,35,178,446,285,514,107,68,bowl
13749,31,balls,29,0,810,23,187,405,287,457,100,52,sports ball
13750,9,chair,9,1,811,27,89,354,163,469,74,115,chair
13751,10,sofa,10,1,811,53,424,327,664,470,240,143,couch
13752,24,plate,24,0,811,15,203,150,237,181,34,31,plate
13753,5,desk,6,1,812,23,320,310,421,378,101,68,desk
13754,7,chair,8,1,812,15,349,298,390,364,41,66,chair
13755,14,window,13,0,812,29,2,13,174,355,172,342,window
13756,15,window,14,0,812,22,193,64,322,335,129,271,window
13757,19,sofa,18,1,812,41,368,315,640,408,272,93,couch
13758,19,pot,19,1,813,23,286,340,347,375,61,35,potted plant
13759,50,door,48,0,813,18,90,74,168,349,78,275,door
13760,94,chair,92,1,813,19,31,312,104,351,73,39,chair
13761,3,door,4,1,814,21,420,75,497,311,77,236,door
13762,4,window,5,1,814,23,494,61,686,311,192,250,window
13763,10,window,11,0,814,20,278,108,356,233,78,125,window
13764,17,sofa,18,1,814,52,438,221,684,337,246,116,couch
13765,20,sofa,21,1,814,27,367,306,685,474,318,168,couch
13766,3,window,4,0,815,27,553,153,772,343,219,190,window
13767,5,window,6,0,815,21,444,161,522,345,78,184,window
13768,21,vase,22,0,815,18,280,157,308,198,28,41,vase
13769,22,vase,23,0,815,21,99,129,131,178,32,49,vase
13770,23,sofa,24,1,815,45,481,340,836,557,355,217,couch
13771,8,window,9,1,816,22,346,280,453,408,107,128,window
13772,27,sofa,28,0,816,64,620,423,943,674,323,251,couch
13773,4,window,5,1,817,17,392,51,436,208,44,157,window
13774,12,table,13,0,817,25,604,170,925,285,321,115,dining table
13775,17,sofa,17,0,817,29,503,197,849,356,346,159,couch
13776,18,table,18,1,817,23,129,187,354,242,225,55,dining table
13777,23,sofa,22,0,817,32,104,195,448,350,344,155,couch
13778,7,mirror,8,1,818,42,723,201,782,298,59,97,mirror
13779,10,door,11,1,818,24,0,162,187,386,187,224,door
13780,11,door,12,1,818,37,187,184,335,355,148,171,door
13781,18,sofa,19,1,818,45,78,304,281,475,203,171,couch
13782,22,flowerpot,23,0,818,16,567,319,619,352,52,33,potted plant
13783,23,sofa,24,1,818,70,316,309,616,518,300,209,couch
13784,20,sofa,19,1,819,27,560,464,944,708,384,244,couch
13785,21,sofa,20,1,820,93,0,391,421,626,421,235,couch
13786,9,sofa,9,1,821,43,307,344,540,478,233,134,couch
13787,16,chair,16,1,822,20,695,361,756,454,61,93,chair
13788,17,chair,17,1,822,30,725,369,821,489,96,120,chair
13789,19,chair,19,1,822,16,566,365,622,477,56,112,chair
13790,20,chair,20,0,822,26,612,367,703,487,91,120,chair
13791,21,table,21,1,822,30,606,372,786,482,180,110,dining table
13792,24,sofa,24,1,822,64,2,382,468,617,466,235,couch
13793,29,bowl,29,0,822,28,378,467,446,516,68,49,bowl
13794,42,door,41,0,822,34,62,187,181,398,119,211,door
13795,44,door,43,0,822,15,1,183,63,513,62,330,door
13796,46,door,45,0,822,31,334,223,411,399,77,176,door
13797,48,door,47,0,822,23,252,217,335,389,83,172,door
13798,52,door,51,0,822,16,446,239,501,446,55,207,door
13799,7,window,8,0,823,21,446,236,656,383,210,147,window
13800,15,sofa,15,0,823,72,90,356,638,603,548,247,couch
13801,12,bench,13,1,824,22,1057,481,1317,568,260,87,bench
13802,18,window,19,0,824,18,653,249,863,519,210,270,window
13803,19,window,20,0,824,20,264,205,574,574,310,369,window
13804,32,sofa,33,0,824,28,559,481,1097,775,538,294,couch
13805,33,sofa,34,1,824,46,1283,512,1767,774,484,262,couch
13806,35,table,36,1,824,53,2,492,455,775,453,283,dining table
13807,32,sofa,33,1,825,59,512,249,738,420,226,171,couch
13808,33,bowl,34,0,825,24,432,328,578,369,146,41,bowl
13809,67,bowl,66,0,825,19,34,216,75,228,41,12,bowl
13810,20,sofa,21,1,826,21,438,283,618,411,180,128,couch
13811,27,sofa,28,1,826,17,103,358,638,450,535,92,couch
13812,7,window,8,0,827,19,267,117,316,337,49,220,window
13813,18,sofa,19,1,827,33,292,275,501,372,209,97,couch
13814,26,sofa,27,1,827,20,0,297,172,531,172,234,couch
13815,7,sofa,8,1,828,29,329,371,612,503,283,132,couch
13816,35,chair,36,1,828,31,682,426,956,676,274,250,chair
13817,46,window,46,0,828,15,192,187,285,398,93,211,window
13818,47,window,47,0,828,15,2,35,182,502,180,467,window
13819,48,table,48,0,828,28,20,419,249,682,229,263,dining table
13820,14,sofa,15,1,829,30,171,306,367,409,196,103,couch
13821,17,sofa,18,1,829,23,0,335,276,533,276,198,couch
13822,8,sofa,7,1,830,38,474,358,783,493,309,135,couch
13823,14,chair,13,0,830,33,620,399,928,650,308,251,chair
13824,15,chair,14,1,830,32,218,361,409,490,191,129,chair
13825,16,chair,15,0,830,33,222,427,334,580,112,153,chair
13826,17,chair,16,0,830,42,312,444,476,618,164,174,chair
13827,19,bed,18,1,830,15,0,386,217,481,217,95,bed
13828,9,flowerpot,8,1,831,15,669,510,724,539,55,29,potted plant
13829,11,window,10,1,831,40,647,304,779,497,132,193,window
13830,13,sofa,12,0,831,31,417,432,638,558,221,126,couch
13831,14,sofa,13,0,831,31,715,439,1183,698,468,259,couch
13832,32,window,32,0,832,16,180,157,249,407,69,250,window
13833,37,sofa,37,0,832,51,113,396,501,681,388,285,couch
13834,23,sofa,22,0,833,49,168,351,467,551,299,200,couch
13835,29,plate,27,0,833,16,676,200,751,277,75,77,plate
13836,18,window,17,0,834,15,45,204,127,353,82,149,window
13837,19,window,18,0,834,16,135,206,212,329,77,123,window
13838,23,window,21,0,834,20,477,191,560,356,83,165,window
13839,24,window,22,0,834,17,600,180,707,340,107,160,window
13840,25,window,23,0,834,45,751,169,864,441,113,272,window
13841,31,sofa,29,1,834,54,489,325,791,494,302,169,couch
13842,51,chair,49,0,834,24,86,328,173,462,87,134,chair
13843,54,chair,52,0,834,22,231,312,296,423,65,111,chair
13844,55,chair,53,0,834,22,165,314,230,439,65,125,chair
13845,8,window,9,0,835,17,535,91,799,460,264,369,window
13846,13,chair,13,1,835,17,440,312,538,393,98,81,chair
13847,14,sofa,14,1,835,33,201,344,552,539,351,195,couch
13848,15,window,15,0,835,25,0,133,191,392,191,259,window
13849,16,chair,16,0,835,28,2,339,192,520,190,181,chair
13850,20,table,20,1,835,22,365,403,732,539,367,136,dining table
13851,5,window,6,0,836,17,528,141,740,371,212,230,window
13852,19,sofa,20,0,836,22,622,340,780,426,158,86,couch
13853,21,sofa,22,0,836,34,542,306,1024,638,482,332,couch
13854,32,sofa,31,0,836,35,34,358,493,638,459,280,couch
13855,5,window,4,0,837,19,451,157,638,265,187,108,window
13856,7,window,6,0,837,17,718,150,800,315,82,165,window
13857,8,window,7,0,837,43,2,119,356,334,354,215,window
13858,10,sofa,9,0,837,51,459,230,783,494,324,264,couch
13859,17,table,16,1,837,22,80,268,272,310,192,42,dining table
13860,18,chair,17,0,837,22,220,257,305,375,85,118,chair
13861,19,chair,18,0,837,36,129,263,219,406,90,143,chair
13862,20,chair,19,0,837,33,32,257,135,392,103,135,chair
13863,1,window,2,0,838,83,2,202,425,568,423,366,window
13864,15,sofa,14,1,838,43,189,388,444,560,255,172,couch
13865,19,sofa,18,1,838,82,691,431,1024,682,333,251,couch
13866,23,vase,22,0,838,17,590,270,621,306,31,36,vase
13867,21,sofa,21,1,839,35,314,317,446,397,132,80,couch
13868,25,chair,25,0,839,24,440,324,533,437,93,113,chair
13869,26,chair,26,0,839,25,244,325,347,444,103,119,chair
13870,10,sofa,9,0,840,81,409,279,872,598,463,319,couch
13871,14,sofa,13,1,840,47,2,273,414,469,412,196,couch
13872,7,window,8,0,841,25,600,28,739,352,139,324,window
13873,11,flowerpot,12,0,841,19,686,489,756,562,70,73,potted plant
13874,13,clock,14,0,841,15,710,368,752,433,42,65,clock
13875,24,sofa,25,1,841,47,745,336,1039,695,294,359,couch
13876,2,vase,3,0,842,19,287,231,322,270,35,39,vase
13877,9,window,10,0,842,16,275,128,322,269,47,141,window
13878,10,window,11,0,842,21,67,106,211,284,144,178,window
13879,23,sofa,24,1,842,26,0,263,262,499,262,236,couch
13880,5,dog,6,0,843,33,205,505,279,596,74,91,dog
13881,10,chair,11,0,843,31,536,448,640,599,104,151,chair
13882,15,window,16,0,843,22,701,186,1022,559,321,373,window
13883,16,sofa,17,1,843,28,671,569,997,748,326,179,couch
13884,55,window,56,0,843,20,720,288,1022,550,302,262,window
13885,15,sofa,14,0,844,67,362,346,907,636,545,290,couch
13886,16,sofa,15,0,844,39,2,355,363,583,361,228,couch
13887,90,bowl,87,0,844,22,411,440,464,469,53,29,bowl
13888,9,window,10,0,845,20,361,25,500,162,139,137,window
13889,13,sofa,14,0,845,34,299,144,500,225,201,81,couch
13890,5,window,6,0,846,23,696,225,802,409,106,184,window
13891,11,window,12,0,846,34,343,200,493,360,150,160,window
13892,12,window,13,0,846,16,278,237,330,388,52,151,window
13893,23,sofa,18,1,846,28,351,329,484,392,133,63,couch
13894,24,sofa,19,0,846,51,492,337,729,508,237,171,couch
13895,47,chair,42,1,846,20,763,341,809,463,46,122,chair
13896,48,chair,43,1,846,18,746,336,781,443,35,107,chair
13897,27,sofa,28,1,847,35,0,257,343,499,343,242,couch
13898,6,sofa,7,0,848,40,450,250,781,461,331,211,couch
13899,24,clock,25,0,848,24,237,158,267,208,30,50,clock
13900,4,window,5,0,849,29,378,156,481,312,103,156,window
13901,14,window,15,0,849,22,2,130,213,311,211,181,window
13902,19,chair,20,1,849,35,196,268,266,350,70,82,chair
13903,21,sofa,22,1,849,52,287,249,449,330,162,81,couch
13904,23,vase,24,0,849,17,335,288,358,316,23,28,vase
13905,26,chair,27,0,849,45,76,282,205,404,129,122,chair
13906,12,window,13,0,850,20,625,80,797,293,172,213,window
13907,26,sofa,27,0,850,40,2,275,351,579,349,304,couch
13908,33,table,34,1,850,37,582,286,797,412,215,126,dining table
13909,15,bowl,16,0,851,17,696,526,759,567,63,41,bowl
13910,19,vase,20,0,851,20,437,453,476,509,39,56,vase
13911,22,sofa,23,1,851,43,0,396,648,684,648,288,couch
13912,23,clock,24,0,851,16,621,243,704,284,83,41,clock
13913,7,door,7,1,852,42,112,180,466,456,354,276,door
13914,8,desk,8,0,852,26,2,334,253,490,251,156,desk
13915,9,sofa,9,0,852,44,72,379,493,664,421,285,couch
13916,11,sofa,11,1,852,33,488,393,1000,723,512,330,couch
13917,2,window,3,1,853,33,1037,398,1199,862,162,464,window
13918,3,window,4,1,853,49,67,163,635,969,568,806,window
13919,9,sofa,10,0,853,43,0,899,1203,1465,1203,566,couch
13920,10,sofa,11,0,853,36,725,798,1165,1173,440,375,couch
13921,13,chair,14,1,853,27,1117,796,1244,978,127,182,chair
13922,19,mirror,19,0,853,18,1500,381,1803,653,303,272,mirror
13923,25,sofa,23,1,853,35,1605,881,2199,1465,594,584,couch
13924,30,flowerpot,27,1,853,19,2028,770,2175,874,147,104,potted plant
13925,16,window,17,0,854,20,2,11,215,411,213,400,window
13926,20,pot,21,0,854,16,329,318,352,349,23,31,potted plant
13927,29,sofa,30,0,854,49,0,367,339,568,339,201,couch
13928,9,window,10,0,855,21,107,173,261,313,154,140,window
13929,4,window,5,0,856,28,195,145,272,338,77,193,window
13930,5,window,6,0,856,32,513,142,593,328,80,186,window
13931,16,sofa,16,1,856,54,271,309,534,427,263,118,couch
13932,24,chair,24,1,856,27,2,294,56,489,54,195,chair
13933,2,desk,3,0,857,20,634,267,746,381,112,114,desk
13934,3,chair,4,1,857,23,658,267,716,378,58,111,chair
13935,14,sofa,15,1,857,27,2,348,304,678,302,330,couch
13936,18,sofa,19,0,857,47,386,398,978,678,592,280,couch
13937,27,bed,27,1,858,23,98,465,167,588,69,123,bed
13938,49,sofa,48,0,858,42,429,601,925,799,496,198,couch
13939,18,window,17,1,859,44,287,252,486,421,199,169,window
13940,24,sofa,23,0,859,84,618,407,1002,662,384,255,couch
13941,16,window,17,0,860,34,676,414,1023,727,347,313,window
13942,17,chair,18,1,860,26,814,595,917,730,103,135,chair
13943,20,vase,21,0,860,23,352,689,425,765,73,76,vase
13944,23,sofa,24,1,860,37,24,617,261,910,237,293,couch
13945,24,sofa,25,1,860,45,447,620,881,927,434,307,couch
13946,86,bowl,87,0,860,22,353,687,424,763,71,76,bowl
13947,14,sofa,15,0,861,35,103,259,342,420,239,161,couch
13948,16,window,17,0,861,42,23,58,181,322,158,264,window
13949,5,sofa,6,1,862,41,744,481,1250,778,506,297,couch
13950,7,sofa,8,1,862,15,479,687,991,830,512,143,couch
13951,13,mirror,14,0,862,17,89,84,498,473,409,389,mirror
13952,18,window,19,0,863,16,0,144,180,488,180,344,window
13953,19,chair,20,1,863,50,0,395,257,682,257,287,chair
13954,23,sofa,24,1,863,28,824,382,1024,682,200,300,couch
13955,22,sofa,23,0,864,58,431,274,749,486,318,212,couch
13956,12,window,12,0,865,16,542,225,682,406,140,181,window
13957,15,window,14,0,865,17,393,220,540,407,147,187,window
13958,19,sofa,18,1,865,51,204,388,490,542,286,154,couch
13959,21,sofa,20,1,865,27,601,386,812,489,211,103,couch
13960,24,flowerpot,23,0,865,18,402,436,465,486,63,50,potted plant
13961,29,chair,28,1,865,25,2,418,242,685,240,267,chair
13962,11,mirror,12,0,866,20,765,111,907,258,142,147,mirror
13963,26,flowerpot,27,0,866,20,52,441,149,517,97,76,potted plant
13964,29,chair,30,0,866,31,520,363,636,499,116,136,chair
13965,32,sofa,33,0,866,39,263,406,877,683,614,277,couch
13966,17,clock,17,0,867,15,224,141,264,181,40,40,clock
13967,21,sofa,21,1,867,19,578,330,799,533,221,203,couch
13968,5,table,6,1,868,20,499,264,558,315,59,51,dining table
13969,6,chair,7,1,868,16,491,268,513,314,22,46,chair
13970,7,chair,8,1,868,15,519,271,556,322,37,51,chair
13971,12,television,13,0,868,16,559,244,614,327,55,83,tv
13972,18,sofa,19,1,868,52,48,300,345,512,297,212,couch
13973,31,sofa,32,1,868,35,165,431,800,531,635,100,couch
13974,10,window,11,0,869,23,686,262,779,373,93,111,window
13975,11,window,12,0,869,16,585,274,668,400,83,126,window
13976,12,sofa,13,0,869,50,617,359,911,592,294,233,couch
13977,11,sofa,12,0,870,44,253,225,542,337,289,112,couch
13978,12,chair,13,1,871,19,770,337,830,422,60,85,chair
13979,7,window,8,0,872,48,363,136,741,357,378,221,window
13980,10,sofa,11,1,872,66,358,285,612,405,254,120,couch
13981,21,bench,20,1,872,24,2,286,69,364,67,78,bench
13982,8,sofa,9,1,873,29,315,273,523,382,208,109,couch
13983,13,window,13,1,873,21,305,200,354,288,49,88,window
13984,17,sofa,17,0,873,24,146,269,260,386,114,117,couch
13985,8,door,5,1,874,18,533,319,655,434,122,115,door
13986,14,window,11,0,874,28,342,306,472,444,130,138,window
13987,16,chair,13,1,874,22,207,416,332,566,125,150,chair
13988,17,sofa,14,0,874,47,428,414,771,659,343,245,couch
13989,28,chair,25,1,874,21,734,403,802,517,68,114,chair
13990,29,chair,26,0,874,29,801,406,882,533,81,127,chair
13991,30,table,27,1,874,21,709,416,946,529,237,113,dining table
13992,33,vase,30,0,874,15,304,502,345,548,41,46,vase
13993,13,window,14,0,875,63,182,218,468,438,286,220,window
13994,19,sofa,20,1,875,59,2,373,440,620,438,247,couch
13995,24,sofa,25,1,875,28,483,442,932,620,449,178,couch
13996,14,sofa,15,1,876,39,0,234,159,557,159,323,couch
13997,26,sofa,27,1,876,30,500,320,799,579,299,259,couch
13998,13,bowl,14,0,877,15,304,315,367,366,63,51,bowl
13999,17,sofa,18,1,877,34,0,220,276,461,276,241,couch
14000,8,sofa,9,0,878,61,2,242,411,531,409,289,couch
14001,2,window,3,1,879,16,283,330,445,1065,162,735,window
14002,4,window,5,0,879,20,468,400,748,990,280,590,window
14003,5,window,6,1,879,24,782,432,1186,905,404,473,window
14004,6,window,7,0,879,28,1227,394,1489,997,262,603,window
14005,10,chair,11,1,879,32,644,777,908,1050,264,273,chair
14006,11,chair,12,1,879,15,1146,775,1295,814,149,39,chair
14007,12,chair,13,0,879,62,978,807,1313,1284,335,477,chair
14008,13,chair,14,0,879,59,582,802,924,1264,342,462,chair
14009,15,table,16,1,879,37,788,894,1088,1226,300,332,dining table
14010,16,chair,17,1,879,24,412,1046,517,1258,105,212,chair
14011,18,vase,19,0,879,24,153,173,295,414,142,241,vase
14012,24,sofa,25,1,879,40,1204,922,2101,1399,897,477,couch
14013,9,window,9,0,880,24,484,144,627,492,143,348,window
14014,13,sofa,13,1,880,50,192,459,1080,719,888,260,couch
14015,17,window,17,0,881,15,690,205,735,405,45,200,window
14016,18,window,18,0,881,15,501,208,552,377,51,169,window
14017,22,clock,20,1,881,21,366,210,434,443,68,233,clock
14018,25,sofa,23,1,881,40,502,346,703,465,201,119,couch
14019,30,sofa,28,0,881,28,798,391,1021,802,223,411,couch
14020,32,mirror,30,1,881,24,2,132,163,303,161,171,mirror
14021,16,window,15,0,882,35,57,246,402,450,345,204,window
14022,17,window,16,0,882,22,424,273,596,444,172,171,window
14023,21,sofa,20,0,882,55,533,393,828,585,295,192,couch
14024,23,sofa,22,1,882,37,317,393,522,512,205,119,couch
14025,28,window,28,0,883,17,51,212,188,450,137,238,window
14026,33,sofa,33,0,883,54,110,400,491,593,381,193,couch
14027,34,sofa,34,0,883,50,667,406,982,655,315,249,couch
14028,26,sofa,27,1,884,54,266,261,566,427,300,166,couch
14029,32,table,32,1,884,18,2,271,131,294,129,23,dining table
14030,33,chair,33,1,884,23,54,257,110,330,56,73,chair
14031,34,chair,34,1,884,21,2,254,62,338,60,84,chair
14032,20,sofa,21,1,885,46,640,347,919,511,279,164,couch
14033,21,window,22,0,885,20,638,96,1021,400,383,304,window
14034,24,sofa,25,1,885,29,680,422,1023,683,343,261,couch
14035,8,flowerpot,9,0,886,15,2,541,165,686,163,145,potted plant
14036,27,sofa,28,1,886,33,715,410,965,493,250,83,couch
14037,28,sofa,29,1,886,28,753,443,1024,686,271,243,couch
14038,33,window,33,0,886,26,757,229,1020,457,263,228,window
14039,8,window,9,0,887,17,242,269,293,438,51,169,window
14040,27,sofa,28,1,887,32,0,495,368,798,368,303,couch
14041,5,sofa,6,0,888,46,17,280,329,526,312,246,couch
14042,18,chair,19,1,888,57,599,257,761,426,162,169,chair
14043,20,chair,21,1,888,28,670,327,800,509,130,182,chair
14044,12,window,12,0,889,16,713,176,794,362,81,186,window
14045,16,plate,16,0,889,15,123,290,183,336,60,46,plate
14046,22,sofa,22,1,889,65,526,344,934,623,408,279,couch
14047,5,mirror,4,0,890,17,167,253,268,356,101,103,mirror
14048,8,bottle,6,0,890,15,388,370,416,472,28,102,bottle
14049,22,sofa,23,1,891,29,268,310,378,374,110,64,couch
14050,24,sofa,25,0,891,35,251,352,513,509,262,157,couch
14051,29,chair,30,1,892,19,229,311,284,348,55,37,chair
14052,30,chair,31,1,892,17,296,307,343,340,47,33,chair
14053,45,window,46,0,892,61,507,212,756,404,249,192,window
14054,46,sofa,47,1,892,47,521,326,752,440,231,114,couch
14055,47,sofa,48,0,892,50,173,327,481,502,308,175,couch
14056,59,bowl,60,0,892,19,467,380,513,412,46,32,bowl
14057,19,chair,20,0,893,49,508,486,573,613,65,127,chair
14058,20,chair,21,1,893,20,566,476,610,586,44,110,chair
14059,30,sofa,31,0,893,50,585,509,876,647,291,138,couch
14060,31,sofa,32,1,893,57,398,695,1279,856,881,161,couch
14061,10,window,11,1,894,20,881,381,1188,808,307,427,window
14062,11,window,12,0,894,18,1233,378,1581,776,348,398,window
14063,13,sofa,14,1,894,89,716,721,1828,1317,1112,596,couch
14064,19,flowerpot,20,0,894,18,697,938,822,1067,125,129,potted plant
14065,29,window,30,0,894,41,0,368,389,981,389,613,window
14066,4,window,5,0,895,15,209,180,315,331,106,151,window
14067,10,balls,11,0,895,28,476,361,560,390,84,29,sports ball
14068,12,sofa,13,0,895,39,141,309,451,533,310,224,couch
14069,24,chair,23,0,895,15,748,305,790,366,42,61,chair
14070,9,sofa,10,1,896,30,490,245,625,410,135,165,couch
14071,5,sofa,5,1,897,23,720,432,1023,685,303,253,couch
14072,6,sofa,6,1,897,44,18,477,629,685,611,208,couch
14073,3,window,4,0,898,103,508,0,827,524,319,524,window
14074,4,flowerpot,5,1,898,21,482,470,555,542,73,72,potted plant
14075,6,window,7,0,898,90,0,0,482,570,482,570,window
14076,7,sofa,8,0,898,74,162,435,569,713,407,278,couch
14077,16,plate,15,0,898,17,0,507,97,620,97,113,plate
14078,17,vase,16,0,898,26,115,505,168,599,53,94,vase
14079,3,vase,4,0,899,15,381,191,414,227,33,36,vase
14080,8,window,9,0,899,65,221,23,689,320,468,297,window
14081,14,chair,14,1,899,24,2,384,173,621,171,237,chair
14082,15,sofa,15,0,899,75,72,265,467,567,395,302,couch
14083,2,window,3,1,900,25,347,191,422,437,75,246,window
14084,9,sofa,10,0,900,60,478,361,1009,566,531,205,couch
14085,8,sofa,9,0,901,58,350,338,618,485,268,147,couch
14086,17,sofa,16,0,901,40,2,351,338,632,336,281,couch
14087,22,window,21,1,901,26,772,154,835,417,63,263,window
14088,24,flowerpot,23,0,901,15,865,517,940,570,75,53,potted plant
14089,7,sofa,8,0,902,35,561,310,964,523,403,213,couch
14090,13,chair,14,1,902,30,137,396,383,569,246,173,chair
14091,14,chair,15,1,902,49,77,282,576,679,499,397,chair
14092,10,clock,11,0,903,15,347,252,390,272,43,20,clock
14093,14,window,15,0,903,22,2,29,190,445,188,416,window
14094,16,sofa,17,0,903,39,325,322,699,468,374,146,couch
14095,7,chair,8,0,904,18,350,241,390,318,40,77,chair
14096,11,sofa,12,1,904,31,463,247,700,460,237,213,couch
14097,3,window,4,0,905,26,717,155,1259,630,542,475,window
14098,6,sofa,6,1,905,70,229,496,608,756,379,260,couch
14099,7,sofa,7,0,905,52,676,499,1233,856,557,357,couch
14100,8,sofa,9,1,906,39,182,354,481,539,299,185,couch
14101,11,chair,11,1,906,31,630,385,755,544,125,159,chair
14102,12,chair,12,0,906,41,492,424,712,653,220,229,chair
14103,13,mirror,13,0,906,19,581,211,665,298,84,87,mirror
14104,2,sofa,3,1,907,92,0,348,606,614,606,266,couch
14105,3,sofa,4,1,907,28,0,468,568,669,568,201,couch
14106,15,sofa,15,1,908,55,214,317,481,458,267,141,couch
14107,7,window,8,0,909,20,323,117,481,337,158,220,window
14108,14,chair,15,1,909,19,717,247,799,324,82,77,chair
14109,16,sofa,17,0,909,43,387,259,796,511,409,252,couch
14110,2,sofa,3,1,910,50,209,355,633,557,424,202,couch
14111,8,window,8,1,910,18,708,116,857,439,149,323,window
14112,8,window,9,1,911,20,800,184,1000,436,200,252,window
14113,15,sofa,16,1,911,19,2,454,482,685,480,231,couch
14114,24,sofa,25,1,911,20,648,419,1023,685,375,266,couch
14115,18,sofa,19,0,912,30,156,330,435,531,279,201,couch
14116,23,pot,24,0,912,22,707,392,739,462,32,70,potted plant
14117,17,pot,18,0,913,20,687,159,729,224,42,65,potted plant
14118,32,sofa,33,1,913,30,2,402,594,589,592,187,couch
14119,33,sofa,34,1,913,18,843,414,916,589,73,175,couch
14120,43,door,44,0,913,27,123,175,173,398,50,223,door
14121,21,sofa,21,1,914,30,435,334,664,476,229,142,couch
14122,22,sofa,22,0,914,26,2,340,457,668,455,328,couch
14123,31,vase,31,0,914,19,902,377,948,459,46,82,vase
14124,23,window,24,0,915,23,985,534,1567,928,582,394,window
14125,27,chair,27,1,915,42,717,995,1277,1551,560,556,chair
14126,29,sofa,29,1,915,24,0,928,575,1553,575,625,couch
14127,32,chair,32,1,915,30,168,860,351,1029,183,169,chair
14128,33,chair,33,1,915,15,321,873,531,1031,210,158,chair
14129,42,book,40,1,915,20,730,1486,1106,1553,376,67,book
14130,110,chair,108,0,915,25,1285,897,1539,1145,254,248,chair
14131,17,vase,18,0,916,29,39,467,94,538,55,71,vase
14132,3,table,4,1,917,33,169,375,400,452,231,77,dining table
14133,4,chair,5,1,917,20,198,352,238,421,40,69,chair
14134,6,chair,7,1,917,15,322,351,351,408,29,57,chair
14135,7,chair,8,0,917,21,379,354,413,440,34,86,chair
14136,8,chair,9,0,917,29,324,359,382,469,58,110,chair
14137,9,chair,10,1,917,19,268,362,326,472,58,110,chair
14138,13,sofa,14,1,917,77,418,370,659,540,241,170,couch
14139,15,door,16,1,917,15,652,200,764,433,112,233,door
14140,16,sofa,17,0,917,36,584,385,1024,682,440,297,couch
14141,21,chair,22,1,917,18,215,360,267,444,52,84,chair
14142,23,sofa,24,1,917,27,0,438,407,683,407,245,couch
14143,15,table,16,1,918,37,521,270,719,404,198,134,dining table
14144,17,chair,18,1,918,15,692,255,719,333,27,78,chair
14145,18,chair,19,1,918,16,672,331,719,414,47,83,chair
14146,20,chair,21,1,918,20,511,246,544,304,33,58,chair
14147,21,chair,22,1,918,32,484,251,549,376,65,125,chair
14148,22,chair,23,0,918,35,536,255,644,411,108,156,chair
14149,31,sofa,32,1,918,32,2,254,203,406,201,152,couch
14150,19,chair,20,1,919,15,493,212,521,248,28,36,chair
14151,20,chair,21,1,919,15,521,214,554,274,33,60,chair
14152,21,chair,22,1,919,18,554,214,586,276,32,62,chair
14153,22,table,23,1,919,22,507,215,604,268,97,53,dining table
14154,27,sofa,28,0,919,38,219,239,547,362,328,123,couch
14155,27,sofa,27,1,920,16,0,392,134,533,134,141,couch
14156,28,sofa,28,1,920,29,425,361,798,533,373,172,couch
14157,8,window,9,0,921,34,617,205,887,491,270,286,window
14158,18,sofa,19,0,921,42,955,441,1279,839,324,398,couch
14159,8,door,9,1,922,22,284,231,460,470,176,239,door
14160,18,sofa,18,0,922,58,612,434,1023,676,411,242,couch
14161,19,sofa,19,0,922,53,157,433,530,677,373,244,couch
14162,74,bowl,74,0,922,17,588,561,662,609,74,48,bowl
14163,79,bowl,79,0,922,15,576,549,596,584,20,35,bowl
14164,10,sofa,9,0,923,67,2,393,570,676,568,283,couch
14165,2,window,3,1,924,16,2,1,277,442,275,441,window
14166,8,window,9,0,924,18,623,140,698,380,75,240,window
14167,5,sofa,6,1,925,21,86,407,290,452,204,45,couch
14168,20,sofa,21,0,925,31,757,436,1200,799,443,363,couch
14169,21,sofa,22,0,925,30,0,429,434,799,434,370,couch
14170,5,sofa,5,0,926,67,11,298,491,509,480,211,couch
14171,15,sofa,15,1,927,45,497,364,822,532,325,168,couch
14172,18,sofa,18,1,927,31,608,411,1024,684,416,273,couch
14173,31,balls,30,0,927,23,468,451,530,492,62,41,sports ball
14174,6,chair,6,1,928,25,737,496,1005,662,268,166,chair
14175,14,window,14,0,928,41,0,73,245,473,245,400,window
14176,49,mirror,48,0,928,74,583,152,709,358,126,206,mirror
14177,4,window,5,0,929,29,534,88,777,598,243,510,window
14178,8,window,9,1,929,28,1436,44,1692,656,256,612,window
14179,12,bottle,13,0,929,23,1035,510,1100,601,65,91,bottle
14180,16,vase,17,0,929,15,919,708,960,767,41,59,vase
14181,31,sofa,32,1,929,48,239,540,711,1027,472,487,couch
14182,4,table,5,0,11093,17,86,264,265,363,179,99,dining table
14183,0,sofa,1,0,11095,19,2,860,821,1536,819,676,couch
14184,20,vase,20,0,11096,36,873,1242,1087,1496,214,254,vase
14185,23,bowl,23,0,11096,26,1696,480,1767,532,71,52,bowl
14186,24,plate,24,0,11096,20,1782,608,1867,694,85,86,plate
14187,2,sofa,3,0,11097,17,2,581,1341,1650,1339,1069,couch
14188,5,table,6,0,11098,31,190,254,252,318,62,64,dining table
14189,12,chair,13,1,11098,27,482,259,626,509,144,250,chair
14190,13,chair,14,1,11098,15,691,255,762,388,71,133,chair
14191,14,chair,15,1,11098,32,615,279,763,526,148,247,chair
14192,16,sofa,17,0,11098,29,165,269,482,499,317,230,couch
14193,8,window,9,0,11099,15,2,92,247,313,245,221,window
14194,15,desk,16,0,11101,21,37,157,199,383,162,226,desk
14195,0,sofa,1,0,11102,27,943,534,2193,1576,1250,1042,couch
14196,1,table,2,0,11102,20,207,1007,903,1650,696,643,dining table
14197,5,sofa,6,0,11102,15,6,528,683,1142,677,614,couch
14198,1,vase,2,0,11103,15,1109,935,1252,1252,143,317,vase
14199,2,chair,3,0,11103,88,773,555,1129,1303,356,748,chair
14200,5,sofa,6,0,11105,24,1128,521,1939,1089,811,568,couch
14201,7,sofa,8,0,11105,18,1,751,1134,1650,1133,899,couch
14202,14,vase,15,0,11105,20,1103,519,1148,630,45,111,vase
14203,15,plate,16,0,11105,17,983,2,1106,149,123,147,plate
14204,20,vase,21,0,11105,23,853,1138,1121,1449,268,311,vase
14205,28,plate,29,0,11105,17,1401,14,1580,237,179,223,plate
14206,3,sofa,4,0,11106,18,171,228,456,416,285,188,couch
14207,23,chair,17,1,11106,22,375,180,449,479,74,299,chair
14208,24,chair,18,1,11106,18,596,387,639,480,43,93,chair
14209,9,table,10,0,11107,45,2,214,141,332,139,118,dining table
14210,10,chair,11,1,11107,29,86,208,181,297,95,89,chair
14211,12,chair,13,1,11107,26,2,262,42,341,40,79,chair
14212,13,chair,14,0,11107,43,37,237,150,363,113,126,chair
14213,3,sofa,4,0,11108,24,304,687,1623,1518,1319,831,couch
14214,7,table,8,0,11108,16,1780,662,2166,1255,386,593,dining table
14215,4,clock,5,0,11109,27,372,559,553,694,181,135,clock
14216,4,sofa,5,0,11110,26,789,996,1861,1533,1072,537,couch
14217,14,clock,15,0,11110,95,1383,68,1635,718,252,650,clock
14218,22,pot,23,0,11110,20,976,198,1041,359,65,161,potted plant
14219,1,bicycle,2,1,11111,56,407,210,527,329,120,119,bicycle
14220,12,sofa,13,0,11111,27,190,256,503,412,313,156,couch
14221,9,sofa,10,1,11113,19,7,1048,884,1650,877,602,couch
14222,0,sofa,1,0,11114,34,2,362,677,643,675,281,couch
14223,13,table,14,0,11114,24,20,486,467,725,447,239,dining table
14224,1,vase,2,0,11116,17,1146,523,1262,660,116,137,vase
14225,5,sofa,6,0,11116,39,945,691,2015,1650,1070,959,couch
14226,0,sofa,1,0,11118,24,129,408,1408,1245,1279,837,couch
14227,2,sofa,3,0,11120,23,1,263,285,509,284,246,couch
14228,6,chair,7,1,11120,19,670,351,800,532,130,181,chair
14229,7,table,8,1,11120,26,390,373,794,532,404,159,dining table
14230,17,chair,18,1,11120,38,402,347,552,532,150,185,chair
14231,4,chair,5,0,11121,21,78,908,676,1468,598,560,chair
14232,70,vase,66,0,11121,16,1544,379,1602,529,58,150,vase
14233,71,vase,67,0,11121,20,1406,780,1465,912,59,132,vase
14234,4,sofa,5,1,11122,28,332,250,720,499,388,249,couch
14235,5,sofa,6,1,11122,18,285,398,796,561,511,163,couch
14236,11,bottle,12,0,11123,15,175,36,196,123,21,87,bottle
14237,14,chair,14,1,11124,17,211,319,412,597,201,278,chair
14238,1,sofa,2,0,11125,25,81,140,241,272,160,132,couch
14239,10,table,11,1,11125,30,275,201,507,382,232,181,dining table
14240,11,chair,12,0,11125,38,369,232,507,396,138,164,chair
14241,12,chair,13,1,11125,22,21,210,107,262,86,52,chair
14242,15,chair,16,1,11125,23,2,258,128,396,126,138,chair
14243,4,sofa,5,0,11127,28,254,386,666,583,412,197,couch
14244,11,person,9,1,11128,36,893,719,1017,992,124,273,person
14245,25,chair,22,1,11128,29,1818,1000,2046,1164,228,164,chair
14246,3,sofa,4,1,11130,33,341,207,741,438,400,231,couch
14247,5,chair,6,1,11130,25,599,211,783,529,184,318,chair
14248,7,table,8,0,11130,15,171,228,236,281,65,53,dining table
14249,2,sofa,3,0,11131,32,62,208,275,332,213,124,couch
14250,13,mirror,14,0,11133,29,1758,198,2038,564,280,366,mirror
14251,1,sofa,2,0,11134,33,659,590,1788,1252,1129,662,couch
14252,3,chair,4,0,11134,15,3,838,638,1646,635,808,chair
14253,9,table,10,0,11135,23,7,208,160,395,153,187,dining table
14254,10,chair,11,1,11135,25,118,199,208,343,90,144,chair
14255,11,chair,12,0,11135,39,20,232,138,400,118,168,chair
14256,9,chair,10,0,11137,35,737,596,1041,1156,304,560,chair
14257,10,chair,11,0,11137,31,1309,696,1598,1113,289,417,chair
14258,50,chair,48,0,11137,17,697,1075,1095,1199,398,124,chair
14259,51,table,49,0,11137,17,3,897,91,1199,88,302,dining table
14260,52,chair,50,0,11137,19,3,918,364,1201,361,283,chair
14261,16,table,17,0,11138,28,446,253,640,373,194,120,dining table
14262,11,sofa,12,0,11139,33,257,159,460,270,203,111,couch
14263,15,table,16,0,11139,17,439,221,497,267,58,46,dining table
14264,1,sofa,2,0,11140,18,820,783,2203,1650,1383,867,couch
14265,11,chair,12,0,11141,19,1413,1346,1511,1536,98,190,chair
14266,2,bed,3,1,11142,17,0,382,97,599,97,217,bed
14267,12,sofa,13,0,11142,24,504,357,753,551,249,194,couch
14268,13,desk,14,0,11142,15,542,329,798,517,256,188,desk
14269,18,sofa,19,0,11143,18,1,162,256,255,255,93,couch
14270,5,sofa,6,0,11144,19,6,102,204,166,198,64,couch
14271,14,window,15,0,11147,70,0,49,273,336,273,287,window
14272,26,window,27,0,11147,21,616,154,690,276,74,122,window
14273,27,chair,28,0,11147,62,591,254,642,325,51,71,chair
14274,28,table,29,1,11147,66,619,276,773,346,154,70,dining table
14275,30,chair,31,0,11147,53,657,257,721,354,64,97,chair
14276,32,chair,33,1,11147,30,767,260,800,363,33,103,chair
14277,34,sofa,35,0,11147,68,259,351,800,533,541,182,couch
14278,39,bowl,40,0,11147,18,271,395,324,432,53,37,bowl
14279,47,chair,48,0,11147,23,0,352,107,528,107,176,chair
14280,12,sofa,13,0,11148,17,32,121,196,201,164,80,couch
14281,11,sofa,12,1,11149,16,121,120,195,156,74,36,couch
14282,12,chair,12,0,11150,24,219,147,255,255,36,108,chair
14283,1,sofa,2,0,11152,34,77,132,290,270,213,138,couch
14284,13,chair,14,1,11152,40,24,303,180,404,156,101,chair
14285,2,sofa,3,0,11153,17,38,84,255,196,217,112,couch
14286,2,sofa,3,0,11154,16,77,93,246,220,169,127,couch
14287,6,sofa,7,0,11155,16,10,93,119,158,109,65,couch
14288,8,chair,9,0,11155,17,129,75,151,103,22,28,chair
14289,10,sofa,11,0,11155,18,73,139,256,255,183,116,couch
14290,42,table,38,1,11157,27,4,286,183,320,179,34,dining table
14291,49,table,45,1,11157,30,418,273,524,335,106,62,dining table
14292,50,chair,46,1,11157,23,509,259,545,338,36,79,chair
14293,51,chair,47,1,11157,19,461,257,515,342,54,85,chair
14294,53,chair,49,1,11157,29,387,260,446,337,59,77,chair
14295,55,sofa,51,0,11157,37,0,291,347,481,347,190,couch
14296,63,sofa,59,0,11157,32,547,286,799,532,252,246,couch
14297,16,window,17,0,11158,22,413,164,527,275,114,111,window
14298,24,bowl,25,0,11158,23,450,292,480,337,30,45,bowl
14299,32,sofa,33,0,11158,63,591,269,857,437,266,168,couch
14300,35,window,36,0,11158,21,723,86,857,275,134,189,window
14301,3,chair,4,0,11160,18,544,183,628,332,84,149,chair
14302,18,sofa,19,1,11160,36,2,209,320,438,318,229,couch
14303,19,table,20,0,11160,43,234,323,446,477,212,154,dining table
14304,0,sofa,1,0,11161,27,41,31,298,210,257,179,couch
14305,30,door,29,1,11162,15,173,156,269,330,96,174,door
14306,31,door,30,0,11162,21,60,143,174,401,114,258,door
14307,40,clock,39,0,11162,16,468,228,512,251,44,23,clock
14308,52,pot,51,0,11162,17,647,385,677,411,30,26,potted plant
14309,53,pot,52,0,11162,15,676,384,705,410,29,26,potted plant
14310,57,sofa,56,1,11162,88,107,312,390,433,283,121,couch
14311,72,sofa,71,1,11162,85,251,363,653,532,402,169,couch
14312,39,sofa,40,1,11164,24,36,135,107,195,71,60,couch
14313,52,chair,53,1,11164,30,195,116,208,170,13,54,chair
14314,53,chair,54,1,11164,33,205,117,220,177,15,60,chair
14315,54,chair,55,1,11164,36,215,118,256,186,41,68,chair
14316,13,sofa,12,0,11165,26,1,141,204,260,203,119,couch
14317,26,table,25,0,11165,62,257,153,362,242,105,89,dining table
14318,62,window,63,0,11166,81,422,257,778,649,356,392,window
14319,77,sofa,78,1,11166,87,450,635,676,756,226,121,couch
14320,84,sofa,85,1,11166,43,68,683,510,1066,442,383,couch
14321,8,sofa,9,1,11167,19,0,221,202,383,202,162,couch
14322,9,sofa,10,1,11168,18,0,127,81,216,81,89,couch
14323,12,sofa,9,0,11169,37,215,343,499,526,284,183,couch
14324,15,table,12,0,11169,66,143,352,382,532,239,180,dining table
14325,30,chair,25,1,11169,21,132,302,183,390,51,88,chair
14326,43,chair,35,1,11169,18,275,299,314,344,39,45,chair
14327,45,bottle,37,0,11169,15,647,222,676,262,29,40,bottle
14328,0,chair,1,0,11170,38,5,173,48,212,43,39,chair
14329,6,sofa,7,0,11170,17,175,157,284,234,109,77,couch
14330,34,chair,35,1,11170,32,554,179,606,252,52,73,chair
14331,0,sofa,1,0,11171,19,101,71,264,179,163,108,couch
14332,3,table,4,0,11171,22,64,133,154,204,90,71,dining table
14333,5,table,6,1,11171,17,240,106,299,148,59,42,dining table
14334,6,sofa,7,1,11172,24,43,87,284,213,241,126,couch
14335,8,sofa,9,0,11173,15,104,105,256,234,152,129,couch
14336,3,chair,4,0,11174,15,283,258,362,398,79,140,chair
14337,5,table,6,0,11174,15,112,259,284,394,172,135,dining table
14338,6,chair,7,0,11174,16,78,274,207,432,129,158,chair
14339,5,sofa,6,0,11175,20,234,288,473,400,239,112,couch
14340,9,table,10,0,11175,45,244,339,389,414,145,75,dining table
14341,2,television,3,0,11176,15,248,104,296,143,48,39,tv
14342,4,sofa,5,0,11176,15,2,103,135,225,133,122,couch
14343,5,sofa,6,0,11177,25,135,114,241,177,106,63,couch
14344,2,chair,3,1,11178,19,309,167,364,234,55,67,chair
14345,17,chair,18,1,11178,26,385,292,501,406,116,114,chair
14346,39,chair,40,1,11179,29,417,282,473,322,56,40,chair
14347,60,chair,61,1,11179,26,257,310,331,409,74,99,chair
14348,61,chair,62,1,11179,26,199,300,250,370,51,70,chair
14349,62,chair,63,1,11179,45,155,309,239,412,84,103,chair
14350,63,table,64,1,11179,39,192,312,292,414,100,102,dining table
14351,64,window,65,0,11179,20,147,131,226,324,79,193,window
14352,65,window,66,0,11179,23,255,158,323,313,68,155,window
14353,66,window,67,0,11179,16,0,192,91,320,91,128,window
14354,4,sofa,5,0,11180,16,103,85,254,204,151,119,couch
14355,11,table,12,0,11182,17,124,135,223,203,99,68,dining table
14356,12,chair,13,0,11182,26,147,140,208,234,61,94,chair
14357,14,chair,15,0,11182,18,85,128,106,159,21,31,chair
14358,9,sofa,10,1,11183,37,276,222,733,473,457,251,couch
14359,5,mirror,6,0,11184,21,22,52,60,133,38,81,mirror
14360,6,vase,7,0,11184,15,27,119,43,148,16,29,vase
14361,7,mirror,8,0,11184,21,203,52,243,131,40,79,mirror
14362,0,mirror,1,0,11185,18,41,49,150,155,109,106,mirror
14363,13,table,14,0,11185,15,632,298,715,375,83,77,dining table
14364,14,chair,15,1,11185,17,2,197,74,389,72,192,chair
14365,17,chair,18,1,11185,15,48,214,207,439,159,225,chair
14366,8,sofa,9,0,11186,23,69,105,254,198,185,93,couch
14367,28,sofa,29,0,11187,45,92,284,348,445,256,161,couch
14368,30,chair,31,1,11187,38,368,286,439,370,71,84,chair
14369,31,sofa,32,0,11187,52,461,282,688,414,227,132,couch
14370,34,sofa,35,1,11187,34,445,362,799,533,354,171,couch
14371,49,window,50,0,11187,32,170,152,291,307,121,155,window
14372,73,vase,74,0,11187,16,774,274,788,293,14,19,vase
14373,23,mirror,22,0,11188,15,103,78,134,121,31,43,mirror
14374,28,chair,27,0,11188,18,175,215,245,254,70,39,chair
14375,27,chair,28,0,11189,18,396,287,436,340,40,53,chair
14376,36,chair,37,0,11189,53,438,271,498,401,60,130,chair
14377,37,chair,38,0,11189,61,492,271,566,414,74,143,chair
14378,44,sofa,45,0,11189,67,158,293,399,463,241,170,couch
14379,57,sofa,58,1,11189,41,0,342,433,533,433,191,couch
14380,79,door,80,0,11189,20,124,169,197,387,73,218,door
14381,43,sofa,44,1,11190,40,1,512,316,691,315,179,couch
14382,44,chair,45,1,11190,57,476,386,540,503,64,117,chair
14383,45,vase,46,0,11190,30,376,469,468,552,92,83,vase
14384,64,vase,65,0,11190,25,219,292,260,344,41,52,vase
14385,65,vase,66,0,11190,23,389,298,419,340,30,42,vase
14386,8,table,8,0,11191,34,92,134,220,229,128,95,dining table
14387,9,chair,9,0,11191,18,208,144,256,227,48,83,chair
14388,50,vase,50,0,11191,16,132,102,154,135,22,33,vase
14389,3,sofa,4,0,11192,38,72,186,241,255,169,69,couch
14390,7,sofa,8,0,11192,16,163,157,255,230,92,73,couch
14391,15,sofa,13,0,11193,29,479,324,799,502,320,178,couch
14392,33,chair,30,1,11193,37,237,404,406,532,169,128,chair
14393,34,chair,31,1,11193,23,235,324,285,369,50,45,chair
14394,35,chair,32,1,11193,23,281,335,337,388,56,53,chair
14395,36,chair,33,0,11193,27,59,326,159,369,100,43,chair
14396,50,window,47,0,11193,19,293,149,413,214,120,65,window
14397,8,sofa,9,0,11194,16,19,109,223,193,204,84,couch
14398,8,sofa,9,0,11195,17,1,109,89,212,88,103,couch
14399,1,table,2,0,11196,17,285,307,406,408,121,101,dining table
14400,18,sofa,19,0,11196,23,0,274,225,407,225,133,couch
14401,23,chair,24,0,11196,15,398,220,429,279,31,59,chair
14402,29,chair,30,0,11196,17,462,222,484,277,22,55,chair
14403,3,sofa,4,0,11198,25,51,34,279,147,228,113,couch
14404,8,sofa,9,1,11199,21,66,220,415,326,349,106,couch
14405,10,table,11,0,11200,29,310,442,569,671,259,229,dining table
14406,13,sofa,14,1,11200,24,0,403,301,776,301,373,couch
14407,19,pot,18,1,11200,15,12,652,310,777,298,125,potted plant
14408,3,sofa,2,0,11201,18,182,175,255,256,73,81,couch
14409,8,sofa,9,0,11202,33,2,95,177,175,175,80,couch
14410,7,chair,8,0,11203,15,345,127,408,216,63,89,chair
14411,10,sofa,11,1,11203,22,52,172,370,341,318,169,couch
14412,11,table,12,0,11203,38,19,206,270,341,251,135,dining table
14413,9,sofa,10,0,11204,27,64,118,241,221,177,103,couch
14414,0,television,1,0,11205,15,176,113,252,183,76,70,tv
14415,13,sofa,14,0,11205,26,0,120,126,209,126,89,couch
14416,39,window,40,1,11206,17,552,255,592,330,40,75,window
14417,47,sofa,48,0,11206,93,0,363,388,903,388,540,couch
14418,49,bowl,50,0,11206,22,597,548,724,615,127,67,bowl
14419,50,bowl,51,0,11206,34,607,617,725,691,118,74,bowl
14420,52,door,53,0,11206,16,746,146,837,570,91,424,door
14421,2,mirror,3,0,11207,16,50,11,124,82,74,71,mirror
14422,3,sofa,4,0,11207,16,28,81,165,164,137,83,couch
14423,22,sofa,23,0,11207,16,41,171,256,254,215,83,couch
14424,24,table,25,0,11207,15,161,90,227,143,66,53,dining table
14425,0,bowl,1,0,11208,18,35,163,79,192,44,29,bowl
14426,6,sofa,7,0,11208,25,130,134,256,240,126,106,couch
14427,33,sofa,33,0,11209,26,0,150,82,207,82,57,couch
14428,34,sofa,34,1,11209,19,135,177,252,256,117,79,couch
14429,59,sofa,60,0,11210,91,161,269,593,411,432,142,couch
14430,69,vase,70,0,11210,22,356,301,391,361,35,60,vase
14431,75,vase,76,0,11210,15,595,319,613,353,18,34,vase
14432,4,sofa,5,0,11211,23,50,139,252,254,202,115,couch
14433,6,table,7,0,11211,31,120,168,256,255,136,87,dining table
14434,15,window,16,0,11211,25,18,18,102,147,84,129,window
14435,7,sofa,7,0,11213,22,246,349,908,738,662,389,couch
14436,0,sofa,1,0,11214,21,1,1,249,284,248,283,couch
14437,32,chair,33,1,11215,20,304,357,344,415,40,58,chair
14438,33,chair,34,1,11215,30,252,361,305,437,53,76,chair
14439,34,table,35,1,11215,22,243,362,326,430,83,68,dining table
14440,37,window,38,0,11215,19,52,227,85,457,33,230,window
14441,42,flowerpot,43,0,11215,29,56,464,123,515,67,51,potted plant
14442,49,plate,50,0,11215,17,430,343,492,396,62,53,plate
14443,50,sofa,51,0,11215,78,274,381,768,685,494,304,couch
14444,62,vase,63,0,11215,45,212,435,291,537,79,102,vase
14445,69,flowerpot,70,0,11215,18,739,426,768,469,29,43,potted plant
14446,85,vase,86,0,11215,52,873,461,1009,570,136,109,vase
14447,103,bowl,104,0,11215,16,847,276,863,291,16,15,bowl
14448,26,flowerpot,27,0,11216,15,648,348,696,390,48,42,potted plant
14449,29,television,30,1,11216,29,644,233,711,309,67,76,tv
14450,51,window,52,0,11216,25,0,53,179,405,179,352,window
14451,0,sofa,1,0,11217,45,1,115,256,197,255,82,couch
14452,7,bottle,8,0,11217,17,6,174,33,248,27,74,bottle
14453,4,sofa,5,0,11218,22,0,482,485,824,485,342,couch
14454,26,table,27,0,11218,16,698,412,1003,595,305,183,dining table
14455,38,chair,38,1,11218,17,917,375,1003,514,86,139,chair
14456,39,chair,39,1,11218,26,871,384,979,585,108,201,chair
14457,40,chair,40,1,11218,25,726,383,758,567,32,184,chair
14458,41,chair,41,0,11218,48,737,388,845,618,108,230,chair
14459,0,sofa,1,0,11219,21,49,121,255,255,206,134,couch
14460,7,sofa,8,1,11219,22,154,98,256,162,102,64,couch
14461,8,sofa,9,0,11220,18,26,115,180,199,154,84,couch
14462,10,sofa,11,0,11220,33,105,126,256,255,151,129,couch
14463,26,sofa,27,1,11221,17,2,299,165,462,163,163,couch
14464,37,window,38,0,11221,25,102,112,248,301,146,189,window
14465,36,door,37,1,11223,26,104,168,172,395,68,227,door
14466,38,door,39,1,11223,35,294,185,327,373,33,188,door
14467,39,door,40,1,11223,58,326,186,393,368,67,182,door
14468,48,sofa,49,0,11223,74,367,292,747,450,380,158,couch
14469,1,chair,1,0,11224,44,584,261,1025,727,441,466,chair
14470,23,sofa,23,1,11224,34,3,295,723,631,720,336,couch
14471,24,bowl,24,0,11224,16,151,644,422,768,271,124,bowl
14472,32,plate,32,0,11224,21,331,511,485,546,154,35,plate
14473,29,chair,30,0,11225,104,732,291,800,488,68,197,chair
14474,30,chair,31,0,11225,89,638,292,706,449,68,157,chair
14475,31,chair,32,1,11225,35,603,293,642,396,39,103,chair
14476,38,door,39,0,11225,23,0,190,30,417,30,227,door
14477,39,door,40,1,11225,41,29,193,111,392,82,199,door
14478,40,door,41,1,11225,16,111,206,164,306,53,100,door
14479,41,door,42,1,11225,24,164,214,201,306,37,92,door
14480,42,window,43,0,11225,39,286,226,349,309,63,83,window
14481,50,chair,51,1,11225,15,441,280,467,303,26,23,chair
14482,52,window,53,0,11225,35,500,225,557,310,57,85,window
14483,53,chair,54,1,11225,18,443,286,480,322,37,36,chair
14484,54,chair,55,1,11225,19,376,286,413,316,37,30,chair
14485,55,table,56,1,11225,45,341,301,516,326,175,25,dining table
14486,62,sofa,63,0,11225,88,270,307,557,458,287,151,couch
14487,63,sofa,64,0,11225,77,170,377,683,533,513,156,couch
14488,8,table,9,0,11226,37,240,630,1050,1402,810,772,dining table
14489,12,vase,13,1,11226,21,701,430,867,656,166,226,vase
14490,9,vase,10,0,11227,17,9,78,38,117,29,39,vase
14491,0,sofa,1,0,11228,26,34,800,986,1489,952,689,couch
14492,21,pot,22,0,11228,19,686,685,739,792,53,107,potted plant
14493,47,book,48,1,11228,30,384,756,472,861,88,105,book
14494,58,bowl,59,1,11228,17,41,894,126,947,85,53,bowl
14495,64,plate,65,1,11228,17,175,441,248,502,73,61,plate
14496,2,chair,3,0,11229,16,138,156,164,196,26,40,chair
14497,4,table,5,0,11229,16,157,200,201,255,44,55,dining table
14498,32,window,32,0,11229,16,35,36,154,166,119,130,window
14499,27,sofa,21,1,11230,17,139,89,255,156,116,67,couch
14500,1,sofa,2,0,11231,15,0,105,101,205,101,100,couch
14501,4,sofa,5,1,11232,30,2,56,183,158,181,102,couch
14502,5,table,6,0,11232,16,189,121,244,180,55,59,dining table
14503,7,chair,8,1,11232,22,73,138,144,224,71,86,chair
14504,11,sofa,12,0,11233,23,84,96,255,214,171,118,couch
14505,23,window,24,0,11235,18,150,116,342,192,192,76,window
14506,24,window,25,0,11235,40,150,193,340,345,190,152,window
14507,27,flowerpot,28,0,11235,30,45,328,118,396,73,68,potted plant
14508,34,flowerpot,35,0,11235,18,682,351,712,395,30,44,potted plant
14509,43,table,44,1,11235,22,229,303,288,326,59,23,dining table
14510,44,chair,45,1,11235,22,251,291,285,328,34,37,chair
14511,45,chair,46,1,11235,28,260,295,310,355,50,60,chair
14512,50,sofa,51,0,11235,67,112,335,389,532,277,197,couch
14513,51,sofa,52,1,11235,45,213,375,760,533,547,158,couch
14514,3,sofa,4,0,11236,34,479,631,994,938,515,307,couch
14515,3,sofa,4,0,11237,31,369,537,884,846,515,309,couch
14516,53,table,49,0,11237,55,831,643,1023,801,192,158,dining table
14517,61,vase,57,0,11237,17,207,716,396,829,189,113,vase
14518,19,sofa,15,0,11238,25,0,1076,1387,1470,1387,394,couch
14519,49,table,42,1,11238,50,1776,743,1910,928,134,185,dining table
14520,53,chair,46,1,11238,49,1881,694,1968,942,87,248,chair
14521,58,chair,51,1,11238,27,1891,687,1992,726,101,39,chair
14522,6,sofa,7,1,11239,44,167,605,817,949,650,344,couch
14523,23,plate,24,0,11239,17,444,508,556,606,112,98,plate
14524,24,plate,25,0,11239,15,448,216,547,298,99,82,plate
14525,0,mirror,1,0,11240,16,2,17,82,173,80,156,mirror
14526,11,sofa,12,0,11240,37,221,262,493,483,272,221,couch
14527,3,window,4,1,11241,16,535,2,797,231,262,229,window
14528,6,sofa,7,0,11241,31,403,194,798,456,395,262,couch
14529,10,flowerpot,11,0,11242,24,108,1073,296,1366,188,293,potted plant
14530,12,chair,13,1,11242,31,637,923,964,1292,327,369,chair
14531,15,sofa,16,1,11242,20,1014,1038,2199,1465,1185,427,couch
14532,17,bottle,18,0,11242,19,1071,1012,1110,1108,39,96,bottle
14533,20,bottle,21,0,11242,20,1110,971,1148,1110,38,139,bottle
14534,115,chair,115,1,11242,89,31,915,450,1267,419,352,chair
14535,118,chair,118,1,11242,15,0,1071,83,1289,83,218,chair
14536,127,vase,127,0,11242,29,752,468,835,546,83,78,vase
14537,152,window,150,1,11242,28,201,180,404,967,203,787,window
14538,179,door,177,0,11242,17,1118,714,1284,1105,166,391,door
14539,180,door,178,0,11242,74,950,714,1118,1105,168,391,door
14540,25,window,26,0,11243,46,233,180,567,359,334,179,window
14541,26,window,27,0,11243,21,0,147,142,326,142,179,window
14542,28,window,29,0,11243,32,671,142,799,386,128,244,window
14543,34,flowerpot,35,0,11243,18,457,325,486,348,29,23,potted plant
14544,36,sofa,37,1,11243,45,465,294,632,376,167,82,couch
14545,37,sofa,38,0,11243,54,508,313,757,501,249,188,couch
14546,50,chair,51,1,11243,38,137,305,203,394,66,89,chair
14547,51,table,52,1,11243,29,111,325,197,411,86,86,dining table
14548,56,chair,57,1,11243,30,0,400,184,533,184,133,chair
14549,57,chair,58,1,11243,24,112,353,150,409,38,56,chair
14550,58,vase,59,1,11243,21,767,296,799,399,32,103,vase
14551,1,chair,2,0,11244,43,149,426,441,897,292,471,chair
14552,2,plate,3,0,11244,16,351,756,518,825,167,69,plate
14553,8,sofa,8,0,11244,25,280,343,799,568,519,225,couch
14554,17,chair,16,0,11244,35,804,406,1049,732,245,326,chair
14555,27,chair,26,0,11244,16,6,359,342,629,336,270,chair
14556,41,chair,40,0,11244,28,784,391,1120,631,336,240,chair
14557,43,chair,42,0,11244,38,2,609,207,900,205,291,chair
14558,15,chair,15,0,11245,16,216,114,256,167,40,53,chair
14559,16,sofa,16,0,11245,22,0,99,226,185,226,86,couch
14560,20,bowl,21,0,11246,17,138,216,170,236,32,20,bowl
14561,22,table,23,0,11246,15,126,141,180,179,54,38,dining table
14562,33,sofa,34,1,11246,24,11,176,130,254,119,78,couch
14563,2,sofa,3,1,11249,21,120,166,256,256,136,90,couch
14564,3,sofa,4,0,11249,18,0,115,121,207,121,92,couch
14565,0,sofa,1,0,11250,22,303,314,841,512,538,198,couch
14566,1,chair,2,0,11250,18,13,328,366,636,353,308,chair
14567,7,sofa,8,0,11251,17,12,146,142,220,130,74,couch
14568,17,window,18,0,11252,18,677,146,799,351,122,205,window
14569,23,flowerpot,24,0,11252,17,690,309,764,333,74,24,potted plant
14570,30,table,31,1,11252,51,266,352,406,425,140,73,dining table
14571,31,sofa,32,1,11252,139,373,309,707,525,334,216,couch
14572,38,plate,39,0,11252,19,242,195,289,242,47,47,plate
14573,45,window,46,0,11252,27,306,173,393,325,87,152,window
14574,5,sofa,6,0,11253,24,114,64,299,169,185,105,couch
14575,12,vase,13,0,11253,15,132,151,157,173,25,22,vase
14576,6,sofa,7,0,11255,34,50,100,206,176,156,76,couch
14577,12,sofa,13,1,11256,66,144,330,461,499,317,169,couch
14578,28,bowl,29,0,11256,20,608,341,651,370,43,29,bowl
14579,29,bowl,30,0,11256,46,387,385,488,459,101,74,bowl
14580,37,plate,38,0,11256,16,44,453,107,475,63,22,plate
14581,38,flowerpot,39,0,11256,23,34,402,119,470,85,68,potted plant
14582,40,sofa,41,1,11256,44,384,382,800,599,416,217,couch
14583,25,chair,25,0,11257,27,301,375,399,514,98,139,chair
14584,35,chair,35,0,11257,28,337,573,628,900,291,327,chair
14585,41,sofa,41,1,11257,25,856,466,1200,900,344,434,couch
14586,61,window,62,0,11258,21,236,274,307,372,71,98,window
14587,62,table,63,1,11258,27,167,345,297,376,130,31,dining table
14588,63,chair,64,1,11258,16,222,334,250,377,28,43,chair
14589,79,sofa,80,0,11258,74,176,355,651,493,475,138,couch
14590,17,door,18,0,11259,21,658,212,701,455,43,243,door
14591,30,plate,31,0,11259,17,498,470,579,489,81,19,plate
14592,48,pot,49,0,11259,15,537,486,565,521,28,35,potted plant
14593,12,table,13,0,11261,29,269,216,424,282,155,66,dining table
14594,19,dog,20,0,11261,21,163,226,244,257,81,31,dog
14595,7,table,8,0,11262,15,14,108,204,222,190,114,dining table
14596,11,chair,12,1,11262,15,0,144,45,254,45,110,chair
14597,12,chair,13,1,11262,16,172,119,256,254,84,135,chair
14598,16,chair,16,0,11263,22,660,465,1015,800,355,335,chair
14599,19,table,19,0,11263,21,532,557,629,686,97,129,dining table
14600,36,chair,34,0,11263,25,1131,490,1200,646,69,156,chair
14601,59,bowl,56,0,11263,32,119,376,248,515,129,139,bowl
14602,11,vase,12,0,11264,22,817,828,971,1055,154,227,vase
14603,15,bowl,16,0,11264,15,619,862,824,971,205,109,bowl
14604,6,sofa,7,1,11265,24,1,870,852,1059,851,189,couch
14605,7,sofa,8,0,11265,15,45,744,304,945,259,201,couch
14606,33,chair,31,1,11265,20,227,703,288,747,61,44,chair
14607,34,chair,32,1,11265,18,158,687,197,757,39,70,chair
14608,35,chair,33,1,11265,31,88,689,168,796,80,107,chair
14609,37,vase,35,0,11265,15,408,560,432,611,24,51,vase
14610,102,flowerpot,100,0,11265,16,508,715,535,757,27,42,potted plant
14611,140,bowl,138,0,11265,23,370,985,536,1163,166,178,bowl
14612,2,sofa,3,0,11267,21,2,291,326,480,324,189,couch
14613,41,flowerpot,42,0,11269,19,3,369,51,405,48,36,potted plant
14614,44,sofa,45,1,11269,67,79,318,417,511,338,193,couch
14615,52,door,53,0,11269,21,564,160,633,419,69,259,door
14616,1,sofa,2,0,11270,19,48,71,255,182,207,111,couch
14617,8,bowl,7,0,11271,44,713,380,780,448,67,68,bowl
14618,10,chair,9,0,11271,96,795,390,967,578,172,188,chair
14619,18,bowl,15,0,11271,15,796,590,859,633,63,43,bowl
14620,19,vase,16,0,11271,28,707,566,815,647,108,81,vase
14621,23,sofa,20,0,11271,28,845,438,1200,773,355,335,couch
14622,24,sofa,21,0,11271,46,151,429,734,778,583,349,couch
14623,20,sofa,21,0,11272,40,564,456,906,626,342,170,couch
14624,4,sofa,5,1,11273,35,17,70,256,183,239,113,couch
14625,3,sofa,4,0,11274,21,0,130,207,239,207,109,couch
14626,33,window,34,0,11275,21,675,136,799,317,124,181,window
14627,44,sofa,45,1,11275,100,192,299,509,472,317,173,couch
14628,61,flowerpot,62,0,11275,17,179,150,214,166,35,16,potted plant
14629,3,bowl,2,0,11276,16,571,255,628,324,57,69,bowl
14630,6,chair,4,0,11276,22,177,294,495,640,318,346,chair
14631,26,chair,23,0,11276,18,631,299,769,515,138,216,chair
14632,59,flowerpot,56,0,11276,16,756,534,829,579,73,45,potted plant
14633,76,chair,73,1,11276,42,404,313,575,534,171,221,chair
14634,24,vase,25,0,11277,29,302,400,337,441,35,41,vase
14635,31,mirror,32,0,11277,96,360,88,517,227,157,139,mirror
14636,32,clock,33,0,11277,39,403,181,450,242,47,61,clock
14637,14,sofa,14,1,11278,20,1,228,196,464,195,236,couch
14638,31,window,32,0,11279,20,596,179,698,421,102,242,window
14639,36,flowerpot,37,0,11279,16,393,352,420,369,27,17,potted plant
14640,38,clock,39,0,11279,42,524,216,568,273,44,57,clock
14641,43,chair,44,1,11279,66,40,355,131,508,91,153,chair
14642,44,chair,45,1,11279,24,104,352,166,420,62,68,chair
14643,45,chair,46,1,11279,37,145,354,228,498,83,144,chair
14644,53,sofa,54,0,11279,77,157,379,594,618,437,239,couch
14645,81,table,82,1,11279,56,60,367,286,517,226,150,dining table
14646,65,sofa,66,0,11280,56,1,328,313,532,312,204,couch
14647,73,sofa,74,0,11280,51,508,328,800,532,292,204,couch
14648,87,bowl,88,0,11280,29,388,367,442,427,54,60,bowl
14649,9,sofa,9,0,11281,15,1,134,151,233,150,99,couch
14650,14,vase,15,0,11282,18,720,247,795,449,75,202,vase
14651,21,table,22,0,11282,67,83,872,690,1493,607,621,dining table
14652,0,mirror,1,0,11283,31,93,26,138,95,45,69,mirror
14653,2,sofa,3,0,11283,22,0,140,69,243,69,103,couch
14654,7,sofa,8,0,11283,34,166,139,255,238,89,99,couch
14655,14,sofa,13,1,11284,29,325,406,609,556,284,150,couch
14656,53,vase,52,0,11284,19,314,374,351,424,37,50,vase
14657,8,chair,9,0,11285,18,7,164,107,254,100,90,chair
14658,9,chair,10,0,11285,19,7,155,85,205,78,50,chair
14659,10,sofa,11,0,11285,32,83,139,216,213,133,74,couch
14660,38,chair,39,1,11286,17,490,410,564,482,74,72,chair
14661,39,chair,40,0,11286,25,425,416,507,524,82,108,chair
14662,40,chair,41,1,11286,29,752,471,894,655,142,184,chair
14663,41,chair,42,0,11286,34,642,494,819,678,177,184,chair
14664,42,sofa,43,1,11286,40,613,447,806,518,193,71,couch
14665,43,vase,44,0,11286,23,555,441,623,500,68,59,vase
14666,45,vase,46,0,11286,33,634,414,666,509,32,95,vase
14667,46,vase,47,0,11286,19,511,453,539,506,28,53,vase
14668,52,vase,53,0,11286,34,244,499,302,677,58,178,vase
14669,53,sofa,54,0,11286,49,260,470,526,679,266,209,couch
14670,60,bowl,61,0,11286,33,454,593,485,636,31,43,bowl
14671,37,door,38,1,11287,19,498,181,537,302,39,121,door
14672,38,door,39,0,11287,16,554,168,592,357,38,189,door
14673,43,sofa,44,1,11287,73,1,285,202,509,201,224,couch
14674,62,vase,62,0,11287,19,157,203,179,246,22,43,vase
14675,63,vase,63,0,11287,17,312,212,330,248,18,36,vase
14676,2,sofa,3,0,11288,50,35,101,222,208,187,107,couch
14677,5,door,6,0,11288,15,140,20,168,99,28,79,door
14678,14,table,15,0,11288,17,10,83,64,114,54,31,dining table
14679,21,sofa,22,1,11289,18,0,209,132,255,132,46,couch
14680,16,flowerpot,17,0,11290,47,14,346,87,410,73,64,potted plant
14681,27,window,28,0,11290,32,426,181,494,296,68,115,window
14682,31,mirror,32,1,11290,91,613,54,759,274,146,220,mirror
14683,33,sofa,34,1,11290,127,254,306,616,533,362,227,couch
14684,11,bed,11,1,11293,27,356,573,966,1007,610,434,bed
14685,12,bed,12,1,11293,18,504,838,967,1199,463,361,bed
14686,14,table,14,1,11293,35,1,633,419,1153,418,520,dining table
14687,56,plate,56,1,11293,21,661,865,778,898,117,33,plate
14688,12,sofa,11,1,11294,20,187,284,449,386,262,102,couch
14689,14,chair,13,0,11294,32,218,316,363,523,145,207,chair
14690,15,chair,14,1,11294,17,2,295,48,410,46,115,chair
14691,1,sofa,2,0,11295,24,274,216,680,530,406,314,couch
14692,2,chair,3,1,11295,23,666,293,796,528,130,235,chair
14693,4,table,5,1,11295,23,697,272,796,532,99,260,dining table
14694,9,table,8,1,11296,15,379,327,511,413,132,86,dining table
14695,10,sofa,9,0,11296,20,178,295,398,462,220,167,couch
14696,17,chair,14,1,11296,25,450,421,614,532,164,111,chair
14697,21,table,18,1,11296,22,485,379,774,532,289,153,dining table
14698,48,chair,45,1,11296,42,638,366,790,531,152,165,chair
14699,57,clock,54,0,11296,16,736,136,799,224,63,88,clock
14700,49,window,50,0,11297,15,0,401,169,651,169,250,window
14701,54,window,55,0,11297,34,213,418,384,717,171,299,window
14702,56,window,57,0,11297,23,211,255,384,391,173,136,window
14703,75,sofa,76,1,11297,40,0,638,179,749,179,111,couch
14704,76,sofa,77,1,11297,52,27,656,372,965,345,309,couch
14705,50,vase,51,0,11298,23,76,391,100,438,24,47,vase
14706,69,flowerpot,70,0,11298,18,125,382,182,421,57,39,potted plant
14707,70,sofa,71,1,11298,65,122,422,476,686,354,264,couch
14708,81,vase,82,1,11298,16,418,394,447,445,29,51,vase
14709,26,vase,27,0,11299,31,657,408,702,478,45,70,vase
14710,35,window,36,0,11299,25,221,190,323,391,102,201,window
14711,36,window,37,0,11299,35,9,142,210,421,201,279,window
14712,54,sofa,55,1,11299,28,850,367,1023,641,173,274,couch
14713,16,sofa,16,0,11300,49,286,208,895,544,609,336,couch
14714,31,chair,32,1,11301,22,295,287,311,330,16,43,chair
14715,37,door,38,1,11301,33,378,169,435,359,57,190,door
14716,45,door,46,0,11301,27,757,118,800,403,43,285,door
14717,56,door,55,1,11301,24,144,202,197,344,53,142,door
14718,59,flowerpot,58,0,11301,20,423,351,475,390,52,39,potted plant
14719,65,sofa,64,1,11301,65,74,356,455,534,381,178,couch
14720,68,table,67,1,11301,45,43,304,164,366,121,62,dining table
14721,69,chair,68,1,11301,40,52,292,91,348,39,56,chair
14722,70,chair,69,1,11301,32,67,295,132,358,65,63,chair
14723,71,chair,70,1,11301,46,129,288,175,362,46,74,chair
14724,72,table,71,1,11301,34,0,391,209,534,209,143,dining table
14725,73,bowl,72,0,11301,43,31,351,168,466,137,115,bowl
14726,76,vase,75,0,11301,29,449,409,527,510,78,101,vase
14727,23,sofa,24,1,11303,58,181,370,618,602,437,232,couch
14728,0,sofa,1,0,11304,23,540,417,740,560,200,143,couch
14729,10,sofa,11,1,11304,18,61,423,245,531,184,108,couch
14730,18,table,19,0,11304,36,355,501,523,683,168,182,dining table
14731,12,sofa,13,1,11305,38,204,163,511,322,307,159,couch
14732,13,sofa,14,1,11305,21,2,194,156,383,154,189,couch
14733,16,pot,17,0,11305,22,261,310,319,369,58,59,potted plant
14734,18,table,19,1,11305,16,2,169,63,195,61,26,dining table
14735,13,table,14,1,11306,28,3,512,158,768,155,256,dining table
14736,23,bowl,24,0,11306,30,854,386,1025,524,171,138,bowl
14737,24,sofa,25,0,11306,50,191,267,1025,645,834,378,couch
14738,10,flowerpot,10,0,11307,17,8,175,113,265,105,90,potted plant
14739,12,chair,12,1,11307,29,2,335,455,759,453,424,chair
14740,60,sofa,61,0,11308,52,49,281,418,531,369,250,couch
14741,75,chair,76,1,11308,26,565,269,629,368,64,99,chair
14742,76,table,77,1,11308,18,518,280,701,299,183,19,dining table
14743,77,chair,78,0,11308,32,480,268,536,342,56,74,chair
14744,78,chair,79,0,11308,33,691,270,766,374,75,104,chair
14745,83,bowl,84,0,11308,19,452,340,568,380,116,40,bowl
14746,91,bowl,92,0,11308,15,453,339,568,378,115,39,bowl
14747,0,sofa,1,0,11310,32,2,167,398,505,396,338,couch
14748,2,mirror,3,0,11310,23,317,1,398,94,81,93,mirror
14749,4,table,5,1,11310,15,135,117,208,177,73,60,dining table
14750,5,chair,6,1,11310,15,129,113,166,172,37,59,chair
14751,8,sofa,9,0,11311,24,129,158,248,200,119,42,couch
14752,0,sofa,1,0,11312,48,2,68,289,205,287,137,couch
14753,25,table,26,1,11313,22,466,418,763,452,297,34,dining table
14754,26,window,27,1,11313,15,495,241,869,505,374,264,window
14755,29,chair,30,0,11313,38,500,389,597,533,97,144,chair
14756,30,chair,31,0,11313,40,638,394,724,545,86,151,chair
14757,32,chair,33,0,11313,50,771,405,918,591,147,186,chair
14758,35,door,36,0,11313,16,1043,232,1200,514,157,282,door
14759,39,vase,40,0,11313,17,384,411,410,450,26,39,vase
14760,48,sofa,49,1,11313,34,675,478,1199,798,524,320,couch
14761,84,clock,85,1,11313,27,884,392,923,472,39,80,clock
14762,20,chair,21,0,11314,29,657,342,707,422,50,80,chair
14763,21,chair,22,0,11314,40,705,340,787,446,82,106,chair
14764,24,door,25,1,11314,33,792,112,996,483,204,371,door
14765,29,window,30,0,11314,25,632,0,1020,168,388,168,window
14766,40,table,41,0,11314,31,0,345,191,435,191,90,dining table
14767,42,chair,42,1,11314,37,0,320,112,412,112,92,chair
14768,44,chair,44,1,11314,16,133,325,176,347,43,22,chair
14769,45,chair,45,1,11314,46,135,322,212,434,77,112,chair
14770,48,chair,48,0,11314,52,289,207,357,444,68,237,chair
14771,49,pot,49,0,11314,19,73,378,99,414,26,36,potted plant
14772,57,bowl,57,0,11314,30,225,512,345,584,120,72,bowl
14773,63,door,63,1,11314,28,469,185,554,445,85,260,door
14774,34,window,35,0,11315,25,280,188,346,313,66,125,window
14775,36,window,37,1,11315,20,370,182,443,210,73,28,window
14776,40,window,41,0,11315,17,721,95,799,136,78,41,window
14777,42,window,43,1,11315,36,720,122,799,334,79,212,window
14778,43,vase,44,0,11315,16,626,161,655,210,29,49,vase
14779,47,chair,48,0,11315,119,558,322,795,527,237,205,chair
14780,54,chair,55,1,11315,75,312,282,377,365,65,83,chair
14781,55,chair,56,1,11315,53,262,309,328,415,66,106,chair
14782,56,sofa,57,1,11315,73,0,297,298,528,298,231,couch
14783,61,vase,62,0,11315,45,324,318,343,377,19,59,vase
14784,46,window,47,0,11316,20,823,131,1024,405,201,274,window
14785,48,flowerpot,49,0,11316,17,960,266,1024,332,64,66,potted plant
14786,53,sofa,54,1,11316,76,537,371,863,551,326,180,couch
14787,75,flowerpot,76,0,11316,20,539,443,580,468,41,25,potted plant
14788,85,chair,86,1,11316,30,307,374,350,457,43,83,chair
14789,86,chair,87,1,11316,18,358,376,385,462,27,86,chair
14790,87,table,88,1,11316,17,325,383,373,460,48,77,dining table
14791,21,door,22,1,11317,29,116,230,172,363,56,133,door
14792,23,table,24,0,11317,53,102,323,199,386,97,63,dining table
14793,41,sofa,42,1,11317,66,73,400,416,663,343,263,couch
14794,42,sofa,43,0,11317,44,532,414,885,663,353,249,couch
14795,46,table,47,1,11317,28,1,420,159,662,158,242,dining table
14796,3,bowl,4,0,11318,23,957,775,1027,834,70,59,bowl
14797,4,sofa,5,1,11318,18,943,619,1505,1001,562,382,couch
14798,9,dog,10,0,11318,62,1255,636,1428,879,173,243,dog
14799,39,table,39,1,11318,19,1185,611,1504,708,319,97,dining table
14800,45,chair,43,1,11318,15,1237,610,1354,671,117,61,chair
14801,16,clock,17,0,11319,15,443,244,482,305,39,61,clock
14802,22,sofa,23,0,11319,117,610,355,999,667,389,312,couch
14803,30,vase,31,0,11319,24,457,413,487,461,30,48,vase
14804,32,chair,33,0,11319,74,263,347,402,501,139,154,chair
14805,35,plate,36,0,11319,17,496,429,542,464,46,35,plate
14806,41,chair,42,1,11319,22,54,346,107,405,53,59,chair
14807,43,window,44,0,11319,34,575,194,650,403,75,209,window
14808,44,window,45,0,11319,100,276,193,351,363,75,170,window
14809,46,sofa,47,0,11319,49,0,372,350,667,350,295,couch
14810,52,chair,53,1,11319,47,155,342,205,453,50,111,chair
14811,14,vase,15,0,11320,19,92,210,127,242,35,32,vase
14812,33,bottle,34,0,11321,26,261,397,319,465,58,68,bottle
14813,60,chair,61,1,11321,18,663,329,694,354,31,25,chair
14814,61,chair,62,1,11321,19,677,331,705,406,28,75,chair
14815,62,sofa,63,0,11321,69,385,345,691,540,306,195,couch
14816,72,sofa,73,1,11321,35,458,461,920,614,462,153,couch
14817,3,chair,4,0,11323,24,109,204,359,448,250,244,chair
14818,12,table,13,1,11323,28,261,247,468,345,207,98,dining table
14819,13,sofa,14,1,11323,17,181,184,388,254,207,70,couch
14820,16,chair,17,1,11323,15,516,239,584,374,68,135,chair
14821,16,table,17,0,11324,16,318,532,476,680,158,148,dining table
14822,50,chair,51,0,11324,34,125,511,310,769,185,258,chair
14823,51,chair,52,0,11324,16,420,501,556,656,136,155,chair
14824,61,table,62,0,11324,15,987,637,1365,912,378,275,dining table
14825,12,sofa,11,0,11325,18,692,374,1025,768,333,394,couch
14826,22,table,21,0,11325,19,80,426,267,584,187,158,dining table
14827,49,window,49,0,11326,47,721,243,973,436,252,193,window
14828,50,sofa,50,1,11326,52,661,382,883,503,222,121,couch
14829,62,sofa,62,0,11326,53,747,403,994,663,247,260,couch
14830,68,vase,67,0,11326,29,640,386,676,449,36,63,vase
14831,11,window,12,0,11327,16,7,16,70,162,63,146,window
14832,3,chair,4,0,11328,28,112,530,248,792,136,262,chair
14833,29,hat,30,0,11328,15,37,415,129,469,92,54,hat
14834,39,table,40,1,11328,43,1,902,708,1199,707,297,dining table
14835,15,sofa,16,0,11329,31,668,300,799,462,131,162,couch
14836,16,sofa,17,0,11329,28,0,297,165,494,165,197,couch
14837,17,sofa,18,0,11329,33,1,448,799,533,798,85,couch
14838,3,sofa,2,0,11330,30,529,396,941,765,412,369,couch
14839,10,table,9,0,11330,19,392,441,473,583,81,142,dining table
14840,15,chair,14,0,11330,23,41,335,232,579,191,244,chair
14841,33,sofa,29,0,11330,24,295,336,763,556,468,220,couch
14842,55,vase,56,0,11331,16,225,246,251,277,26,31,vase
14843,57,vase,58,0,11331,18,355,251,378,277,23,26,vase
14844,58,vase,59,0,11331,22,350,231,385,252,35,21,vase
14845,62,sofa,63,0,11331,127,133,371,488,649,355,278,couch
14846,75,sofa,76,0,11331,75,433,330,689,464,256,134,couch
14847,82,chair,83,1,11331,22,773,296,800,355,27,59,chair
14848,83,chair,84,1,11331,15,663,302,695,339,32,37,chair
14849,85,chair,86,1,11331,24,680,303,734,386,54,83,chair
14850,5,chair,5,0,11332,23,506,231,640,472,134,241,chair
14851,25,table,25,0,11332,16,569,269,1200,620,631,351,dining table
14852,34,pot,32,0,11332,19,19,388,76,454,57,66,potted plant
14853,35,chair,33,0,11332,61,625,282,822,589,197,307,chair
14854,36,chair,34,0,11332,46,869,314,1069,660,200,346,chair
14855,37,vase,35,0,11332,27,364,3,452,125,88,122,vase
14856,40,chair,38,1,11332,42,1031,260,1188,542,157,282,chair
14857,27,sofa,24,0,11333,25,602,429,809,571,207,142,couch
14858,28,sofa,25,1,11333,22,791,506,998,666,207,160,couch
14859,39,sofa,40,1,11334,61,211,367,436,493,225,126,couch
14860,40,sofa,41,1,11334,81,0,390,334,683,334,293,couch
14861,50,bowl,51,0,11334,33,412,431,489,467,77,36,bowl
14862,56,window,57,0,11334,84,18,171,375,401,357,230,window
14863,37,chair,38,0,11335,36,947,356,1020,474,73,118,chair
14864,38,chair,39,1,11335,17,529,379,598,424,69,45,chair
14865,39,chair,40,1,11335,18,600,384,670,433,70,49,chair
14866,40,chair,41,1,11335,24,668,386,745,483,77,97,chair
14867,41,chair,42,1,11335,27,766,391,839,461,73,70,chair
14868,53,sofa,54,0,11335,49,311,412,729,606,418,194,couch
14869,9,window,10,0,11336,26,0,61,270,391,270,330,window
14870,17,window,18,0,11336,19,343,84,428,335,85,251,window
14871,21,sofa,22,0,11336,76,397,289,787,481,390,192,couch
14872,40,bowl,41,0,11336,25,377,395,447,439,70,44,bowl
14873,44,table,45,1,11336,17,4,327,145,448,141,121,dining table
14874,45,chair,46,1,11336,19,88,298,126,380,38,82,chair
14875,46,chair,47,1,11336,25,144,302,196,426,52,124,chair
14876,47,chair,48,0,11336,33,12,309,133,469,121,160,chair
14877,30,bowl,31,0,11337,22,413,491,468,531,55,40,bowl
14878,42,vase,43,0,11337,15,592,513,626,551,34,38,vase
14879,44,sofa,45,1,11337,39,853,378,1137,724,284,346,couch
14880,46,sofa,47,0,11337,61,1,534,1050,799,1049,265,couch
14881,36,sofa,37,1,11338,41,577,352,1024,683,447,331,couch
14882,37,chair,38,1,11338,30,0,436,590,683,590,247,chair
14883,42,bowl,43,0,11338,19,554,387,593,420,39,33,bowl
14884,22,sofa,23,0,11339,59,291,810,1202,1448,911,638,couch
14885,47,vase,48,0,11339,15,2071,1115,2160,1216,89,101,vase
14886,19,window,20,0,11340,30,254,180,531,480,277,300,window
14887,25,sofa,26,0,11340,48,588,376,924,601,336,225,couch
14888,37,sofa,38,1,11340,53,273,386,567,532,294,146,couch
14889,42,vase,43,1,11340,18,381,429,403,479,22,50,vase
14890,43,vase,44,0,11340,18,390,435,424,482,34,47,vase
14891,45,bowl,46,0,11340,15,396,481,453,505,57,24,bowl
14892,46,bowl,47,0,11340,18,464,477,527,503,63,26,bowl
14893,49,vase,50,0,11340,26,574,348,597,429,23,81,vase
14894,51,television,52,0,11340,24,98,259,144,416,46,157,tv
14895,1,sofa,2,0,11341,16,218,554,583,890,365,336,couch
14896,30,window,31,0,11342,16,505,175,593,416,88,241,window
14897,31,window,32,0,11342,58,15,74,213,447,198,373,window
14898,36,flowerpot,37,0,11342,20,573,413,612,471,39,58,potted plant
14899,47,sofa,48,1,11342,118,295,450,889,741,594,291,couch
14900,0,sofa,1,0,11343,47,20,304,857,769,837,465,couch
14901,17,bowl,17,0,11343,15,41,138,204,212,163,74,bowl
14902,1,mirror,2,0,11344,15,168,36,202,95,34,59,mirror
14903,5,sofa,6,0,11344,23,1,137,120,214,119,77,couch
14904,9,sofa,10,1,11344,15,199,200,256,256,57,56,couch
14905,1,table,2,0,11345,18,35,179,166,263,131,84,dining table
14906,4,chair,5,0,11345,16,279,129,350,210,71,81,chair
14907,7,window,8,0,11345,16,223,1,350,169,127,168,window
14908,5,chair,6,0,11346,17,336,235,479,370,143,135,chair
14909,8,chair,9,0,11346,17,191,251,350,376,159,125,chair
14910,18,sofa,19,0,11347,26,50,138,251,255,201,117,couch
14911,35,table,36,0,11347,34,121,168,254,256,133,88,dining table
14912,52,window,53,0,11348,19,350,387,451,573,101,186,window
14913,63,sofa,64,1,11348,32,0,497,144,596,144,99,couch
14914,64,chair,65,1,11348,28,102,502,136,621,34,119,chair
14915,65,chair,66,1,11348,40,113,502,231,640,118,138,chair
14916,67,sofa,68,1,11348,155,163,567,768,951,605,384,couch
14917,73,bottle,74,0,11348,25,376,762,426,885,50,123,bottle
14918,74,bottle,75,0,11348,21,316,799,361,876,45,77,bottle
14919,75,bottle,76,0,11348,23,336,835,396,913,60,78,bottle
14920,2,chair,3,1,11349,24,185,113,264,161,79,48,chair
14921,9,sofa,9,0,11350,33,16,375,611,678,595,303,couch
14922,10,sofa,10,0,11350,16,0,536,525,765,525,229,couch
14923,13,table,13,0,11350,37,508,544,842,761,334,217,dining table
14924,27,vase,27,0,11350,21,859,438,920,489,61,51,vase
14925,1,sofa,2,0,11351,36,116,90,255,216,139,126,couch
14926,2,chair,3,1,11351,28,2,142,120,255,118,113,chair
14927,8,sofa,9,0,11353,32,2,86,138,179,136,93,couch
14928,21,bowl,20,0,11353,17,149,123,187,142,38,19,bowl
14929,8,table,9,0,11354,24,0,177,115,236,115,59,dining table
14930,24,sofa,24,1,11355,22,285,699,1163,899,878,200,couch
14931,25,chair,25,0,11355,36,171,349,327,547,156,198,chair
14932,26,desk,26,0,11355,21,16,380,416,576,400,196,desk
14933,27,chair,27,0,11355,29,150,430,362,743,212,313,chair
14934,28,chair,28,0,11355,32,75,472,338,836,263,364,chair
14935,36,window,37,0,11356,31,412,265,541,405,129,140,window
14936,39,window,40,0,11356,30,586,291,633,383,47,92,window
14937,42,chair,43,0,11356,47,614,359,676,465,62,106,chair
14938,43,chair,44,0,11356,87,657,362,742,502,85,140,chair
14939,46,mirror,47,1,11356,59,800,191,963,399,163,208,mirror
14940,47,vase,48,0,11356,16,746,322,766,351,20,29,vase
14941,59,sofa,60,1,11356,141,69,391,465,683,396,292,couch
14942,67,plate,68,0,11356,20,252,140,292,212,40,72,plate
14943,68,plate,69,0,11356,31,253,213,292,314,39,101,plate
14944,70,plate,71,0,11356,17,553,302,577,336,24,34,plate
14945,40,window,41,0,11357,18,1936,528,2158,876,222,348,window
14946,45,sofa,46,1,11357,18,2052,758,2199,1017,147,259,couch
14947,57,window,58,0,11357,24,345,506,876,739,531,233,window
14948,60,window,61,0,11357,32,906,534,1280,855,374,321,window
14949,87,sofa,88,1,11357,108,1,725,1200,1465,1199,740,couch
14950,9,sofa,10,0,11358,20,0,158,156,256,156,98,couch
14951,0,sofa,1,0,11359,23,704,501,1023,767,319,266,couch
14952,24,sofa,25,1,11359,16,0,534,469,767,469,233,couch
14953,36,clock,37,0,11359,16,342,153,429,256,87,103,clock
14954,0,sofa,1,0,11360,37,2,48,408,374,406,326,couch
14955,10,person,11,1,11360,31,572,52,640,378,68,326,person
14956,30,flowerpot,31,0,11361,16,564,372,591,400,27,28,potted plant
14957,40,sofa,41,0,11361,39,518,396,800,532,282,136,couch
14958,5,sofa,5,0,11362,16,123,149,254,218,131,69,couch
14959,18,table,19,0,11363,23,395,216,511,347,116,131,dining table
14960,38,plate,39,0,11363,18,197,320,256,344,59,24,plate
14961,15,window,16,0,11364,19,0,0,317,406,317,406,window
14962,20,vase,21,0,11364,19,1043,369,1105,490,62,121,vase
14963,21,vase,22,0,11364,18,980,410,1044,481,64,71,vase
14964,27,sofa,28,0,11364,59,0,392,566,771,566,379,couch
14965,6,boat,7,0,11365,16,183,13,233,49,50,36,boat
14966,23,sofa,24,1,11366,42,728,340,990,502,262,162,couch
14967,32,chair,33,1,11366,17,536,340,627,413,91,73,chair
14968,34,chair,35,1,11366,42,358,342,493,511,135,169,chair
14969,48,sofa,49,1,11366,44,1,376,522,665,521,289,couch
14970,52,table,53,1,11367,21,805,417,1088,449,283,32,dining table
14971,56,chair,57,1,11367,26,851,391,933,525,82,134,chair
14972,58,chair,59,0,11367,45,1043,387,1153,525,110,138,chair
14973,59,chair,60,1,11367,28,932,391,1022,497,90,106,chair
14974,60,sofa,61,0,11367,67,517,447,778,605,261,158,couch
14975,61,sofa,62,0,11367,47,663,484,1199,795,536,311,couch
14976,70,pot,71,0,11367,23,0,589,64,713,64,124,potted plant
14977,74,bottle,75,0,11367,18,505,556,535,605,30,49,bottle
14978,75,bottle,76,0,11367,18,481,542,505,614,24,72,bottle
14979,92,door,93,0,11367,16,931,302,991,390,60,88,door
14980,93,door,94,0,11367,17,990,300,1048,420,58,120,door
14981,2,sofa,3,0,11368,54,2,73,296,202,294,129,couch
14982,3,chair,4,0,11369,16,164,188,313,411,149,223,chair
14983,32,sofa,33,1,11370,54,588,340,800,533,212,193,couch
14984,34,sofa,35,1,11370,115,97,326,549,533,452,207,couch
14985,36,bottle,37,0,11370,35,71,300,113,413,42,113,bottle
14986,37,bottle,38,0,11370,34,176,337,227,468,51,131,bottle
14987,57,plate,58,0,11370,18,680,435,762,469,82,34,plate
14988,62,pot,63,0,11370,15,109,67,131,94,22,27,potted plant
14989,37,window,38,1,11371,22,796,246,853,386,57,140,window
14990,51,table,52,1,11371,24,669,405,745,450,76,45,dining table
14991,52,flowerpot,53,0,11371,15,618,404,680,455,62,51,potted plant
14992,55,chair,56,1,11371,20,499,396,543,455,44,59,chair
14993,57,table,58,1,11371,17,581,408,609,440,28,32,dining table
14994,65,mirror,66,0,11371,21,145,227,219,318,74,91,mirror
14995,76,sofa,77,1,11371,65,134,437,610,680,476,243,couch
14996,82,flowerpot,83,0,11371,29,547,484,610,535,63,51,potted plant
14997,91,chair,92,1,11371,16,1,442,48,560,47,118,chair
14998,11,flowerpot,12,0,11372,18,401,398,459,451,58,53,potted plant
14999,17,sofa,18,1,11372,71,505,342,847,532,342,190,couch
15000,18,pot,19,0,11372,20,651,387,709,440,58,53,potted plant
15001,25,window,26,0,11372,22,568,243,802,352,234,109,window
15002,27,window,28,1,11372,26,846,236,1022,415,176,179,window
15003,29,window,30,0,11372,44,436,259,546,375,110,116,window
15004,33,window,34,0,11372,36,288,235,419,400,131,165,window
15005,36,window,37,0,11372,46,6,177,259,382,253,205,window
15006,37,chair,38,1,11372,32,16,327,236,599,220,272,chair
15007,38,table,39,1,11372,25,4,375,271,682,267,307,dining table
15008,22,door,20,0,11373,18,450,14,582,603,132,589,door
15009,33,chair,34,1,11374,15,37,273,54,321,17,48,chair
15010,35,sofa,36,1,11374,48,98,287,299,397,201,110,couch
15011,38,sofa,39,1,11374,35,1,307,357,533,356,226,couch
15012,16,table,17,0,11375,15,162,121,240,173,78,52,dining table
15013,41,table,42,1,11376,17,109,304,257,343,148,39,dining table
15014,42,chair,43,1,11376,24,250,284,297,343,47,59,chair
15015,45,window,46,0,11376,27,5,179,121,335,116,156,window
15016,62,sofa,63,0,11376,68,367,295,717,533,350,238,couch
15017,10,sofa,11,0,11377,24,0,1018,993,1681,993,663,couch
15018,12,vase,13,0,11377,39,349,805,411,920,62,115,vase
15019,23,vase,24,0,11377,38,602,879,662,955,60,76,vase
15020,26,plate,27,0,11377,24,615,977,677,1033,62,56,plate
15021,33,plate,34,0,11377,19,680,805,736,855,56,50,plate
15022,36,pot,37,0,11377,19,610,833,641,847,31,14,potted plant
15023,31,door,32,1,11378,17,251,375,310,575,59,200,door
15024,32,window,33,0,11378,38,0,337,250,586,250,249,window
15025,33,chair,34,1,11378,21,164,525,263,566,99,41,chair
15026,34,chair,35,1,11378,36,378,496,493,617,115,121,chair
15027,35,sofa,36,0,11378,87,6,549,504,872,498,323,couch
15028,60,clock,61,0,11378,51,673,386,732,446,59,60,clock
15029,67,flowerpot,68,0,11378,16,894,633,955,692,61,59,potted plant
15030,69,vase,70,0,11378,20,824,420,852,464,28,44,vase
15031,72,table,72,1,11379,32,1134,456,1380,537,246,81,dining table
15032,73,chair,73,1,11379,25,1139,429,1197,514,58,85,chair
15033,74,chair,74,1,11379,27,1257,437,1347,513,90,76,chair
15034,75,chair,75,1,11379,27,1183,436,1306,532,123,96,chair
15035,76,chair,76,1,11379,35,1307,442,1425,540,118,98,chair
15036,101,sofa,101,0,11379,84,500,464,835,686,335,222,couch
15037,105,sofa,105,0,11379,101,854,469,1499,884,645,415,couch
15038,38,window,39,0,11380,21,512,179,646,340,134,161,window
15039,39,window,40,0,11380,16,426,180,516,339,90,159,window
15040,40,chair,41,1,11380,19,481,320,508,344,27,24,chair
15041,46,table,47,1,11380,43,404,349,628,417,224,68,dining table
15042,62,sofa,63,1,11380,59,335,370,613,530,278,160,couch
15043,71,sofa,72,0,11380,53,570,419,861,733,291,314,couch
15044,1,table,2,0,11381,23,203,557,305,745,102,188,dining table
15045,26,chair,27,1,11382,22,654,424,799,599,145,175,chair
15046,27,sofa,28,1,11382,58,299,352,777,519,478,167,couch
15047,29,chair,30,1,11382,17,531,535,779,768,248,233,chair
15048,30,table,31,1,11382,29,618,539,1024,767,406,228,dining table
15049,15,window,16,0,11383,40,492,360,702,854,210,494,window
15050,32,sofa,33,1,11383,15,2,1171,317,1460,315,289,couch
15051,32,sofa,32,1,11384,81,1159,640,1854,1024,695,384,couch
15052,12,chair,13,1,11385,18,121,349,205,479,84,130,chair
15053,13,chair,14,1,11385,28,170,355,255,577,85,222,chair
15054,14,chair,15,1,11385,35,101,386,208,605,107,219,chair
15055,15,table,16,1,11385,16,107,399,249,609,142,210,dining table
15056,19,sofa,20,0,11385,36,511,421,1023,724,512,303,couch
15057,9,chair,10,1,11386,15,212,291,355,430,143,139,chair
15058,10,chair,11,1,11386,56,121,336,454,840,333,504,chair
15059,11,chair,12,1,11386,18,26,560,130,752,104,192,chair
15060,13,table,14,1,11386,28,22,392,466,838,444,446,dining table
15061,15,window,16,0,11386,47,787,68,988,256,201,188,window
15062,18,sofa,19,1,11386,45,758,244,1060,417,302,173,couch
15063,20,sofa,21,1,11386,46,425,258,756,436,331,178,couch
15064,9,window,10,0,11387,45,1465,63,2200,553,735,490,window
15065,10,window,11,0,11387,54,1091,1,1475,777,384,776,window
15066,11,window,12,0,11387,16,504,1,1027,535,523,534,window
15067,13,window,14,0,11387,27,3,3,533,1054,530,1051,window
15068,14,sofa,15,0,11387,54,310,504,1090,1028,780,524,couch
15069,20,chair,21,1,11387,33,1381,440,1508,828,127,388,chair
15070,24,chair,25,1,11387,34,1512,559,1709,852,197,293,chair
15071,25,chair,26,1,11387,21,1711,566,1872,735,161,169,chair
15072,27,table,28,1,11387,52,1405,528,2197,854,792,326,dining table
15073,28,sofa,29,0,11387,47,838,615,2051,1650,1213,1035,couch
15074,15,door,16,1,11388,26,1,75,261,832,260,757,door
15075,25,sofa,25,1,11388,50,1189,556,2199,1466,1010,910,couch
15076,14,sofa,15,0,11389,37,615,1039,1772,1646,1157,607,couch
15077,18,vase,19,0,11390,23,1490,553,1612,725,122,172,vase
15078,19,vase,20,0,11390,19,1283,487,1412,726,129,239,vase
15079,20,vase,21,0,11390,20,1112,367,1217,726,105,359,vase
15080,22,table,23,1,11390,38,999,697,1732,746,733,49,dining table
15081,23,sofa,24,1,11390,94,413,732,2199,1443,1786,711,couch
15082,36,bowl,37,0,11390,26,1394,1174,1755,1401,361,227,bowl
15083,29,door,30,1,11391,26,1651,474,1816,1022,165,548,door
15084,30,window,31,0,11391,16,1494,477,1663,846,169,369,window
15085,36,chair,37,1,11391,21,1513,791,1653,1027,140,236,chair
15086,37,table,38,1,11391,16,1491,843,1651,1027,160,184,dining table
15087,42,chair,43,1,11391,15,84,1274,438,1650,354,376,chair
15088,48,vase,49,0,11391,29,965,1143,1106,1345,141,202,vase
15089,51,bowl,52,0,11391,19,1108,1192,1235,1358,127,166,bowl
15090,64,table,65,1,11391,29,1936,993,2198,1342,262,349,dining table
15091,17,door,18,0,11392,27,777,64,1099,500,322,436,door
15092,18,sofa,19,1,11392,55,263,349,676,633,413,284,couch
15093,22,chair,23,1,11392,24,46,423,238,520,192,97,chair
15094,23,table,24,1,11392,21,0,517,314,732,314,215,dining table
15095,29,plate,30,1,11392,30,87,556,278,626,191,70,plate
15096,32,fork,33,0,11392,17,69,631,227,653,158,22,fork
15097,33,chair,34,1,11392,35,177,451,445,733,268,282,chair
15098,7,window,8,0,11393,44,1,490,1459,1086,1458,596,window
15099,8,chair,9,0,11393,29,291,904,527,1134,236,230,chair
15100,9,chair,10,0,11393,40,528,903,782,1126,254,223,chair
15101,10,vase,11,0,11393,32,554,975,672,1204,118,229,vase
15102,17,sofa,18,0,11393,23,1,950,1059,1466,1058,516,couch
15103,13,window,14,0,11394,57,113,202,550,633,437,431,window
15104,25,sofa,26,1,11394,36,530,549,761,666,231,117,couch
15105,28,flowerpot,28,0,11394,19,448,563,513,608,65,45,potted plant
15106,12,vase,13,0,11395,17,1,385,130,639,129,254,vase
15107,14,chair,15,1,11395,19,1207,551,1468,958,261,407,chair
15108,16,sofa,17,0,11395,58,266,469,985,837,719,368,couch
15109,34,sofa,34,0,11397,67,1012,589,2069,1323,1057,734,couch
15110,58,sofa,58,1,11397,124,1,825,1218,1650,1217,825,couch
15111,13,sofa,14,0,11398,76,156,506,766,957,610,451,couch
15112,20,window,21,0,11398,23,926,235,1119,559,193,324,window
15113,14,window,15,0,11399,19,993,215,1155,273,162,58,window
15114,17,window,18,0,11399,28,1058,303,1142,509,84,206,window
15115,20,door,21,1,11399,63,932,300,1062,634,130,334,door
15116,21,person,22,0,11399,53,938,325,1050,674,112,349,person
15117,33,chair,34,0,11399,62,154,488,429,752,275,264,chair
15118,36,flowerpot,37,0,11399,18,227,634,289,680,62,46,potted plant
15119,49,bottle,50,1,11399,18,746,11,803,94,57,83,bottle
15120,52,chair,53,0,11399,23,800,561,950,698,150,137,chair
15121,53,chair,54,1,11399,21,306,870,907,960,601,90,chair
15122,15,sofa,16,0,11400,35,337,897,1495,1470,1158,573,couch
15123,9,table,10,0,11401,22,1093,937,1515,1297,422,360,dining table
15124,10,sofa,11,1,11401,18,1474,733,2046,1466,572,733,couch
15125,12,bowl,13,0,11401,17,1904,913,2044,1066,140,153,bowl
15126,13,chair,14,0,11401,22,1383,736,1727,1131,344,395,chair
15127,14,chair,15,0,11401,41,752,814,1305,1485,553,671,chair
15128,15,sofa,16,1,11401,17,0,738,695,1233,695,495,couch
15129,86,chair,83,1,11401,35,31,836,409,1532,378,696,chair
15130,46,window,47,0,11402,19,1183,290,1382,785,199,495,window
15131,48,window,49,0,11402,31,486,99,886,877,400,778,window
15132,49,window,50,0,11402,29,1,1,520,1017,519,1016,window
15133,54,sofa,55,0,11402,69,652,760,1446,1256,794,496,couch
15134,66,bowl,67,0,11402,21,1421,973,1693,1085,272,112,bowl
15135,24,chair,25,1,11403,41,1151,755,1431,1172,280,417,chair
15136,26,vase,27,0,11403,33,1479,682,1543,839,64,157,vase
15137,31,bowl,32,0,11403,26,1457,1040,1695,1138,238,98,bowl
15138,33,window,34,0,11403,25,360,318,896,834,536,516,window
15139,41,sofa,42,0,11403,47,438,762,1039,1184,601,422,couch
15140,62,clock,62,0,11403,20,1499,230,1674,490,175,260,clock
15141,51,sofa,52,1,11404,33,0,622,612,959,612,337,couch
15142,60,sofa,61,1,11404,69,660,612,1128,959,468,347,couch
15143,72,chair,73,0,11404,42,800,515,874,668,74,153,chair
15144,75,vase,76,0,11404,37,593,709,654,921,61,212,vase
15145,76,vase,77,0,11404,34,661,698,720,911,59,213,vase
15146,78,bowl,79,0,11404,22,546,651,598,703,52,52,bowl
15147,82,vase,83,0,11404,25,779,719,903,911,124,192,vase
15148,83,chair,84,1,11404,24,1202,544,1278,712,76,168,chair
15149,8,window,9,0,11405,17,409,327,869,808,460,481,window
15150,9,window,10,0,11405,27,869,322,1325,815,456,493,window
15151,17,sofa,18,0,11405,67,1288,822,1982,1452,694,630,couch
15152,22,sofa,23,1,11405,53,383,737,1318,1150,935,413,couch
15153,30,vase,31,0,11406,16,106,465,153,598,47,133,vase
15154,34,sofa,35,0,11406,24,903,450,1199,798,296,348,couch
15155,0,sofa,1,0,11408,31,713,457,1798,1198,1085,741,couch
15156,16,table,17,0,11408,17,684,688,1152,883,468,195,dining table
15157,17,vase,18,0,11408,15,961,457,1030,694,69,237,vase
15158,22,window,23,1,11409,27,1991,231,2199,794,208,563,window
15159,23,chair,24,1,11409,23,2153,649,2199,800,46,151,chair
15160,24,chair,25,1,11409,51,1685,657,1828,826,143,169,chair
15161,25,chair,26,1,11409,26,2036,1055,2199,1359,163,304,chair
15162,26,chair,27,0,11409,159,1609,714,2154,1466,545,752,chair
15163,27,table,28,1,11409,38,1539,780,2199,1119,660,339,dining table
15164,38,sofa,39,1,11409,115,30,681,591,1117,561,436,couch
15165,40,flowerpot,41,0,11409,19,52,1300,280,1466,228,166,potted plant
15166,19,window,20,1,11410,51,137,325,236,550,99,225,window
15167,23,sofa,24,1,11410,42,308,511,565,638,257,127,couch
15168,32,plate,33,0,11410,16,735,321,793,378,58,57,plate
15169,33,pot,34,0,11410,17,829,334,866,377,37,43,potted plant
15170,35,chair,36,1,11410,15,973,549,1024,703,51,154,chair
15171,36,chair,37,1,11410,23,881,573,1023,767,142,194,chair
15172,31,window,32,0,11411,25,447,227,557,531,110,304,window
15173,32,window,33,0,11411,21,593,217,685,534,92,317,window
15174,33,window,34,0,11411,15,897,158,1002,534,105,376,window
15175,34,window,35,0,11411,22,34,206,187,569,153,363,window
15176,42,sofa,43,0,11411,71,116,489,566,768,450,279,couch
15177,46,vase,47,0,11411,17,578,492,620,563,42,71,vase
15178,29,door,30,0,11412,31,1068,204,1437,850,369,646,door
15179,31,chair,32,1,11412,33,1437,550,1655,795,218,245,chair
15180,42,vase,43,0,11412,38,1896,650,1996,798,100,148,vase
15181,44,table,45,1,11412,19,1869,947,2047,1424,178,477,dining table
15182,45,chair,46,0,11412,79,1205,650,1699,1071,494,421,chair
15183,46,chair,47,0,11412,50,893,667,1105,958,212,291,chair
15184,55,vase,56,0,11412,17,172,371,270,485,98,114,vase
15185,8,chair,9,1,11413,25,1378,1075,1716,1288,338,213,chair
15186,12,flowerpot,13,1,11413,16,1187,1333,1340,1466,153,133,potted plant
15187,14,window,15,0,11413,70,1384,387,2063,1212,679,825,window
15188,23,sofa,24,0,11413,73,2,1093,849,1650,847,557,couch
15189,12,table,13,0,11414,18,1358,998,2138,1455,780,457,dining table
15190,13,bowl,14,0,11414,15,1849,880,2076,1125,227,245,bowl
15191,16,sofa,15,0,11414,17,1189,769,1501,1107,312,338,couch
15192,34,chair,32,1,11414,35,1075,943,1776,1461,701,518,chair
15193,37,chair,35,1,11414,40,1344,813,1736,1357,392,544,chair
15194,42,chair,40,1,11414,20,1589,799,1820,1022,231,223,chair
15195,44,flowerpot,42,0,11414,16,944,878,1034,960,90,82,potted plant
15196,29,table,30,1,11415,25,620,305,827,347,207,42,dining table
15197,30,bowl,31,0,11415,17,659,305,726,323,67,18,bowl
15198,36,door,37,0,11415,16,882,36,985,371,103,335,door
15199,42,sofa,43,0,11415,75,250,300,947,656,697,356,couch
15200,35,sofa,36,1,11416,57,192,726,893,1166,701,440,couch
15201,37,sofa,38,0,11416,55,341,903,1415,1472,1074,569,couch
15202,45,sofa,46,0,11417,29,1,911,1035,1650,1034,739,couch
15203,50,sofa,51,0,11418,98,487,455,909,635,422,180,couch
15204,69,bowl,70,0,11418,26,551,572,611,626,60,54,bowl
15205,75,sofa,76,0,11418,87,10,467,474,775,464,308,couch
15206,92,vase,93,0,11418,22,9,538,51,621,42,83,vase
15207,93,pot,94,0,11418,24,84,583,124,626,40,43,potted plant
15208,96,vase,97,0,11418,30,447,401,467,489,20,88,vase
15209,97,vase,98,0,11418,34,467,401,488,487,21,86,vase
15210,104,door,105,0,11418,20,956,284,1019,493,63,209,door
15211,114,vase,115,0,11418,21,1122,336,1159,397,37,61,vase
15212,115,vase,116,0,11418,25,1226,328,1279,418,53,90,vase
15213,1,sofa,2,1,11419,25,0,963,1021,1647,1021,684,couch
15214,10,person,10,0,11419,16,0,231,237,1015,237,784,person
15215,11,television,12,0,11420,16,1066,56,1486,384,420,328,tv
15216,14,vase,15,0,11420,17,762,205,860,405,98,200,vase
15217,24,ball,25,0,11420,15,792,1078,893,1176,101,98,sports ball
15218,25,ball,26,0,11420,16,712,1068,809,1124,97,56,sports ball
15219,27,ball,28,0,11420,15,617,1055,717,1159,100,104,sports ball
15220,28,sofa,29,0,11420,40,2,700,704,1438,702,738,couch
15221,30,sofa,31,0,11420,35,1115,841,2198,1650,1083,809,couch
15222,36,sofa,37,1,11421,49,671,319,981,474,310,155,couch
15223,44,chair,45,1,11421,32,960,536,1199,799,239,263,chair
15224,18,chair,19,1,11422,20,587,648,708,859,121,211,chair
15225,20,sofa,21,1,11422,19,38,542,274,716,236,174,couch
15226,27,vase,28,0,11422,18,1196,968,1313,1121,117,153,vase
15227,32,bowl,33,0,11422,16,1128,1115,1300,1188,172,73,bowl
15228,18,door,19,0,11423,24,831,174,1241,966,410,792,door
15229,20,door,21,0,11423,32,145,202,703,1027,558,825,door
15230,24,sofa,25,1,11423,97,2,876,634,1306,632,430,couch
15231,31,bowl,32,0,11423,15,997,884,1128,966,131,82,bowl
15232,29,sofa,30,1,11424,61,687,575,1068,863,381,288,couch
15233,30,chair,31,1,11424,40,883,618,1125,844,242,226,chair
15234,31,chair,32,1,11424,26,858,722,1041,862,183,140,chair
15235,32,table,33,1,11424,23,944,649,1152,864,208,215,dining table
15236,18,window,19,0,11425,21,373,10,465,423,92,413,window
15237,19,sofa,20,0,11425,97,164,413,603,861,439,448,couch
15238,21,door,22,1,11426,17,373,637,604,1123,231,486,door
15239,32,flowerpot,33,0,11426,22,1115,781,1201,843,86,62,potted plant
15240,38,sofa,39,1,11426,57,184,1024,790,1251,606,227,couch
15241,39,sofa,40,0,11426,68,290,1160,1573,1650,1283,490,couch
15242,19,window,20,0,11427,18,100,163,185,463,85,300,window
15243,22,window,23,0,11427,15,646,190,814,433,168,243,window
15244,23,window,24,0,11427,106,396,172,649,451,253,279,window
15245,24,window,25,0,11427,35,231,194,398,433,167,239,window
15246,31,sofa,32,0,11427,61,24,406,330,671,306,265,couch
15247,32,sofa,33,0,11427,55,419,380,634,501,215,121,couch
15248,36,bowl,37,0,11427,15,492,513,548,541,56,28,bowl
15249,55,bowl,56,0,11427,17,789,461,852,481,63,20,bowl
15250,62,chair,63,1,11427,18,211,599,487,696,276,97,chair
15251,63,chair,64,1,11427,19,536,596,798,695,262,99,chair
15252,69,table,70,1,11427,58,56,689,1015,768,959,79,dining table
15253,15,window,16,0,11429,74,1340,238,1658,694,318,456,window
15254,16,window,17,0,11429,22,1846,236,2158,784,312,548,window
15255,17,sofa,18,0,11429,35,1533,691,2157,1240,624,549,couch
15256,18,sofa,19,0,11429,52,272,689,1292,1306,1020,617,couch
15257,33,flowerpot,34,0,11429,16,1279,824,1399,961,120,137,potted plant
15258,38,sofa,39,1,11429,33,3,1078,1509,1438,1506,360,couch
15259,64,mirror,65,0,11430,15,201,149,394,496,193,347,mirror
15260,74,flowerpot,75,0,11430,15,646,615,700,659,54,44,potted plant
15261,78,window,79,1,11430,28,716,416,799,610,83,194,window
15262,50,chair,51,0,11431,16,706,411,781,514,75,103,chair
15263,52,sofa,53,0,11431,39,420,449,743,653,323,204,couch
15264,60,clock,61,0,11431,18,374,178,446,256,72,78,clock
15265,12,clock,13,0,11432,15,191,10,440,241,249,231,clock
15266,13,sofa,14,0,11432,52,1126,637,2096,1204,970,567,couch
15267,14,sofa,15,0,11432,35,622,955,2199,1648,1577,693,couch
15268,13,table,14,1,11433,25,770,517,1008,638,238,121,dining table
15269,17,sofa,18,1,11433,58,874,501,1243,813,369,312,couch
15270,23,sofa,24,0,11433,76,326,483,920,828,594,345,couch
15271,24,chair,25,1,11433,36,612,564,847,829,235,265,chair
15272,0,person,1,0,11434,33,1589,713,1776,1402,187,689,person
15273,9,table,9,0,11434,21,1475,956,1944,1337,469,381,dining table
15274,14,sofa,14,0,11434,15,731,590,1226,839,495,249,couch
15275,43,chair,42,1,11434,18,725,518,796,582,71,64,chair
15276,44,chair,43,1,11434,15,854,516,921,581,67,65,chair
15277,46,chair,45,1,11434,15,1046,523,1125,589,79,66,chair
15278,47,chair,46,1,11434,15,901,523,983,591,82,68,chair
15279,48,chair,47,1,11434,36,725,528,830,738,105,210,chair
15280,49,table,48,1,11434,51,667,578,1168,744,501,166,dining table
15281,50,chair,49,1,11434,16,1165,520,1224,658,59,138,chair
15282,70,chair,68,0,11434,57,1716,1109,1984,1466,268,357,chair
15283,73,bowl,71,0,11434,15,1548,928,1617,979,69,51,bowl
15284,80,vase,78,0,11434,55,201,669,350,861,149,192,vase
15285,25,window,26,0,11435,52,362,82,848,561,486,479,window
15286,27,sofa,28,0,11435,34,409,428,961,872,552,444,couch
15287,20,window,21,0,11436,16,92,295,282,855,190,560,window
15288,35,vase,36,1,11436,21,1859,744,1939,877,80,133,vase
15289,36,vase,37,0,11436,20,1830,761,1902,895,72,134,vase
15290,37,vase,38,0,11436,21,1926,758,2001,898,75,140,vase
15291,38,vase,39,0,11436,22,2018,701,2136,927,118,226,vase
15292,48,sofa,49,0,11436,65,139,747,983,1149,844,402,couch
15293,60,vase,61,0,11437,16,1264,675,1305,728,41,53,vase
15294,84,chair,85,1,11437,22,91,1202,810,1649,719,447,chair
15295,86,chair,87,1,11437,24,53,1025,244,1299,191,274,chair
15296,90,plate,91,0,11437,20,1183,1552,1400,1645,217,93,plate
15297,24,sofa,25,0,11439,45,195,341,576,594,381,253,couch
15298,49,window,50,0,11439,20,3,1,74,525,71,524,window
15299,32,sofa,33,0,11440,108,2,944,2197,1649,2195,705,couch
15300,49,dog,50,0,11440,39,222,1262,541,1401,319,139,dog
15301,60,chair,61,1,11440,17,990,1508,1621,1648,631,140,chair
15302,61,vase,62,0,11440,32,2,1329,187,1648,185,319,vase
15303,7,window,8,0,11441,28,1297,2,2199,579,902,577,window
15304,11,sofa,12,0,11441,43,1331,487,2198,1135,867,648,couch
15305,20,sofa,21,1,11441,60,186,478,1350,1139,1164,661,couch
15306,22,sofa,23,1,11442,31,634,387,734,429,100,42,couch
15307,30,chair,30,1,11442,28,337,305,476,387,139,82,chair
15308,31,sofa,31,1,11442,28,186,332,439,435,253,103,couch
15309,35,chair,35,1,11442,80,142,430,376,734,234,304,chair
15310,38,window,38,0,11442,32,804,74,913,398,109,324,window
15311,40,chair,40,1,11442,32,881,424,1024,757,143,333,chair
15312,41,sofa,41,1,11442,54,811,389,1024,674,213,285,couch
15313,45,table,45,1,11442,32,187,714,994,768,807,54,dining table
15314,30,window,31,0,11443,43,117,391,323,592,206,201,window
15315,35,chair,36,1,11443,42,290,502,348,653,58,151,chair
15316,36,chair,37,1,11443,18,126,586,191,607,65,21,chair
15317,37,chair,38,1,11443,33,90,503,192,680,102,177,chair
15318,38,chair,39,0,11443,60,192,502,300,692,108,190,chair
15319,39,table,40,1,11443,59,130,546,341,690,211,144,dining table
15320,68,sofa,69,0,11443,57,652,536,905,700,253,164,couch
15321,13,sofa,14,0,11444,42,433,425,865,760,432,335,couch
15322,19,vase,20,0,11444,20,341,488,385,580,44,92,vase
15323,28,window,29,0,11444,32,901,86,1091,579,190,493,window
15324,10,sofa,11,0,11445,71,41,493,592,753,551,260,couch
15325,11,sofa,12,0,11445,38,502,534,800,964,298,430,couch
15326,35,chair,36,0,11446,57,299,736,474,1020,175,284,chair
15327,36,chair,37,0,11446,38,477,733,644,944,167,211,chair
15328,37,chair,38,1,11446,38,602,724,733,941,131,217,chair
15329,38,chair,39,1,11446,46,680,716,794,944,114,228,chair
15330,63,flowerpot,64,0,11446,31,1725,1193,1892,1366,167,173,potted plant
15331,65,sofa,66,0,11446,101,451,926,1396,1450,945,524,couch
15332,74,chair,75,1,11446,45,747,1362,1279,1535,532,173,chair
15333,76,bowl,77,0,11446,24,1341,813,1403,874,62,61,bowl
15334,19,sofa,20,1,11447,69,899,931,2047,1536,1148,605,couch
15335,21,sofa,22,0,11447,98,29,704,757,1536,728,832,couch
15336,31,vase,32,0,11447,16,977,387,1014,462,37,75,vase
15337,26,vase,27,0,11448,17,703,322,728,369,25,47,vase
15338,28,flowerpot,29,0,11448,16,428,471,467,513,39,42,potted plant
15339,31,sofa,32,0,11448,79,4,420,390,856,386,436,couch
15340,36,chair,37,1,11448,48,1070,549,1207,752,137,203,chair
15341,53,sofa,54,1,11449,42,10,401,240,675,230,274,couch
15342,58,sofa,59,1,11449,91,326,481,880,768,554,287,couch
15343,59,chair,60,1,11449,19,669,499,857,714,188,215,chair
15344,11,sofa,12,1,11450,25,1,401,1057,1467,1056,1066,couch
15345,21,table,22,0,11450,47,1372,353,2131,904,759,551,dining table
15346,9,sofa,10,0,11451,49,698,691,2047,1534,1349,843,couch
15347,33,door,34,0,11451,30,2,82,486,1161,484,1079,door
15348,10,window,11,1,11452,15,151,125,179,290,28,165,window
15349,13,door,14,0,11452,90,336,120,1006,491,670,371,door
15350,19,chair,20,1,11452,19,121,270,178,320,57,50,chair
15351,20,chair,21,1,11452,22,13,273,99,334,86,61,chair
15352,21,table,22,1,11452,25,101,307,264,365,163,58,dining table
15353,24,chair,25,1,11452,23,138,291,229,361,91,70,chair
15354,25,chair,26,1,11452,22,259,281,335,354,76,73,chair
15355,26,chair,27,0,11452,25,269,269,345,347,76,78,chair
15356,28,sofa,29,0,11452,90,81,338,525,521,444,183,couch
15357,34,sofa,35,0,11452,87,95,440,658,768,563,328,couch
15358,11,window,12,0,11453,29,693,372,1507,1009,814,637,window
15359,12,vase,13,0,11453,21,1100,859,1190,987,90,128,vase
15360,24,mirror,25,0,11453,24,210,405,270,909,60,504,mirror
15361,28,sofa,29,0,11453,52,695,968,1795,1552,1100,584,couch
15362,19,sofa,20,1,11454,105,55,823,1148,1648,1093,825,couch
15363,27,bowl,28,0,11454,43,454,1341,810,1650,356,309,bowl
15364,27,window,28,0,11455,42,1744,113,1964,676,220,563,window
15365,30,sofa,31,0,11455,49,209,664,871,1455,662,791,couch
15366,42,door,43,0,11455,20,413,200,985,980,572,780,door
15367,43,door,44,0,11455,19,1028,200,1564,975,536,775,door
15368,2,table,3,0,11456,41,1069,999,1874,1470,805,471,dining table
15369,26,vase,25,0,11456,22,1205,911,1372,1143,167,232,vase
15370,23,sofa,24,0,11457,83,468,762,1416,1242,948,480,couch
15371,45,chair,46,1,11457,34,1,1096,148,1464,147,368,chair
15372,11,sofa,12,0,11458,48,667,796,1778,1481,1111,685,couch
15373,27,sofa,28,0,11459,34,708,1013,1617,1364,909,351,couch
15374,8,sofa,9,0,11460,66,42,762,1300,1286,1258,524,couch
15375,16,television,17,0,11460,26,1531,569,1835,863,304,294,tv
15376,20,chair,21,1,11460,15,1661,914,1977,1171,316,257,chair
15377,21,chair,22,1,11460,17,1393,1119,1783,1536,390,417,chair
15378,22,table,23,1,11460,24,1356,1133,2046,1536,690,403,dining table
15379,9,window,10,0,11461,85,80,263,1358,1097,1278,834,window
15380,14,window,15,0,11461,42,1912,317,2199,1149,287,832,window
15381,20,sofa,21,1,11461,75,317,829,1072,1272,755,443,couch
15382,26,flowerpot,27,0,11461,23,1122,1061,1275,1105,153,44,potted plant
15383,31,sofa,32,0,11461,93,1318,921,2174,1648,856,727,couch
15384,36,chair,37,1,11461,28,2012,1218,2199,1648,187,430,chair
15385,37,chair,38,1,11461,23,1757,1479,2114,1649,357,170,chair
15386,45,vase,46,0,11461,21,1475,358,1525,439,50,81,vase
15387,20,chair,21,0,11462,66,254,778,678,1307,424,529,chair
15388,25,sofa,26,0,11462,44,1261,865,1996,1524,735,659,couch
15389,19,door,20,0,11463,18,520,239,548,597,28,358,door
15390,25,desk,26,1,11463,42,314,342,526,618,212,276,desk
15391,29,sofa,30,0,11463,44,66,501,415,767,349,266,couch
15392,43,window,44,0,11463,55,2,1,87,623,85,622,window
15393,30,sofa,31,0,11464,51,1,1012,1431,1649,1430,637,couch
15394,35,bench,36,1,11464,97,1703,804,2199,1438,496,634,bench
15395,36,window,37,0,11464,79,1557,366,2197,895,640,529,window
15396,38,flowerpot,39,0,11464,18,1365,434,1432,497,67,63,potted plant
15397,29,chair,30,1,11465,31,896,352,951,402,55,50,chair
15398,30,chair,31,0,11465,37,895,360,963,453,68,93,chair
15399,31,chair,32,0,11465,33,817,360,876,453,59,93,chair
15400,32,chair,33,1,11465,23,821,353,874,399,53,46,chair
15401,33,table,34,1,11465,46,801,358,943,453,142,95,dining table
15402,39,sofa,40,0,11465,33,356,389,682,571,326,182,couch
15403,43,door,44,0,11465,27,66,66,257,575,191,509,door
15404,44,chair,45,1,11465,55,25,492,186,667,161,175,chair
15405,10,window,11,0,11466,34,721,92,830,457,109,365,window
15406,12,window,13,0,11466,22,1004,36,1036,591,32,555,window
15407,21,sofa,22,0,11466,29,0,425,446,722,446,297,couch
15408,29,window,30,0,11466,57,386,122,574,612,188,490,window
15409,49,sofa,49,0,11467,59,622,314,857,471,235,157,couch
15410,55,chair,55,1,11467,22,1,323,123,406,122,83,chair
15411,56,chair,56,1,11467,21,1,473,138,625,137,152,chair
15412,57,chair,57,0,11467,75,141,369,365,678,224,309,chair
15413,71,chair,71,1,11467,47,299,322,374,545,75,223,chair
15414,72,table,72,1,11467,26,0,378,234,667,234,289,dining table
15415,0,chair,1,0,11468,15,1128,683,1258,941,130,258,chair
15416,46,chair,45,1,11468,17,705,747,769,788,64,41,chair
15417,47,chair,46,0,11468,34,701,777,862,978,161,201,chair
15418,24,clock,24,0,11469,16,131,95,213,298,82,203,clock
15419,35,table,35,0,11469,16,490,337,586,442,96,105,dining table
15420,38,person,38,0,11469,19,0,168,91,448,91,280,person
15421,46,sofa,46,1,11469,43,283,281,530,421,247,140,couch
15422,17,sofa,18,0,11470,47,586,379,1023,768,437,389,couch
15423,14,table,13,1,11471,18,72,1070,1468,1651,1396,581,dining table
15424,15,chair,14,0,11471,15,1098,1086,1515,1650,417,564,chair
15425,20,sofa,19,0,11471,17,1878,896,2194,1483,316,587,couch
15426,42,chair,41,1,11471,18,91,963,305,1111,214,148,chair
15427,86,chair,84,1,11471,27,44,1045,447,1651,403,606,chair
15428,99,chair,96,0,11471,26,383,1084,935,1646,552,562,chair
15429,3,table,4,0,11472,20,1014,608,1152,793,138,185,dining table
15430,16,sofa,13,0,11472,20,149,504,534,670,385,166,couch
15431,28,chair,29,1,11473,26,1236,473,1312,733,76,260,chair
15432,30,window,31,0,11473,102,858,197,1403,548,545,351,window
15433,37,sofa,38,0,11473,62,111,483,618,723,507,240,couch
15434,23,sofa,24,1,11474,45,882,483,1279,647,397,164,couch
15435,24,sofa,25,0,11474,27,898,519,1280,960,382,441,couch
15436,30,chair,31,1,11474,19,1,703,165,920,164,217,chair
15437,31,chair,32,1,11474,23,286,484,438,579,152,95,chair
15438,33,sofa,34,1,11474,25,119,489,297,612,178,123,couch
15439,35,chair,36,0,11474,36,441,523,682,930,241,407,chair
15440,39,table,40,1,11474,33,108,594,516,691,408,97,dining table
15441,40,chair,41,0,11474,51,186,560,446,960,260,400,chair
15442,18,sofa,19,1,11475,155,119,367,892,746,773,379,couch
15443,20,flowerpot,21,1,11475,16,803,560,923,637,120,77,potted plant
15444,30,mirror,31,0,11475,165,237,18,643,385,406,367,mirror
15445,31,sofa,32,1,11475,24,342,704,1022,768,680,64,couch
15446,11,chair,12,0,11476,30,737,250,905,450,168,200,chair
15447,13,sofa,14,0,11476,70,192,315,763,723,571,408,couch
15448,8,sofa,9,0,11477,80,212,303,746,555,534,252,couch
15449,13,door,14,0,11477,21,939,67,1023,511,84,444,door
15450,20,table,21,1,11477,21,824,511,1023,690,199,179,dining table
15451,21,chair,22,1,11477,59,734,406,883,768,149,362,chair
15452,22,chair,23,1,11477,22,771,591,1023,768,252,177,chair
15453,23,hat,24,0,11477,23,4,436,111,492,107,56,hat
15454,22,sofa,23,1,11478,61,447,711,1138,1007,691,296,couch
15455,23,sofa,24,0,11478,64,65,766,871,1518,806,752,couch
15456,1,sofa,1,0,11479,61,0,416,1835,1301,1835,885,couch
15457,10,table,8,0,11479,17,1667,366,1797,496,130,130,dining table
15458,56,chair,54,1,11479,22,417,204,579,447,162,243,chair
15459,57,chair,55,1,11479,24,246,201,443,466,197,265,chair
15460,58,chair,56,1,11479,21,5,168,91,453,86,285,chair
15461,71,chair,69,0,11479,58,1869,371,2055,697,186,326,chair
15462,72,chair,70,1,11479,33,2025,411,2199,742,174,331,chair
15463,85,sofa,83,1,11479,37,761,634,2198,1645,1437,1011,couch
15464,32,table,33,0,11480,40,811,414,1011,584,200,170,dining table
15465,33,mirror,34,0,11480,32,876,252,987,431,111,179,mirror
15466,39,sofa,40,1,11480,55,52,432,253,606,201,174,couch
15467,48,vase,49,0,11480,16,861,377,888,426,27,49,vase
15468,27,mirror,28,0,11481,24,1771,587,1913,983,142,396,mirror
15469,29,door,30,1,11481,45,1987,373,2199,1093,212,720,door
15470,30,door,31,1,11481,52,1332,432,1536,930,204,498,door
15471,31,door,32,1,11481,16,1532,425,1769,1130,237,705,door
15472,37,desk,38,1,11481,34,1253,928,1756,1267,503,339,desk
15473,52,sofa,53,0,11481,84,1,908,1764,1476,1763,568,couch
15474,27,chair,28,0,11482,38,1092,649,1313,971,221,322,chair
15475,37,sofa,38,0,11482,50,267,654,1052,1001,785,347,couch
15476,55,table,56,1,11483,25,606,504,745,564,139,60,dining table
15477,56,television,57,0,11483,18,387,478,475,639,88,161,tv
15478,58,chair,59,1,11483,24,700,483,780,544,80,61,chair
15479,59,sofa,60,1,11483,51,582,520,846,644,264,124,couch
15480,65,bowl,66,0,11483,25,676,613,751,649,75,36,bowl
15481,67,chair,68,1,11483,46,901,540,1078,639,177,99,chair
15482,68,chair,69,1,11483,35,1015,588,1181,840,166,252,chair
15483,69,bowl,70,0,11483,16,970,610,1050,654,80,44,bowl
15484,72,sofa,73,0,11483,40,478,602,1085,886,607,284,couch
15485,12,sofa,13,0,11484,72,242,739,1627,1536,1385,797,couch
15486,10,sofa,9,0,11485,25,747,428,1187,889,440,461,couch
15487,15,chair,13,1,11485,18,1031,403,1168,504,137,101,chair
15488,16,table,14,1,11485,15,478,568,635,746,157,178,dining table
15489,17,table,15,0,11485,19,511,640,710,886,199,246,dining table
15490,19,table,17,1,11485,17,3,552,134,812,131,260,dining table
15491,20,chair,18,1,11485,22,2,420,255,735,253,315,chair
15492,32,sofa,33,0,11486,59,28,1024,1180,1650,1152,626,couch
15493,48,window,49,1,11487,40,129,479,372,833,243,354,window
15494,52,chair,53,1,11487,20,194,762,377,968,183,206,chair
15495,53,chair,54,1,11487,21,425,760,617,981,192,221,chair
15496,54,chair,55,1,11487,27,602,760,776,994,174,234,chair
15497,57,refrigerator,58,1,11487,18,421,566,675,824,254,258,refrigerator
15498,61,sofa,62,1,11487,66,3,901,766,1649,763,748,couch
15499,62,flowerpot,63,0,11487,28,415,1143,721,1444,306,301,potted plant
15500,71,window,72,0,11487,17,1440,476,1605,856,165,380,window
15501,76,bowl,77,0,11487,17,1854,540,1953,594,99,54,bowl
15502,82,chair,83,1,11487,24,1025,751,1231,969,206,218,chair
15503,83,chair,84,1,11487,17,1158,741,1277,820,119,79,chair
15504,84,chair,85,0,11487,45,1266,763,1467,1061,201,298,chair
15505,85,chair,86,1,11487,45,1430,749,1583,1022,153,273,chair
15506,87,table,88,1,11487,35,1151,818,1548,952,397,134,dining table
15507,90,sofa,91,1,11487,55,1465,889,2199,1228,734,339,couch
15508,14,door,15,0,11488,45,124,168,961,942,837,774,door
15509,18,sofa,19,0,11488,76,1009,633,1856,1476,847,843,couch
15510,19,vase,20,0,11488,19,1409,961,1504,1183,95,222,vase
15511,31,chair,32,0,11488,37,78,620,342,1004,264,384,chair
15512,32,table,33,1,11488,22,3,682,172,1013,169,331,dining table
15513,9,sofa,10,0,11489,88,167,376,1056,771,889,395,couch
15514,10,bowl,11,0,11489,15,709,676,823,745,114,69,bowl
15515,23,sofa,24,0,11489,28,1,475,173,912,172,437,couch
15516,21,vase,22,0,11490,18,1017,1379,1100,1479,83,100,vase
15517,23,bottle,24,0,11490,28,1009,766,1069,930,60,164,bottle
15518,26,clock,27,0,11490,50,1286,808,1421,939,135,131,clock
15519,32,sofa,33,0,11490,39,1,1159,580,1650,579,491,couch
15520,32,window,33,0,11491,21,478,200,688,482,210,282,window
15521,35,table,36,0,11491,56,479,470,727,630,248,160,dining table
15522,37,chair,38,1,11491,49,196,449,500,691,304,242,chair
15523,41,sofa,42,1,11491,29,801,550,1477,963,676,413,couch
15524,19,sofa,20,1,11492,55,132,363,550,586,418,223,couch
15525,21,vase,22,0,11492,21,456,437,484,496,28,59,vase
15526,32,mirror,33,0,11492,67,171,229,392,367,221,138,mirror
15527,7,sofa,8,1,11493,24,1,346,206,669,205,323,couch
15528,8,sofa,9,0,11493,85,202,314,809,613,607,299,couch
15529,9,vase,10,0,11493,18,485,471,537,566,52,95,vase
15530,25,sofa,26,0,11494,79,35,870,1416,1533,1381,663,couch
15531,28,sofa,29,1,11494,67,1019,732,1834,1105,815,373,couch
15532,41,chair,42,1,11494,24,1936,1135,2048,1462,112,327,chair
15533,28,window,29,0,11495,23,1344,469,1795,983,451,514,window
15534,54,bowl,55,0,11495,16,316,860,384,916,68,56,bowl
15535,55,sofa,56,1,11495,35,441,845,1004,1073,563,228,couch
15536,67,window,68,0,11495,20,1,414,228,958,227,544,window
15537,41,chair,42,1,11496,26,667,640,915,940,248,300,chair
15538,46,chair,47,1,11496,17,2070,809,2199,942,129,133,chair
15539,52,sofa,53,1,11496,75,1054,719,1862,1118,808,399,couch
15540,60,bowl,61,0,11496,17,1231,940,1329,1043,98,103,bowl
15541,6,sofa,5,0,11497,35,788,708,2056,1229,1268,521,couch
15542,20,chair,18,0,11497,33,1051,1003,1974,1519,923,516,chair
15543,24,chair,25,1,11498,25,1412,569,1674,869,262,300,chair
15544,26,chair,27,1,11498,43,1593,793,2043,1321,450,528,chair
15545,30,door,31,0,11498,22,1162,304,1333,878,171,574,door
15546,35,sofa,36,0,11498,54,250,685,1057,1275,807,590,couch
15547,36,table,37,1,11498,63,1343,834,2197,1464,854,630,dining table
15548,41,window,42,0,11498,17,209,214,408,729,199,515,window
15549,58,door,59,0,11498,15,963,283,1364,874,401,591,door
15550,25,chair,26,1,11499,20,709,596,838,770,129,174,chair
15551,26,table,27,1,11499,21,2,820,107,1243,105,423,dining table
15552,31,sofa,32,1,11499,55,8,764,1077,1381,1069,617,couch
15553,35,bowl,36,0,11499,18,818,1009,1002,1095,184,86,bowl
15554,37,sofa,38,1,11499,100,552,923,1964,1650,1412,727,couch
15555,39,table,40,0,11499,96,1188,976,2199,1650,1011,674,dining table
15556,21,table,22,1,11500,20,482,346,667,411,185,65,dining table
15557,26,sofa,27,1,11500,53,61,342,593,612,532,270,couch
15558,32,plate,33,0,11500,19,605,505,699,541,94,36,plate
15559,34,mirror,35,0,11500,46,147,95,335,307,188,212,mirror
15560,37,window,38,0,11500,25,471,116,659,358,188,242,window
15561,26,sofa,27,1,11501,88,581,656,1316,1006,735,350,couch
15562,39,sofa,40,0,11501,78,1299,799,1947,1430,648,631,couch
15563,43,vase,44,0,11501,18,1857,751,1961,915,104,164,vase
15564,51,window,52,0,11501,24,818,77,1136,701,318,624,window
15565,52,window,53,0,11501,33,1204,70,1426,747,222,677,window
15566,31,desk,32,0,11502,25,411,541,642,777,231,236,desk
15567,39,window,40,1,11502,16,854,204,1341,511,487,307,window
15568,44,chair,45,1,11502,30,544,482,725,765,181,283,chair
15569,46,chair,47,0,11502,40,649,500,927,855,278,355,chair
15570,49,chair,50,1,11502,47,1340,514,1626,855,286,341,chair
15571,53,chair,54,1,11502,51,1470,824,2014,1511,544,687,chair
15572,55,flowerpot,56,0,11502,19,1793,1,1932,383,139,382,potted plant
15573,57,flowerpot,58,0,11502,16,1611,49,1696,322,85,273,potted plant
15574,59,window,60,1,11502,16,1802,89,2015,815,213,726,window
15575,60,sofa,61,1,11502,53,774,493,1415,774,641,281,couch
15576,72,sofa,73,1,11502,50,2,882,1054,1490,1052,608,couch
15577,75,clock,76,0,11502,23,58,360,144,477,86,117,clock
15578,10,chair,11,0,11503,21,636,458,849,826,213,368,chair
15579,11,table,12,0,11503,23,796,596,1113,760,317,164,dining table
15580,13,vase,14,0,11503,17,802,462,869,624,67,162,vase
15581,18,door,19,1,11505,33,6,317,88,792,82,475,door
15582,32,sofa,33,0,11505,32,1417,538,1727,855,310,317,couch
15583,33,sofa,34,1,11505,43,245,547,631,899,386,352,couch
15584,34,sofa,35,0,11505,124,107,776,1936,1480,1829,704,couch
15585,37,vase,38,0,11505,37,35,317,174,806,139,489,vase
15586,55,mirror,56,0,11505,23,831,8,1103,251,272,243,mirror
15587,0,sofa,1,0,11506,31,2,415,561,799,559,384,couch
15588,2,sofa,3,0,11506,15,547,379,890,554,343,175,couch
15589,4,table,5,0,11506,21,366,473,751,677,385,204,dining table
15590,9,window,10,0,11506,18,429,207,667,470,238,263,window
15591,29,table,27,0,11506,15,0,529,196,799,196,270,dining table
15592,67,flowerpot,64,0,11506,25,1070,481,1193,582,123,101,potted plant
15593,16,sofa,17,0,11507,90,225,444,868,868,643,424,couch
15594,30,window,31,0,11507,18,12,130,104,374,92,244,window
15595,32,table,33,0,11507,20,150,357,332,487,182,130,dining table
15596,33,chair,34,0,11507,26,232,332,301,474,69,142,chair
15597,11,sofa,12,0,11508,29,519,378,1024,684,505,306,couch
15598,12,sofa,13,0,11508,19,1,410,502,768,501,358,couch
15599,0,chair,1,0,11509,15,888,524,1279,958,391,434,chair
15600,3,table,3,0,11509,22,196,571,537,708,341,137,dining table
15601,20,door,21,0,11510,17,329,294,420,464,91,170,door
15602,24,chair,25,1,11510,36,724,438,814,554,90,116,chair
15603,25,chair,26,1,11510,41,738,450,866,615,128,165,chair
15604,26,table,27,0,11510,49,656,456,803,593,147,137,dining table
15605,29,door,30,1,11510,45,708,310,790,494,82,184,door
15606,42,sofa,43,0,11510,72,0,433,454,771,454,338,couch
15607,45,flowerpot,46,0,11510,27,471,586,531,633,60,47,potted plant
15608,10,door,11,0,21177,21,661,189,799,351,138,162,door
15609,27,vase,28,0,21177,15,163,206,185,255,22,49,vase
15610,28,mirror,29,0,21177,21,447,203,508,273,61,70,mirror
15611,30,chair,31,1,21177,16,716,317,760,409,44,92,chair
15612,31,chair,32,0,21177,17,661,296,705,369,44,73,chair
15613,32,sofa,33,0,21177,46,366,301,608,438,242,137,couch
15614,33,sofa,34,0,21177,38,378,337,753,533,375,196,couch
15615,24,door,25,0,21178,21,273,224,333,328,60,104,door
15616,26,chair,27,0,21178,19,101,287,129,369,28,82,chair
15617,30,chair,31,1,21178,17,231,286,274,357,43,71,chair
15618,42,sofa,43,0,21178,49,402,300,725,466,323,166,couch
15619,47,sofa,48,1,21178,21,752,332,800,544,48,212,couch
15620,10,window,11,0,21179,34,150,198,326,356,176,158,window
15621,11,window,12,0,21179,27,30,191,123,319,93,128,window
15622,12,window,13,0,21179,34,165,3,307,177,142,174,window
15623,13,window,14,0,21179,22,51,30,109,172,58,142,window
15624,16,door,17,0,21179,42,369,193,427,369,58,176,door
15625,29,vase,30,0,21179,30,495,167,523,233,28,66,vase
15626,30,vase,31,0,21179,43,649,146,686,229,37,83,vase
15627,31,sofa,32,1,21179,56,157,319,406,456,249,137,couch
15628,37,sofa,38,1,21179,34,550,371,799,533,249,162,couch
15629,40,bowl,41,0,21179,16,639,458,699,497,60,39,bowl
15630,49,chair,50,1,21179,25,122,306,174,357,52,51,chair
15631,51,chair,52,1,21179,29,32,309,102,390,70,81,chair
15632,57,vase,58,0,21179,19,539,344,557,403,18,59,vase
15633,35,window,36,0,21180,19,368,206,436,306,68,100,window
15634,37,mirror,38,0,21180,15,459,186,593,281,134,95,mirror
15635,40,chair,41,0,21180,56,357,277,406,356,49,79,chair
15636,50,window,51,0,21180,69,632,183,690,323,58,140,window
15637,51,sofa,52,1,21180,47,657,306,800,519,143,213,couch
15638,52,sofa,53,1,21180,68,0,337,799,532,799,195,couch
15639,19,sofa,20,0,21181,33,112,305,314,466,202,161,couch
15640,33,bowl,34,0,21181,17,380,362,440,385,60,23,bowl
15641,34,balls,35,0,21181,16,391,339,431,376,40,37,sports ball
15642,20,window,21,0,21182,18,122,103,276,311,154,208,window
15643,35,clock,36,0,21182,27,718,129,777,191,59,62,clock
15644,36,chair,37,1,21182,18,646,220,800,533,154,313,chair
15645,39,chair,40,1,21182,39,551,252,670,407,119,155,chair
15646,40,chair,41,1,21182,82,498,248,702,533,204,285,chair
15647,41,sofa,42,0,21182,57,193,290,427,416,234,126,couch
15648,62,chair,63,0,21182,145,84,294,213,490,129,196,chair
15649,63,table,64,1,21182,86,0,330,144,513,144,183,dining table
15650,31,clock,32,0,21183,15,3,330,155,454,152,124,clock
15651,35,door,36,0,21183,20,1309,508,1535,953,226,445,door
15652,37,chair,38,1,21183,42,1128,795,1392,1021,264,226,chair
15653,39,sofa,40,0,21183,59,855,875,1717,1461,862,586,couch
15654,69,bowl,70,0,21183,23,60,1117,379,1269,319,152,bowl
15655,70,balls,71,0,21183,37,69,1074,375,1205,306,131,sports ball
15656,80,chair,81,1,21183,23,1574,1202,1876,1460,302,258,chair
15657,84,door,85,0,21183,26,826,541,1018,952,192,411,door
15658,7,door,8,0,21184,18,472,217,545,364,73,147,door
15659,23,sofa,24,0,21184,81,275,393,1023,683,748,290,couch
15660,30,bench,31,0,21185,21,289,324,362,358,73,34,bench
15661,34,sofa,35,0,21185,71,246,324,638,533,392,209,couch
15662,39,window,39,0,21186,28,559,209,642,436,83,227,window
15663,50,table,50,0,21186,32,46,376,225,497,179,121,dining table
15664,52,chair,52,1,21186,44,174,356,274,489,100,133,chair
15665,53,chair,53,0,21186,41,1,355,84,511,83,156,chair
15666,58,sofa,58,0,21186,70,265,364,535,606,270,242,couch
15667,0,sofa,1,0,21187,17,28,62,296,175,268,113,couch
15668,10,plate,11,0,21188,19,767,317,838,388,71,71,plate
15669,15,chair,16,0,21188,41,871,412,999,632,128,220,chair
15670,16,chair,17,0,21188,43,755,401,866,584,111,183,chair
15671,17,table,18,1,21188,15,667,397,735,419,68,22,dining table
15672,25,window,26,0,21188,18,559,223,686,413,127,190,window
15673,30,chair,31,0,21188,23,640,377,695,460,55,83,chair
15674,32,table,33,0,21188,83,666,462,798,667,132,205,dining table
15675,37,sofa,38,0,21188,53,422,453,697,667,275,214,couch
15676,41,bowl,42,0,21188,21,353,398,412,434,59,36,bowl
15677,17,window,18,0,21189,35,851,340,983,774,132,434,window
15678,29,door,30,0,21189,17,606,398,811,743,205,345,door
15679,30,table,31,1,21189,51,0,696,579,925,579,229,dining table
15680,32,chair,33,1,21189,26,23,721,238,889,215,168,chair
15681,33,chair,34,0,21189,28,264,715,440,960,176,245,chair
15682,34,chair,35,1,21189,16,541,795,609,912,68,117,chair
15683,43,clock,44,0,21189,16,990,1046,1123,1151,133,105,clock
15684,47,sofa,48,1,21189,20,1,873,345,1465,344,592,couch
15685,61,bowl,62,0,21189,17,228,682,349,717,121,35,bowl
15686,20,sofa,21,0,21190,16,447,309,508,358,61,49,couch
15687,21,door,22,0,21190,22,389,217,436,327,47,110,door
15688,26,chair,27,1,21190,15,359,305,424,342,65,37,chair
15689,27,sofa,28,0,21190,48,107,297,271,427,164,130,couch
15690,30,sofa,31,1,21190,112,202,346,648,533,446,187,couch
15691,32,pot,33,0,21190,22,397,392,432,439,35,47,potted plant
15692,35,bowl,36,0,21190,15,542,396,568,415,26,19,bowl
15693,38,vase,39,0,21190,18,578,442,615,499,37,57,vase
15694,42,vase,43,0,21190,16,446,484,480,531,34,47,vase
15695,14,window,15,0,21191,47,853,231,1196,501,343,270,window
15696,19,plate,20,0,21191,15,1202,313,1265,365,63,52,plate
15697,22,chair,23,1,21191,15,1085,506,1278,633,193,127,chair
15698,24,window,25,0,21191,35,369,261,584,484,215,223,window
15699,29,window,30,0,21191,21,182,266,269,452,87,186,window
15700,38,sofa,39,1,21191,55,1,426,300,631,299,205,couch
15701,41,table,42,1,21191,20,1009,623,1278,852,269,229,dining table
15702,25,sofa,26,1,21192,122,726,473,1200,800,474,327,couch
15703,27,plant pot,28,0,21192,28,739,696,857,797,118,101,potted plant
15704,40,chair,40,1,21192,26,261,444,330,584,69,140,chair
15705,41,chair,41,1,21192,32,289,458,431,657,142,199,chair
15706,42,chair,42,1,21192,48,417,452,552,650,135,198,chair
15707,43,chair,43,1,21192,28,538,439,607,588,69,149,chair
15708,44,window,44,0,21192,21,570,269,652,520,82,251,window
15709,45,table,45,1,21192,26,239,466,558,539,319,73,dining table
15710,20,door,21,0,21193,24,270,233,311,296,41,63,door
15711,21,chair,22,1,21193,20,226,287,243,335,17,48,chair
15712,22,chair,23,1,21193,25,237,286,270,345,33,59,chair
15713,23,table,24,0,21193,32,246,295,298,345,52,50,dining table
15714,24,chair,25,1,21193,22,275,309,298,344,23,35,chair
15715,37,clock,38,0,21193,20,728,185,774,230,46,45,clock
15716,50,sofa,51,0,21193,60,204,336,595,533,391,197,couch
15717,33,sofa,34,0,21194,79,3,276,449,519,446,243,couch
15718,31,chair,32,0,21195,40,460,326,526,431,66,105,chair
15719,40,sofa,41,0,21195,55,157,388,547,613,390,225,couch
15720,46,vase,47,0,21195,37,540,222,566,268,26,46,vase
15721,47,vase,48,0,21195,47,696,211,732,267,36,56,vase
15722,13,sofa,14,0,21196,78,292,258,709,430,417,172,couch
15723,22,chair,23,0,21196,28,131,271,206,372,75,101,chair
15724,25,chair,26,0,21196,22,207,271,278,370,71,99,chair
15725,26,chair,27,1,21196,16,195,271,228,312,33,41,chair
15726,20,sofa,21,0,21197,27,491,287,799,533,308,246,couch
15727,23,sofa,24,0,21197,56,8,288,408,533,400,245,couch
15728,0,sofa,1,0,21198,37,13,42,277,190,264,148,couch
15729,16,television,17,0,21199,15,397,485,501,549,104,64,tv
15730,22,sofa,23,0,21199,32,21,509,309,695,288,186,couch
15731,33,bottle,34,0,21199,17,512,520,534,627,22,107,bottle
15732,27,sofa,28,0,21200,77,356,285,611,406,255,121,couch
15733,31,bench,32,1,21200,45,0,284,69,366,69,82,bench
15734,23,sofa,24,1,21201,32,0,296,158,533,158,237,couch
15735,31,chair,32,1,21201,19,257,280,365,378,108,98,chair
15736,32,chair,33,0,21201,35,348,286,486,448,138,162,chair
15737,37,table,38,1,21201,22,498,287,567,358,69,71,dining table
15738,39,chair,40,1,21201,29,470,280,516,356,46,76,chair
15739,42,chair,43,1,21201,20,410,274,431,318,21,44,chair
15740,15,bed,16,1,21202,16,401,752,603,968,202,216,bed
15741,16,door,17,0,21202,18,344,502,676,1086,332,584,door
15742,64,bowl,65,0,21202,50,1198,1214,1372,1298,174,84,bowl
15743,23,door,24,0,21203,20,655,171,800,340,145,169,door
15744,38,sofa,39,1,21203,33,700,301,800,413,100,112,couch
15745,49,sofa,50,0,21203,35,0,305,474,533,474,228,couch
15746,50,chair,51,1,21203,15,151,288,227,334,76,46,chair
15747,55,bowl,56,0,21203,16,216,276,252,292,36,16,bowl
15748,15,sofa,16,0,21204,30,918,412,1148,495,230,83,couch
15749,29,plant pot,29,0,21204,22,386,537,450,605,64,68,potted plant
15750,34,bowl,34,0,21204,16,456,558,533,588,77,30,bowl
15751,35,bowl,35,0,21204,21,473,577,567,620,94,43,bowl
15752,16,chair,17,1,21205,18,0,369,85,449,85,80,chair
15753,17,chair,18,1,21205,28,0,408,78,532,78,124,chair
15754,20,chair,21,1,21205,17,160,371,195,422,35,51,chair
15755,21,chair,22,0,21205,31,68,377,167,515,99,138,chair
15756,22,table,23,1,21205,29,0,396,204,518,204,122,dining table
15757,28,sofa,29,0,21205,43,75,411,348,630,273,219,couch
15758,33,vase,34,0,21205,15,307,518,339,561,32,43,vase
15759,34,vase,35,0,21205,22,460,528,524,618,64,90,vase
15760,53,table,54,1,21205,27,689,378,914,541,225,163,dining table
15761,10,window,11,0,21206,35,733,514,863,764,130,250,window
15762,15,toilet,16,1,21206,18,833,614,919,772,86,158,toilet
15763,16,door,17,0,21206,28,709,102,992,891,283,789,door
15764,24,mirror,24,0,21206,37,352,73,629,604,277,531,mirror
15765,28,bed,28,1,21206,72,251,415,1279,960,1028,545,bed
15766,34,sink,34,0,21206,16,423,611,629,644,206,33,sink
15767,48,bed,48,1,21206,27,1,621,72,959,71,338,bed
15768,53,plant pot,53,0,21206,20,216,695,275,793,59,98,potted plant
15769,18,sofa,19,0,21207,52,403,314,591,450,188,136,couch
15770,21,sofa,22,0,21207,64,114,314,372,436,258,122,couch
15771,54,bowl,55,1,21207,16,37,352,87,384,50,32,bowl
15772,55,plant pot,56,0,21207,19,203,381,249,445,46,64,potted plant
15773,62,vase,63,0,21207,22,746,168,800,274,54,106,vase
15774,64,mirror,65,0,21207,17,686,188,769,269,83,81,mirror
15775,67,chair,68,1,21207,22,170,278,200,330,30,52,chair
15776,24,sofa,25,0,21208,53,235,272,444,390,209,118,couch
15777,26,table,27,1,21208,24,1,292,168,390,167,98,dining table
15778,27,chair,28,1,21208,19,88,283,149,330,61,47,chair
15779,28,chair,29,1,21208,36,107,284,180,375,73,91,chair
15780,30,chair,31,1,21208,28,5,292,114,403,109,111,chair
15781,31,sofa,32,1,21208,16,0,325,63,479,63,154,couch
15782,34,plant pot,35,0,21208,28,180,401,236,445,56,44,potted plant
15783,8,vase,9,0,21209,16,70,239,141,325,71,86,vase
15784,12,table,13,1,21209,116,0,278,287,676,287,398,dining table
15785,20,sofa,21,0,21209,91,232,232,758,594,526,362,couch
15786,25,plate,26,0,21209,19,504,478,603,517,99,39,plate
15787,6,window,7,0,21210,31,471,123,832,351,361,228,window
15788,19,bench,20,1,21210,31,1,319,159,374,158,55,bench
15789,22,vase,23,0,21210,25,106,297,131,378,25,81,vase
15790,28,sofa,29,0,21210,54,157,272,544,555,387,283,couch
15791,34,bowl,35,0,21210,21,507,336,583,365,76,29,bowl
15792,42,bowl,43,0,21210,17,38,363,113,390,75,27,bowl
15793,6,sofa,7,0,21211,39,431,208,640,398,209,190,couch
15794,19,plate,20,0,21211,16,454,107,472,134,18,27,plate
15795,20,plate,21,0,21211,15,454,141,473,168,19,27,plate
15796,28,window,29,0,21212,59,103,183,536,443,433,260,window
15797,34,window,35,0,21212,17,663,255,741,322,78,67,window
15798,40,sofa,41,0,21212,61,432,371,812,607,380,236,couch
15799,9,chair,10,0,21213,41,389,291,576,433,187,142,chair
15800,11,sofa,12,0,21213,35,0,366,493,707,493,341,couch
15801,13,window,14,0,21214,21,397,137,704,332,307,195,window
15802,14,window,15,0,21214,20,322,169,381,328,59,159,window
15803,17,sofa,18,0,21214,56,336,304,694,503,358,199,couch
15804,22,vase,23,0,21214,16,384,353,412,416,28,63,vase
15805,29,window,30,0,21214,38,134,162,205,329,71,167,window
15806,39,bowl,40,0,21214,17,329,413,413,446,84,33,bowl
15807,40,balls,41,0,21214,22,334,394,411,432,77,38,sports ball
15808,14,window,15,0,21215,38,231,154,799,410,568,256,window
15809,16,sofa,17,0,21215,35,1,312,281,428,280,116,couch
15810,17,chair,18,0,21215,31,496,356,587,440,91,84,chair
15811,19,sofa,20,0,21215,32,133,338,505,532,372,194,couch
15812,7,window,8,0,21216,27,173,83,229,361,56,278,window
15813,8,window,9,0,21216,15,246,83,356,268,110,185,window
15814,9,window,10,0,21216,37,366,120,395,277,29,157,window
15815,13,sofa,14,0,21216,78,441,260,782,427,341,167,couch
15816,21,sofa,22,0,21216,66,175,259,429,428,254,169,couch
15817,27,clock,28,0,21216,32,111,248,158,311,47,63,clock
15818,33,balls,34,0,21216,16,488,318,543,355,55,37,sports ball
15819,24,table,25,0,21217,51,749,467,998,679,249,212,dining table
15820,16,sofa,17,0,21218,31,431,262,677,339,246,77,couch
15821,27,plant pot,28,0,21218,31,77,399,164,475,87,76,potted plant
15822,35,sofa,36,0,21219,81,640,445,1023,677,383,232,couch
15823,47,sofa,48,1,21219,61,0,524,1023,694,1023,170,couch
15824,53,bottle,54,0,21219,31,719,548,745,624,26,76,bottle
15825,19,door,20,0,21220,18,31,170,130,367,99,197,door
15826,25,sofa,26,1,21220,22,613,360,800,532,187,172,couch
15827,28,vase,29,0,21220,25,31,311,68,392,37,81,vase
15828,33,sofa,34,1,21220,20,0,386,133,532,133,146,couch
15829,35,plant pot,36,0,21220,16,443,333,481,376,38,43,potted plant
15830,7,table,8,0,21221,24,27,920,553,1213,526,293,dining table
15831,13,sofa,14,1,21221,66,975,908,1667,1241,692,333,couch
15832,13,window,14,0,21222,16,934,239,1006,425,72,186,window
15833,16,window,17,0,21222,58,425,115,643,434,218,319,window
15834,27,sofa,28,0,21222,71,560,353,868,557,308,204,couch
15835,40,plant pot,41,0,21222,18,240,255,263,283,23,28,potted plant
15836,42,plant pot,43,0,21222,16,350,261,370,285,20,24,potted plant
15837,44,chair,45,1,21222,15,981,329,1008,495,27,166,chair
15838,50,pot,51,0,21222,31,21,354,73,435,52,81,potted plant
15839,8,window,9,0,21223,67,0,2,592,628,592,626,window
15840,10,window,11,0,21223,34,681,1,1024,584,343,583,window
15841,20,sofa,21,1,21223,78,139,389,609,626,470,237,couch
15842,24,bowl,25,0,21223,23,296,471,365,557,69,86,bowl
15843,19,window,20,0,21224,18,169,113,270,193,101,80,window
15844,20,window,21,0,21224,18,278,77,431,176,153,99,window
15845,21,window,22,0,21224,21,442,26,690,152,248,126,window
15846,27,sofa,28,1,21224,58,287,305,549,423,262,118,couch
15847,39,sofa,40,1,21224,57,0,314,263,453,263,139,couch
15848,42,vase,43,0,21224,16,19,307,44,356,25,49,vase
15849,12,window,13,0,21225,16,135,182,310,456,175,274,window
15850,13,window,14,0,21225,18,461,270,627,412,166,142,window
15851,23,television,24,0,21225,45,800,316,885,406,85,90,tv
15852,30,plant pot,31,0,21225,19,0,536,98,681,98,145,potted plant
15853,34,sofa,35,0,21225,52,110,402,415,631,305,229,couch
15854,14,window,15,0,21226,18,45,180,129,424,84,244,window
15855,21,mirror,22,0,21226,37,563,228,699,331,136,103,mirror
15856,29,door,30,0,21226,23,360,251,437,448,77,197,door
15857,32,sofa,33,0,21226,35,1,461,537,681,536,220,couch
15858,13,window,14,0,21227,16,1995,142,2136,685,141,543,window
15859,15,sofa,16,0,21227,33,1447,667,2198,1366,751,699,couch
15860,17,sofa,18,0,21227,21,0,794,504,1366,504,572,couch
15861,23,sofa,24,0,21228,24,688,276,867,371,179,95,couch
15862,28,table,29,0,21228,20,843,288,899,369,56,81,dining table
15863,41,sofa,42,0,21228,33,419,290,629,420,210,130,couch
15864,46,sofa,47,0,21228,55,146,293,420,425,274,132,couch
15865,52,vase,53,0,21228,18,339,310,374,367,35,57,vase
15866,29,bowl,30,0,21229,18,1569,964,1732,1030,163,66,bowl
15867,30,balls,31,0,21229,17,1594,946,1723,1004,129,58,sports ball
15868,32,sofa,33,0,21229,40,308,765,1022,1191,714,426,couch
15869,49,chair,50,1,21229,33,288,755,362,987,74,232,chair
15870,50,window,51,0,21229,40,296,525,450,911,154,386,window
15871,52,table,53,1,21229,15,318,788,383,878,65,90,dining table
15872,67,clock,68,0,21229,16,1388,602,1420,639,32,37,clock
15873,71,table,72,0,21229,34,1244,782,1539,1009,295,227,dining table
15874,72,chair,73,1,21229,37,1328,748,1469,955,141,207,chair
15875,73,chair,74,1,21229,21,1484,747,1566,946,82,199,chair
15876,74,chair,75,1,21229,43,1438,758,1565,995,127,237,chair
15877,75,chair,76,0,21229,43,1258,755,1413,1011,155,256,chair
15878,81,vase,82,0,21229,32,1898,1108,2021,1380,123,272,vase
15879,7,sofa,8,0,21230,31,327,300,629,453,302,153,couch
15880,32,bowl,33,0,21231,18,293,429,378,472,85,43,bowl
15881,36,window,37,0,21231,18,296,224,385,402,89,178,window
15882,42,mirror,43,0,21231,32,137,180,231,277,94,97,mirror
15883,44,sofa,45,1,21231,87,0,429,229,564,229,135,couch
15884,45,plant pot,46,0,21231,15,0,547,64,646,64,99,potted plant
15885,57,vase,58,0,21231,24,516,139,547,219,31,80,vase
15886,9,window,10,0,21232,26,883,102,1041,466,158,364,window
15887,19,sofa,20,0,21232,42,0,367,357,598,357,231,couch
15888,32,table,33,0,21232,43,821,413,1027,523,206,110,dining table
15889,25,door,26,0,21233,21,749,139,899,399,150,260,door
15890,28,table,29,0,21233,22,893,288,1023,442,130,154,dining table
15891,33,sofa,34,0,21233,60,10,301,664,628,654,327,couch
15892,38,sofa,39,1,21233,34,533,372,1021,690,488,318,couch
15893,40,backpack,41,0,21233,18,719,335,781,408,62,73,backpack
15894,9,sofa,10,0,21234,65,420,255,799,522,379,267,couch
15895,22,sofa,23,1,21234,30,1,278,120,533,119,255,couch
15896,28,mirror,29,0,21234,24,173,163,284,245,111,82,mirror
15897,10,window,11,0,21235,18,453,5,591,129,138,124,window
15898,20,sofa,21,1,21235,57,1,332,799,532,798,200,couch
15899,12,sofa,13,0,21236,46,625,391,998,663,373,272,couch
15900,15,window,16,0,21236,20,520,290,637,439,117,149,window
15901,17,window,18,0,21236,41,108,287,455,449,347,162,window
15902,18,table,19,0,21236,94,268,406,392,535,124,129,dining table
15903,19,chair,20,0,21236,64,217,412,316,537,99,125,chair
15904,20,chair,21,0,21236,70,340,406,432,521,92,115,chair
15905,22,vase,23,0,21236,30,480,345,513,425,33,80,vase
15906,29,bowl,30,0,21236,53,602,561,783,658,181,97,bowl
15907,30,balls,31,0,21236,46,633,538,755,630,122,92,sports ball
15908,9,window,10,0,21237,24,0,113,139,356,139,243,window
15909,15,sofa,16,1,21237,41,119,258,304,341,185,83,couch
15910,20,door,21,0,21238,26,0,233,88,487,88,254,door
15911,25,vase,26,0,21238,27,87,321,136,411,49,90,vase
15912,26,vase,27,0,21238,21,230,326,268,424,38,98,vase
15913,27,sofa,28,0,21238,148,17,372,517,668,500,296,couch
15914,28,sofa,29,1,21238,56,571,369,897,563,326,194,couch
15915,32,sink,33,0,21238,20,322,373,433,456,111,83,sink
15916,33,sofa,34,1,21238,39,657,389,1023,683,366,294,couch
15917,41,vase,42,0,21238,18,542,470,577,547,35,77,vase
15918,17,sofa,18,0,21239,59,339,223,771,448,432,225,couch
15919,20,table,21,0,21239,28,229,360,593,556,364,196,dining table
15920,29,window,30,0,21239,25,1,1,238,321,237,320,window
15921,22,window,23,0,21240,16,81,327,238,552,157,225,window
15922,23,window,24,0,21240,17,264,330,393,520,129,190,window
15923,28,sofa,29,1,21240,35,158,517,454,624,296,107,couch
15924,26,table,27,0,21241,39,647,388,890,508,243,120,dining table
15925,27,sofa,28,0,21241,23,750,370,912,500,162,130,couch
15926,28,chair,29,0,21241,40,853,383,976,530,123,147,chair
15927,30,chair,31,1,21241,31,604,386,680,526,76,140,chair
15928,31,chair,32,1,21241,44,662,389,777,530,115,141,chair
15929,47,sofa,48,0,21241,41,0,429,336,685,336,256,couch
15930,53,window,54,0,21241,45,136,168,596,433,460,265,window
15931,60,vase,61,0,21241,35,366,384,415,495,49,111,vase
15932,61,vase,62,0,21241,25,431,405,466,490,35,85,vase
15933,25,window,26,0,21242,25,253,253,332,346,79,93,window
15934,32,table,33,1,21242,36,297,337,344,377,47,40,dining table
15935,33,chair,34,0,21242,36,308,324,346,380,38,56,chair
15936,34,chair,35,1,21242,17,346,366,354,400,8,34,chair
15937,35,chair,36,1,21242,17,333,322,350,337,17,15,chair
15938,36,chair,37,1,21242,19,339,323,354,376,15,53,chair
15939,37,chair,38,1,21242,16,40,355,88,369,48,14,chair
15940,38,chair,39,1,21242,18,0,358,40,376,40,18,chair
15941,39,sofa,40,0,21242,82,0,360,289,532,289,172,couch
15942,43,vase,44,0,21242,58,201,429,260,488,59,59,vase
15943,53,chair,53,1,21242,19,456,334,475,367,19,33,chair
15944,55,plant pot,55,0,21242,29,496,343,545,376,49,33,potted plant
15945,68,sofa,68,1,21242,32,563,404,800,533,237,129,couch
15946,22,sofa,23,0,21243,67,431,292,678,420,247,128,couch
15947,38,window,39,0,21243,27,353,174,413,353,60,179,window
15948,40,window,41,0,21243,43,81,131,310,367,229,236,window
15949,45,vase,45,0,21243,20,0,457,249,533,249,76,vase
15950,4,window,5,0,21244,20,289,110,454,293,165,183,window
15951,5,window,6,0,21244,19,482,99,561,301,79,202,window
15952,14,sofa,15,1,21244,66,72,337,934,538,862,201,couch
15953,16,sofa,17,0,21244,53,1,246,225,537,224,291,couch
15954,12,door,13,0,21245,34,419,247,524,474,105,227,door
15955,15,window,16,0,21245,37,97,168,299,510,202,342,window
15956,17,sofa,18,1,21245,53,681,460,1024,714,343,254,couch
15957,21,vase,22,0,21245,27,767,446,793,526,26,80,vase
15958,30,sofa,31,0,21245,74,173,413,571,728,398,315,couch
15959,35,mirror,36,0,21245,23,638,233,733,337,95,104,mirror
15960,43,table,44,1,21245,114,1,445,141,725,140,280,dining table
15961,8,window,9,0,21246,35,728,114,1016,486,288,372,window
15962,14,sofa,15,1,21246,83,138,407,602,713,464,306,couch
15963,16,vase,17,0,21246,29,601,481,687,571,86,90,vase
15964,5,door,6,0,21247,15,648,5,799,415,151,410,door
15965,6,plant pot,7,0,21247,23,641,365,703,427,62,62,potted plant
15966,10,window,11,0,21247,21,178,109,289,315,111,206,window
15967,11,window,12,0,21247,35,337,92,582,319,245,227,window
15968,25,sofa,26,1,21247,37,0,304,310,533,310,229,couch
15969,20,sofa,21,0,21248,17,365,283,421,318,56,35,couch
15970,25,door,25,0,21248,32,1,149,123,391,122,242,door
15971,27,window,27,0,21248,20,289,185,347,353,58,168,window
15972,32,sofa,32,0,21248,71,335,300,647,483,312,183,couch
15973,36,sofa,36,1,21248,38,373,360,800,532,427,172,couch
15974,39,plant pot,39,0,21248,20,707,331,760,387,53,56,potted plant
15975,48,clock,48,0,21248,24,350,213,364,264,14,51,clock
15976,26,sofa,27,0,21249,33,551,313,799,533,248,220,couch
15977,31,sofa,32,0,21250,59,1,299,488,682,487,383,couch
15978,14,window,15,0,21251,24,629,117,932,421,303,304,window
15979,16,door,17,0,21251,40,328,246,431,411,103,165,door
15980,35,sofa,36,0,21251,90,491,368,915,591,424,223,couch
15981,36,vase,37,0,21251,24,506,425,545,497,39,72,vase
15982,43,desk,44,0,21251,30,394,350,513,446,119,96,desk
15983,20,door,21,0,21252,30,646,48,800,379,154,331,door
15984,24,chair,25,1,21252,24,683,301,800,398,117,97,chair
15985,25,table,26,1,21252,41,464,365,800,531,336,166,dining table
15986,42,vase,43,0,21252,15,256,321,272,355,16,34,vase
15987,12,chair,12,0,21253,27,713,413,797,507,84,94,chair
15988,13,chair,13,0,21253,22,719,413,798,530,79,117,chair
15989,14,chair,14,0,21253,38,413,400,516,511,103,111,chair
15990,15,chair,15,0,21253,26,406,412,501,536,95,124,chair
15991,27,sofa,27,0,21253,50,1,424,354,796,353,372,couch
15992,25,window,26,0,21254,20,486,169,563,416,77,247,window
15993,26,window,27,0,21254,43,662,168,958,466,296,298,window
15994,28,sofa,29,0,21254,46,734,375,969,587,235,212,couch
15995,35,door,36,0,21254,19,624,0,875,530,251,530,door
15996,40,sofa,41,0,21254,39,0,356,251,589,251,233,couch
15997,11,window,12,0,21255,22,616,52,825,318,209,266,window
15998,14,window,15,0,21255,48,330,1,546,262,216,261,window
15999,15,sofa,16,1,21255,77,359,223,547,353,188,130,couch
16000,17,vase,18,0,21255,27,493,179,533,270,40,91,vase
16001,18,table,19,0,21255,68,438,260,586,382,148,122,dining table
16002,22,sofa,23,1,21255,22,675,393,893,671,218,278,couch
16003,27,vase,28,0,21255,39,214,262,305,458,91,196,vase
16004,29,window,30,0,21255,38,0,0,267,389,267,389,window
16005,15,window,16,0,21256,15,477,93,723,400,246,307,window
16006,28,refrigerator,29,0,21256,15,90,310,181,471,91,161,refrigerator
16007,34,sofa,35,0,21256,53,619,401,1024,704,405,303,couch
16008,31,window,32,0,21257,17,701,257,784,376,83,119,window
16009,35,window,36,0,21257,45,395,273,450,363,55,90,window
16010,39,table,40,0,21257,48,382,377,475,432,93,55,dining table
16011,40,chair,41,0,21257,32,358,366,389,433,31,67,chair
16012,42,chair,43,1,21257,22,135,427,159,489,24,62,chair
16013,43,sofa,44,0,21257,62,155,367,349,513,194,146,couch
16014,44,sofa,45,0,21257,75,486,373,723,640,237,267,couch
16015,51,window,52,0,21257,27,74,243,198,432,124,189,window
16016,56,vase,57,0,21257,28,721,383,749,439,28,56,vase
16017,23,table,24,1,21258,37,926,357,1000,454,74,97,dining table
16018,24,chair,25,1,21258,17,875,337,926,388,51,51,chair
16019,25,chair,26,1,21258,44,929,336,995,444,66,108,chair
16020,26,chair,27,1,21258,46,875,340,945,450,70,110,chair
16021,27,sofa,28,0,21258,52,528,353,857,482,329,129,couch
16022,34,sofa,35,0,21258,56,164,381,471,645,307,264,couch
16023,40,window,41,0,21258,16,519,209,628,324,109,115,window
16024,61,bowl,61,0,21259,17,408,384,476,427,68,43,bowl
16025,9,sofa,10,0,21260,31,864,435,1200,800,336,365,couch
16026,11,sofa,12,0,21260,43,450,172,792,496,342,324,couch
16027,12,sofa,13,0,21260,105,380,396,775,582,395,186,couch
16028,24,vase,25,0,21260,16,942,386,980,446,38,60,vase
16029,25,vase,26,0,21260,17,1007,400,1041,451,34,51,vase
16030,27,window,28,0,21260,29,72,66,451,500,379,434,window
16031,11,chair,12,1,21261,28,1,462,151,619,150,157,chair
16032,19,television,20,0,21261,20,1113,384,1269,539,156,155,tv
16033,24,sofa,25,0,21261,39,0,602,816,959,816,357,couch
16034,15,sofa,16,0,21262,111,255,363,930,679,675,316,couch
16035,17,television,18,0,21262,19,817,336,917,414,100,78,tv
16036,28,bench,29,0,21262,41,67,359,257,464,190,105,bench
16037,29,table,30,0,21262,46,177,414,443,676,266,262,dining table
16038,36,window,37,0,21262,52,2,229,251,388,249,159,window
16039,11,window,12,0,21263,17,1044,165,1129,470,85,305,window
16040,17,sofa,18,0,21263,51,74,471,513,748,439,277,couch
16041,29,window,30,0,21264,17,2,84,177,346,175,262,window
16042,34,door,35,0,21264,24,230,137,359,392,129,255,door
16043,37,bowl,38,0,21264,16,101,382,213,429,112,47,bowl
16044,13,window,14,0,21265,29,46,67,364,174,318,107,window
16045,16,window,17,0,21265,64,7,110,147,365,140,255,window
16046,18,sofa,19,0,21265,95,163,309,408,471,245,162,couch
16047,0,sofa,1,0,21266,29,1,27,299,179,298,152,couch
16048,46,sofa,47,0,21267,43,1,373,525,682,524,309,couch
16049,12,sofa,13,0,21268,46,0,346,249,533,249,187,couch
16050,25,vase,26,0,21268,18,171,123,197,160,26,37,vase
16051,29,plate,30,0,21268,17,163,168,206,201,43,33,plate
16052,31,plate,32,0,21268,17,179,225,206,251,27,26,plate
16053,34,plate,35,0,21268,17,578,265,604,293,26,28,plate
16054,35,plate,36,0,21268,18,617,271,647,293,30,22,plate
16055,38,plate,39,0,21268,17,627,217,655,246,28,29,plate
16056,43,plate,44,0,21268,18,667,85,696,113,29,28,plate
16057,44,plate,45,0,21268,16,582,85,605,112,23,27,plate
16058,46,plate,47,0,21268,19,600,41,628,68,28,27,plate
16059,47,plate,48,0,21268,17,649,41,677,67,28,26,plate
16060,19,sofa,20,0,21269,45,186,358,660,533,474,175,couch
16061,20,sofa,21,0,21269,43,479,313,671,423,192,110,couch
16062,25,window,26,0,21269,30,584,92,793,353,209,261,window
16063,28,window,29,0,21269,20,306,161,444,321,138,160,window
16064,17,window,18,0,21270,47,570,48,800,338,230,290,window
16065,37,ball,38,0,21270,19,384,299,422,337,38,38,sports ball
16066,45,sofa,46,0,21270,29,10,294,192,535,182,241,couch
16067,33,sofa,34,0,21271,29,325,413,620,571,295,158,couch
16068,34,sofa,35,0,21271,51,761,432,1199,799,438,367,couch
16069,41,window,42,0,21271,15,936,173,1140,431,204,258,window
16070,46,vase,47,0,21271,16,998,752,1116,799,118,47,vase
16071,8,door,9,0,21272,24,133,126,214,356,81,230,door
16072,13,window,14,0,21272,18,1,109,117,336,116,227,window
16073,14,sofa,15,0,21272,66,503,268,767,396,264,128,couch
16074,18,sofa,19,0,21272,44,277,269,434,382,157,113,couch
16075,21,vase,22,0,21272,23,173,359,222,414,49,55,vase
16076,20,window,21,0,21273,18,586,212,734,427,148,215,window
16077,24,window,25,0,21273,18,435,256,508,395,73,139,window
16078,25,window,26,0,21273,33,83,220,219,417,136,197,window
16079,27,chair,28,1,21273,19,0,397,36,537,36,140,chair
16080,35,sofa,36,0,21273,54,365,421,981,681,616,260,couch
16081,44,plate,45,0,21273,29,810,292,878,352,68,60,plate
16082,50,vase,51,0,21273,17,500,462,520,504,20,42,vase
16083,10,window,11,0,21274,22,607,239,752,490,145,251,window
16084,13,window,14,0,21274,16,800,81,910,243,110,162,window
16085,19,sofa,20,0,21274,66,665,464,1170,792,505,328,couch
16086,43,window,44,0,21274,53,7,204,227,489,220,285,window
16087,16,window,17,0,21275,92,628,555,1498,1047,870,492,window
16088,17,chair,18,1,21275,26,897,867,1032,1050,135,183,chair
16089,18,chair,19,1,21275,34,1114,881,1274,1194,160,313,chair
16090,19,chair,20,1,21275,46,735,902,944,1221,209,319,chair
16091,20,chair,21,0,21275,57,937,923,1142,1262,205,339,chair
16092,21,table,22,0,21275,51,822,943,1192,1240,370,297,dining table
16093,23,sofa,24,0,21275,34,1626,976,2199,1470,573,494,couch
16094,27,table,28,0,21275,39,1523,1193,1798,1472,275,279,dining table
16095,29,television,30,0,21275,26,334,770,615,1176,281,406,tv
16096,26,window,26,0,21276,17,613,457,833,1054,220,597,window
16097,27,window,27,0,21276,24,118,429,615,1057,497,628,window
16098,32,sofa,31,1,21276,22,0,1119,833,1534,833,415,couch
16099,34,plate,33,0,21276,19,729,1157,887,1217,158,60,plate
16100,7,chair,8,1,21277,73,488,785,904,1485,416,700,chair
16101,12,sofa,13,1,21277,28,0,920,653,1648,653,728,couch
16102,8,window,9,0,21278,17,78,234,581,537,503,303,window
16103,9,sofa,10,0,21278,66,209,513,693,699,484,186,couch
16104,9,window,10,0,21279,61,980,49,1800,826,820,777,window
16105,3,sofa,4,0,21280,24,1508,660,2198,1650,690,990,couch
16106,4,sofa,5,0,21280,64,124,417,1423,1169,1299,752,couch
16107,17,sofa,18,0,21281,31,1531,639,2070,1512,539,873,couch
16108,20,sofa,21,0,21281,35,21,1055,1097,1650,1076,595,couch
16109,22,bowl,23,0,21281,20,723,754,822,847,99,93,bowl
16110,23,bowl,24,0,21281,19,850,756,1004,889,154,133,bowl
16111,27,sofa,28,0,21282,30,341,670,1106,853,765,183,couch
16112,29,dog,30,1,21282,16,1114,799,1192,853,78,54,dog
16113,12,door,13,0,21283,17,971,420,1149,749,178,329,door
16114,21,plant pot,22,0,21283,22,441,749,564,787,123,38,potted plant
16115,23,chair,24,1,21283,27,841,583,942,818,101,235,chair
16116,24,chair,25,0,21283,46,1022,582,1129,764,107,182,chair
16117,26,table,27,1,21283,20,1058,641,1194,761,136,120,dining table
16118,27,chair,28,1,21283,44,919,583,1077,868,158,285,chair
16119,28,sofa,29,0,21283,25,825,676,1280,959,455,283,couch
16120,6,sofa,7,0,21284,40,523,300,1024,630,501,330,couch
16121,12,sofa,13,0,21284,37,149,296,515,573,366,277,couch
16122,18,bowl,19,0,21284,16,636,505,751,540,115,35,bowl
16123,21,window,22,0,21285,50,1033,345,1419,1002,386,657,window
16124,28,sofa,29,0,21285,48,197,808,1064,1384,867,576,couch
16125,32,sofa,32,1,21285,54,621,895,1534,1912,913,1017,couch
16126,33,chair,33,1,21285,47,757,1468,1532,1956,775,488,chair
16127,34,vase,34,0,21285,30,1194,1478,1511,1710,317,232,vase
16128,19,door,20,0,21286,20,0,175,147,1109,147,934,door
16129,25,refrigerator,26,0,21286,18,518,399,671,661,153,262,refrigerator
16130,37,door,38,0,21286,32,1389,278,1543,864,154,586,door
16131,43,chair,44,1,21286,50,1281,588,1506,918,225,330,chair
16132,44,chair,45,1,21286,27,1010,588,1131,699,121,111,chair
16133,45,chair,46,1,21286,42,1395,654,1545,964,150,310,chair
16134,46,chair,47,1,21286,50,1081,597,1340,954,259,357,chair
16135,47,table,48,1,21286,52,1033,676,1528,975,495,299,dining table
16136,57,sofa,58,0,21286,110,76,680,1268,1339,1192,659,couch
16137,61,chair,62,0,21286,19,379,585,560,704,181,119,chair
16138,11,window,12,0,21287,29,753,185,1031,628,278,443,window
16139,18,sofa,19,0,21287,45,2,522,650,927,648,405,couch
16140,7,television,8,1,21288,18,665,305,755,452,90,147,tv
16141,15,chair,16,1,21288,32,759,526,983,716,224,190,chair
16142,21,sofa,22,0,21288,67,1,595,577,960,576,365,couch
16143,37,window,38,0,21288,30,60,154,288,567,228,413,window
16144,6,window,7,0,21289,21,1866,397,2199,1132,333,735,window
16145,20,bottle,21,0,21289,18,742,457,799,589,57,132,bottle
16146,8,sofa,9,0,21290,47,0,670,1020,1529,1020,859,couch
16147,24,chair,25,1,21291,22,371,788,495,1060,124,272,chair
16148,25,chair,26,1,21291,27,250,793,396,1055,146,262,chair
16149,26,chair,27,1,21291,22,224,793,285,1022,61,229,chair
16150,41,sofa,42,1,21291,64,514,1254,2199,1650,1685,396,couch
16151,17,table,18,0,21292,27,654,380,896,528,242,148,dining table
16152,22,sofa,23,1,21292,35,464,546,1023,768,559,222,couch
16153,28,plant pot,29,0,21292,28,0,621,69,692,69,71,potted plant
16154,31,chair,32,0,21292,65,121,418,426,711,305,293,chair
16155,42,bowl,43,0,21292,15,881,545,907,557,26,12,bowl
16156,6,sofa,7,0,21293,50,1414,642,2198,1370,784,728,couch
16157,14,window,15,0,21294,44,504,398,714,605,210,207,window
16158,20,plant pot,21,0,21294,21,1045,753,1200,899,155,146,potted plant
16159,29,sofa,30,0,21294,36,395,579,624,846,229,267,couch
16160,40,bottle,41,1,21294,16,42,594,67,660,25,66,bottle
16161,42,bottle,43,0,21294,16,114,325,161,442,47,117,bottle
16162,54,plant pots,55,0,21294,35,391,1,470,141,79,140,potted plant
16163,22,window,23,0,21295,37,1217,233,1715,779,498,546,window
16164,26,mirror,27,0,21295,33,891,309,1143,705,252,396,mirror
16165,31,sofa,32,0,21295,69,542,704,1476,1122,934,418,couch
16166,32,table,33,1,21295,25,904,700,1336,746,432,46,dining table
16167,43,sofa,44,1,21295,22,2,1156,327,1536,325,380,couch
16168,47,bowl,48,0,21295,19,642,827,779,928,137,101,bowl
16169,21,door,22,0,21296,21,1102,526,1218,964,116,438,door
16170,29,refrigerator,29,0,21296,15,566,570,729,763,163,193,refrigerator
16171,46,clock,45,0,21296,18,994,542,1064,617,70,75,clock
16172,55,chair,54,1,21296,23,1015,873,1217,1015,202,142,chair
16173,56,chair,55,1,21296,16,777,927,987,998,210,71,chair
16174,58,table,57,1,21296,29,624,917,1033,1008,409,91,dining table
16175,60,sofa,59,0,21296,65,2,982,1660,1536,1658,554,couch
16176,15,television,14,0,21297,19,1160,870,1526,1153,366,283,tv
16177,18,sofa,17,0,21297,47,205,999,1503,1648,1298,649,couch
16178,6,sofa,7,0,21298,26,528,365,1037,842,509,477,couch
16179,12,vase,13,0,21299,16,671,446,703,494,32,48,vase
16180,13,vase,14,0,21299,16,698,434,731,498,33,64,vase
16181,15,sofa,16,0,21299,24,0,536,221,767,221,231,couch
16182,16,sofa,17,0,21299,72,204,415,620,645,416,230,couch
16183,30,vase,31,0,21299,26,414,593,454,674,40,81,vase
16184,31,vase,32,0,21299,18,355,601,385,666,30,65,vase
16185,11,sofa,12,1,21300,17,931,417,1024,687,93,270,couch
16186,16,sofa,17,1,21301,55,807,432,1200,800,393,368,couch
16187,22,desk,23,1,21301,26,0,216,182,706,182,490,desk
16188,16,sofa,17,0,21302,50,516,389,1024,767,508,378,couch
16189,17,sofa,18,0,21302,29,2,409,314,748,312,339,couch
16190,23,bottle,24,0,21302,16,424,440,460,504,36,64,bottle
16191,13,door,14,0,21303,27,403,223,518,671,115,448,door
16192,25,sofa,26,0,21303,36,517,481,807,675,290,194,couch
16193,28,sofa,29,0,21303,63,0,542,550,960,550,418,couch
16194,42,window,43,0,21303,20,783,158,1043,257,260,99,window
16195,15,window,16,0,21304,28,159,175,751,665,592,490,window
16196,16,sofa,17,1,21304,43,167,581,497,926,330,345,couch
16197,5,chair,6,0,21305,32,2,1026,454,1391,452,365,chair
16198,6,chair,7,1,21305,29,1063,1097,1567,1394,504,297,chair
16199,7,sofa,8,0,21305,43,1139,1087,1844,1790,705,703,couch
16200,8,sofa,9,1,21305,16,0,1139,206,1572,206,433,couch
16201,11,window,12,0,21306,27,1543,3,1629,597,86,594,window
16202,16,sofa,17,0,21306,57,1258,542,2199,1300,941,758,couch
16203,8,bicycle,9,0,21307,90,1438,578,1941,1562,503,984,bicycle
16204,9,bicycle,10,0,21307,96,1174,546,1711,1401,537,855,bicycle
16205,10,sofa,11,0,21307,30,0,691,784,1225,784,534,couch
16206,11,sofa,12,1,21307,62,786,671,1560,1099,774,428,couch
16207,9,sofa,10,0,21308,54,927,626,2079,1225,1152,599,couch
16208,29,sofa,30,0,21309,18,922,894,1649,1587,727,693,couch
16209,10,window,11,0,21310,29,457,975,1120,1500,663,525,window
16210,22,sofa,23,0,21310,38,378,1318,1019,1796,641,478,couch
16211,35,window,36,0,21310,15,83,967,256,1427,173,460,window
16212,27,sofa,28,1,21311,42,328,693,697,921,369,228,couch
16213,28,sofa,29,0,21311,37,638,767,864,1111,226,344,couch
16214,34,vase,35,0,21311,22,406,770,455,835,49,65,vase
16215,36,book,37,0,21311,16,460,836,584,877,124,41,book
16216,23,bed,23,1,21312,76,893,141,1070,488,177,347,bed
16217,33,chair,33,0,21312,45,429,399,556,596,127,197,chair
16218,34,table,34,1,21312,91,277,394,605,630,328,236,dining table
16219,35,chair,35,1,21312,28,353,376,467,574,114,198,chair
16220,36,chair,36,0,21312,41,244,410,388,604,144,194,chair
16221,37,chair,37,1,21312,70,522,370,628,555,106,185,chair
16222,38,sofa,38,1,21312,46,1,477,595,997,594,520,couch
16223,8,window,9,0,21313,37,1384,764,1828,1304,444,540,window
16224,11,vase,12,1,21313,19,580,1278,675,1495,95,217,vase
16225,19,sofa,20,1,21313,22,2,1149,670,1648,668,499,couch
16226,8,sofa,9,0,21314,41,766,403,1024,748,258,345,couch
16227,9,sofa,10,0,21314,90,241,340,735,562,494,222,couch
16228,12,sofa,13,0,21315,38,63,830,826,1517,763,687,couch
16229,14,television,15,0,21315,16,1659,776,2035,1195,376,419,tv
16230,12,sofa,13,1,21316,39,1062,714,2199,1096,1137,382,couch
16231,7,sofa,8,0,21317,34,1121,889,1839,1350,718,461,couch
16232,8,chair,9,1,21317,30,902,797,1121,1088,219,291,chair
16233,12,sofa,13,1,21317,30,210,1031,623,1535,413,504,couch
16234,18,ball,19,0,21317,15,939,1103,1006,1143,67,40,sports ball
16235,10,window,11,1,21318,21,1895,579,2180,900,285,321,window
16236,22,vase,23,0,21318,18,1115,982,1183,1041,68,59,vase
16237,26,vase,27,0,21318,16,558,368,610,440,52,72,vase
16238,27,vase,28,0,21318,15,467,350,517,437,50,87,vase
16239,42,plate,43,0,21318,16,1427,605,1482,661,55,56,plate
16240,72,sofa,73,1,21318,81,1,1180,2055,1461,2054,281,couch
16241,80,vase,81,0,21318,16,960,1209,1071,1292,111,83,vase
16242,81,plate,82,0,21318,18,1112,1251,1252,1315,140,64,plate
16243,24,sofa,25,0,21319,64,466,331,1024,737,558,406,couch
16244,27,sofa,28,0,21319,47,0,328,438,641,438,313,couch
16245,37,window,38,0,21319,24,317,144,586,281,269,137,window
16246,4,window,5,0,21320,15,1977,106,2199,709,222,603,window
16247,5,sofa,6,0,21320,44,1537,680,2199,1311,662,631,couch
16248,8,window,9,0,21321,26,710,449,965,725,255,276,window
16249,16,chair,17,1,21321,22,1777,1061,1988,1438,211,377,chair
16250,19,sofa,20,0,21321,48,855,739,1455,982,600,243,couch
16251,20,sofa,21,1,21321,47,293,848,1194,1118,901,270,couch
16252,35,chair,36,1,21321,17,609,706,687,765,78,59,chair
16253,39,ball,40,1,21321,19,800,780,878,883,78,103,sports ball
16254,19,sofa,20,0,21322,32,444,463,1136,851,692,388,couch
16255,20,bench,21,0,21323,23,1385,733,1671,878,286,145,bench
16256,24,sofa,25,0,21323,43,1,681,739,1293,738,612,couch
16257,29,ball,30,0,21323,20,922,871,1070,1007,148,136,sports ball
16258,30,ball,31,0,21323,15,808,921,910,1030,102,109,sports ball
16259,37,television,38,0,21323,20,1881,462,2047,745,166,283,tv
16260,6,chair,7,0,21324,22,70,343,93,411,23,68,chair
16261,19,window,19,0,21324,36,873,181,1125,421,252,240,window
16262,23,chair,23,1,21324,53,307,347,391,497,84,150,chair
16263,25,sofa,25,0,21324,127,354,384,1007,726,653,342,couch
16264,17,vase,18,0,21325,15,1931,614,1989,779,58,165,vase
16265,22,window,23,0,21325,27,1682,305,1808,647,126,342,window
16266,24,window,25,0,21325,18,1389,358,1700,942,311,584,window
16267,28,sofa,29,1,21325,62,865,897,1700,1255,835,358,couch
16268,17,door,18,0,21326,20,1048,572,1152,912,104,340,door
16269,18,chair,19,1,21326,42,1252,749,1390,998,138,249,chair
16270,19,chair,20,1,21326,35,1158,754,1315,1020,157,266,chair
16271,20,chair,21,1,21326,24,1087,753,1169,985,82,232,chair
16272,21,chair,22,1,21326,46,1351,749,1521,1040,170,291,chair
16273,22,table,23,1,21326,45,1062,801,1525,1039,463,238,dining table
16274,23,plant pot,24,0,21326,17,1635,931,1734,1020,99,89,potted plant
16275,25,television,26,1,21326,32,1955,636,2198,857,243,221,tv
16276,31,sofa,32,0,21326,39,343,788,905,1173,562,385,couch
16277,35,chair,36,1,21326,15,650,762,729,796,79,34,chair
16278,43,chair,44,1,21326,32,20,775,202,1019,182,244,chair
16279,44,sofa,45,1,21326,21,0,993,315,1466,315,473,couch
16280,48,plate,49,0,21326,17,960,1071,1075,1122,115,51,plate
16281,50,bowl,51,0,21326,18,878,1006,1008,1055,130,49,bowl
16282,13,window,14,0,21329,19,1048,550,1291,665,243,115,window
16283,14,window,15,0,21329,31,1320,558,1554,671,234,113,window
16284,35,sofa,36,0,21329,90,1705,718,2158,1009,453,291,couch
16285,57,table,58,1,21329,64,70,1072,514,1579,444,507,dining table
16286,65,plant pot,66,0,21329,15,2162,365,2198,470,36,105,potted plant
16287,18,sofa,19,0,21330,56,623,401,910,589,287,188,couch
16288,21,sofa,22,0,21330,68,258,386,622,565,364,179,couch
16289,23,vase,24,0,21330,17,569,448,600,493,31,45,vase
16290,29,window,30,0,21330,78,219,270,565,454,346,184,window
16291,30,chair,31,1,21330,17,0,669,260,767,260,98,chair
16292,33,plant pot,34,0,21330,19,1,604,74,766,73,162,potted plant
16293,15,sofa,16,1,21331,29,1,300,227,533,226,233,couch
16294,23,window,24,0,21331,25,423,80,613,365,190,285,window
16295,24,window,25,0,21331,45,608,71,768,378,160,307,window
16296,25,window,26,0,21331,67,761,41,924,402,163,361,window
16297,26,sofa,27,1,21331,87,379,318,805,534,426,216,couch
16298,33,sofa,34,1,21331,40,746,377,1024,768,278,391,couch
16299,42,vase,43,0,21331,18,944,601,992,665,48,64,vase
16300,29,chair,30,1,21332,19,960,273,1012,300,52,27,chair
16301,35,sofa,36,1,21332,40,434,481,1023,767,589,286,couch
16302,7,window,8,0,21333,52,353,399,1519,1199,1166,800,window
16303,17,vase,18,0,21334,17,1968,1137,2044,1391,76,254,vase
16304,20,bottle,21,0,21334,16,1378,926,1457,1123,79,197,bottle
16305,25,chair,26,0,21334,29,758,788,1019,1187,261,399,chair
16306,26,chair,27,0,21334,31,154,857,553,1339,399,482,chair
16307,37,window,38,0,21334,16,486,320,1232,861,746,541,window
16308,18,television,19,0,21335,16,1230,827,1498,1066,268,239,tv
16309,23,sofa,24,1,21335,27,963,1388,1718,1650,755,262,couch
16310,38,bowl,39,0,21335,19,1711,1361,1856,1431,145,70,bowl
16311,14,bed,15,0,21336,18,1321,847,1470,1062,149,215,bed
16312,16,door,17,0,21336,15,791,358,1093,1262,302,904,door
16313,25,sofa,26,0,21336,50,1396,924,2196,1645,800,721,couch
16314,28,vase,29,0,21336,18,1545,1253,1631,1392,86,139,vase
16315,31,chair,32,0,21336,51,614,973,1085,1554,471,581,chair
16316,35,table,36,0,21336,35,76,906,521,1309,445,403,dining table
16317,36,chair,37,0,21336,31,343,898,625,1303,282,405,chair
16318,37,chair,38,0,21336,33,22,891,301,1310,279,419,chair
16319,38,chair,39,0,21336,21,2,902,178,1247,176,345,chair
16320,20,sofa,21,0,21337,18,1673,905,2199,1467,526,562,couch
16321,38,chair,39,0,21337,24,576,658,756,998,180,340,chair
16322,40,sofa,41,0,21337,45,635,782,1493,1204,858,422,couch
16323,16,refrigerator,17,0,21338,16,924,394,1037,624,113,230,refrigerator
16324,29,chair,30,1,21338,27,1167,511,1200,711,33,200,chair
16325,30,chair,31,0,21338,41,1035,504,1133,736,98,232,chair
16326,31,desk,32,1,21338,27,638,490,809,658,171,168,desk
16327,39,chair,40,1,21338,20,424,516,508,621,84,105,chair
16328,46,sofa,47,0,21338,40,475,595,905,900,430,305,couch
16329,50,sofa,51,0,21338,31,0,667,368,900,368,233,couch
16330,53,vase,54,0,21338,15,184,286,245,353,61,67,vase
16331,14,sofa,15,0,21339,35,601,481,992,767,391,286,couch
16332,5,door,6,0,21340,27,1613,141,2066,1017,453,876,door
16333,17,refrigerator,18,0,21340,17,1270,375,1372,894,102,519,refrigerator
16334,42,chair,43,1,21340,63,217,750,705,1381,488,631,chair
16335,20,chair,21,1,21341,15,544,497,655,540,111,43,chair
16336,23,chair,24,1,21341,28,665,512,766,770,101,258,chair
16337,24,table,25,1,21341,31,391,534,739,790,348,256,dining table
16338,25,sofa,26,0,21341,45,0,566,679,1066,679,500,couch
16339,35,sofa,36,0,21341,18,405,847,799,1066,394,219,couch
16340,3,window,4,0,21342,27,1668,40,2199,784,531,744,window
16341,5,sofa,6,0,21342,45,23,532,889,1101,866,569,couch
16342,17,chair,18,1,21342,37,1694,509,2192,959,498,450,chair
16343,24,sofa,25,0,21342,36,845,801,2199,1650,1354,849,couch
16344,15,vase,16,0,21343,16,336,323,435,463,99,140,vase
16345,24,sofa,25,0,21343,46,1368,801,2046,1251,678,450,couch
16346,25,sofa,26,0,21343,29,1295,1134,2044,1486,749,352,couch
16347,15,sofa,16,0,21344,23,888,558,1088,832,200,274,couch
16348,9,window,10,0,21345,35,568,340,1077,899,509,559,window
16349,14,sofa,15,0,21345,41,1315,843,1948,1231,633,388,couch
16350,16,sofa,17,0,21345,38,591,818,1138,1069,547,251,couch
16351,19,window,20,0,21345,56,1155,585,1332,881,177,296,window
16352,20,window,21,0,21345,37,250,560,463,952,213,392,window
16353,22,table,23,1,21346,30,2,1267,907,1650,905,383,dining table
16354,23,chair,24,1,21346,23,137,1422,780,1650,643,228,chair
16355,28,sofa,29,0,21346,31,1179,658,1788,1152,609,494,couch
16356,34,chair,35,1,21346,17,229,1020,626,1293,397,273,chair
16357,36,chair,37,1,21346,46,268,686,672,1042,404,356,chair
16358,16,person,17,1,21347,56,5,1097,497,1650,492,553,person
16359,18,remote control,19,0,21347,21,329,1574,523,1630,194,56,remote
16360,16,sofa,17,0,21348,67,1,680,749,1405,748,725,couch
16361,20,table,21,0,21348,43,1034,633,1325,892,291,259,dining table
16362,21,chair,22,0,21348,72,1492,679,2052,1207,560,528,chair
16363,22,chair,23,1,21348,31,1603,1160,2198,1650,595,490,chair
16364,25,window,26,0,21348,45,1306,201,1583,819,277,618,window
16365,26,window,27,0,21348,43,803,200,1058,796,255,596,window
16366,27,clock,28,0,21348,49,1142,276,1230,432,88,156,clock
16367,13,chair,14,1,21349,43,64,393,352,531,288,138,chair
16368,14,sofa,15,0,21349,37,0,471,457,818,457,347,couch
16369,28,bowl,29,0,21349,16,1142,100,1221,171,79,71,bowl
16370,31,sofa,32,0,21349,62,526,406,933,670,407,264,couch
16371,20,sofa,21,0,21350,57,693,436,1258,801,565,365,couch
16372,27,chair,28,1,21350,34,1,472,207,807,206,335,chair
16373,38,window,39,0,21350,18,683,87,772,264,89,177,window
16374,7,plant pot,8,0,21351,23,827,524,972,690,145,166,potted plant
16375,10,sofa,11,0,21351,42,426,410,772,538,346,128,couch
16376,11,sofa,12,0,21351,47,189,480,806,767,617,287,couch
16377,17,bowl,18,0,21351,17,281,484,355,499,74,15,bowl
16378,25,chair,26,1,21351,17,0,590,47,751,47,161,chair
16379,26,table,27,1,21352,18,742,769,852,1052,110,283,dining table
16380,27,chair,28,1,21352,16,746,764,826,967,80,203,chair
16381,28,chair,29,1,21352,17,290,771,396,957,106,186,chair
16382,29,chair,30,1,21352,37,788,723,1016,927,228,204,chair
16383,34,sofa,35,0,21352,48,848,804,1920,1413,1072,609,couch
16384,6,window,7,0,21353,18,2,230,325,751,323,521,window
16385,7,sofa,8,1,21353,31,0,687,503,1186,503,499,couch
16386,18,vase,19,0,21353,19,1233,401,1257,512,24,111,vase
16387,29,chair,30,0,21353,50,1123,711,1422,1045,299,334,chair
16388,30,chair,31,0,21353,30,686,703,944,957,258,254,chair
16389,14,sofa,15,0,21354,62,276,581,723,745,447,164,couch
16390,15,sofa,16,1,21354,58,12,598,336,860,324,262,couch
16391,19,vase,20,0,21354,15,407,681,435,761,28,80,vase
16392,50,sofa,51,1,21355,41,566,515,1216,750,650,235,couch
16393,53,vase,54,0,21355,29,420,476,467,613,47,137,vase
16394,8,sofa,9,0,21356,92,722,620,2197,1650,1475,1030,couch
16395,19,plant pot,20,0,21356,18,1563,1322,1741,1439,178,117,potted plant
16396,32,window,33,0,21356,19,651,3,857,727,206,724,window
16397,15,sofa,16,0,21357,33,1440,679,1803,1118,363,439,couch
16398,20,sofa,21,1,21357,33,931,612,1434,874,503,262,couch
16399,25,window,26,0,21357,17,922,276,1559,677,637,401,window
16400,45,chair,46,0,21357,45,1028,780,1400,1269,372,489,chair
16401,13,window,14,0,21358,16,775,381,1484,844,709,463,window
16402,25,sofa,25,1,21358,36,1344,890,1746,1187,402,297,couch
16403,5,sofa,6,0,21359,31,1,0,595,487,594,487,couch
16404,14,sofa,15,0,21359,32,1,341,489,757,488,416,couch
16405,6,chair,7,0,21360,23,0,493,77,871,77,378,chair
16406,8,chair,9,1,21360,46,46,490,191,836,145,346,chair
16407,17,sofa,18,0,21360,59,1066,678,2169,1347,1103,669,couch
16408,18,sofa,19,0,21360,60,0,657,1080,1649,1080,992,couch
16409,17,bowl,18,0,21361,26,629,492,739,576,110,84,bowl
16410,31,window,32,1,21361,69,508,213,626,534,118,321,window
16411,42,sofa,43,0,21361,151,156,427,536,668,380,241,couch
16412,50,table,51,1,21361,78,218,634,615,802,397,168,dining table
16413,22,window,23,0,21362,28,427,263,639,493,212,230,window
16414,24,window,25,0,21362,30,1,46,334,250,333,204,window
16415,25,window,26,0,21362,25,1,246,331,512,330,266,window
16416,28,chair,29,1,21362,15,162,469,230,503,68,34,chair
16417,30,table,31,1,21362,25,1,496,252,561,251,65,dining table
16418,35,desk,36,0,21362,29,421,482,649,660,228,178,desk
16419,36,chair,37,1,21362,40,487,486,557,631,70,145,chair
16420,38,sofa,39,0,21362,37,0,525,575,856,575,331,couch
16421,21,sofa,22,0,21363,28,2,948,880,1536,878,588,couch
16422,21,window,22,0,21364,18,972,211,1125,534,153,323,window
16423,22,window,23,0,21364,30,561,236,881,604,320,368,window
16424,23,window,24,0,21364,35,351,268,496,563,145,295,window
16425,32,sofa,33,1,21364,41,2,513,445,682,443,169,couch
16426,33,sofa,34,1,21364,49,1,611,559,958,558,347,couch
16427,40,vase,41,0,21364,26,1048,616,1173,909,125,293,vase
16428,19,plant pot,20,1,21365,16,0,813,147,900,147,87,potted plant
16429,29,chair,30,1,21365,25,260,476,408,722,148,246,chair
16430,30,table,31,1,21365,19,337,519,617,585,280,66,dining table
16431,31,chair,32,0,21365,39,547,471,695,726,148,255,chair
16432,32,chair,33,0,21365,41,386,496,535,764,149,268,chair
16433,33,chair,34,1,21365,19,479,460,548,519,69,59,chair
16434,46,bottle,47,0,21365,15,871,479,901,523,30,44,bottle
16435,9,window,10,0,21366,17,1262,371,1484,649,222,278,window
16436,19,door,20,0,21366,38,158,67,889,766,731,699,door
16437,21,sofa,22,0,21366,117,197,663,1423,1561,1226,898,couch
16438,24,plant pot,25,0,21366,18,1484,977,1613,1101,129,124,potted plant
16439,34,table,35,0,21366,119,5,898,842,1650,837,752,dining table
16440,35,plant pot,36,0,21366,16,131,836,273,950,142,114,potted plant
16441,39,bowl,40,0,21366,30,305,942,572,1033,267,91,bowl
16442,17,sofa,18,0,21367,87,62,392,685,764,623,372,couch
16443,21,clock,22,0,21367,58,182,151,313,354,131,203,clock
16444,18,plate,19,0,21368,46,1741,1426,2154,1650,413,224,plate
16445,34,table,35,0,21368,29,730,505,1197,747,467,242,dining table
16446,36,chair,37,1,21368,21,1052,443,1239,759,187,316,chair
16447,40,sofa,41,0,21368,88,270,679,1736,1536,1466,857,couch
16448,56,cup,57,0,21368,19,609,1167,677,1283,68,116,cup
16449,17,window,18,0,21369,18,1076,307,1329,622,253,315,window
16450,18,window,19,0,21369,66,1606,283,2149,811,543,528,window
16451,40,chair,41,1,21369,37,1617,676,1791,918,174,242,chair
16452,41,table,42,0,21369,81,1520,706,1847,1013,327,307,dining table
16453,42,chair,43,0,21369,50,1723,697,1969,1086,246,389,chair
16454,46,refrigerator,47,0,21369,19,514,418,869,990,355,572,refrigerator
16455,47,sofa,48,0,21369,80,656,715,1595,1472,939,757,couch
16456,55,door,56,0,21369,17,136,210,516,1014,380,804,door
16457,8,window,9,0,21370,56,1454,340,2085,955,631,615,window
16458,11,chair,12,1,21370,17,541,909,700,1115,159,206,chair
16459,12,chair,13,0,21370,36,1246,864,1438,1260,192,396,chair
16460,13,chair,14,0,21370,38,1404,866,1605,1294,201,428,chair
16461,14,chair,15,0,21370,40,1589,923,1787,1299,198,376,chair
16462,17,sofa,18,0,21370,32,2,1009,832,1655,830,646,couch
16463,25,clock,26,0,21371,15,659,122,692,181,33,59,clock
16464,44,sofa,45,0,21371,58,356,259,718,448,362,189,couch
16465,22,door,23,0,21372,15,946,471,1024,1024,78,553,door
16466,17,mirror,18,0,21373,35,995,176,1136,299,141,123,mirror
16467,24,sofa,25,0,21373,42,704,428,1090,637,386,209,couch
16468,34,chair,35,1,21373,48,0,464,203,637,203,173,chair
16469,12,sofa,13,0,21374,62,343,538,1132,952,789,414,couch
16470,16,bowl,17,0,21374,33,540,773,614,849,74,76,bowl
16471,19,sofa,20,0,21374,28,42,540,409,955,367,415,couch
16472,14,window,15,0,21375,42,2,0,357,538,355,538,window
16473,17,sofa,18,0,21375,47,434,445,870,607,436,162,couch
16474,24,sofa,25,0,21375,51,267,544,965,767,698,223,couch
16475,27,table,28,0,21375,42,321,380,445,538,124,158,dining table
16476,13,vase,14,0,21376,20,2072,649,2135,852,63,203,vase
16477,20,sofa,21,0,21376,70,518,1069,1942,1510,1424,441,couch
16478,11,window,12,0,21377,21,0,236,803,1172,803,936,window
16479,15,sofa,16,0,21377,81,551,815,1519,1493,968,678,couch
16480,11,window,12,0,21378,40,80,230,426,507,346,277,window
16481,12,sofa,13,0,21378,52,178,402,496,644,318,242,couch
16482,14,sofa,15,0,21379,53,478,773,1492,1301,1014,528,couch
16483,13,sofa,14,0,21380,22,1699,834,2047,1378,348,544,couch
16484,17,plant pot,18,0,21380,18,1284,886,1459,1106,175,220,potted plant
16485,20,vase,21,0,21380,26,1306,239,1394,397,88,158,vase
16486,21,vase,22,0,21380,24,560,220,652,389,92,169,vase
16487,33,bowl,34,0,21380,25,1369,1088,1494,1158,125,70,bowl
16488,35,book,36,0,21380,24,1626,1262,1952,1375,326,113,book
16489,11,sofa,12,0,21382,37,1251,759,1862,1313,611,554,couch
16490,7,sofa,8,0,21383,19,1893,822,2199,997,306,175,couch
16491,25,ball,26,0,21383,20,569,876,695,1006,126,130,sports ball
16492,36,vase,37,1,21383,17,1249,710,1280,771,31,61,vase
16493,13,sofa,14,0,21384,28,1185,1055,2085,1650,900,595,couch
16494,19,sofa,20,0,21384,50,483,974,1195,1449,712,475,couch
16495,19,window,20,0,21385,20,414,72,717,673,303,601,window
16496,21,sofa,22,1,21385,60,49,624,937,1173,888,549,couch
16497,32,bowl,33,0,21385,23,1127,805,1265,889,138,84,bowl
16498,20,chair,21,1,21386,32,2017,829,2199,1179,182,350,chair
16499,29,window,30,0,21386,20,663,133,861,672,198,539,window
16500,32,sofa,33,0,21386,52,463,753,1338,1480,875,727,couch
16501,36,plate,37,0,21386,24,684,490,856,680,172,190,plate
16502,40,sofa,41,1,21386,17,54,786,259,1485,205,699,couch
16503,6,sofa,7,0,21387,48,807,644,1835,1143,1028,499,couch
16504,9,sofa,10,0,21388,74,108,367,590,617,482,250,couch
16505,12,window,13,0,21388,23,756,1,1023,353,267,352,window
16506,6,window,7,0,21389,22,813,0,1024,438,211,438,window
16507,15,sofa,16,0,21389,20,628,467,1023,768,395,301,couch
16508,18,sofa,19,0,21390,59,168,319,628,572,460,253,couch
16509,10,chair,11,1,21391,20,593,446,670,548,77,102,chair
16510,11,chair,12,0,21391,31,369,384,463,538,94,154,chair
16511,12,table,13,0,21391,31,471,417,577,544,106,127,dining table
16512,19,sofa,20,1,21391,26,892,564,1024,768,132,204,couch
16513,9,sofa,10,0,21392,59,656,702,2021,1444,1365,742,couch
16514,20,television,21,0,21392,16,45,446,434,1055,389,609,tv
16515,22,chair,23,1,21393,22,453,709,556,843,103,134,chair
16516,26,sofa,27,0,21393,39,590,753,1399,1138,809,385,couch
16517,27,sofa,28,0,21393,30,1,763,584,1251,583,488,couch
16518,33,clock,34,0,21393,17,840,0,1050,160,210,160,clock
16519,12,window,13,0,21394,22,827,143,1092,516,265,373,window
16520,15,chair,16,1,21394,35,992,409,1076,633,84,224,chair
16521,16,chair,17,1,21394,17,1021,432,1080,626,59,194,chair
16522,24,window,25,0,21394,57,1,92,391,544,390,452,window
16523,25,sofa,26,0,21394,49,0,470,310,876,310,406,couch
16524,12,window,13,0,21395,43,706,198,1390,785,684,587,window
16525,14,television,15,0,21395,17,1539,807,1734,977,195,170,tv
16526,16,sofa,17,1,21395,148,653,785,1451,1127,798,342,couch
16527,17,person,18,0,21395,66,968,725,1203,1179,235,454,person
16528,18,person,19,0,21395,95,587,705,929,1164,342,459,person
16529,19,sofa,20,1,21395,169,100,898,692,1410,592,512,couch
16530,21,person,22,1,21395,116,357,839,981,1315,624,476,person
16531,22,person,23,1,21395,101,224,879,836,1405,612,526,person
16532,24,person,25,1,21395,81,88,1104,765,1535,677,431,person
16533,26,sofa,27,1,21395,122,1638,877,2047,1372,409,495,couch
16534,27,person,28,1,21395,119,1458,814,1996,1265,538,451,person
16535,28,person,29,1,21395,82,1558,1013,2047,1354,489,341,person
16536,29,chair,30,1,21395,25,1758,1310,2047,1533,289,223,chair
16537,10,sofa,11,0,21396,94,0,662,1225,1331,1225,669,couch
16538,20,vase,21,0,21397,16,1786,528,1856,615,70,87,vase
16539,26,chair,27,1,21397,44,1182,632,1454,828,272,196,chair
16540,32,sofa,33,1,21397,69,813,804,1736,1439,923,635,couch
16541,34,bowl,35,0,21397,16,604,771,755,836,151,65,bowl
16542,35,vase,36,0,21397,18,745,751,834,860,89,109,vase
16543,36,bowl,37,0,21397,20,1371,825,1509,911,138,86,bowl
16544,39,table,40,1,21397,33,631,608,993,804,362,196,dining table
16545,41,window,42,0,21397,21,539,269,849,623,310,354,window
16546,49,chair,50,1,21397,28,538,604,710,790,172,186,chair
16547,50,chair,51,1,21397,30,270,661,319,909,49,248,chair
16548,53,bottle,54,0,21397,27,733,434,808,640,75,206,bottle
16549,57,chair,58,1,21397,18,203,1369,373,1535,170,166,chair
16550,8,vase,9,0,21398,23,461,315,513,385,52,70,vase
16551,9,sofa,10,1,21398,40,531,338,1152,513,621,175,couch
16552,12,vase,13,0,21398,23,657,382,796,507,139,125,vase
16553,18,sofa,19,0,21399,90,83,419,1024,768,941,349,couch
16554,9,sofa,10,0,21400,132,924,569,2196,1113,1272,544,couch
16555,29,window,30,0,21400,31,1039,145,1321,625,282,480,window
16556,44,window,45,0,21400,27,1,127,371,973,370,846,window
16557,45,window,46,0,21400,50,381,185,690,836,309,651,window
16558,46,chair,47,1,21400,71,96,737,450,1229,354,492,chair
16559,47,table,48,0,21400,71,42,823,707,1307,665,484,dining table
16560,58,bowl,59,0,21400,17,160,777,238,856,78,79,bowl
16561,12,window,13,0,21401,50,669,86,963,765,294,679,window
16562,7,window,8,0,21402,21,0,218,291,704,291,486,window
16563,13,sofa,14,1,21402,23,1,606,215,882,214,276,couch
16564,5,window,6,0,21403,16,0,0,237,412,237,412,window
16565,8,window,9,0,21403,16,361,5,588,214,227,209,window
16566,9,window,10,0,21403,15,922,0,1196,161,274,161,window
16567,24,sofa,25,0,21403,36,1,391,435,821,434,430,couch
16568,8,window,9,0,21404,17,151,89,618,856,467,767,window
16569,9,window,10,0,21404,19,1168,108,1450,717,282,609,window
16570,12,sofa,13,0,21404,110,383,613,1984,1372,1601,759,couch
16571,7,window,8,0,21405,67,1143,0,2194,767,1051,767,window
16572,14,sofa,15,0,21405,76,3,451,993,1152,990,701,couch
16573,15,chair,16,0,21405,31,1721,707,2016,1109,295,402,chair
16574,16,chair,17,0,21405,29,1475,662,1765,1055,290,393,chair
16575,17,table,18,0,21405,17,1134,677,1493,985,359,308,dining table
16576,18,chair,19,1,21405,18,1148,660,1309,934,161,274,chair
16577,19,chair,20,1,21405,19,1274,723,1486,981,212,258,chair
16578,47,sofa,48,0,21406,52,0,801,719,1475,719,674,couch
16579,52,bowl,53,0,21406,33,791,886,922,1056,131,170,bowl
16580,26,sofa,27,0,21407,85,358,333,1023,767,665,434,couch
16581,31,chair,32,1,21407,24,0,542,207,767,207,225,chair
16582,9,window,10,0,21408,19,416,140,552,592,136,452,window
16583,18,plant pot,19,0,21408,24,378,562,470,656,92,94,potted plant
16584,20,sofa,21,1,21408,34,0,448,255,665,255,217,couch
16585,22,dog,23,0,21408,28,94,537,241,610,147,73,dog
16586,17,sofa,18,0,21409,27,1,394,354,704,353,310,couch
16587,26,window,27,0,21409,32,953,58,1119,668,166,610,window
16588,30,plant pot,31,0,21409,19,783,530,871,586,88,56,potted plant
16589,42,clock,43,0,21409,17,701,173,745,218,44,45,clock
16590,13,window,14,0,21410,15,732,0,1174,732,442,732,window
16591,15,window,16,0,21410,33,0,0,582,1157,582,1157,window
16592,21,sofa,22,0,21410,41,356,653,1262,1254,906,601,couch
16593,22,sofa,23,0,21410,37,1384,692,2199,1298,815,606,couch
16594,44,bowl,45,0,21410,17,1270,1062,1466,1196,196,134,bowl
16595,12,bed,13,1,21411,17,1701,727,1843,838,142,111,bed
16596,17,chair,18,1,21411,43,1717,813,1982,1488,265,675,chair
16597,24,television,25,0,21411,22,802,636,1198,991,396,355,tv
16598,33,window,34,0,21411,20,3,398,245,1172,242,774,window
16599,35,sofa,36,0,21411,36,756,1073,1641,1488,885,415,couch
16600,18,door,19,0,21412,16,2,168,224,1160,222,992,door
16601,20,window,21,0,21412,29,705,221,927,758,222,537,window
16602,24,vase,25,0,21412,15,691,749,774,877,83,128,vase
16603,27,chair,28,0,21412,40,1426,787,1767,1239,341,452,chair
16604,28,chair,29,1,21412,27,1507,751,1774,1117,267,366,chair
16605,29,chair,30,1,21412,27,1552,725,1809,1053,257,328,chair
16606,32,sofa,33,0,21412,83,141,829,1219,1443,1078,614,couch
16607,45,table,46,1,21412,16,597,860,802,904,205,44,dining table
16608,20,sofa,21,0,21413,73,469,726,1261,1228,792,502,couch
16609,22,table,23,1,21413,23,1233,736,1437,881,204,145,dining table
16610,23,chair,24,1,21413,32,1269,710,1382,870,113,160,chair
16611,36,plant pot,37,1,21413,18,1,1069,276,1463,275,394,potted plant
16612,38,sofa,39,0,21414,52,1445,827,2083,1467,638,640,couch
16613,40,sofa,41,0,21414,59,567,675,1094,1146,527,471,couch
16614,46,bowl,47,0,21414,23,1206,871,1282,956,76,85,bowl
16615,55,window,56,0,21414,28,658,366,806,593,148,227,window
16616,56,window,57,0,21414,42,535,359,660,576,125,217,window
16617,57,table,58,1,21414,22,468,565,655,735,187,170,dining table
16618,60,chair,61,0,21414,30,416,556,579,759,163,203,chair
16619,61,chair,62,0,21414,33,591,548,725,749,134,201,chair
16620,62,chair,63,1,21414,29,596,518,711,631,115,113,chair
16621,63,chair,64,1,21414,39,430,519,574,640,144,121,chair
16622,67,desk,68,0,21414,48,132,518,453,668,321,150,desk
16623,68,chair,69,1,21414,34,279,511,393,673,114,162,chair
16624,72,chair,73,1,21414,27,200,589,303,921,103,332,chair
16625,73,chair,74,1,21414,20,68,563,156,622,88,59,chair
16626,81,vase,82,0,21414,40,1534,396,1594,556,60,160,vase
16627,11,sofa,12,0,21415,39,0,590,625,1342,625,752,couch
16628,12,sofa,13,0,21415,62,626,522,1799,1039,1173,517,couch
16629,13,sofa,14,0,21415,38,1380,696,2184,1650,804,954,couch
16630,8,sofa,9,0,21416,36,78,1033,902,1707,824,674,couch
16631,9,chair,10,0,21416,46,982,1016,1464,1688,482,672,chair
16632,12,window,13,0,21417,57,0,133,350,357,350,224,window
16633,13,sofa,14,0,21417,71,71,325,418,497,347,172,couch
16634,11,sofa,12,0,21418,52,852,646,1861,991,1009,345,couch
16635,14,chair,15,0,21418,50,1577,593,2154,1172,577,579,chair
16636,17,chair,18,1,21418,16,0,875,130,1277,130,402,chair
16637,15,chair,16,1,21419,28,1060,570,1228,879,168,309,chair
16638,16,plant pot,17,0,21419,17,1023,579,1118,689,95,110,potted plant
16639,18,sofa,19,0,21419,43,486,323,918,481,432,158,couch
16640,19,sofa,20,0,21419,54,150,419,976,907,826,488,couch
16641,10,sofa,11,0,21420,92,502,548,1220,979,718,431,couch
16642,14,chair,15,1,21420,18,710,897,1180,979,470,82,chair
16643,15,chair,16,1,21420,15,113,932,633,979,520,47,chair
16644,7,window,8,0,21421,62,1187,148,1898,935,711,787,window
16645,15,sofa,16,0,21421,148,818,851,1893,1473,1075,622,couch
16646,5,window,6,0,21422,47,2,0,836,827,834,827,window
16647,10,chair,11,1,21422,17,1982,1036,2197,1248,215,212,chair
16648,11,sofa,12,0,21422,43,81,724,1816,1387,1735,663,couch
16649,13,book,14,0,21422,20,1189,991,1626,1097,437,106,book
16650,19,sofa,20,1,21423,20,1507,1127,2197,1648,690,521,couch
16651,20,sofa,21,1,21423,27,0,1038,755,1648,755,610,couch
16652,8,mirror,9,0,21424,18,0,0,344,658,344,658,mirror
16653,11,door,12,0,21424,19,1193,334,1343,619,150,285,door
16654,25,sofa,26,0,21424,42,0,597,581,987,581,390,couch
16655,29,sofa,30,0,21424,88,703,594,1343,987,640,393,couch
16656,33,ball,34,0,21424,16,921,823,976,876,55,53,sports ball
16657,35,ball,36,0,21424,22,906,900,977,972,71,72,sports ball
16658,37,ball,38,0,21424,17,834,869,887,918,53,49,sports ball
16659,43,chair,44,1,21424,27,915,494,1079,613,164,119,chair
16660,44,chair,45,1,21424,27,1079,495,1236,619,157,124,chair
16661,45,chair,46,1,21424,18,1217,487,1317,621,100,134,chair
16662,46,window,47,0,21424,17,1353,332,1499,520,146,188,window
16663,48,chair,49,1,21424,33,1358,499,1438,658,80,159,chair
16664,49,chair,50,1,21424,17,1434,508,1499,674,65,166,chair
16665,50,table,51,1,21424,31,1392,520,1436,664,44,144,dining table
16666,26,sofa,27,0,21425,72,965,608,1279,959,314,351,couch
16667,36,sofa,37,0,21425,84,201,621,517,959,316,338,couch
16668,38,plant pot,39,0,21425,27,341,759,424,830,83,71,potted plant
16669,62,person,62,1,21425,26,1108,390,1158,614,50,224,person
16670,17,door,18,0,21426,37,678,376,795,628,117,252,door
16671,20,table,21,1,21426,23,431,536,530,638,99,102,dining table
16672,22,window,23,0,21426,32,937,367,1119,580,182,213,window
16673,23,table,24,0,21426,27,920,564,1111,706,191,142,dining table
16674,26,window,27,0,21426,15,1347,297,1442,658,95,361,window
16675,32,sofa,33,1,21426,37,771,597,1104,836,333,239,couch
16676,5,window,6,0,21427,36,758,32,2149,974,1391,942,window
16677,6,sofa,7,0,21427,65,514,737,2061,1433,1547,696,couch
16678,11,vase,12,0,21427,16,635,1109,758,1353,123,244,vase
16679,13,book,14,0,21427,18,854,1288,1458,1466,604,178,book
16680,18,window,19,0,21428,36,1300,248,1477,667,177,419,window
16681,20,window,21,0,21428,19,1035,239,1209,780,174,541,window
16682,22,window,23,0,21428,24,100,122,391,854,291,732,window
16683,26,sofa,27,0,21428,65,1101,637,1819,1062,718,425,couch
16684,37,bowl,38,0,21428,15,1238,642,1298,691,60,49,bowl
16685,42,vase,43,0,21428,20,573,315,627,424,54,109,vase
16686,43,vase,44,0,21428,20,871,335,919,441,48,106,vase
16687,10,sofa,11,1,21429,33,744,460,1024,740,280,280,couch
16688,13,sofa,14,0,21429,16,691,352,876,489,185,137,couch
16689,22,sofa,23,0,21429,27,0,447,383,768,383,321,couch
16690,5,window,6,0,21430,17,873,33,1086,486,213,453,window
16691,7,window,8,0,21430,27,284,23,860,450,576,427,window
16692,9,sofa,10,0,21430,64,291,429,952,728,661,299,couch
16693,22,chair,22,1,21430,35,41,450,143,735,102,285,chair
16694,25,plant pot,25,0,21430,15,227,488,283,534,56,46,potted plant
16695,27,plant pot,27,1,21430,17,214,511,269,548,55,37,potted plant
16696,29,plant pot,29,1,21430,16,150,483,218,515,68,32,potted plant
16697,32,plant pot,32,0,21430,21,140,511,216,566,76,55,potted plant
16698,34,plant pot,34,1,21430,19,71,480,127,537,56,57,potted plant
16699,12,television,13,0,21431,18,26,421,223,598,197,177,tv
16700,19,sofa,20,1,21431,28,729,629,1348,1011,619,382,couch
16701,5,door,6,0,21432,18,725,83,998,635,273,552,door
16702,11,television,12,0,21432,26,167,370,402,558,235,188,tv
16703,22,chair,23,1,21432,66,474,401,704,655,230,254,chair
16704,24,sofa,25,0,21432,25,1,648,990,799,989,151,couch
16705,8,window,9,0,21433,26,725,202,1014,450,289,248,window
16706,9,door,10,0,21433,22,192,120,440,531,248,411,door
16707,13,sofa,14,0,21433,67,532,436,1073,760,541,324,couch
16708,17,sofa,18,0,21433,36,0,483,530,960,530,477,couch
16709,24,television,25,0,21433,19,1194,446,1279,734,85,288,tv
16710,21,table,22,1,21434,28,545,802,628,890,83,88,dining table
16711,25,window,26,0,21434,28,1486,391,2129,1031,643,640,window
16712,30,chair,31,1,21434,15,1995,1073,2135,1381,140,308,chair
16713,31,window,32,0,21434,39,980,539,1211,883,231,344,window
16714,32,window,33,0,21434,44,825,575,905,846,80,271,window
16715,37,table,38,0,21434,54,828,811,1044,994,216,183,dining table
16716,40,door,41,0,21434,24,516,560,795,958,279,398,door
16717,5,sofa,6,0,21435,190,734,564,2048,1533,1314,969,couch
16718,17,chair,18,1,21435,97,664,1027,1931,1535,1267,508,chair
16719,23,window,23,0,21435,31,778,187,982,480,204,293,window
16720,24,table,24,1,21435,24,803,478,1005,637,202,159,dining table
16721,25,chair,25,1,21435,40,748,398,873,656,125,258,chair
16722,26,chair,26,1,21435,23,849,413,1006,574,157,161,chair
16723,29,chair,29,1,21435,41,458,521,700,847,242,326,chair
16724,32,window,32,0,21435,23,0,0,342,583,342,583,window
16725,36,sofa,36,0,21435,37,1,521,527,1090,526,569,couch
16726,10,window,11,0,21436,16,1,133,379,632,378,499,window
16727,13,window,14,0,21436,21,621,163,812,572,191,409,window
16728,14,sofa,15,0,21436,53,850,495,1259,645,409,150,couch
16729,15,sofa,16,0,21436,40,735,613,1228,869,493,256,couch
16730,22,sofa,23,0,21436,50,487,482,796,691,309,209,couch
16731,30,clock,31,0,21436,22,409,545,436,612,27,67,clock
16732,33,vase,34,0,21436,20,741,764,793,828,52,64,vase
16733,35,vase,36,0,21436,16,689,757,724,817,35,60,vase
16734,12,window,13,0,21437,39,448,250,683,449,235,199,window
16735,20,sofa,21,0,21437,57,289,391,660,662,371,271,couch
16736,22,oven,23,0,21438,18,1761,568,1949,716,188,148,oven
16737,26,chair,27,0,21438,50,1429,608,1665,1091,236,483,chair
16738,27,chair,28,1,21438,27,1610,626,1785,915,175,289,chair
16739,28,chair,29,1,21438,28,1770,639,1960,934,190,295,chair
16740,31,sofa,32,0,21438,98,186,723,1426,1366,1240,643,couch
16741,39,window,40,0,21438,48,2,35,1302,878,1300,843,window
16742,40,plant pot,41,0,21438,16,2,886,196,1070,194,184,potted plant
16743,49,sofa,50,1,21438,40,1351,1345,2199,1649,848,304,couch
16744,22,table,23,0,21439,15,487,559,641,654,154,95,dining table
16745,28,sofa,29,0,21439,32,230,635,800,1021,570,386,couch
16746,35,table,36,0,21439,16,1,692,90,914,89,222,dining table
16747,20,window,21,0,21440,32,1344,434,1473,720,129,286,window
16748,25,chair,26,0,21440,37,2033,734,2199,986,166,252,chair
16749,44,plant pot,44,0,21440,17,596,366,679,422,83,56,potted plant
16750,54,plate,54,0,21440,16,1,226,85,288,84,62,plate
16751,60,sofa,60,0,21440,78,988,691,1794,1444,806,753,couch
16752,9,chair,10,0,21441,46,1756,197,2132,578,376,381,chair
16753,11,chair,12,0,21441,36,1031,5,1303,373,272,368,chair
16754,16,sofa,17,0,21441,50,973,514,2058,1392,1085,878,couch
16755,12,television,12,0,21442,24,136,743,679,1130,543,387,tv
16756,11,window,12,0,21443,15,0,338,395,1072,395,734,window
16757,25,sofa,25,1,21443,47,1257,931,2016,1301,759,370,couch
16758,26,sofa,26,0,21443,27,521,1200,2189,1650,1668,450,couch
16759,31,table,31,0,21443,23,557,1060,1125,1510,568,450,dining table
16760,16,sofa,17,1,21444,106,69,538,818,768,749,230,couch
16761,18,vase,19,0,21444,32,340,584,528,668,188,84,vase
16762,14,window,14,0,21445,28,1568,243,1959,446,391,203,window
16763,15,window,15,0,21445,25,2006,258,2199,458,193,200,window
16764,33,vase,33,0,21445,28,1920,767,2078,929,158,162,vase
16765,16,door,17,0,21446,16,901,539,1181,1353,280,814,door
16766,29,chair,30,0,21446,29,1069,1105,1369,1638,300,533,chair
16767,30,chair,31,1,21446,28,1430,1235,1823,1647,393,412,chair
16768,33,table,34,0,21446,49,1124,1159,2173,1638,1049,479,dining table
16769,8,door,9,0,21447,16,541,866,804,1234,263,368,door
16770,20,person,21,0,21447,45,924,1102,1071,1367,147,265,person
16771,21,dog,22,1,21447,46,859,1185,974,1375,115,190,dog
16772,26,table,27,0,21447,28,291,1118,748,1318,457,200,dining table
16773,28,chair,29,1,21447,22,558,1094,696,1329,138,235,chair
16774,16,window,17,0,21448,63,1095,223,1743,800,648,577,window
16775,19,table,20,1,21448,40,1339,739,1563,901,224,162,dining table
16776,28,sofa,29,1,21448,85,586,800,1663,1461,1077,661,couch
16777,30,balls,31,0,21448,29,1277,855,1446,899,169,44,sports ball
16778,38,window,39,0,21448,17,889,253,1019,756,130,503,window
16779,43,boat,44,0,21448,65,641,182,903,580,262,398,boat
16780,11,sofa,12,1,21449,23,1021,407,1067,800,46,393,couch
16781,22,table,23,0,21449,42,582,214,711,309,129,95,dining table
16782,23,chair,24,1,21449,27,629,215,668,309,39,94,chair
16783,26,chair,27,1,21449,54,489,208,573,342,84,134,chair
16784,28,window,29,0,21449,16,365,53,511,246,146,193,window
16785,30,window,31,0,21449,16,0,15,171,339,171,324,window
16786,33,sofa,34,0,21449,34,0,272,255,591,255,319,couch
16787,38,chair,39,1,21449,37,66,557,545,799,479,242,chair
16788,20,table,21,0,21450,16,1133,405,1289,552,156,147,dining table
16789,23,chair,24,0,21450,23,966,423,1123,602,157,179,chair
16790,24,chair,25,1,21450,18,748,424,901,573,153,149,chair
16791,26,table,27,0,21450,34,662,398,790,541,128,143,dining table
16792,28,window,29,0,21450,15,351,114,539,487,188,373,window
16793,29,sofa,30,0,21450,79,236,440,738,731,502,291,couch
16794,36,chair,37,1,21450,38,238,668,751,864,513,196,chair
16795,12,window,13,0,21451,17,698,243,1085,408,387,165,window
16796,14,sofa,15,1,21451,40,431,358,939,542,508,184,couch
16797,15,sofa,16,1,21451,46,375,432,981,869,606,437,couch
16798,10,refrigerator,11,0,21452,20,1571,328,2030,1035,459,707,refrigerator
16799,22,vase,23,0,21452,20,128,258,221,358,93,100,vase
16800,23,vase,24,0,21452,20,1,190,99,359,98,169,vase
16801,34,window,35,0,21453,19,157,256,263,570,106,314,window
16802,36,window,37,0,21453,26,29,260,110,645,81,385,window
16803,41,sofa,42,0,21453,35,0,569,452,959,452,390,couch
16804,8,window,9,0,21454,51,759,145,926,521,167,376,window
16805,11,window,12,0,21454,19,523,145,649,411,126,266,window
16806,12,window,13,0,21454,26,267,152,416,417,149,265,window
16807,14,sofa,15,1,21454,54,196,386,696,621,500,235,couch
16808,13,window,14,0,21455,32,2,285,165,513,163,228,window
16809,16,sofa,17,0,21455,63,148,495,567,677,419,182,couch
16810,27,sofa,28,0,21455,103,403,560,1018,845,615,285,couch
16811,29,mirror,30,0,21455,16,1176,260,1280,598,104,338,mirror
16812,32,chair,33,1,21455,31,885,645,1216,959,331,314,chair
16813,11,sofa,12,0,21456,54,771,936,1492,1340,721,404,couch
16814,23,sofa,24,0,21456,44,2,991,739,1696,737,705,couch
16815,33,chair,34,1,21456,48,1163,1106,1480,1851,317,745,chair
16816,10,window,11,0,21457,17,16,71,540,1051,524,980,window
16817,12,table,13,1,21457,18,840,1614,2199,1915,1359,301,dining table
16818,17,sofa,18,1,21457,54,4,997,1247,1655,1243,658,couch
16819,18,window,19,0,21458,17,251,260,482,476,231,216,window
16820,22,sofa,23,0,21458,54,449,407,915,584,466,177,couch
16821,48,bowl,49,0,21459,19,103,237,198,284,95,47,bowl
16822,9,sofa,10,0,21460,36,1062,915,2116,1264,1054,349,couch
16823,9,vase,10,0,21461,16,811,225,917,339,106,114,vase
16824,15,sofa,16,0,21461,59,0,1023,2047,1536,2047,513,couch
16825,8,window,9,0,21462,23,719,412,1190,679,471,267,window
16826,16,bench,17,0,21462,71,655,641,1064,951,409,310,bench
16827,20,sofa,21,0,21462,118,1071,633,1926,1336,855,703,couch
16828,26,vase,27,0,21462,22,1159,792,1259,925,100,133,vase
16829,33,person,34,1,21462,23,2086,1542,2199,1649,113,107,person
16830,13,sofa,13,0,21463,62,607,437,880,670,273,233,couch
16831,23,chair,23,0,21463,26,250,420,411,608,161,188,chair
16832,29,bowl,29,0,21463,22,208,474,267,512,59,38,bowl
16833,2,window,3,0,23761,23,27,222,160,648,133,426,window
16834,7,window,8,0,23761,16,916,285,1035,501,119,216,window
16835,13,sofa,14,0,23761,21,3,638,281,1024,278,386,couch
16836,6,sofa,7,0,23762,78,1,268,572,676,571,408,couch
16837,10,vase,11,0,23762,30,456,438,515,570,59,132,vase
16838,11,pot,12,0,23762,16,569,458,630,529,61,71,potted plant
16839,12,mirror,13,0,23763,22,346,174,577,281,231,107,mirror
16840,7,sofa,8,0,23764,33,468,274,1022,619,554,345,couch
16841,3,window,4,0,23765,25,911,165,1145,562,234,397,window
16842,4,window,5,0,23765,23,228,179,535,404,307,225,window
16843,7,sofa,8,1,23765,64,118,387,666,667,548,280,couch
16844,8,sofa,9,0,23765,51,680,385,1124,670,444,285,couch
16845,22,vase,23,0,23765,20,83,450,131,526,48,76,vase
16846,3,sofa,4,0,23766,29,1,549,600,846,599,297,couch
16847,7,chair,8,0,23767,58,1,96,181,300,180,204,chair
16848,8,chair,9,0,23767,48,231,77,356,245,125,168,chair
16849,9,sofa,10,0,23767,27,466,125,629,323,163,198,couch
16850,20,chair,21,0,23767,18,0,290,295,486,295,196,chair
16851,3,sofa,4,0,23768,69,234,391,511,540,277,149,couch
16852,4,table,5,0,23768,23,372,406,522,546,150,140,dining table
16853,5,chair,6,0,23768,44,337,414,441,571,104,157,chair
16854,6,chair,7,1,23768,29,500,396,574,529,74,133,chair
16855,7,chair,8,0,23768,42,477,405,562,548,85,143,chair
16856,9,window,10,0,23768,25,585,134,708,381,123,247,window
16857,18,book,19,0,23768,17,389,412,445,431,56,19,book
16858,25,plant pot,26,0,23768,18,759,454,808,520,49,66,potted plant
16859,4,window,5,0,23769,29,197,59,334,429,137,370,window
16860,11,sofa,12,0,23769,83,528,312,1023,623,495,311,couch
16861,10,window,11,0,23770,35,607,348,762,541,155,193,window
16862,11,window,12,0,23770,26,276,352,429,525,153,173,window
16863,42,sofa,43,0,23770,124,242,478,745,682,503,204,couch
16864,57,vase,58,0,23770,23,657,485,691,568,34,83,vase
16865,6,sofa,7,0,23771,27,26,324,169,485,143,161,couch
16866,9,plate,10,0,23771,17,16,392,74,420,58,28,plate
16867,1,sofa,2,1,23772,34,1,93,816,816,815,723,couch
16868,2,window,3,0,23773,22,134,44,335,337,201,293,window
16869,5,sofa,6,0,23773,30,417,232,598,349,181,117,couch
16870,13,table,14,0,23773,18,2,267,47,433,45,166,dining table
16871,14,vase,15,0,23773,19,266,184,318,238,52,54,vase
16872,10,chair,11,1,23775,43,293,1,464,249,171,248,chair
16873,11,chair,12,1,23775,17,212,72,270,213,58,141,chair
16874,16,sofa,17,0,23775,45,1212,16,1599,271,387,255,couch
16875,2,window,3,0,23776,20,736,203,925,633,189,430,window
16876,7,mirror,8,0,23776,88,54,1,431,659,377,658,mirror
16877,28,chair,29,0,23776,64,1061,488,1297,856,236,368,chair
16878,30,chair,31,1,23776,40,740,467,904,698,164,231,chair
16879,35,sofa,36,0,23776,30,2,696,1117,891,1115,195,couch
16880,3,chair,4,0,23777,21,399,582,527,765,128,183,chair
16881,7,table,8,0,11601,16,247,320,359,422,112,102,dining table
16882,8,chair,9,0,11604,17,129,79,182,161,53,82,chair
16883,6,bed,7,0,11605,28,309,277,635,467,326,190,bed
16884,11,table,12,1,11605,17,0,535,203,761,203,226,dining table
16885,19,chair,20,0,11605,32,820,377,962,573,142,196,chair
16886,24,umbrella,25,0,11605,19,133,336,254,446,121,110,umbrella
16887,5,table,6,1,220,18,0,301,536,387,536,86,dining table
16888,6,person,7,1,220,47,413,92,620,387,207,295,person
16889,15,person,16,1,220,88,330,0,620,313,290,313,person
16890,21,person,22,1,220,65,159,117,382,310,223,193,person
16891,29,person,30,1,220,60,1,34,269,324,268,290,person
16892,42,bowl,43,1,220,16,226,310,299,354,73,44,bowl
16893,43,bowl,44,1,220,15,209,321,284,369,75,48,bowl
16894,1,table,2,0,221,38,1,482,999,621,998,139,dining table
16895,5,person,6,1,221,46,743,16,999,502,256,486,person
16896,10,person,11,1,221,73,62,22,528,436,466,414,person
16897,15,person,16,1,221,45,364,179,705,520,341,341,person
16898,22,person,23,1,221,74,111,60,579,566,468,506,person
16899,29,person,30,1,221,38,1,36,214,606,213,570,person
16900,15,cup,16,0,13867,16,463,303,520,339,57,36,cup
16901,5,clock,6,0,13868,16,95,72,123,106,28,34,clock
16902,27,mirror,28,0,13872,15,53,271,114,404,61,133,mirror
16903,4,door,5,1,13879,18,2,0,84,766,82,766,door
16904,8,chair,9,0,13880,58,7,1003,405,1854,398,851,chair
16905,4,bed,5,0,13881,57,0,0,267,233,267,233,bed
16906,2,sofa,3,1,13886,20,170,147,254,223,84,76,couch
16907,9,person,10,0,13888,32,197,167,247,240,50,73,person
16908,3,chair,4,0,13895,25,219,174,301,253,82,79,chair
16909,3,bed,4,0,13896,47,251,340,703,598,452,258,bed
16910,10,window,11,0,13896,16,309,206,506,369,197,163,window
16911,6,chair,7,1,13900,27,2,187,158,449,156,262,chair
16912,1,table,2,0,13901,37,135,180,199,255,64,75,dining table
16913,7,sofa,8,0,13901,35,155,143,238,210,83,67,couch
16914,7,window,8,1,13902,31,460,153,685,354,225,201,window
16915,9,window,10,1,13902,21,0,148,117,352,117,204,window
16916,17,chair,18,1,13902,41,0,469,172,714,172,245,chair
16917,4,person,5,1,13903,43,62,177,163,441,101,264,person
16918,9,window,10,0,13907,27,396,450,1043,1221,647,771,window
16919,4,bed,5,1,13910,21,0,165,75,319,75,154,bed
16920,6,chair,7,0,13910,30,280,187,375,319,95,132,chair
16921,0,chair,1,0,13916,18,231,373,473,638,242,265,chair
16922,0,bed,1,1,13918,28,163,114,256,230,93,116,bed
16923,8,chair,9,0,13918,26,35,118,81,181,46,63,chair
16924,2,window,3,0,23927,18,1,1,400,255,399,254,window
16925,2,door,3,0,23929,19,239,71,354,471,115,400,door
16926,10,chair,11,0,23929,44,440,367,552,482,112,115,chair
16927,11,window,12,0,23929,22,385,119,685,384,300,265,window
16928,3,bed,4,0,23930,46,18,346,681,903,663,557,bed
16929,19,dog,20,0,23931,45,358,966,487,1169,129,203,dog
16930,1,person,2,1,23932,30,359,333,538,508,179,175,person
16931,2,person,3,0,23933,129,398,607,1949,1170,1551,563,person
16932,4,door,5,0,23934,15,1316,1,1599,1064,283,1063,door
16933,10,bed,11,0,23935,90,175,287,1966,1616,1791,1329,bed
16934,27,umbrella,28,0,23935,28,2028,336,2090,648,62,312,umbrella
16935,1,window,2,1,13927,51,58,1,273,121,215,120,window
16936,2,bed,3,1,13927,70,0,93,299,273,299,180,bed
16937,3,person,4,0,13927,52,111,59,217,299,106,240,person
16938,4,person,5,1,13927,59,153,15,299,206,146,191,person
16939,8,person,9,0,13928,49,126,55,216,210,90,155,person
16940,18,clock,19,0,13928,15,172,0,187,23,15,23,clock
16941,0,window,1,1,13929,40,2,1,215,240,213,239,window
16942,4,person,5,1,13929,29,205,26,332,362,127,336,person
16943,9,person,10,0,13929,64,8,58,333,498,325,440,person
16944,15,person,16,1,13930,22,60,165,121,307,61,142,person
16945,16,person,17,1,13930,17,153,219,220,272,67,53,person
16946,18,table,19,1,13930,19,145,305,276,457,131,152,dining table
16947,19,person,20,1,13930,26,2,267,86,416,84,149,person
16948,20,person,21,1,13930,32,11,295,194,477,183,182,person
16949,21,person,22,1,13930,33,247,242,335,400,88,158,person
16950,22,person,23,1,13930,32,250,304,429,466,179,162,person
16951,23,person,24,0,13930,38,384,230,487,407,103,177,person
16952,24,person,25,1,13930,30,441,225,511,379,70,154,person
16953,25,table,26,0,13930,16,450,272,596,391,146,119,dining table
16954,6,person,7,0,13931,74,20,17,186,295,166,278,person
16955,8,person,9,0,13931,74,123,17,282,296,159,279,person
16956,4,person,5,1,13932,27,247,34,320,239,73,205,person
16957,5,person,6,1,13932,37,231,48,266,240,35,192,person
16958,6,person,7,1,13932,16,134,49,151,93,17,44,person
16959,7,person,8,1,13932,41,65,34,137,149,72,115,person
16960,8,person,9,1,13932,48,120,48,189,238,69,190,person
16961,9,person,10,1,13932,54,135,49,254,240,119,191,person
16962,10,person,11,1,13932,35,4,62,79,178,75,116,person
16963,11,person,12,0,13932,35,0,114,126,239,126,125,person
16964,12,person,13,1,13932,15,0,156,32,212,32,56,person
16965,13,chair,14,1,13932,31,12,152,136,239,124,87,chair
16966,0,window,1,0,13933,24,29,1,221,169,192,168,window
16967,8,person,9,1,13933,35,33,113,133,264,100,151,person
16968,9,person,10,1,13933,44,117,147,222,289,105,142,person
16969,4,person,5,1,23936,106,29,138,597,1023,568,885,person
16970,5,person,6,1,23936,71,332,213,636,1023,304,810,person
16971,11,person,12,1,23936,23,594,418,681,752,87,334,person
16972,12,person,13,1,23937,38,53,763,272,1187,219,424,person
16973,17,person,18,1,23937,110,1042,322,2046,1536,1004,1214,person
16974,18,person,19,1,23937,120,124,282,1218,1534,1094,1252,person
16975,4,person,5,1,23938,55,818,201,1599,1199,781,998,person
16976,5,person,6,1,23938,69,125,30,1600,1198,1475,1168,person
16977,3,toilet,4,0,14190,33,344,101,691,652,347,551,toilet
16978,8,pot,9,0,944,18,292,39,366,142,74,103,potted plant
16979,9,pot,10,0,944,17,227,38,295,141,68,103,potted plant
16980,10,pot,11,0,944,20,160,38,227,142,67,104,potted plant
16981,41,bottle,42,0,944,23,21,315,64,445,43,130,bottle
16982,42,bottle,43,0,944,19,66,319,92,388,26,69,bottle
16983,50,bottle,51,1,944,15,165,329,180,361,15,32,bottle
16984,51,bottle,52,1,944,15,185,331,205,389,20,58,bottle
16985,53,bottle,54,0,944,22,206,315,236,432,30,117,bottle
16986,54,bottle,55,0,944,20,235,311,266,433,31,122,bottle
16987,55,bottle,56,0,944,16,269,309,298,425,29,116,bottle
16988,56,bottle,57,0,944,16,292,319,328,434,36,115,bottle
16989,22,bottle,23,0,14969,15,462,404,495,450,33,46,bottle
16990,29,bottle,30,1,14969,16,739,260,805,280,66,20,bottle
16991,30,bottle,31,1,14969,15,739,296,818,319,79,23,bottle
16992,93,table,94,0,14969,27,137,698,304,854,167,156,dining table
16993,111,bottle,112,1,14969,16,337,600,351,662,14,62,bottle
16994,25,bowl,26,0,14971,16,193,388,277,438,84,50,bowl
16995,27,table,28,1,14971,17,32,385,471,451,439,66,dining table
16996,28,chair,29,1,14971,15,439,374,566,451,127,77,chair
16997,29,chair,30,1,14971,27,2,286,124,451,122,165,chair
16998,37,bowl,34,1,14974,15,202,360,246,384,44,24,bowl
16999,22,table,23,1,14978,28,2,191,156,310,154,119,dining table
17000,9,sofa,10,0,14979,21,1036,387,1279,723,243,336,couch
17001,70,bottle,71,0,14983,16,399,388,416,415,17,27,bottle
17002,6,bottle,7,0,14986,15,751,561,807,655,56,94,bottle
17003,30,table,31,1,14986,24,2,516,314,871,312,355,dining table
17004,31,chair,32,1,14986,19,2,426,243,777,241,351,chair
17005,32,chair,33,0,14986,30,94,445,365,848,271,403,chair
17006,24,table,25,1,14988,30,2,438,112,649,110,211,dining table
17007,7,blender,8,0,14990,23,178,247,206,300,28,53,blender
17008,27,pots,16,0,14991,16,306,123,353,184,47,61,potted plant
17009,41,bottle,24,0,14991,17,181,428,226,483,45,55,bottle
17010,82,bottle,62,1,14991,16,115,119,131,151,16,32,bottle
17011,83,bottle,63,1,14991,17,125,122,146,190,21,68,bottle
17012,5,bottle,6,0,14992,15,144,25,167,68,23,43,bottle
17013,42,bottle,29,0,14993,21,452,141,499,234,47,93,bottle
17014,43,bottle,30,1,14993,21,428,122,462,234,34,112,bottle
17015,15,blender,16,0,14994,19,177,366,252,579,75,213,blender
17016,18,vase,19,0,14994,17,118,18,246,123,128,105,vase
17017,35,pot,36,0,14994,20,16,4,137,120,121,116,potted plant
17018,15,bottle,16,0,24029,32,175,612,309,767,134,155,bottle
17019,17,bottle,18,0,24029,29,317,434,372,575,55,141,bottle
17020,44,person,45,1,24029,154,416,187,688,766,272,579,person
17021,3,bowl,4,0,24030,15,84,186,215,266,131,80,bowl
17022,13,bowl,14,0,24030,15,387,204,432,254,45,50,bowl
17023,33,bowl,34,0,24030,19,879,486,954,570,75,84,bowl
17024,34,pot,35,0,24030,18,878,408,958,493,80,85,potted plant
17025,35,bottle,36,0,24030,17,805,422,847,586,42,164,bottle
17026,36,bowl,37,0,24030,24,575,528,709,625,134,97,bowl
17027,37,bowl,38,0,24030,18,345,498,469,565,124,67,bowl
17028,43,pot,44,0,24030,20,514,451,591,556,77,105,potted plant
17029,44,pot,45,0,24030,19,592,452,667,531,75,79,potted plant
17030,5,sofa,6,1,15150,18,367,387,479,638,112,251,couch
17031,6,chair,7,1,15150,19,324,251,404,420,80,169,chair
17032,7,chair,8,1,15150,26,45,255,122,433,77,178,chair
17033,8,table,9,0,15150,47,115,291,355,579,240,288,dining table
17034,11,clock,12,0,15150,22,157,76,197,201,40,125,clock
17035,2,sofa,3,1,15152,28,2,857,389,1267,387,410,couch
17036,4,chair,5,1,15152,65,329,748,575,1182,246,434,chair
17037,10,window,11,1,15152,46,1095,38,1399,794,304,756,window
17038,13,desk,14,0,15152,113,1268,689,2012,1326,744,637,desk
17039,8,window,9,0,15153,17,184,1,236,103,52,102,window
17040,5,desk,6,0,15154,42,132,376,413,566,281,190,desk
17041,16,chair,17,0,15155,27,1579,955,1848,1360,269,405,chair
17042,20,chair,21,0,15155,24,89,949,346,1301,257,352,chair
17043,22,chair,23,0,15155,37,384,1071,721,1559,337,488,chair
17044,2,sofa,3,0,15156,59,20,241,367,400,347,159,couch
17045,8,chair,9,0,15156,47,398,195,495,375,97,180,chair
17046,17,window,18,0,15156,25,55,0,292,253,237,253,window
17047,5,sofa,5,0,15157,18,2,452,85,585,83,133,couch
17048,11,sofa,11,0,15157,43,172,389,312,487,140,98,couch
17049,16,chair,16,0,15157,24,105,410,142,483,37,73,chair
17050,7,table,8,0,15158,59,11,266,128,381,117,115,dining table
17051,9,sofa,10,1,15159,24,0,297,243,479,243,182,couch
17052,19,vase,20,0,15159,15,280,370,305,400,25,30,vase
17053,11,table,12,0,15160,44,106,209,226,275,120,66,dining table
17054,11,chair,12,0,15161,15,99,220,120,257,21,37,chair
17055,12,chair,13,0,15161,16,120,221,143,261,23,40,chair
17056,13,chair,14,0,15161,15,145,221,167,257,22,36,chair
17057,15,chair,16,0,15161,15,203,222,221,262,18,40,chair
17058,16,chair,17,0,15161,16,225,222,243,260,18,38,chair
17059,17,chair,18,0,15161,16,248,222,268,261,20,39,chair
17060,20,chair,20,0,15161,18,394,237,437,297,43,60,chair
17061,24,chair,24,0,15161,18,332,224,354,260,22,36,chair
17062,25,chair,25,1,15161,15,337,226,361,262,24,36,chair
17063,26,chair,26,1,15161,21,370,232,404,281,34,49,chair
17064,11,sofa,12,0,15162,25,376,248,505,305,129,57,couch
17065,16,chair,17,1,15162,24,101,244,156,323,55,79,chair
17066,18,chair,19,1,15162,18,187,233,221,286,34,53,chair
17067,2,chair,3,1,15163,23,510,265,639,429,129,164,chair
17068,5,chair,6,0,15163,24,166,196,288,361,122,165,chair
17069,6,chair,7,0,15163,48,2,189,284,478,282,289,chair
17070,6,chair,7,0,15164,23,269,385,323,461,54,76,chair
17071,7,table,8,0,15165,182,620,1148,1138,1649,518,501,dining table
17072,9,chair,10,0,15165,26,452,1004,593,1271,141,267,chair
17073,10,table,11,1,15165,84,1754,1101,2199,1392,445,291,dining table
17074,7,sofa,8,0,15166,31,65,130,177,203,112,73,couch
17075,0,mirror,1,0,15167,30,361,160,1232,1868,871,1708,mirror
17076,7,table,8,1,15167,16,4,1359,209,1859,205,500,dining table
17077,1,sofa,2,1,15168,29,276,1076,964,1428,688,352,couch
17078,16,vase,17,1,15168,16,445,978,541,1105,96,127,vase
17079,25,door,26,1,15168,18,1763,732,1907,1299,144,567,door
17080,30,sofa,31,1,15168,20,1178,1032,1450,1177,272,145,couch
17081,31,chair,32,0,15168,37,1302,1040,1475,1254,173,214,chair
17082,32,chair,33,1,15168,26,896,1019,1055,1228,159,209,chair
17083,16,sofa,17,1,15169,40,0,194,129,282,129,88,couch
17084,3,window,4,0,15171,15,92,61,129,134,37,73,window
17085,7,mirror,8,0,15171,15,44,72,67,100,23,28,mirror
17086,22,sofa,23,1,15172,44,690,689,1168,880,478,191,couch
17087,24,sofa,25,1,15172,40,270,726,933,1069,663,343,couch
17088,35,vase,36,0,15172,16,1528,741,1582,818,54,77,vase
17089,37,chair,38,1,15172,29,1445,845,1598,1133,153,288,chair
17090,40,vase,41,0,15172,17,12,730,127,913,115,183,vase
17091,127,window,128,0,15172,17,962,332,1093,448,131,116,window
17092,5,desk,6,0,15173,32,3,365,637,424,634,59,desk
17093,21,chair,22,1,15174,26,279,487,311,536,32,49,chair
17094,11,chair,12,0,15175,37,340,189,405,270,65,81,chair
17095,12,chair,13,0,15175,38,32,186,91,272,59,86,chair
17096,13,mirror,14,0,15175,51,201,85,244,180,43,95,mirror
17097,9,table,10,0,15176,45,622,1148,1136,1647,514,499,dining table
17098,11,chair,12,0,15176,19,450,1003,598,1271,148,268,chair
17099,15,window,16,0,15176,19,98,315,382,974,284,659,window
17100,5,sofa,6,1,15177,15,35,105,88,156,53,51,couch
17101,12,chair,13,0,15177,21,125,135,185,218,60,83,chair
17102,10,chair,11,0,15178,16,7,275,30,302,23,27,chair
17103,9,chair,10,0,15179,25,360,263,408,331,48,68,chair
17104,11,chair,12,0,15179,23,12,261,54,329,42,68,chair
17105,8,sofa,9,1,15180,37,90,211,325,434,235,223,couch
17106,9,television,10,1,15180,16,4,189,97,388,93,199,tv
17107,4,door,5,0,15181,16,1562,131,1920,1382,358,1251,door
17108,15,sofa,16,0,15181,21,383,1062,825,1333,442,271,couch
17109,20,chair,21,0,15181,16,1378,1077,1513,1286,135,209,chair
17110,24,table,25,1,15181,32,831,1265,1537,1466,706,201,dining table
17111,8,chair,9,1,15182,26,98,174,180,240,82,66,chair
17112,2,window,3,0,15184,18,238,1,298,152,60,151,window
17113,8,sofa,9,0,15184,45,32,133,198,219,166,86,couch
17114,4,person,5,0,15186,62,223,86,296,312,73,226,person
17115,4,sofa,5,0,15187,95,204,318,1014,830,810,512,couch
17116,9,mirror,10,0,15187,25,591,1,819,289,228,288,mirror
17117,23,bottle,24,0,15187,23,999,645,1051,759,52,114,bottle
17118,5,clock,6,0,15188,42,354,315,487,611,133,296,clock
17119,17,table,18,0,15188,18,316,1035,959,1278,643,243,dining table
17120,18,bowl,19,0,15188,16,619,1084,798,1180,179,96,bowl
17121,20,glasses,21,0,15188,17,724,1219,824,1259,100,40,eye glasses
17122,2,chair,3,1,15189,40,0,139,121,247,121,108,chair
17123,4,sofa,5,1,15189,43,8,98,118,163,110,65,couch
17124,12,window,13,1,15189,22,212,39,298,127,86,88,window
17125,13,window,14,1,15189,23,55,39,140,127,85,88,window
17126,16,sofa,17,1,15189,36,228,97,324,162,96,65,couch
17127,20,chair,21,0,15189,44,224,132,355,247,131,115,chair
17128,5,mirror,6,0,15190,15,250,48,290,105,40,57,mirror
17129,16,sofa,17,0,15190,55,67,135,164,205,97,70,couch
17130,8,chair,9,0,15191,28,123,107,160,179,37,72,chair
17131,9,chair,10,1,15191,23,207,127,239,188,32,61,chair
17132,12,chair,13,0,15191,15,273,128,309,199,36,71,chair
17133,8,table,9,0,15192,74,134,161,272,279,138,118,dining table
17134,6,window,7,0,15194,43,33,16,105,144,72,128,window
17135,8,sofa,9,1,15194,44,2,122,152,206,150,84,couch
17136,9,table,10,1,15194,45,116,147,231,233,115,86,dining table
17137,10,chair,11,1,15194,26,169,163,264,234,95,71,chair
17138,14,chair,15,1,15194,20,335,124,349,212,14,88,chair
17139,2,sofa,3,0,15195,29,0,115,136,255,136,140,couch
17140,15,chair,16,0,15195,48,143,111,185,178,42,67,chair
17141,16,chair,17,0,15195,51,212,104,247,175,35,71,chair
17142,23,mirror,24,0,15195,22,147,36,192,78,45,42,mirror
17143,3,window,4,0,15196,23,1368,298,1715,842,347,544,window
17144,6,table,7,0,15196,133,1617,773,2026,1082,409,309,dining table
17145,7,chair,8,0,15196,34,1450,680,1624,1011,174,331,chair
17146,14,sofa,15,0,15196,96,5,708,860,1346,855,638,couch
17147,21,vase,22,0,15196,28,1166,953,1310,1215,144,262,vase
17148,22,vase,23,0,15196,15,1854,700,1910,799,56,99,vase
17149,37,plate,38,1,15196,23,1119,1150,1326,1222,207,72,plate
17150,7,mirror,7,1,15197,34,157,35,220,109,63,74,mirror
17151,11,sofa,10,0,15197,27,190,151,289,232,99,81,couch
17152,15,sofa,14,1,15197,59,12,140,120,192,108,52,couch
17153,27,table,26,0,15197,44,94,178,148,231,54,53,dining table
17154,29,table,28,0,15197,27,64,168,99,197,35,29,dining table
17155,30,table,29,1,15197,49,216,149,242,194,26,45,dining table
17156,3,window,4,0,15198,16,68,105,99,188,31,83,window
17157,4,window,5,0,15198,15,135,110,168,183,33,73,window
17158,5,window,6,0,15198,15,207,108,237,187,30,79,window
17159,10,sofa,11,0,15199,39,203,83,294,155,91,72,couch
17160,11,sofa,12,0,15199,50,26,84,134,171,108,87,couch
17161,20,chair,21,1,15199,23,0,167,77,223,77,56,chair
17162,22,chair,23,1,15199,21,264,116,300,149,36,33,chair
17163,25,chair,26,0,15199,49,207,141,287,222,80,81,chair
17164,26,chair,27,0,15199,34,132,147,203,222,71,75,chair
17165,5,vase,6,0,15200,26,706,449,821,629,115,180,vase
17166,7,chair,8,0,15200,52,48,956,442,1349,394,393,chair
17167,8,sofa,9,0,15200,55,623,844,1546,1311,923,467,couch
17168,9,chair,10,1,15200,29,1010,1043,1505,1347,495,304,chair
17169,1,sofa,2,0,15201,66,22,73,183,172,161,99,couch
17170,3,window,4,0,15202,22,864,0,1279,532,415,532,window
17171,8,sofa,9,0,15202,49,192,427,751,725,559,298,couch
17172,4,door,5,0,15203,24,458,624,591,1163,133,539,door
17173,6,sofa,7,0,15203,148,734,1025,1655,1466,921,441,couch
17174,8,chair,9,1,15205,19,55,77,95,112,40,35,chair
17175,10,sofa,11,0,15205,40,5,96,101,187,96,91,couch
17176,11,chair,12,0,15205,29,168,91,238,158,70,67,chair
17177,12,chair,13,0,15205,40,177,121,299,224,122,103,chair
17178,12,sofa,13,0,15206,130,420,377,1366,1071,946,694,couch
17179,15,chair,16,0,15207,17,227,102,253,138,26,36,chair
17180,18,sofa,19,0,15207,28,237,121,356,246,119,125,couch
17181,22,chair,23,1,15207,29,169,111,226,185,57,74,chair
17182,23,chair,24,1,15207,35,95,110,164,164,69,54,chair
17183,26,pot,27,1,15207,22,127,132,145,167,18,35,potted plant
17184,27,pot,28,0,15207,37,137,120,168,176,31,56,potted plant
17185,37,chair,38,1,15207,18,2,105,44,183,42,78,chair
17186,5,chair,6,0,15208,59,548,762,941,1362,393,600,chair
17187,16,chair,17,1,15209,15,86,168,105,187,19,19,chair
17188,17,chair,18,1,15209,24,233,191,287,249,54,58,chair
17189,18,chair,19,0,15209,31,21,124,66,195,45,71,chair
17190,23,sofa,24,1,15209,42,28,181,279,249,251,68,couch
17191,2,desk,3,0,15210,101,423,184,1129,1048,706,864,desk
17192,4,chair,5,0,15210,84,10,642,267,1056,257,414,chair
17193,5,chair,6,0,15210,89,244,630,488,1054,244,424,chair
17194,6,chair,7,0,15210,66,1127,587,1290,933,163,346,chair
17195,7,chair,8,1,15210,71,1224,579,1437,906,213,327,chair
17196,8,chair,9,1,15210,69,1359,572,1567,881,208,309,chair
17197,74,door,75,0,15210,24,497,532,1121,745,624,213,door
17198,17,mirror,18,0,15211,22,0,183,191,606,191,423,mirror
17199,26,mirror,27,1,15211,28,532,316,612,437,80,121,mirror
17200,30,sofa,31,0,15211,72,1016,483,1443,920,427,437,couch
17201,38,chair,39,0,15211,62,399,582,834,999,435,417,chair
17202,2,window,3,0,15212,21,47,21,162,137,115,116,window
17203,4,sofa,5,0,15212,25,0,119,78,171,78,52,couch
17204,5,sofa,6,1,15212,56,65,116,262,237,197,121,couch
17205,9,chair,10,1,15212,56,201,152,286,256,85,104,chair
17206,4,chair,5,1,15213,48,903,903,1256,1508,353,605,chair
17207,6,vase,7,0,15213,17,1507,717,1630,998,123,281,vase
17208,7,bowl,8,0,15213,30,1706,901,1838,1025,132,124,bowl
17209,10,mirror,11,0,15213,56,169,16,488,892,319,876,mirror
17210,11,window,12,0,15213,17,559,3,1113,944,554,941,window
17211,12,sofa,13,1,15213,50,29,898,820,1643,791,745,couch
17212,13,table,14,0,15213,38,488,1190,1240,1645,752,455,dining table
17213,8,dog,9,0,15214,40,94,175,150,222,56,47,dog
17214,10,chair,11,0,15214,24,245,114,290,196,45,82,chair
17215,5,sofa,6,1,15216,41,168,100,293,168,125,68,couch
17216,13,chair,14,1,15216,16,261,162,299,201,38,39,chair
17217,6,clock,7,0,15217,22,937,248,993,342,56,94,clock
17218,12,sofa,13,0,15217,86,123,447,657,891,534,444,couch
17219,9,sofa,10,0,15218,25,757,828,1185,1151,428,323,couch
17220,23,chair,24,0,15218,45,1288,816,1531,1200,243,384,chair
17221,94,window,95,0,15218,17,755,278,1038,853,283,575,window
17222,95,window,96,0,15218,24,1042,179,1293,936,251,757,window
17223,96,window,97,0,15218,19,307,231,649,1003,342,772,window
17224,8,door,9,1,15219,19,1601,537,1864,1033,263,496,door
17225,9,door,10,1,15219,35,1126,493,1303,1117,177,624,door
17226,14,sofa,15,1,15219,62,204,886,1112,1236,908,350,couch
17227,18,pot,19,0,15219,20,917,1082,1082,1157,165,75,potted plant
17228,4,chair,5,1,15220,28,112,198,209,287,97,89,chair
17229,7,chair,8,0,15220,35,0,152,60,262,60,110,chair
17230,7,clock,8,0,15221,24,517,366,593,531,76,165,clock
17231,14,chair,15,0,15221,77,329,439,514,729,185,290,chair
17232,16,sofa,17,1,15221,61,675,453,1029,724,354,271,couch
17233,76,bowl,77,0,15221,16,814,537,890,573,76,36,bowl
17234,15,chair,16,0,15222,75,24,547,347,1070,323,523,chair
17235,16,chair,17,0,15222,77,956,560,1209,1051,253,491,chair
17236,5,ball,6,0,15384,15,860,680,1028,853,168,173,sports ball
17237,7,ball,8,0,15384,16,1170,818,1335,979,165,161,sports ball
17238,4,table,5,0,15385,16,187,229,363,343,176,114,dining table
17239,5,chair,6,0,15385,23,337,242,401,338,64,96,chair
17240,6,chair,7,0,15385,26,220,249,291,352,71,103,chair
17241,3,table,4,0,15386,17,160,154,319,245,159,91,dining table
17242,3,chair,4,1,15388,15,158,206,203,262,45,56,chair
17243,8,table,9,0,15388,46,144,174,304,289,160,115,dining table
17244,9,person,10,0,15388,44,119,132,182,276,63,144,person
17245,11,clock,12,0,15388,15,142,38,179,84,37,46,clock
17246,15,chair,16,0,15388,28,259,166,334,287,75,121,chair
17247,6,chair,7,0,15389,20,23,212,99,299,76,87,chair
17248,7,table,8,0,15390,17,61,140,183,204,122,64,dining table
17249,5,desk,6,0,15391,16,225,115,344,180,119,65,desk
17250,11,chair,12,1,15391,19,183,110,216,153,33,43,chair
17251,13,table,14,0,15391,27,8,167,231,257,223,90,dining table
17252,14,chair,15,1,15391,20,177,187,228,261,51,74,chair
17253,15,chair,16,1,15391,21,137,202,184,263,47,61,chair
17254,12,table,13,1,15392,15,0,249,140,399,140,150,dining table
17255,13,chair,14,1,15392,35,62,228,151,350,89,122,chair
17256,19,chair,20,1,15392,15,656,420,790,537,134,117,chair
17257,11,table,12,0,15393,15,871,511,1036,645,165,134,dining table
17258,13,chair,14,0,15393,19,830,498,925,632,95,134,chair
17259,14,chair,15,0,15393,41,585,628,820,930,235,302,chair
17260,15,chair,16,0,15393,21,889,619,1109,844,220,225,chair
17261,16,chair,17,1,15393,19,872,740,1275,956,403,216,chair
17262,11,table,12,1,15394,21,107,155,157,216,50,61,dining table
17263,12,chair,13,1,15394,25,99,144,126,192,27,48,chair
17264,13,chair,14,1,15394,19,140,146,170,189,30,43,chair
17265,14,chair,15,0,15394,21,82,165,122,221,40,56,chair
17266,15,chair,16,1,15394,19,137,165,174,228,37,63,chair
17267,31,table,32,0,15395,19,181,170,262,244,81,74,dining table
17268,32,chair,33,1,15395,22,187,169,216,229,29,60,chair
17269,33,chair,34,1,15395,17,222,186,255,244,33,58,chair
17270,34,chair,35,1,15395,18,375,170,400,264,25,94,chair
17271,11,chair,12,0,15396,17,1162,453,1247,563,85,110,chair
17272,3,person,4,0,15398,67,137,19,233,288,96,269,person
17273,26,table,27,1,15400,15,880,506,1035,647,155,141,dining table
17274,27,chair,28,0,15400,20,824,499,926,639,102,140,chair
17275,28,chair,29,1,15400,23,976,487,1071,622,95,135,chair
17276,30,chair,31,1,15400,21,892,620,1107,848,215,228,chair
17277,31,chair,32,0,15400,32,585,631,820,931,235,300,chair
17278,0,chair,1,0,15401,17,519,102,637,372,118,270,chair
17279,2,person,3,0,15401,67,116,183,259,410,143,227,person
17280,9,desk,10,0,15401,17,22,86,219,252,197,166,desk
17281,10,chair,11,1,15401,15,260,1,374,158,114,157,chair
17282,12,chair,13,0,15401,22,282,92,365,207,83,115,chair
17283,20,person,21,0,15401,78,391,97,562,458,171,361,person
17284,24,table,25,0,15401,21,417,35,537,130,120,95,dining table
17285,2,sofa,3,0,15402,22,0,206,214,374,214,168,couch
17286,4,table,5,1,15402,15,329,235,410,305,81,70,dining table
17287,6,chair,7,1,15402,15,345,286,392,345,47,59,chair
17288,7,chair,8,0,15402,18,381,287,455,366,74,79,chair
17289,13,table,14,1,15403,16,44,187,142,275,98,88,dining table
17290,14,chair,15,0,15403,26,42,199,99,287,57,88,chair
17291,15,chair,16,1,15403,29,98,172,142,254,44,82,chair
17292,23,table,24,0,15404,42,304,318,572,467,268,149,dining table
17293,11,chair,12,0,15406,16,312,201,347,255,35,54,chair
17294,3,ball,4,0,15407,16,39,284,86,331,47,47,sports ball
17295,4,chair,5,0,15407,21,254,230,317,325,63,95,chair
17296,11,chair,12,0,15407,20,326,223,390,317,64,94,chair
17297,15,clock,16,0,15409,16,82,4,114,42,32,38,clock
17298,23,chair,24,1,15412,50,1570,960,1863,1418,293,458,chair
17299,24,chair,25,1,15412,42,1328,963,1586,1406,258,443,chair
17300,25,chair,26,0,15412,44,1347,1029,1663,1502,316,473,chair
17301,26,chair,27,0,15412,36,1760,1007,2058,1526,298,519,chair
17302,27,table,28,1,15412,25,1425,1043,1863,1495,438,452,dining table
17303,3,person,4,0,15413,56,115,128,201,218,86,90,person
17304,4,clock,5,0,15414,16,236,220,335,323,99,103,clock
17305,13,window,14,0,15414,33,427,183,1107,566,680,383,window
17306,23,table,24,0,15414,24,697,897,1043,1087,346,190,dining table
17307,27,table,28,0,15414,34,689,1075,1190,1478,501,403,dining table
17308,3,table,4,0,15415,20,119,87,235,207,116,120,dining table
17309,9,chair,10,0,15415,27,208,118,276,199,68,81,chair
17310,10,chair,11,0,15415,28,93,143,164,229,71,86,chair
17311,17,chair,18,0,15416,19,777,999,977,1318,200,319,chair
17312,22,table,23,1,15416,38,1276,1200,2200,1646,924,446,dining table
17313,24,chair,25,1,15416,23,1978,1264,2194,1624,216,360,chair
17314,25,chair,26,0,15416,48,1265,1301,1604,1648,339,347,chair
17315,26,chair,27,1,15416,33,1576,1392,1974,1648,398,256,chair
17316,59,table,60,1,15416,24,857,988,1184,1312,327,324,dining table
17317,6,chair,7,1,15418,29,890,371,1186,675,296,304,chair
17318,7,chair,8,1,15418,41,871,398,1224,964,353,566,chair
17319,8,chair,9,1,15418,36,611,370,935,694,324,324,chair
17320,9,chair,10,0,15418,35,514,409,922,1044,408,635,chair
17321,11,table,12,1,15418,23,749,466,1113,986,364,520,dining table
17322,3,sofa,4,1,15419,20,951,1319,2013,1508,1062,189,couch
17323,4,person,5,1,15419,31,1529,1274,1868,1453,339,179,person
17324,10,backpack,11,1,15419,17,1047,894,1134,1149,87,255,backpack
17325,13,desk,14,0,15419,32,102,976,535,1408,433,432,desk
17326,10,person,11,0,15420,51,732,303,860,650,128,347,person
17327,11,chair,12,0,24126,19,483,416,539,491,56,75,chair
17328,12,chair,13,0,24126,21,557,423,618,495,61,72,chair
17329,13,table,14,0,24126,23,626,418,763,555,137,137,dining table
17330,14,chair,15,0,24126,23,643,460,715,549,72,89,chair
17331,5,bottle,6,0,24127,23,63,269,195,596,132,327,bottle
17332,7,person,8,1,24127,100,255,124,933,767,678,643,person
17333,8,person,9,1,24127,41,477,224,1023,766,546,542,person
17334,9,bed,10,0,24128,15,338,304,660,494,322,190,bed
17335,21,table,22,0,24128,25,247,225,321,303,74,78,dining table
17336,24,chair,25,1,24128,20,224,217,246,298,22,81,chair
17337,25,chair,26,1,24128,33,236,233,291,325,55,92,chair
17338,12,person,13,0,948,22,73,65,84,95,11,30,person
17339,9,sofa,8,1,15494,49,655,622,1204,782,549,160,couch
17340,15,mirror,14,0,15494,17,2053,379,2129,608,76,229,mirror
17341,8,person,9,1,15495,31,303,217,425,493,122,276,person
17342,9,person,10,1,15495,38,437,327,582,522,145,195,person
17343,10,person,11,1,15495,42,90,168,254,573,164,405,person
17344,19,sofa,20,1,15496,27,93,313,327,428,234,115,couch
17345,11,sink,12,0,15497,21,72,405,291,536,219,131,sink
17346,10,chair,11,1,15498,17,45,105,89,146,44,41,chair
17347,11,chair,12,1,15498,20,115,105,168,144,53,39,chair
17348,5,table,6,1,15500,19,0,128,38,215,38,87,dining table
17349,6,chair,7,1,15500,22,16,119,53,187,37,68,chair
17350,3,window,4,0,15501,24,126,11,484,211,358,200,window
17351,7,chair,8,1,15501,21,399,161,493,288,94,127,chair
17352,10,chair,11,1,15501,28,105,165,214,282,109,117,chair
17353,2,sofa,3,0,15502,30,64,136,205,199,141,63,couch
17354,4,sofa,5,1,15502,23,208,141,316,184,108,43,couch
17355,20,chair,21,1,15502,17,0,175,41,268,41,93,chair
17356,21,chair,22,1,15502,16,0,200,56,300,56,100,chair
17357,6,chair,7,0,15503,19,269,79,303,128,34,49,chair
17358,11,chair,12,1,15503,31,4,81,54,148,50,67,chair
17359,1,window,2,0,15504,20,0,0,654,572,654,572,window
17360,2,sofa,3,1,15504,30,0,490,780,790,780,300,couch
17361,10,table,11,0,15505,26,494,242,598,383,104,141,dining table
17362,4,window,5,1,15506,17,1929,1,2196,882,267,881,window
17363,19,chair,20,1,15506,29,829,447,995,716,166,269,chair
17364,20,chair,21,1,15506,36,1046,504,1371,788,325,284,chair
17365,6,chair,7,0,15508,18,311,173,346,226,35,53,chair
17366,7,chair,8,0,15508,16,346,174,385,235,39,61,chair
17367,9,chair,10,1,15510,19,2018,1030,2198,1325,180,295,chair
17368,13,window,14,0,15510,19,580,476,1100,945,520,469,window
17369,5,sofa,4,1,15511,18,63,161,158,210,95,49,couch
17370,10,chair,9,0,15511,17,4,159,56,226,52,67,chair
17371,8,bench,9,1,15512,32,223,128,300,184,77,56,bench
17372,6,sofa,7,1,15513,52,140,239,380,358,240,119,couch
17373,9,person,10,1,15513,34,367,165,432,279,65,114,person
17374,10,person,11,0,15513,78,74,156,172,454,98,298,person
17375,7,person,8,1,15514,46,592,114,762,626,170,512,person
17376,8,person,9,1,15514,81,709,64,961,766,252,702,person
17377,18,chair,19,1,15514,21,0,354,119,515,119,161,chair
17378,4,table,5,1,15515,16,223,98,298,169,75,71,dining table
17379,11,sofa,12,0,15516,25,409,216,611,330,202,114,couch
17380,17,table,18,0,15516,31,412,238,536,333,124,95,dining table
17381,22,window,23,0,15516,30,12,116,177,279,165,163,window
17382,7,chair,8,1,15517,37,985,669,1188,954,203,285,chair
17383,16,clock,14,0,15517,28,1453,472,1588,680,135,208,clock
17384,21,mirror,19,0,15517,118,1287,1,1824,686,537,685,mirror
17385,22,pot,20,0,15517,23,1773,1116,1925,1346,152,230,potted plant
17386,23,chair,21,1,15517,56,1920,996,2199,1459,279,463,chair
17387,11,bench,12,1,15518,16,356,187,509,330,153,143,bench
17388,4,window,5,0,15519,16,106,82,164,159,58,77,window
17389,5,window,6,0,15519,18,172,82,223,159,51,77,window
17390,9,sofa,10,0,15521,57,170,410,759,759,589,349,couch
17391,10,bottle,11,1,15522,23,232,89,256,185,24,96,bottle
17392,10,table,11,0,15523,26,16,135,113,206,97,71,dining table
17393,13,chair,14,1,15523,20,78,120,127,190,49,70,chair
17394,14,chair,15,0,15523,24,0,131,58,210,58,79,chair
17395,4,sofa,5,1,15524,38,330,131,569,256,239,125,couch
17396,6,table,7,1,15525,19,228,145,350,179,122,34,dining table
17397,7,table,8,1,15525,30,367,165,443,236,76,71,dining table
17398,10,chair,11,1,15525,25,190,145,241,182,51,37,chair
17399,11,sofa,12,1,15525,16,0,155,105,281,105,126,couch
17400,6,door,7,1,15526,21,145,46,194,170,49,124,door
17401,11,balls,12,0,15526,15,85,170,120,182,35,12,sports ball
17402,13,table,14,0,15527,29,230,212,333,303,103,91,dining table
17403,10,chair,11,1,15528,20,229,158,277,207,48,49,chair
17404,11,table,12,1,15528,48,595,194,689,341,94,147,dining table
17405,12,chair,13,0,15528,39,525,172,604,322,79,150,chair
17406,15,chair,16,0,15528,33,61,163,128,277,67,114,chair
17407,11,sofa,12,1,15529,26,323,291,572,418,249,127,couch
17408,51,flowerpot,52,1,15530,16,434,716,545,790,111,74,potted plant
17409,7,chair,8,0,15531,18,170,287,267,441,97,154,chair
17410,14,table,15,1,15532,35,86,224,268,355,182,131,dining table
17411,86,vase,86,0,15532,20,184,105,200,140,16,35,vase
17412,88,vase,88,1,15532,15,318,106,333,142,15,36,vase
17413,7,person,8,1,15534,54,257,77,357,225,100,148,person
17414,6,sofa,7,1,15535,24,117,115,218,155,101,40,couch
17415,8,sofa,9,0,15535,28,0,120,96,211,96,91,couch
17416,4,sofa,5,1,15536,23,207,83,300,136,93,53,couch
17417,6,sofa,7,1,15536,15,42,83,132,102,90,19,couch
17418,8,chair,9,1,15538,15,238,93,249,149,11,56,chair
17419,10,sofa,11,1,15538,22,0,141,217,204,217,63,couch
17420,14,chair,15,0,15538,19,2,94,29,138,27,44,chair
17421,10,table,11,0,15541,23,2,116,41,171,39,55,dining table
17422,7,person,8,1,15542,32,146,169,234,247,88,78,person
17423,11,chair,12,0,15542,24,252,151,319,242,67,91,chair
17424,12,chair,13,0,15542,20,327,163,389,259,62,96,chair
17425,13,chair,14,0,15542,24,393,176,462,285,69,109,chair
17426,14,person,15,0,15542,47,470,156,562,336,92,180,person
17427,15,chair,16,0,15542,33,536,333,639,477,103,144,chair
17428,18,chair,19,1,15542,16,0,326,74,446,74,120,chair
17429,5,sofa,6,1,15543,20,88,68,168,108,80,40,couch
17430,12,chair,13,1,15543,18,93,162,195,239,102,77,chair
17431,13,table,14,1,15543,16,2,171,160,240,158,69,dining table
17432,9,sofa,10,1,15544,21,183,89,246,139,63,50,couch
17433,11,sofa,12,1,15544,21,36,93,103,148,67,55,couch
17434,11,door,12,1,15545,21,1028,108,1200,1598,172,1490,door
17435,12,sofa,13,1,15551,26,396,265,686,426,290,161,couch
17436,13,sofa,14,1,15551,23,55,265,342,340,287,75,couch
17437,23,person,24,0,15554,84,56,625,330,1108,274,483,person
17438,24,person,25,0,15554,78,809,472,1074,1296,265,824,person
17439,43,chair,44,0,15554,34,1013,663,1158,1022,145,359,chair
17440,17,sofa,18,1,15555,15,1096,428,1248,532,152,104,couch
17441,46,chair,47,0,15555,35,1329,461,1480,771,151,310,chair
17442,47,chair,48,1,15555,23,770,444,886,548,116,104,chair
17443,35,bed,36,0,15556,16,165,542,1067,827,902,285,bed
17444,14,window,15,0,15557,34,555,301,879,1211,324,910,window
17445,16,chair,17,1,15557,36,876,841,1126,1161,250,320,chair
17446,6,sofa,7,1,15558,35,257,140,375,232,118,92,couch
17447,10,chair,11,0,15560,15,210,753,424,1135,214,382,chair
17448,33,chair,32,1,15561,32,1,1141,332,1650,331,509,chair
17449,34,person,33,1,15561,18,1,1019,167,1584,166,565,person
17450,7,sofa,8,1,15562,28,166,103,319,203,153,100,couch
17451,13,door,14,1,15563,17,605,387,754,709,149,322,door
17452,19,dog,20,0,15564,58,19,1160,304,1413,285,253,dog
17453,25,door,26,0,15565,26,1339,413,1526,878,187,465,door
17454,28,chair,29,0,15565,16,1404,737,1599,885,195,148,chair
17455,40,table,41,1,15565,18,2,1195,678,1650,676,455,dining table
17456,43,sofa,44,1,15566,60,1678,713,2195,1083,517,370,couch
17457,44,sofa,45,1,15566,25,1828,695,2199,845,371,150,couch
17458,45,table,46,1,15566,38,1384,726,1812,879,428,153,dining table
17459,47,chair,48,1,15566,16,1512,706,1723,874,211,168,chair
17460,56,chair,57,1,15566,21,374,639,511,885,137,246,chair
17461,63,bed,64,0,15566,17,3,866,1860,1447,1857,581,bed
17462,13,person,14,1,15567,63,246,481,483,1110,237,629,person
17463,14,person,15,1,15567,32,526,723,782,881,256,158,person
17464,15,person,16,1,15567,33,911,716,1115,913,204,197,person
17465,16,person,17,1,15567,51,1317,452,1617,1039,300,587,person
17466,22,sofa,23,1,15567,27,1134,831,1699,1068,565,237,couch
17467,24,window,25,0,15567,33,298,433,615,760,317,327,window
17468,17,chair,18,1,15568,23,1339,942,1544,1195,205,253,chair
17469,19,window,20,0,15568,23,647,234,940,921,293,687,window
17470,21,table,22,1,15568,19,1046,969,1399,1031,353,62,dining table
17471,14,chair,15,0,15570,15,217,71,246,104,29,33,chair
17472,15,chair,16,1,15570,20,253,72,288,103,35,31,chair
17473,16,sofa,17,1,15570,40,6,78,174,164,168,86,couch
17474,23,window,24,0,15572,17,709,303,919,636,210,333,window
17475,43,sofa,44,1,15572,48,10,674,913,1044,903,370,couch
17476,18,chair,19,1,15573,21,204,673,437,929,233,256,chair
17477,19,sofa,20,1,15573,20,538,674,943,817,405,143,couch
17478,33,sofa,34,1,15573,32,288,1142,1628,1223,1340,81,couch
17479,25,clock,22,0,15578,17,401,318,485,403,84,85,clock
17480,3,sofa,4,0,15579,22,172,70,276,132,104,62,couch
17481,22,chair,23,1,15580,30,3,643,152,938,149,295,chair
17482,8,flowerpot,7,0,15581,15,645,413,709,470,64,57,potted plant
17483,26,table,24,1,15581,17,2,584,128,850,126,266,dining table
17484,27,sofa,25,1,15581,56,0,708,1598,1198,1598,490,couch
17485,2,window,3,0,15585,18,273,138,560,706,287,568,window
17486,11,chair,12,0,15585,44,405,450,598,774,193,324,chair
17487,12,table,13,1,15585,19,516,494,656,595,140,101,dining table
17488,13,chair,14,1,15585,39,610,476,800,704,190,228,chair
17489,14,chair,15,1,15585,35,767,461,950,681,183,220,chair
17490,33,chair,34,1,15586,18,1957,1310,2198,1647,241,337,chair
17491,7,window,8,0,22042,31,1196,296,2198,962,1002,666,window
17492,36,sofa,37,1,22042,20,0,1125,870,1649,870,524,couch
17493,29,sofa,30,0,22044,36,874,587,1500,833,626,246,couch
17494,14,window,15,0,22045,16,720,246,1174,736,454,490,window
17495,15,window,16,0,22045,18,1304,204,2196,923,892,719,window
17496,16,chair,17,0,22045,72,1784,756,2125,1393,341,637,chair
17497,7,person,8,1,15769,41,193,57,223,159,30,102,person
17498,10,person,11,1,15769,34,18,99,99,177,81,78,person
17499,2,chair,3,1,15770,24,1073,460,1279,762,206,302,chair
17500,4,chair,5,1,15770,22,636,450,825,533,189,83,chair
17501,6,sofa,7,1,15770,20,2,414,533,808,531,394,couch
17502,7,chair,8,1,15770,20,3,600,113,777,110,177,chair
17503,15,clock,16,0,15770,15,954,39,1025,113,71,74,clock
17504,10,chair,11,1,15772,16,63,136,105,158,42,22,chair
17505,6,sofa,7,1,15773,21,139,217,339,322,200,105,couch
17506,7,sofa,8,0,15773,33,34,269,307,473,273,204,couch
17507,8,sofa,9,1,15773,20,383,210,567,301,184,91,couch
17508,9,sofa,10,0,15773,30,375,246,621,444,246,198,couch
17509,16,chair,17,0,15774,20,575,612,689,816,114,204,chair
17510,17,chair,18,0,15774,27,687,614,809,822,122,208,chair
17511,7,person,8,0,15775,77,184,89,279,225,95,136,person
17512,8,person,9,1,15775,36,17,91,92,137,75,46,person
17513,13,chair,14,0,15775,16,147,88,163,113,16,25,chair
17514,6,ball,7,1,24252,16,273,450,347,519,74,69,sports ball
17515,20,table,21,0,24253,48,1,235,140,409,139,174,dining table
17516,1,door,2,0,24254,80,702,0,927,407,225,407,door
17517,8,person,9,1,24254,83,738,23,956,466,218,443,person
17518,9,person,10,1,24254,53,45,79,276,457,231,378,person
17519,6,person,7,1,24255,16,54,273,65,376,11,103,person
17520,18,television,19,0,24255,17,226,251,317,334,91,83,tv
17521,5,chair,6,1,24256,23,1028,408,1070,504,42,96,chair
17522,15,balls,16,0,24256,21,496,439,596,471,100,32,sports ball
17523,20,chair,21,1,24256,16,1,386,19,484,18,98,chair
17524,5,window,6,0,24257,24,377,276,481,468,104,192,window
17525,9,table,10,1,24257,19,384,463,500,647,116,184,dining table
17526,10,chair,11,0,24257,49,323,469,451,653,128,184,chair
17527,11,chair,12,1,24257,27,356,444,433,526,77,82,chair
17528,12,chair,13,1,24257,23,441,390,498,466,57,76,chair
17529,17,chair,18,1,24257,15,458,520,500,708,42,188,chair
17530,10,bottle,11,1,15943,18,326,310,408,451,82,141,bottle
17531,13,bottle,14,0,15943,24,173,598,316,796,143,198,bottle
17532,14,bottle,15,0,15943,28,310,548,460,729,150,181,bottle
17533,8,table,9,1,15946,16,0,668,473,958,473,290,dining table
17534,6,flowerpot,7,0,16288,16,33,182,69,222,36,40,potted plant
17535,0,door,1,0,24400,17,59,0,477,800,418,800,door
17536,3,toilet,4,0,24400,19,118,534,241,669,123,135,toilet
17537,4,sink,5,0,24402,21,391,570,509,605,118,35,sink
17538,5,sink,6,0,24402,17,104,618,234,674,130,56,sink
17539,4,sink,5,0,24404,19,401,540,767,1012,366,472,sink
17540,6,toilet,7,1,24406,22,595,582,671,750,76,168,toilet
17541,9,sink,10,0,24406,25,110,502,430,747,320,245,sink
17542,14,hair dryer,15,0,16299,26,432,142,455,207,23,65,hair drier
17543,11,person,12,1,290,72,118,148,274,270,156,122,person
17544,17,person,18,1,290,66,35,132,499,323,464,191,person
17545,21,sofa,22,1,290,21,0,271,519,347,519,76,couch
17546,7,person,8,1,19092,26,228,107,312,173,84,66,person
17547,9,person,10,1,19092,38,144,126,304,257,160,131,person
17548,14,person,15,1,19092,35,312,110,467,235,155,125,person
17549,15,person,16,1,19092,37,2,136,210,279,208,143,person
17550,10,table,11,0,19093,15,52,95,126,138,74,43,dining table
17551,16,chair,17,1,19093,17,225,71,243,123,18,52,chair
17552,3,chair,4,1,24535,25,549,832,1058,1380,509,548,chair
17553,5,sofa,6,1,24535,135,186,549,1395,1380,1209,831,couch
17554,7,television,8,0,24535,19,1597,305,2071,698,474,393,tv
17555,9,window,10,0,24535,22,1518,0,1860,691,342,691,window
17556,11,window,12,0,24535,29,656,1,1398,702,742,701,window
17557,14,window,15,0,24535,24,29,1,542,605,513,604,window
17558,21,person,22,1,24535,63,4,410,371,893,367,483,person
17559,23,person,24,1,24535,99,169,654,1411,1174,1242,520,person
17560,24,person,25,1,24535,64,664,484,1323,1380,659,896,person
17561,25,person,26,1,24535,44,1264,931,2073,1380,809,449,person
17562,8,sofa,9,0,24536,33,1,373,514,694,513,321,couch
17563,5,window,6,0,24537,29,174,166,356,374,182,208,window
17564,7,window,8,0,24537,18,463,162,517,309,54,147,window
17565,10,sofa,11,0,24537,45,45,297,224,486,179,189,couch
17566,13,table,14,0,24537,49,485,328,798,566,313,238,dining table
17567,14,chair,15,0,24537,50,490,346,657,565,167,219,chair
17568,15,chair,16,0,24537,46,695,382,847,565,152,183,chair
17569,18,chair,19,1,24537,33,676,317,765,433,89,116,chair
17570,31,mirror,32,0,24537,20,625,107,798,273,173,166,mirror
17571,14,sofa,15,0,24538,42,920,444,1419,720,499,276,couch
17572,6,bed,7,1,24539,18,449,368,1022,768,573,400,bed
17573,7,sofa,8,0,24539,23,69,273,559,558,490,285,couch
17574,6,sofa,7,0,24540,56,328,278,611,421,283,143,couch
17575,7,sofa,8,1,24540,38,297,354,638,479,341,125,couch
17576,14,televisio,15,0,24540,17,26,88,65,260,39,172,tv
17577,20,bed,21,1,24541,16,0,407,517,553,517,146,bed
17578,21,chair,22,0,24541,32,441,357,619,553,178,196,chair
17579,3,door,4,0,24542,20,1,90,333,572,332,482,door
17580,4,sofa,5,0,24542,21,0,376,118,683,118,307,couch
17581,2,person,3,1,24544,29,749,154,1023,681,274,527,person
17582,3,person,4,1,24544,67,470,161,709,680,239,519,person
17583,4,person,5,1,24544,45,1,337,253,682,252,345,person
17584,5,window,6,0,24544,30,127,18,398,594,271,576,window
17585,5,sofa,6,0,24546,36,238,258,415,412,177,154,couch
17586,2,person,3,1,22239,38,77,95,194,194,117,99,person
17587,3,window,4,0,22239,16,141,58,269,133,128,75,window
17588,3,sink,4,0,19389,21,186,81,243,117,57,36,sink
17589,6,table,7,1,19389,15,0,124,229,224,229,100,dining table
17590,49,door,50,0,298,23,446,496,573,635,127,139,door
17591,50,window,51,0,298,16,458,516,553,620,95,104,window
17592,55,door,56,0,298,27,610,531,806,705,196,174,door
17593,56,window,57,0,298,16,641,556,777,682,136,126,window
17594,23,window,24,0,19404,15,93,163,136,216,43,53,window
17595,18,door,19,0,19406,26,41,86,103,149,62,63,door
17596,19,window,20,0,19406,15,55,97,93,137,38,40,window
17597,20,door,21,0,19406,21,114,90,162,145,48,55,door
17598,15,door,16,0,19407,20,54,145,121,216,67,71,door
17599,16,window,17,0,19407,16,65,153,112,202,47,49,window
17600,22,door,23,0,19408,23,252,314,330,447,78,133,door
17601,23,window,24,0,19408,17,269,332,323,428,54,96,window
17602,25,door,26,0,19408,29,43,343,219,541,176,198,door
17603,26,window,27,0,19408,21,81,369,200,515,119,146,window
17604,20,door,21,0,19410,17,313,181,343,282,30,101,door
17605,24,door,25,0,19410,20,255,190,304,326,49,136,door
17606,13,door,14,0,19415,25,149,218,224,286,75,68,door
17607,14,window,15,0,19415,21,162,228,210,272,48,44,window
17608,17,door,18,0,19415,25,254,220,330,288,76,68,door
17609,18,window,19,0,19415,19,268,233,318,276,50,43,window
17610,16,door,17,0,19419,21,173,226,262,309,89,83,door
17611,17,window,18,0,19419,21,184,236,248,295,64,59,window
17612,15,door,16,0,19421,24,252,209,385,366,133,157,door
17613,16,window,17,0,19421,20,264,232,362,348,98,116,window
17614,19,door,20,0,19421,20,127,182,214,312,87,130,door
17615,20,window,21,0,19421,18,134,200,198,295,64,95,window
17616,17,door,18,0,19425,20,97,117,146,170,49,53,door
17617,18,window,19,0,19425,17,107,126,137,161,30,35,window
17618,6,sink,7,0,19426,16,249,832,608,1088,359,256,sink
17619,14,door,15,0,19427,16,340,108,382,171,42,63,door
17620,16,door,17,0,19427,16,296,143,333,219,37,76,door
17621,16,door,17,0,19429,23,317,317,399,410,82,93,door
17622,17,window,18,0,19429,23,332,332,385,396,53,64,window
17623,7,table,8,1,19757,21,106,245,264,366,158,121,dining table
17624,13,table,13,1,19915,17,0,399,88,557,88,158,dining table
17625,14,chair,14,1,19915,18,8,323,226,558,218,235,chair
17626,8,chair,9,0,19922,21,213,111,275,236,62,125,chair
17627,12,chair,13,1,19923,24,384,868,793,1155,409,287,chair
17628,12,bottle,13,0,19924,18,2094,810,2145,945,51,135,bottle
17629,13,bottle,14,1,19924,22,2038,814,2091,921,53,107,bottle
17630,15,bottle,16,0,19924,17,1929,802,1972,898,43,96,bottle
17631,23,refrigerator,24,1,19924,17,531,612,600,941,69,329,refrigerator
17632,29,sofa,30,1,19924,68,370,858,1225,1282,855,424,couch
17633,30,sofa,31,0,19924,59,0,1066,1518,1642,1518,576,couch
17634,31,vase,32,0,19924,20,258,1081,319,1207,61,126,vase
17635,34,bottle,35,0,19924,16,182,1146,228,1225,46,79,bottle
17636,13,sofa,14,1,19925,45,1324,787,2047,1533,723,746,couch
17637,12,bottle,13,0,19926,17,58,31,99,74,41,43,bottle
17638,13,bottle,14,0,19926,19,104,41,133,75,29,34,bottle
17639,11,chair,12,1,19927,57,761,382,942,708,181,326,chair
17640,12,chair,13,0,19927,91,434,388,613,733,179,345,chair
17641,13,chair,14,0,19927,69,262,347,401,617,139,270,chair
17642,6,cup,7,0,19929,17,1372,640,1424,726,52,86,cup
17643,7,cup,8,0,19929,17,1332,639,1379,728,47,89,cup
17644,13,bottle,14,0,19931,16,339,368,391,421,52,53,bottle
17645,18,chair,19,0,19932,18,152,124,197,210,45,86,chair
17646,7,vase,8,0,19933,17,222,76,248,184,26,108,vase
17647,10,bowl,11,0,19933,21,114,74,171,88,57,14,bowl
17648,11,chair,12,0,19933,34,65,104,138,247,73,143,chair
17649,12,chair,13,1,19933,28,0,108,65,247,65,139,chair
17650,22,sofa,23,1,19934,42,522,575,1033,789,511,214,couch
17651,17,sofa,18,0,19937,50,1143,747,1920,1447,777,700,couch
17652,25,sofa,26,0,19937,39,415,805,1076,1254,661,449,couch
17653,27,vase,28,0,19937,22,1216,932,1321,1076,105,144,vase
17654,24,vase,25,0,19938,16,1527,726,1580,839,53,113,vase
17655,31,sofa,32,1,19939,31,308,622,798,1064,490,442,couch
17656,66,bowl,67,0,19939,15,418,492,466,512,48,20,bowl
17657,21,sofa,22,1,19940,42,2,612,785,766,783,154,couch
17658,8,pot,9,1,19941,19,173,840,284,970,111,130,potted plant
17659,4,flowerpot,5,0,19942,15,826,644,908,722,82,78,potted plant
17660,27,sofa,28,1,19942,31,0,579,244,959,244,380,couch
17661,31,window,32,0,19942,43,3,223,491,590,488,367,window
17662,15,chair,16,0,19945,30,78,147,148,239,70,92,chair
17663,17,chair,18,1,19945,18,212,191,306,240,94,49,chair
17664,21,sofa,22,1,19946,42,1033,1639,1648,2199,615,560,couch
17665,36,door,37,0,19946,17,934,1467,1198,1829,264,362,door
17666,36,bottle,37,1,19947,15,1718,797,1760,879,42,82,bottle
17667,38,bottle,39,1,19947,16,1835,806,1875,890,40,84,bottle
17668,39,bottle,40,0,19947,17,1916,799,1955,892,39,93,bottle
17669,46,sofa,47,0,19947,94,67,913,1203,1480,1136,567,couch
17670,49,vase,50,0,19947,23,317,1252,407,1433,90,181,vase
17671,50,bottle,51,0,19947,16,273,1363,352,1482,79,119,bottle
17672,8,clock,9,0,24736,15,238,34,308,109,70,75,clock
17673,10,sofa,11,0,24736,34,118,236,470,309,352,73,couch
17674,12,vase,13,0,24736,16,137,244,198,328,61,84,vase
17675,15,chair,16,0,24737,28,201,440,313,635,112,195,chair
17676,16,chair,17,0,24737,31,115,441,219,637,104,196,chair
17677,18,sofa,19,0,24737,42,690,431,1023,662,333,231,couch
17678,19,sofa,20,0,24737,22,513,621,1023,767,510,146,couch
17679,7,person,8,0,20001,62,180,12,288,241,108,229,person
17680,8,hat,9,0,20001,19,304,92,369,133,65,41,hat
17681,3,window,4,0,20004,31,152,1,444,272,292,271,window
17682,6,chair,7,1,20010,30,121,247,191,371,70,124,chair
17683,14,dog,15,0,20014,20,233,204,286,231,53,27,dog
17684,16,table,17,0,20014,22,408,217,584,362,176,145,dining table
17685,4,bed,5,1,20016,15,2,383,239,522,237,139,bed
17686,8,window,9,1,20021,18,167,1,229,110,62,109,window
17687,11,person,12,0,20023,57,206,97,279,251,73,154,person
17688,4,person,5,0,20027,54,114,30,198,200,84,170,person
17689,12,table,13,1,20031,15,78,189,307,240,229,51,dining table
17690,14,chair,15,1,20031,22,255,141,320,226,65,85,chair
17691,43,sofa,44,1,20031,31,49,129,182,239,133,110,couch
17692,14,window,15,0,20032,15,15,21,270,174,255,153,window
17693,6,person,7,0,20037,68,288,432,1133,765,845,333,person
17694,16,bed,17,1,20039,29,0,775,710,1199,710,424,bed
17695,1,window,2,0,20040,20,0,1,221,222,221,221,window
17696,13,bed,14,1,20040,18,2,283,251,335,249,52,bed
17697,15,sofa,16,1,20041,35,1411,855,2197,1646,786,791,couch
17698,6,window,7,0,20042,20,144,19,251,139,107,120,window
17699,6,bed,7,0,316,38,96,192,624,480,528,288,bed
17700,3,bed,4,0,20144,33,139,6,399,289,260,283,bed
17701,7,chair,8,0,20144,24,2,133,77,287,75,154,chair
17702,8,chair,9,0,20144,24,74,130,147,286,73,156,chair
17703,4,bed,5,0,20145,28,273,355,935,664,662,309,bed
17704,12,bed,13,1,20145,15,612,69,999,390,387,321,bed
17705,3,bed,4,0,20146,25,420,59,799,480,379,421,bed
17706,10,bed,11,1,20147,30,13,80,355,326,342,246,bed
17707,9,television,10,0,20148,16,937,18,1112,163,175,145,tv
17708,13,bed,14,0,20148,25,78,407,596,727,518,320,bed
17709,3,bed,4,1,20149,18,103,93,199,261,96,168,bed
17710,4,bed,5,1,20149,20,0,72,105,297,105,225,bed
17711,2,bed,3,0,20150,35,205,1,499,332,294,331,bed
17712,3,bed,4,0,20150,29,99,1,316,321,217,320,bed
17713,6,bed,7,0,20150,17,2,3,101,333,99,330,bed
17714,4,desk,5,0,20151,19,113,117,185,198,72,81,desk
17715,1,bed,2,1,20152,31,75,35,233,186,158,151,bed
17716,2,bed,3,1,20152,28,125,34,293,220,168,186,bed
17717,5,bed,6,1,20152,24,2,26,68,221,66,195,bed
17718,9,table,10,0,20153,17,388,225,472,331,84,106,dining table
17719,11,bed,12,0,20153,16,0,42,310,331,310,289,bed
17720,7,bed,8,0,20154,34,6,307,639,1061,633,754,bed
17721,6,bed,7,0,20155,26,113,206,559,766,446,560,bed
17722,8,backpack,9,1,20155,39,506,436,653,655,147,219,backpack
17723,9,table,10,0,20155,32,616,483,820,746,204,263,dining table
17724,4,bed,5,0,20156,36,0,1,194,192,194,191,bed
17725,6,bench,7,1,20156,24,177,83,256,171,79,88,bench
17726,5,chair,6,1,20157,19,838,988,929,1608,91,620,chair
17727,8,bed,9,0,20157,21,1309,900,2041,1586,732,686,bed
17728,1,bed,2,1,20158,21,0,104,281,257,281,153,bed
17729,2,bed,3,1,20158,39,155,31,343,258,188,227,bed
17730,7,bed,8,1,20159,16,0,1036,474,1594,474,558,bed
17731,4,bed,5,0,20160,26,648,299,1199,844,551,545,bed
17732,7,flowerpot,8,0,20160,40,371,377,626,716,255,339,potted plant
17733,6,bed,7,0,20161,17,74,108,221,185,147,77,bed
17734,1,bed,2,1,20163,32,1018,446,1598,1198,580,752,bed
17735,3,desk,4,0,20163,16,387,525,829,887,442,362,desk
17736,4,chair,5,0,20163,18,601,534,799,900,198,366,chair
17737,6,chair,7,1,20163,15,160,574,304,1038,144,464,chair
17738,2,bed,3,1,20164,16,330,482,643,1022,313,540,bed
17739,4,bed,5,0,20165,48,0,874,1341,2198,1341,1324,bed
17740,2,bed,3,0,20166,55,131,12,1713,1437,1582,1425,bed
17741,3,bed,4,0,20167,21,0,111,94,214,94,103,bed
17742,4,bed,5,0,20167,15,176,107,292,200,116,93,bed
17743,7,table,8,1,20167,16,111,108,187,164,76,56,dining table
17744,8,chair,9,1,20167,18,251,132,299,221,48,89,chair
17745,14,chair,15,0,20167,22,139,109,179,163,40,54,chair
17746,2,bed,3,0,20168,40,0,51,177,254,177,203,bed
17747,3,suitcase,4,0,20168,20,13,139,99,259,86,120,suitcase
17748,4,bed,5,1,20168,17,145,55,346,259,201,204,bed
17749,13,desk,14,0,20169,18,119,37,252,116,133,79,desk
17750,14,chair,15,1,20169,19,156,49,200,92,44,43,chair
17751,10,chair,11,1,20170,18,540,467,620,560,80,93,chair
17752,12,bed,13,1,20170,69,263,429,1009,827,746,398,bed
17753,14,bed,15,0,20170,109,379,415,1568,1093,1189,678,bed
17754,2,bed,3,1,20171,22,164,256,611,767,447,511,bed
17755,5,chair,6,0,20171,35,658,324,1020,767,362,443,chair
17756,8,backpack,9,0,20171,26,161,228,458,514,297,286,backpack
17757,4,suitcase,5,1,20172,16,1187,978,1548,1217,361,239,suitcase
17758,7,bed,8,1,20172,18,1461,932,2047,1531,586,599,bed
17759,11,bed,12,0,20172,32,496,849,1268,1338,772,489,bed
17760,14,bed,15,0,20172,33,0,522,679,1522,679,1000,bed
17761,10,bed,11,0,20173,54,443,555,1574,1235,1131,680,bed
17762,11,bed,12,0,20173,75,900,626,2047,1533,1147,907,bed
17763,12,backpack,13,0,20173,47,80,635,487,1161,407,526,backpack
17764,13,bed,14,1,20173,19,0,911,333,1273,333,362,bed
17765,14,bed,15,1,20173,32,2,1180,1050,1534,1048,354,bed
17766,4,bed,5,0,20174,47,1023,460,2104,1649,1081,1189,bed
17767,9,bed,10,1,20174,29,0,429,792,1647,792,1218,bed
17768,10,chair,11,1,20174,21,765,965,964,1401,199,436,chair
17769,11,backpack,12,0,20174,30,915,1116,1083,1412,168,296,backpack
17770,2,bed,3,0,20175,43,151,6,1299,1022,1148,1016,bed
17771,3,bed,4,1,20176,19,682,486,1279,1023,597,537,bed
17772,4,desk,5,0,20176,37,0,410,558,1017,558,607,desk
17773,5,chair,6,1,20176,32,383,442,599,824,216,382,chair
17774,4,window,5,0,20177,17,470,1,722,395,252,394,window
17775,5,bed,6,0,20177,27,112,332,568,566,456,234,bed
17776,6,bed,7,0,20177,35,270,358,777,667,507,309,bed
17777,7,bed,8,0,20177,35,519,390,1023,766,504,376,bed
17778,4,bed,5,0,20178,63,2,422,796,1121,794,699,bed
17779,4,bed,5,0,20179,19,906,754,1859,1440,953,686,bed
17780,8,bed,9,0,20179,41,0,173,923,1461,923,1288,bed
17781,13,chair,14,1,20179,18,1943,893,2198,1477,255,584,chair
17782,4,bed,5,0,20180,51,10,238,1108,1629,1098,1391,bed
17783,3,bed,4,0,20181,32,120,252,958,1275,838,1023,bed
17784,3,bed,4,0,20182,50,257,152,1018,893,761,741,bed
17785,3,bed,4,1,20183,15,220,77,349,254,129,177,bed
17786,6,chair,7,1,20183,21,277,171,349,245,72,74,chair
17787,8,table,9,1,20183,15,163,133,222,206,59,73,dining table
17788,10,window,11,1,20183,26,49,0,97,211,48,211,window
17789,13,person,14,0,20183,78,65,60,123,236,58,176,person
17790,2,bed,3,0,20184,17,228,63,342,210,114,147,bed
17791,4,bed,5,1,20184,18,0,61,132,226,132,165,bed
17792,8,bed,9,0,20185,25,0,119,216,238,216,119,bed
17793,6,bed,7,0,20186,58,25,57,217,239,192,182,bed
17794,9,bed,10,0,20187,34,66,42,209,203,143,161,bed
17795,10,sofa,11,1,20188,34,0,155,134,249,134,94,couch
17796,15,window,16,0,20188,21,2,1,71,163,69,162,window
17797,9,truck,10,0,5419,64,316,501,860,660,544,159,truck
17798,20,person,21,0,571,42,876,301,911,403,35,102,person
17799,26,person,27,0,571,46,904,302,955,425,51,123,person
17800,31,person,32,0,571,53,952,312,984,407,32,95,person
17801,36,person,37,1,571,21,976,311,992,352,16,41,person
17802,38,person,39,1,571,19,997,319,1009,359,12,40,person
17803,8,person,9,0,6154,18,740,390,788,496,48,106,person
17804,11,person,12,0,6154,23,920,395,961,519,41,124,person
17805,12,person,13,0,6154,28,956,394,1008,521,52,127,person
17806,13,person,14,0,6154,29,1660,497,1734,642,74,145,person
17807,23,person,24,0,6155,54,303,277,440,669,137,392,person
17808,24,person,25,0,6155,44,456,277,535,596,79,319,person
17809,25,person,26,0,6155,49,627,310,741,610,114,300,person
17810,1,person,2,0,6156,44,391,1271,792,2200,401,929,person
17811,3,car,4,0,6157,25,451,631,576,678,125,47,car
17812,4,car,5,0,6157,24,838,619,899,663,61,44,car
17813,5,car,6,1,6157,18,904,602,1023,767,119,165,car
17814,10,traffic light,11,0,6157,30,580,511,696,670,116,159,traffic light
17815,11,traffic light,12,0,6157,52,477,368,984,708,507,340,traffic light
17816,3,car,4,1,6159,25,1046,32,1174,123,128,91,car
17817,9,car,10,0,6160,17,128,73,163,86,35,13,car
17818,13,person,14,0,6160,15,57,143,75,159,18,16,person
17819,14,person,15,0,6160,19,142,104,153,128,11,24,person
17820,8,car,8,0,6161,24,21,188,88,212,67,24,car
17821,13,car,12,0,6161,15,162,179,238,212,76,33,car
17822,17,traffic light,16,0,6161,24,63,129,88,212,25,83,traffic light
17823,21,traffic light,20,0,6161,18,137,145,155,212,18,67,traffic light
17824,12,table,13,0,6162,17,237,181,320,230,83,49,dining table
17825,6,person,7,0,6163,18,267,117,281,154,14,37,person
17826,5,truck,6,0,6164,68,897,158,1651,692,754,534,truck
17827,7,person,8,0,6165,26,58,130,73,167,15,37,person
17828,12,person,13,1,6165,19,160,130,178,155,18,25,person
17829,0,person,1,1,6168,24,974,649,1021,846,47,197,person
17830,4,person,5,0,6168,20,943,660,988,856,45,196,person
17831,6,truck,7,0,6168,50,409,365,1025,829,616,464,truck
17832,22,person,23,1,6170,21,47,0,101,97,54,97,person
17833,23,person,24,0,6170,39,557,163,638,317,81,154,person
17834,25,person,26,0,6170,24,359,370,437,514,78,144,person
17835,26,person,27,0,6170,41,513,523,617,766,104,243,person
17836,27,person,28,0,6170,27,783,508,842,734,59,226,person
17837,28,person,29,0,6170,39,998,516,1073,810,75,294,person
17838,30,person,31,0,6170,36,1076,549,1201,675,125,126,person
17839,9,person,10,1,6171,16,243,339,266,413,23,74,person
17840,10,parking meter,11,0,6171,15,570,373,589,477,19,104,parking meter
17841,3,person,4,1,23146,29,458,235,554,300,96,65,person
17842,4,person,5,0,23146,34,475,345,549,513,74,168,person
17843,5,person,6,1,23146,22,448,370,482,510,34,140,person
17844,9,person,10,1,23148,19,258,406,351,487,93,81,person
17845,8,truck,9,0,7450,21,110,144,144,169,34,25,truck
17846,7,car,8,0,7451,24,78,207,107,219,29,12,car
17847,6,car,7,1,7452,24,270,982,464,1077,194,95,car
17848,4,truck,5,0,7453,19,379,1836,638,1972,259,136,truck
17849,7,person,8,0,7499,18,588,612,617,677,29,65,person
17850,6,truck,7,0,7653,19,330,92,405,149,75,57,truck
17851,2,truck,3,0,7654,28,216,56,287,103,71,47,truck
17852,7,person,8,0,7654,29,248,73,271,133,23,60,person
17853,5,truck,6,0,7655,37,4,141,138,208,134,67,truck
17854,4,person,5,0,7656,33,154,224,199,298,45,74,person
17855,5,person,6,0,7656,27,262,162,291,233,29,71,person
17856,6,person,7,1,7656,26,307,146,329,235,22,89,person
17857,7,person,8,0,7656,46,319,149,370,277,51,128,person
17858,8,person,9,1,7656,19,413,144,438,207,25,63,person
17859,9,person,10,1,7656,27,441,138,471,230,30,92,person
17860,10,person,11,0,7656,36,414,172,455,304,41,132,person
17861,11,person,12,0,7656,34,374,141,420,337,46,196,person
17862,2,person,3,0,7659,21,31,42,46,65,15,23,person
17863,4,person,5,1,7659,21,81,68,100,108,19,40,person
17864,8,truck,9,1,7659,16,256,70,288,87,32,17,truck
17865,13,person,14,0,7659,39,119,63,146,117,27,54,person
17866,9,truck,9,0,7660,15,259,176,331,250,72,74,truck
17867,9,truck,10,1,7661,22,1794,809,1978,943,184,134,truck
17868,12,car,13,0,7661,23,1572,839,1877,943,305,104,car
17869,21,person,22,1,7661,23,320,741,399,948,79,207,person
17870,22,person,23,0,7661,39,313,859,409,1202,96,343,person
17871,23,person,24,1,7661,23,1432,710,1515,828,83,118,person
17872,1,truck,2,0,7662,55,225,112,956,494,731,382,truck
17873,11,boat,10,1,7663,17,1533,1240,2197,1499,664,259,boat
17874,5,bus,6,0,23329,19,0,34,350,200,350,166,bus
17875,7,truck,8,0,23329,31,346,1,925,320,579,319,truck
17876,8,person,9,1,23329,42,775,2,919,372,144,370,person
17877,7,person,8,1,23331,29,957,232,1013,336,56,104,person
17878,8,person,9,0,23331,38,840,252,906,410,66,158,person
17879,9,person,10,0,23331,37,673,261,720,421,47,160,person
17880,10,person,11,1,23331,22,823,263,846,303,23,40,person
17881,11,bench,12,0,23331,19,774,304,845,340,71,36,bench
17882,12,person,13,1,23331,35,799,283,834,342,35,59,person
17883,13,person,14,0,23331,36,525,267,567,348,42,81,person
17884,14,person,15,1,23331,30,548,257,578,318,30,61,person
17885,15,person,16,0,23331,39,441,263,482,356,41,93,person
17886,16,person,17,0,23331,22,471,263,486,335,15,72,person
17887,18,person,19,0,23331,32,302,271,331,323,29,52,person
17888,19,person,20,1,23331,21,368,266,385,323,17,57,person
17889,1,person,2,0,23333,76,678,172,881,490,203,318,person
17890,2,truck,3,0,23334,77,184,0,640,271,456,271,truck
17891,2,bench,3,0,23335,22,839,377,1007,532,168,155,bench
17892,3,bench,4,0,23335,15,735,300,873,370,138,70,bench
17893,4,bench,5,0,23335,15,475,278,682,326,207,48,bench
17894,5,bench,6,0,23335,19,208,288,429,347,221,59,bench
17895,6,bench,7,0,23335,21,1,321,167,407,166,86,bench
17896,10,person,11,0,23336,33,521,445,608,565,87,120,person
17897,2,truck,3,0,23337,50,331,333,610,462,279,129,truck
17898,19,person,20,0,7675,19,73,143,83,164,10,21,person
17899,20,car,21,0,7675,19,252,148,281,166,29,18,car
17900,9,car,10,0,7677,24,18,454,130,517,112,63,car
17901,8,person,9,0,7678,19,157,162,166,181,9,19,person
17902,9,person,10,0,7678,19,143,162,151,183,8,21,person
17903,7,person,8,0,8259,21,123,522,150,563,27,41,person
17904,7,person,8,0,8260,23,53,293,72,332,19,39,person
17905,8,person,9,0,8260,19,30,290,46,329,16,39,person
17906,9,person,10,0,8260,16,20,297,30,330,10,33,person
17907,0,person,1,0,8511,32,543,162,598,242,55,80,person
17908,6,person,7,0,8511,16,326,113,351,157,25,44,person
17909,3,person,4,1,8513,48,259,66,398,335,139,269,person
17910,4,umbrella,5,0,8513,44,254,1,499,260,245,259,umbrella
17911,6,person,7,1,8514,52,108,47,187,225,79,178,person
17912,7,person,8,1,8514,60,27,6,140,225,113,219,person
17913,3,person,4,1,8516,36,202,57,302,267,100,210,person
17914,1,car,2,1,20866,25,82,108,252,169,170,61,car
17915,6,bench,7,0,23613,17,86,761,307,815,221,54,bench
17916,7,car,8,1,23615,19,63,376,174,440,111,64,car
17917,21,person,22,1,23615,37,391,360,441,493,50,133,person
17918,22,person,23,0,23615,43,407,377,480,497,73,120,person
17919,12,car,13,0,23616,56,176,664,848,938,672,274,car
17920,13,car,14,0,23616,34,26,584,327,671,301,87,car
17921,11,car,12,1,23617,25,736,348,1024,682,288,334,car
17922,2,train,3,0,23618,62,143,266,833,444,690,178,train
17923,9,car,10,0,23619,37,134,525,221,579,87,54,car
17924,10,car,11,0,23619,31,220,536,307,600,87,64,car
17925,11,car,12,0,23619,19,263,526,321,581,58,55,car
17926,7,airplane,8,0,23620,28,846,393,1021,441,175,48,airplane
17927,15,car,16,0,23621,32,179,1326,418,1480,239,154,car
17928,16,car,17,1,23621,27,48,1324,233,1448,185,124,car
17929,18,person,19,1,23621,19,2128,1430,2198,1636,70,206,person
17930,23,person,24,0,23621,21,553,1392,592,1433,39,41,person
17931,24,person,25,0,23621,16,440,1388,468,1424,28,36,person
17932,5,truck,6,0,23622,114,330,181,901,567,571,386,truck
17933,9,car,10,1,23622,28,647,439,729,524,82,85,car
17934,10,car,11,1,23622,26,544,442,657,537,113,95,car
17935,13,person,14,0,23622,33,174,412,208,474,34,62,person
17936,12,traffic light,13,0,23624,38,220,228,319,524,99,296,traffic light
17937,13,traffic light,14,0,23624,30,695,312,923,535,228,223,traffic light
17938,7,car,8,0,23625,18,22,907,197,993,175,86,car
17939,2,train,3,0,23626,39,2,188,803,432,801,244,train
17940,3,car,4,0,9854,17,2,167,33,180,31,13,car
17941,3,car,4,1,9857,19,760,483,923,561,163,78,car
17942,4,car,5,1,9857,19,818,483,948,572,130,89,car
17943,5,car,6,1,9857,17,887,485,989,580,102,95,car
17944,4,car,5,0,9859,19,401,176,454,194,53,18,car
17945,6,car,7,0,9861,21,96,397,216,470,120,73,car
17946,5,car,6,1,10047,23,181,1,666,499,485,498,car
17947,2,person,3,0,10050,54,1452,39,1810,1038,358,999,person
17948,14,person,15,0,10053,21,530,179,563,234,33,55,person
17949,9,person,10,0,10054,21,282,209,301,254,19,45,person
17950,0,mirror,1,0,10056,23,236,28,300,163,64,135,mirror
17951,1,car,2,0,10057,15,883,219,1022,337,139,118,car
17952,3,truck,4,0,10057,64,0,0,1004,710,1004,710,truck
17953,4,truck,5,0,10057,39,0,33,693,765,693,732,truck
17954,3,car,4,0,10058,32,126,1,248,123,122,122,car
17955,4,car,5,0,10058,38,20,30,157,186,137,156,car
17956,5,car,6,0,10058,26,22,164,164,244,142,80,car
17957,6,car,7,0,10058,32,151,70,300,199,149,129,car
17958,7,car,8,0,10058,26,209,76,319,219,110,143,car
17959,8,car,9,0,10058,18,250,5,319,85,69,80,car
17960,0,car,1,1,23651,17,0,0,768,575,768,575,car
17961,1,car,2,1,23651,39,0,54,268,191,268,137,car
17962,4,car,5,1,23651,17,228,63,305,107,77,44,car
17963,0,truck,1,1,23653,56,173,101,855,632,682,531,truck
17964,1,car,2,1,23653,25,0,197,322,493,322,296,car
17965,1,car,2,1,23654,42,0,0,484,480,484,480,car
17966,3,motorbike,4,0,23655,47,0,90,324,260,324,170,motorcycle
17967,4,car,5,0,23655,46,0,125,773,552,773,427,car
17968,5,car,6,1,23655,18,691,141,798,336,107,195,car
17969,3,car,4,1,23656,26,1,109,90,159,89,50,car
17970,4,car,5,1,23656,24,42,109,114,157,72,48,car
17971,5,car,6,1,23656,31,78,92,180,160,102,68,car
17972,2,car,3,1,23657,16,984,336,1024,409,40,73,car
17973,4,car,5,1,23657,36,829,298,990,398,161,100,car
17974,5,car,6,0,23657,92,64,167,965,668,901,501,car
17975,8,car,9,1,23657,51,0,154,446,464,446,310,car
17976,9,bus,10,1,23657,26,35,234,265,312,230,78,bus
17977,5,car,6,0,23658,116,20,56,995,755,975,699,car
17978,6,person,7,1,23658,17,364,128,402,215,38,87,person
17979,7,person,8,1,23658,22,303,143,371,223,68,80,person
17980,8,car,9,1,23658,36,271,111,381,234,110,123,car
17981,9,car,10,1,23658,22,199,113,311,156,112,43,car
17982,10,car,11,1,23658,70,56,121,321,236,265,115,car
17983,13,car,14,1,23658,42,0,206,273,538,273,332,car
17984,14,person,15,1,23658,16,118,165,156,227,38,62,person
17985,15,person,16,1,23658,20,183,192,258,252,75,60,person
17986,16,person,17,1,23658,27,203,112,244,216,41,104,person
17987,1,car,2,1,23659,60,1,0,616,545,615,545,car
17988,2,truck,3,1,23660,117,47,107,1015,819,968,712,truck
17989,4,car,5,1,23660,21,2,213,178,469,176,256,car
17990,9,person,10,1,23661,33,183,209,291,310,108,101,person
17991,1,car,2,0,23662,66,38,149,1024,654,986,505,car
17992,3,bird,4,0,648,17,766,22,785,52,19,30,bird
17993,7,chair,8,0,648,18,18,625,195,731,177,106,chair
17994,3,bird,4,0,10847,18,35,215,121,257,86,42,bird
17995,12,bird,13,0,10847,16,302,325,363,346,61,21,bird
17996,24,bird,25,0,10847,17,253,559,327,605,74,46,bird
17997,2,truck,3,0,10850,28,8,79,174,167,166,88,truck
17998,7,person,8,1,10850,18,21,121,37,153,16,32,person
17999,1,truck,2,1,21150,27,161,109,462,323,301,214,truck
18000,2,person,3,0,23718,38,1349,358,1562,920,213,562,person
18001,9,person,10,0,10959,21,270,161,280,185,10,24,person
18002,10,person,11,1,10961,56,0,1,128,225,128,224,person
18003,8,person,9,0,10962,35,435,390,489,553,54,163,person
18004,9,person,10,0,10962,41,892,435,984,591,92,156,person
18005,5,person,6,0,11628,36,260,205,469,253,209,48,person
18006,9,person,10,0,11629,101,201,28,501,483,300,455,person
18007,1,person,2,1,11630,54,178,89,430,374,252,285,person
18008,3,person,4,1,11632,31,1413,0,2172,635,759,635,person
18009,3,person,4,1,21498,43,145,107,228,163,83,56,person
18010,5,door,5,0,11811,20,69,373,353,650,284,277,door
18011,6,person,6,1,11811,15,0,404,173,622,173,218,person
18012,7,person,7,1,11811,17,0,509,227,767,227,258,person
18013,9,person,10,1,13850,38,1006,896,1481,1404,475,508,person
18014,11,person,12,1,13850,30,0,1088,384,1407,384,319,person
18015,22,person,23,1,13850,19,1828,1144,2076,1407,248,263,person
18016,4,person,5,0,13854,20,39,1469,142,1639,103,170,person
18017,5,person,6,0,13854,15,706,1313,759,1448,53,135,person
18018,22,truck,23,0,14142,40,1529,741,1718,993,189,252,truck
18019,3,bench,4,0,15650,24,63,315,149,356,86,41,bench
18020,4,bench,5,0,15650,23,474,318,562,370,88,52,bench
18021,2,train,3,0,16016,18,325,135,480,256,155,121,train
18022,2,train,3,0,22080,38,95,97,448,239,353,142,train
18023,6,person,7,0,16019,24,924,541,969,658,45,117,person
18024,11,boat,12,0,16020,21,2,368,488,517,486,149,boat
18025,9,person,10,1,16022,21,569,520,620,589,51,69,person
18026,10,person,11,1,16022,19,640,534,696,587,56,53,person
18027,4,person,5,0,16023,49,194,142,268,293,74,151,person
18028,1,person,2,0,16025,21,70,33,80,62,10,29,person
18029,2,person,3,0,16025,27,89,35,99,61,10,26,person
18030,3,person,4,0,16025,19,117,33,126,56,9,23,person
18031,4,person,5,0,16160,24,262,122,273,149,11,27,person
18032,14,person,15,1,16843,15,351,501,379,553,28,52,person
18033,6,car,7,0,16844,18,77,292,137,312,60,20,car
18034,5,car,6,0,16845,18,322,385,376,420,54,35,car
18035,6,car,7,0,16845,19,271,387,317,416,46,29,car
18036,2,person,3,1,19360,21,148,77,184,148,36,71,person
18037,3,person,4,1,19360,31,221,101,279,229,58,128,person
18038,4,person,5,0,19360,53,144,111,264,307,120,196,person
18039,5,person,6,1,19360,29,258,161,333,307,75,146,person
18040,6,person,7,0,19360,37,314,109,394,307,80,198,person
18041,2,person,3,1,19362,25,259,227,369,351,110,124,person
18042,3,person,4,1,19362,34,227,296,331,556,104,260,person
18043,4,person,5,1,19362,23,307,329,393,658,86,329,person
18044,5,person,6,1,19362,24,215,499,379,714,164,215,person
18045,4,car,5,0,19363,17,453,217,495,242,42,25,car
18046,6,person,7,0,24594,79,487,147,646,390,159,243,person
18047,7,bicycle,8,0,24594,94,498,271,664,506,166,235,bicycle
18048,8,backpack,9,0,24594,24,573,167,650,244,77,77,backpack
18049,3,person,4,0,24595,43,82,255,161,365,79,110,person
18050,4,person,5,1,24595,60,130,306,222,427,92,121,person
18051,5,person,6,0,24595,39,191,299,262,398,71,99,person
18052,6,person,7,0,24595,69,93,376,259,559,166,183,person
18053,7,person,8,0,24595,61,216,374,317,518,101,144,person
18054,8,person,9,1,24595,47,262,373,337,509,75,136,person
18055,9,person,10,1,24595,51,291,386,373,506,82,120,person
18056,10,person,11,1,24595,35,301,355,356,422,55,67,person
18057,11,person,12,1,24595,31,318,342,378,423,60,81,person
18058,12,backpack,13,0,24595,18,208,403,250,439,42,36,backpack
18059,2,car,3,0,24596,93,116,55,685,425,569,370,car
18060,3,car,4,0,24596,28,34,167,126,267,92,100,car
18061,2,person,3,0,24597,39,260,753,398,966,138,213,person
18062,3,person,4,1,24597,16,327,508,415,612,88,104,person
18063,3,car,4,0,19792,22,68,220,101,241,33,21,car
18064,9,car,10,0,19792,15,223,222,241,235,18,13,car
18065,8,person,9,0,19796,49,205,404,353,555,148,151,person
18066,10,person,11,0,19801,15,729,997,752,1045,23,48,person
18067,6,clock,7,0,19806,16,796,487,888,577,92,90,clock
18068,6,car,7,0,19810,17,14,186,37,199,23,13,car
18069,13,person,14,1,312,32,112,375,177,484,65,109,person
18070,14,person,15,1,312,39,250,377,316,485,66,108,person
18071,15,person,16,0,312,42,137,366,279,525,142,159,person
18072,22,person,23,0,312,33,374,383,454,508,80,125,person
18073,38,person,39,0,312,62,495,381,586,536,91,155,person
18074,4,person,5,0,313,77,162,136,331,362,169,226,person
18075,24,bird,25,0,313,43,291,313,442,459,151,146,bird
18076,4,person,5,1,24756,27,970,340,1024,619,54,279,person
18077,5,person,6,0,24756,82,43,276,181,644,138,368,person
18078,6,person,7,1,24756,75,141,305,219,617,78,312,person
18079,7,person,8,1,24756,17,216,318,247,354,31,36,person
18080,8,person,9,0,24756,72,204,309,307,615,103,306,person
18081,11,person,12,1,24756,33,280,324,325,592,45,268,person
18082,12,person,13,0,24756,50,307,310,412,620,105,310,person
18083,14,person,15,1,24756,22,375,328,411,416,36,88,person
18084,15,person,16,1,24756,34,387,323,456,452,69,129,person
18085,18,person,18,1,24756,47,436,325,531,612,95,287,person
18086,19,person,19,1,24756,25,424,339,523,441,99,102,person
18087,20,person,20,0,24756,63,425,315,633,625,208,310,person
18088,21,person,21,1,24756,50,555,335,631,608,76,273,person
18089,22,person,22,0,24756,48,623,341,698,618,75,277,person
18090,23,person,23,1,24756,37,662,336,706,596,44,260,person
18091,24,person,24,0,24756,64,697,304,788,628,91,324,person
18092,25,person,25,1,24756,52,772,337,833,615,61,278,person
18093,26,person,26,0,24756,58,816,323,908,637,92,314,person
18094,27,person,27,1,24756,41,886,341,945,608,59,267,person
18095,28,person,28,0,24756,48,922,343,1006,639,84,296,person
18096,5,cow,6,0,24764,24,226,608,247,626,21,18,cow
18097,6,cow,7,0,24764,18,245,593,258,606,13,13,cow
18098,1,person,2,0,19,83,282,307,559,687,277,380,person
18099,17,person,18,0,19,73,483,391,734,718,251,327,person
18100,33,person,34,0,19,80,697,421,940,769,243,348,person
18101,48,person,49,0,19,62,902,445,1077,793,175,348,person
18102,2,person,3,0,4,20,348,134,362,169,14,35,person
18103,0,person,1,1,2081,76,978,464,2100,1647,1122,1183,person
18104,0,person,1,0,2086,30,467,665,550,869,83,204,person
18105,0,person,1,0,2087,56,1207,200,1982,1485,775,1285,person
18106,0,person,1,0,2093,26,608,310,700,512,92,202,person
18107,3,car,4,0,2093,31,544,306,885,498,341,192,car
18108,0,person,1,0,2094,41,1043,521,1253,1242,210,721,person
18109,0,person,1,0,2096,43,512,399,1106,1198,594,799,person
18110,0,airplane,1,1,2097,18,0,0,1121,188,1121,188,airplane
18111,0,person,1,0,20262,56,1207,200,1982,1485,775,1285,person
18112,0,dog,1,0,20265,80,857,848,1927,1647,1070,799,dog
18113,1,person,2,0,20265,73,1408,268,1869,1564,461,1296,person
18114,2,person,3,1,22749,20,804,578,902,731,98,153,person
18115,7,person,8,0,22750,68,321,290,437,594,116,304,person
18116,9,person,10,1,22750,34,408,90,437,177,29,87,person
18117,10,person,11,1,22750,46,164,99,201,188,37,89,person
18118,5,car,6,0,22751,81,228,348,660,650,432,302,car
18119,2,person,3,0,22753,56,76,247,229,461,153,214,person
18120,3,person,4,0,22753,55,257,267,391,530,134,263,person
18121,4,person,5,1,22753,45,222,236,289,414,67,178,person
18122,5,person,6,1,22753,35,310,241,375,433,65,192,person
18123,6,person,7,1,22753,68,347,239,435,528,88,289,person
18124,7,person,8,0,22753,84,409,222,509,535,100,313,person
18125,8,person,9,0,22753,83,499,199,616,536,117,337,person
18126,9,person,10,0,22753,83,598,191,704,524,106,333,person
18127,10,person,11,0,22753,72,694,193,820,506,126,313,person
18128,11,person,12,0,22753,98,773,152,955,491,182,339,person
18129,2,person,3,0,22754,28,189,636,216,700,27,64,person
18130,2,person,3,0,22755,46,293,391,339,494,46,103,person
18131,15,person,16,1,22765,34,168,620,235,837,67,217,person
18132,16,backpack,17,0,22765,23,156,656,214,727,58,71,backpack
18133,12,person,13,0,3049,15,363,240,381,295,18,55,person
18134,8,person,9,0,3051,16,96,98,104,129,8,31,person
18135,16,boat,17,0,3051,23,23,198,380,241,357,43,boat
18136,17,person,18,0,3051,22,297,182,348,235,51,53,person
18137,3,boat,4,0,3054,15,88,81,297,103,209,22,boat
18138,6,boat,7,0,3054,17,52,134,398,265,346,131,boat
18139,7,person,8,1,3054,40,163,190,222,258,59,68,person
18140,8,person,9,1,3054,28,306,222,341,297,35,75,person
18141,9,person,10,1,3054,22,110,89,129,130,19,41,person
18142,12,bird,13,0,3056,17,152,362,210,404,58,42,bird
18143,17,bird,18,0,3056,16,947,416,1005,441,58,25,bird
18144,18,bird,19,0,3056,15,791,451,829,490,38,39,bird
18145,3,person,4,1,41,56,237,142,280,337,43,195,person
18146,4,person,5,0,41,65,183,139,246,332,63,193,person
18147,7,person,8,1,41,29,112,286,151,370,39,84,person
18148,9,person,10,0,41,25,2,343,36,382,34,39,person
18149,10,person,11,0,41,29,13,356,109,389,96,33,person
18150,11,person,12,0,41,70,111,316,220,564,109,248,person
18151,20,person,21,0,41,34,174,338,226,534,52,196,person
18152,21,person,22,1,41,38,278,310,351,521,73,211,person
18153,22,person,23,0,41,63,320,320,392,542,72,222,person
18154,2,person,3,0,42,119,22,70,381,504,359,434,person
18155,2,person,3,1,43,111,1,15,815,478,814,463,person
18156,11,person,12,1,43,48,1,1,250,479,249,478,person
18157,14,boat,15,0,44,16,562,582,725,626,163,44,boat
18158,21,person,22,0,44,123,953,550,1148,1088,195,538,person
18159,2,person,3,0,45,40,516,265,543,320,27,55,person
18160,3,person,4,0,45,46,140,78,164,140,24,62,person
18161,4,person,5,0,45,38,88,142,108,211,20,69,person
18162,5,person,6,0,45,51,70,142,94,216,24,74,person
18163,5,person,6,0,3080,15,202,184,212,211,10,27,person
18164,1,person,2,0,3088,23,157,143,177,185,20,42,person
18165,6,bicycle,4,1,3091,22,66,208,80,225,14,17,bicycle
18166,7,person,5,1,3091,23,61,196,73,213,12,17,person
18167,8,bicycle,6,1,3091,38,44,212,70,228,26,16,bicycle
18168,9,person,7,1,3091,21,50,199,63,221,13,22,person
18169,11,person,8,1,3091,22,131,196,146,220,15,24,person
18170,12,bicycle,9,0,3091,39,137,211,166,231,29,20,bicycle
18171,13,person,10,0,3091,20,143,201,155,227,12,26,person
18172,14,bicycle,11,0,3091,36,120,206,146,224,26,18,bicycle
18173,5,person,6,0,3094,19,199,135,206,153,7,18,person
18174,4,person,5,0,3107,20,165,154,188,196,23,42,person
18175,5,person,6,0,3107,16,45,175,66,203,21,28,person
18176,8,person,9,0,3108,16,209,133,216,155,7,22,person
18177,2,person,3,0,3112,16,221,136,232,161,11,25,person
18178,5,person,6,0,3115,22,232,214,244,237,12,23,person
18179,3,boat,4,0,3117,40,88,144,255,189,167,45,boat
18180,4,boat,5,1,3117,43,1,141,141,178,140,37,boat
18181,3,person,4,0,3127,25,199,182,212,213,13,31,person
18182,9,boat,10,0,3129,26,23,149,73,159,50,10,boat
18183,5,person,6,0,3140,27,110,184,123,226,13,42,person
18184,6,person,7,0,3140,25,127,187,136,227,9,40,person
18185,7,person,8,0,3140,35,145,187,158,226,13,39,person
18186,8,person,9,0,3140,15,45,183,60,198,15,15,person
18187,3,person,4,0,3141,21,195,153,207,180,12,27,person
18188,4,person,5,0,3141,23,4,165,20,192,16,27,person
18189,6,person,7,0,3141,28,27,190,49,213,22,23,person
18190,8,person,9,1,3141,31,153,186,192,210,39,24,person
18191,10,person,11,0,3141,21,120,206,134,238,14,32,person
18192,11,person,12,0,3141,32,137,210,157,237,20,27,person
18193,15,person,16,0,3141,16,224,139,230,158,6,19,person
18194,16,person,17,0,3141,15,233,138,238,160,5,22,person
18195,7,person,8,0,3146,16,181,215,194,226,13,11,person
18196,7,person,8,0,3147,17,62,184,71,212,9,28,person
18197,8,person,9,0,3147,20,78,184,87,216,9,32,person
18198,2,person,3,0,20320,50,182,140,210,199,28,59,person
18199,3,person,4,0,20335,25,199,182,212,213,13,31,person
18200,0,person,1,1,22841,83,243,239,638,980,395,741,person
18201,5,person,6,1,22842,48,1,444,383,947,382,503,person
18202,6,airplane,7,0,22845,38,480,321,573,362,93,41,airplane
18203,7,person,8,1,22845,37,1,193,203,682,202,489,person
18204,10,person,11,0,22846,26,371,506,385,532,14,26,person
18205,11,person,12,0,22846,26,576,498,591,536,15,38,person
18206,12,person,13,0,22846,15,679,528,695,537,16,9,person
18207,13,person,14,0,22846,17,886,527,909,539,23,12,person
18208,15,person,16,0,22846,16,1005,522,1019,537,14,15,person
18209,1,boat,2,1,22848,30,1,299,297,538,296,239,boat
18210,2,person,3,0,22848,52,141,151,302,354,161,203,person
18211,3,person,4,1,22848,60,472,201,634,579,162,378,person
18212,4,person,5,1,22848,75,608,205,772,604,164,399,person
18213,13,car,14,0,22850,17,910,353,940,362,30,9,car
18214,14,car,15,0,22850,16,827,356,846,364,19,8,car
18215,3,person,4,0,22851,53,357,278,386,360,29,82,person
18216,4,person,5,0,22851,45,249,332,285,364,36,32,person
18217,7,person,8,0,22853,40,403,441,431,547,28,106,person
18218,8,person,9,1,22853,22,866,439,887,481,21,42,person
18219,9,person,10,0,22853,18,361,437,372,466,11,29,person
18220,10,person,11,0,22853,18,291,449,303,482,12,33,person
18221,11,person,12,0,22853,26,201,447,218,492,17,45,person
18222,12,person,13,0,22853,22,258,446,275,481,17,35,person
18223,13,person,14,0,22853,19,316,446,325,480,9,34,person
18224,14,person,15,1,22853,17,398,440,413,480,15,40,person
18225,16,person,17,0,22853,23,189,450,201,489,12,39,person
18226,17,person,18,1,22853,17,186,440,194,468,8,28,person
18227,18,person,19,0,22853,19,308,440,319,472,11,32,person
18228,19,person,20,0,22853,15,217,443,230,461,13,18,person
18229,20,person,21,1,22853,15,204,435,210,451,6,16,person
18230,21,person,22,0,22853,20,165,437,173,467,8,30,person
18231,22,person,23,0,22853,22,138,438,150,466,12,28,person
18232,23,person,24,0,22853,55,46,417,88,510,42,93,person
18233,24,person,25,1,22853,36,35,420,58,504,23,84,person
18234,25,person,26,0,22853,51,2,419,32,498,30,79,person
18235,26,person,27,1,22853,40,26,426,45,497,19,71,person
18236,27,person,28,0,22853,30,71,424,90,497,19,73,person
18237,28,person,29,1,22853,15,93,434,101,452,8,18,person
18238,29,person,30,1,22853,17,102,438,108,463,6,25,person
18239,30,person,31,0,22853,19,106,440,118,470,12,30,person
18240,31,person,32,0,22853,19,122,432,133,463,11,31,person
18241,4,person,5,0,22854,29,509,426,526,487,17,61,person
18242,4,person,5,0,22855,70,328,33,430,303,102,270,person
18243,5,person,6,0,22855,64,176,27,302,327,126,300,person
18244,3,car,4,0,22856,19,129,191,149,203,20,12,car
18245,12,person,13,0,22856,18,722,189,728,209,6,20,person
18246,7,bicycle,8,0,47,113,1636,650,2182,1066,546,416,bicycle
18247,8,bicycle,9,1,47,48,1540,707,1859,1013,319,306,bicycle
18248,9,bicycle,10,1,47,50,1492,682,1738,986,246,304,bicycle
18249,10,bicycle,11,1,47,50,1357,650,1627,923,270,273,bicycle
18250,11,bicycle,12,1,47,39,1306,655,1481,873,175,218,bicycle
18251,12,bicycle,13,1,47,41,1276,630,1434,827,158,197,bicycle
18252,13,bicycle,14,1,47,40,1256,608,1399,802,143,194,bicycle
18253,14,person,15,1,47,21,1614,536,1673,611,59,75,person
18254,15,person,16,1,47,21,1726,529,1810,612,84,83,person
18255,16,person,17,1,47,20,1700,547,1744,614,44,67,person
18256,17,person,18,1,47,16,1726,530,1765,588,39,58,person
18257,18,person,19,0,47,40,1141,482,1204,707,63,225,person
18258,37,bench,38,1,47,20,90,560,149,639,59,79,bench
18259,38,bench,39,1,47,15,336,538,381,595,45,57,bench
18260,39,person,40,1,47,36,135,478,203,622,68,144,person
18261,41,person,42,1,47,25,302,475,344,596,42,121,person
18262,42,person,43,0,47,122,168,474,368,1080,200,606,person
18263,51,person,52,0,47,57,378,484,436,667,58,183,person
18264,52,person,53,0,47,62,430,490,489,673,59,183,person
18265,53,person,54,0,47,71,472,463,533,669,61,206,person
18266,54,person,55,1,47,35,527,487,564,657,37,170,person
18267,56,person,56,0,47,58,547,483,615,668,68,185,person
18268,57,person,57,1,47,18,609,485,638,528,29,43,person
18269,58,person,58,0,47,42,610,488,659,644,49,156,person
18270,59,person,59,1,47,15,653,481,670,513,17,32,person
18271,60,person,60,0,47,38,651,463,699,612,48,149,person
18272,61,person,61,1,47,16,698,480,720,511,22,31,person
18273,62,person,62,1,47,62,714,487,775,690,61,203,person
18274,64,person,64,1,47,23,745,490,778,574,33,84,person
18275,65,person,65,0,47,108,648,499,781,758,133,259,person
18276,67,person,67,1,47,54,860,476,905,646,45,170,person
18277,69,person,69,1,47,28,901,488,922,564,21,76,person
18278,70,person,70,1,47,28,918,485,944,561,26,76,person
18279,71,person,71,0,47,66,923,490,1006,727,83,237,person
18280,84,person,84,1,47,52,987,485,1036,707,49,222,person
18281,85,person,85,1,47,68,1031,468,1079,704,48,236,person
18282,86,person,86,0,47,89,1053,474,1128,737,75,263,person
18283,95,person,95,0,47,103,768,447,892,756,124,309,person
18284,3,person,4,0,4335,22,270,158,290,224,20,66,person
18285,2,person,3,0,20430,35,1018,704,1148,1069,130,365,person
18286,8,bench,9,0,22901,23,6,509,143,591,137,82,bench
18287,9,bird,10,0,22903,57,393,471,1473,1480,1080,1009,bird
18288,3,umbrella,4,0,22904,15,831,280,900,320,69,40,umbrella
18289,9,person,9,0,22904,29,553,252,564,278,11,26,person
18290,11,person,11,0,22904,19,612,240,619,265,7,25,person
18291,12,person,12,0,22904,21,603,242,610,264,7,22,person
18292,14,person,15,1,554,25,542,826,606,1035,64,209,person
18293,16,person,17,1,554,24,849,895,905,1029,56,134,person
18294,21,bench,22,0,554,20,1540,887,1626,930,86,43,bench
18295,21,person,22,0,4423,25,245,190,270,274,25,84,person
18296,22,person,23,0,4423,26,220,190,247,276,27,86,person
18297,19,person,20,0,4426,21,144,394,169,490,25,96,person
18298,20,person,21,0,4426,17,698,383,718,436,20,53,person
18299,4,person,5,0,22934,26,196,365,213,411,17,46,person
18300,5,bench,6,0,22934,32,649,428,745,516,96,88,bench
18301,7,person,8,1,22934,17,554,437,564,459,10,22,person
18302,9,bench,10,0,22934,30,343,393,380,433,37,40,bench
18303,20,person,21,1,22935,50,458,77,554,384,96,307,person
18304,3,person,4,1,22940,64,332,389,656,888,324,499,person
18305,4,person,5,1,22940,91,374,232,708,896,334,664,person
18306,5,person,6,1,22940,56,921,332,1114,836,193,504,person
18307,6,person,7,1,22940,68,1051,238,1308,969,257,731,person
18308,7,person,8,1,22940,23,1382,239,1500,747,118,508,person
18309,9,person,10,1,22940,77,707,255,1078,877,371,622,person
18310,3,person,4,0,22945,26,57,412,91,513,34,101,person
18311,4,person,5,1,22945,31,154,402,177,498,23,96,person
18312,5,person,6,1,22945,25,185,396,208,473,23,77,person
18313,6,person,7,0,22945,41,159,395,193,510,34,115,person
18314,7,person,8,0,22945,43,210,406,243,503,33,97,person
18315,8,person,9,1,22945,35,249,400,269,476,20,76,person
18316,9,person,10,0,22945,45,255,403,290,500,35,97,person
18317,10,person,11,0,22945,38,291,396,318,476,27,80,person
18318,11,person,12,0,22945,46,315,401,342,496,27,95,person
18319,12,person,13,1,22945,25,329,388,345,481,16,93,person
18320,14,person,15,0,22945,37,371,388,397,479,26,91,person
18321,15,person,16,0,22945,55,393,378,436,502,43,124,person
18322,2,plant pot,3,0,22946,26,371,327,627,395,256,68,potted plant
18323,4,plant pot,5,0,22948,20,127,529,521,930,394,401,potted plant
18324,8,bench,9,0,22949,17,321,461,381,493,60,32,bench
18325,9,bench,10,0,22949,19,433,465,503,501,70,36,bench
18326,10,person,11,1,22950,51,0,3,360,646,360,643,person
18327,2,bicycle,3,0,69,77,381,326,596,504,215,178,bicycle
18328,5,person,6,1,69,53,83,297,417,675,334,378,person
18329,7,person,8,0,70,29,235,229,249,253,14,24,person
18330,8,bicycle,9,0,70,18,238,241,249,260,11,19,bicycle
18331,9,person,10,0,70,57,507,363,555,435,48,72,person
18332,10,backpack,11,0,70,15,513,366,537,380,24,14,backpack
18333,11,bicycle,12,0,70,76,480,396,576,454,96,58,bicycle
18334,12,person,13,0,70,15,48,217,56,231,8,14,person
18335,3,car,4,0,4914,31,862,691,1397,892,535,201,car
18336,6,boat,7,0,4914,60,24,633,806,862,782,229,boat
18337,4,person,5,0,22994,83,30,276,174,484,144,208,person
18338,5,backpack,6,0,22994,31,100,290,168,353,68,63,backpack
18339,7,boat,8,0,5007,17,334,460,411,520,77,60,boat
18340,9,boat,10,1,5010,51,9,177,301,299,292,122,boat
18341,3,boat,4,0,24880,101,263,137,1363,954,1100,817,boat
18342,13,boat,14,0,24881,33,317,550,540,768,223,218,boat
18343,21,chair,22,0,24883,19,1777,972,1863,1037,86,65,chair
18344,22,person,23,0,24883,27,1666,939,1747,1008,81,69,person
18345,23,person,24,0,24883,16,1678,934,1722,987,44,53,person
18346,44,table,45,0,24883,15,1495,902,1523,935,28,33,dining table
18347,13,person,13,0,24884,54,0,159,161,688,161,529,person
18348,15,backpack,15,0,24884,25,58,181,132,278,74,97,backpack
18349,16,person,16,1,24884,43,89,131,161,508,72,377,person
18350,10,bus,11,0,24885,15,750,471,867,506,117,35,bus
18351,11,car,12,0,24885,17,966,486,1021,505,55,19,car
18352,12,car,13,0,24885,15,413,499,437,510,24,11,car
18353,15,car,16,0,24887,23,1,239,53,289,52,50,car
18354,16,car,17,0,24887,23,53,251,105,287,52,36,car
18355,18,person,19,1,24887,15,146,245,174,278,28,33,person
18356,25,boat,26,0,24887,16,462,330,527,343,65,13,boat
18357,25,traffic light,26,0,24888,24,1449,633,1742,1341,293,708,traffic light
18358,26,car,27,0,24888,30,1518,769,1901,990,383,221,car
18359,27,car,28,0,24888,29,788,797,1286,1017,498,220,car
18360,28,car,29,1,24888,40,223,961,754,1274,531,313,car
18361,30,person,31,0,24888,17,881,1017,948,1165,67,148,person
18362,31,person,32,0,24888,15,561,1038,662,1216,101,178,person
18363,34,person,35,0,24888,24,2091,751,2183,925,92,174,person
18364,35,bicycle,36,1,24888,24,2046,832,2185,943,139,111,bicycle
18365,36,person,37,0,24888,20,1984,698,2084,837,100,139,person
18366,37,bicycle,38,1,24888,27,1926,756,2084,853,158,97,bicycle
18367,43,motorbike,44,0,24888,17,1980,647,2081,744,101,97,motorcycle
18368,44,person,45,0,24888,19,1830,619,1888,748,58,129,person
18369,46,person,47,0,24888,21,1573,697,1631,824,58,127,person
18370,48,person,49,0,24888,21,1412,659,1450,809,38,150,person
18371,50,person,51,0,24888,21,836,731,894,868,58,137,person
18372,51,person,52,0,24888,30,694,762,773,914,79,152,person
18373,52,person,53,0,24888,30,365,786,446,972,81,186,person
18374,53,car,54,0,24888,17,160,494,272,563,112,69,car
18375,54,car,55,0,24888,16,286,460,399,526,113,66,car
18376,60,person,61,0,24888,15,1667,463,1693,542,26,79,person
18377,61,person,62,0,24888,20,1513,405,1536,462,23,57,person
18378,62,person,63,0,24888,17,1562,448,1590,485,28,37,person
18379,63,person,64,0,24888,17,1622,476,1660,525,38,49,person
18380,66,person,67,0,24888,16,512,478,548,517,36,39,person
18381,67,person,68,0,24888,15,392,519,422,567,30,48,person
18382,69,person,70,0,24888,18,335,544,384,590,49,46,person
18383,70,person,71,0,24888,18,688,388,706,435,18,47,person
18384,72,person,73,0,24888,15,1868,961,1955,1069,87,108,person
18385,3,person,4,0,24889,94,571,332,765,1049,194,717,person
18386,6,person,7,0,24889,34,295,566,322,599,27,33,person
18387,16,boat,17,0,24890,21,760,476,827,511,67,35,boat
18388,17,person,18,0,24890,17,787,453,808,493,21,40,person
18389,18,car,19,0,24890,16,595,422,617,448,22,26,car
18390,3,person,4,1,80,72,320,114,496,333,176,219,person
18391,13,boat,14,1,80,32,257,252,361,332,104,80,boat
18392,8,boat,9,0,81,47,286,656,544,736,258,80,boat
18393,9,person,10,1,81,21,318,634,380,670,62,36,person
18394,10,person,11,1,81,21,380,628,431,695,51,67,person
18395,11,person,12,1,81,20,411,619,453,664,42,45,person
18396,12,person,13,0,81,23,482,634,536,667,54,33,person
18397,6,boat,7,1,82,29,706,411,958,626,252,215,boat
18398,7,boat,8,0,82,35,437,382,689,512,252,130,boat
18399,10,boat,11,1,82,31,338,373,601,458,263,85,boat
18400,11,boat,12,1,82,52,260,357,488,432,228,75,boat
18401,12,boat,13,1,82,74,169,348,347,404,178,56,boat
18402,14,person,15,0,82,49,150,308,179,390,29,82,person
18403,15,person,16,1,82,23,227,311,256,357,29,46,person
18404,17,person,18,0,82,38,215,321,240,400,25,79,person
18405,18,person,19,0,82,36,272,304,302,364,30,60,person
18406,20,person,21,1,82,23,330,341,370,371,40,30,person
18407,21,person,22,0,82,48,308,362,369,445,61,83,person
18408,22,person,23,1,82,34,380,358,420,420,40,62,person
18409,26,person,27,0,82,98,617,383,735,639,118,256,person
18410,29,backpack,30,0,82,15,136,377,165,411,29,34,backpack
18411,6,boat,7,0,83,17,333,345,461,372,128,27,boat
18412,7,boat,8,0,83,23,320,357,501,399,181,42,boat
18413,8,boat,9,0,83,30,325,383,549,431,224,48,boat
18414,9,boat,10,0,83,54,499,352,812,450,313,98,boat
18415,11,person,12,0,83,23,192,316,216,374,24,58,person
18416,12,person,13,1,83,15,99,335,122,362,23,27,person
18417,10,person,11,0,84,75,624,325,694,504,70,179,person
18418,3,table,4,0,85,19,314,302,420,338,106,36,dining table
18419,8,person,9,0,85,24,449,281,497,363,48,82,person
18420,9,person,10,0,85,27,508,291,551,377,43,86,person
18421,11,bench,12,0,85,15,358,334,446,366,88,32,bench
18422,12,car,13,0,85,43,2,217,316,377,314,160,car
18423,17,door,18,0,85,17,201,224,258,346,57,122,door
18424,4,person,5,0,86,36,361,280,390,343,29,63,person
18425,5,person,6,0,86,49,331,272,371,365,40,93,person
18426,4,person,5,0,87,61,353,377,461,510,108,133,person
18427,5,person,6,0,87,102,451,310,553,571,102,261,person
18428,7,person,8,0,88,62,223,432,406,704,183,272,person
18429,8,bicycle,9,0,88,76,188,545,483,742,295,197,bicycle
18430,15,bicycle,16,0,89,58,209,249,354,342,145,93,bicycle
18431,16,person,17,0,89,53,220,174,328,310,108,136,person
18432,5,person,6,1,90,16,245,220,262,295,17,75,person
18433,7,person,8,0,90,33,255,230,306,332,51,102,person
18434,8,bicycle,9,0,90,24,260,284,300,358,40,74,bicycle
18435,9,person,10,0,90,52,321,327,444,513,123,186,person
18436,10,bicycle,11,0,90,47,310,410,438,611,128,201,bicycle
18437,2,person,3,0,23034,42,558,384,602,445,44,61,person
18438,3,bicycle,4,0,23034,44,551,415,624,458,73,43,bicycle
18439,5,person,6,0,23035,54,547,574,688,840,141,266,person
18440,6,person,7,0,23035,40,510,591,603,836,93,245,person
18441,3,person,4,0,23036,92,259,408,727,1048,468,640,person
18442,4,person,5,0,23036,71,452,463,774,1128,322,665,person
18443,3,person,4,1,23037,28,121,585,200,668,79,83,person
18444,5,person,6,1,23037,17,273,409,304,438,31,29,person
18445,10,person,11,1,5334,33,146,555,796,1536,650,981,person
18446,11,person,12,1,5334,40,740,668,1473,1533,733,865,person
18447,0,person,1,0,5335,68,257,708,589,1650,332,942,person
18448,1,person,2,1,5335,64,858,372,1595,1650,737,1278,person
18449,18,person,19,0,5337,15,721,558,731,580,10,22,person
18450,5,person,6,0,5338,36,651,217,755,612,104,395,person
18451,4,person,5,0,5340,17,618,715,671,829,53,114,person
18452,5,person,6,0,5345,44,204,506,535,996,331,490,person
18453,5,person,6,1,5347,26,152,256,325,337,173,81,person
18454,7,person,8,0,5380,29,403,325,442,440,39,115,person
18455,2,person,3,0,108,101,417,152,718,370,301,218,person
18456,3,person,4,0,109,110,599,1050,1509,1662,910,612,person
18457,12,person,13,0,110,85,107,207,355,376,248,169,person
18458,22,person,23,0,110,50,289,156,483,262,194,106,person
18459,4,person,4,0,5656,30,25,141,92,270,67,129,person
18460,5,person,5,0,5656,35,371,129,480,304,109,175,person
18461,5,bird,6,0,5657,16,278,270,331,303,53,33,bird
18462,4,person,5,1,5658,18,105,103,125,168,20,65,person
18463,5,person,6,0,5658,29,85,116,114,196,29,80,person
18464,4,person,4,0,5660,32,212,50,239,102,27,52,person
18465,5,person,5,0,5660,28,231,49,296,122,65,73,person
18466,4,person,5,0,5662,18,349,325,377,397,28,72,person
18467,6,person,7,0,23089,51,463,210,536,314,73,104,person
18468,7,person,8,0,23090,15,606,594,609,604,3,10,person
18469,8,person,9,0,23090,16,573,569,576,578,3,9,person
18470,9,person,10,0,23090,16,569,569,572,578,3,9,person
18471,29,person,30,0,23091,18,865,301,874,327,9,26,person
18472,4,person,5,0,23098,120,890,315,1667,1314,777,999,person
18473,5,person,6,1,23098,47,1055,876,1395,1268,340,392,person
18474,15,car,16,0,23102,15,75,588,92,597,17,9,car
18475,3,umbrella,4,0,112,75,432,134,833,593,401,459,umbrella
18476,4,chair,5,0,112,52,787,383,956,609,169,226,chair
18477,16,chair,17,0,112,43,653,397,786,611,133,214,chair
18478,23,person,24,1,112,120,644,288,806,548,162,260,person
18479,24,person,25,0,112,19,467,379,474,413,7,34,person
18480,25,person,26,0,112,23,144,403,158,445,14,42,person
18481,26,person,27,0,112,17,882,366,889,394,7,28,person
18482,27,person,28,0,112,18,868,368,876,398,8,30,person
18483,29,person,30,0,112,16,638,368,645,394,7,26,person
18484,6,person,7,0,113,83,144,69,344,290,200,221,person
18485,18,person,19,0,113,73,286,106,421,287,135,181,person
18486,4,surfboard,5,0,114,22,629,486,733,534,104,48,surfboard
18487,5,person,6,0,114,70,663,372,782,519,119,147,person
18488,14,person,15,1,115,40,360,539,567,771,207,232,person
18489,15,person,16,1,115,47,528,436,887,928,359,492,person
18490,16,chair,17,0,115,23,1681,620,1813,815,132,195,chair
18491,18,chair,19,1,115,36,1609,706,1816,1162,207,456,chair
18492,19,chair,20,1,115,39,1792,722,2199,1363,407,641,chair
18493,28,cup,29,0,115,25,1746,1003,2010,1452,264,449,cup
18494,31,person,32,0,115,54,1826,438,2198,1018,372,580,person
18495,32,table,33,1,115,28,1730,678,2198,809,468,131,dining table
18496,33,person,34,1,115,15,1000,560,1088,660,88,100,person
18497,34,person,35,1,115,17,885,586,973,669,88,83,person
18498,35,person,36,1,115,22,830,572,933,682,103,110,person
18499,36,window,37,0,115,34,676,283,1035,649,359,366,window
18500,38,person,39,1,115,57,1,189,868,1473,867,1284,person
18501,46,cup,47,0,115,18,3,1220,281,1470,278,250,cup
18502,48,person,49,1,115,154,735,238,1645,1473,910,1235,person
18503,11,person,12,0,568,23,105,424,127,452,22,28,person
18504,12,person,13,0,568,20,309,558,329,587,20,29,person
18505,13,person,14,0,568,36,108,592,132,681,24,89,person
18506,14,person,15,0,568,27,140,554,177,592,37,38,person
18507,15,person,16,0,568,33,43,482,64,531,21,49,person
18508,16,person,17,0,568,15,564,609,580,640,16,31,person
18509,17,person,18,0,568,35,687,626,711,675,24,49,person
18510,5,boat,6,0,5811,28,190,215,242,246,52,31,boat
18511,5,boat,6,0,5835,15,39,68,65,165,26,97,boat
18512,3,person,4,0,5837,19,67,117,86,134,19,17,person
18513,3,boat,4,1,5860,17,146,99,186,114,40,15,boat
18514,7,bird,8,0,23111,29,832,75,900,215,68,140,bird
18515,5,person,6,0,23113,35,654,449,669,495,15,46,person
18516,6,person,7,0,23113,26,612,458,631,505,19,47,person
18517,7,person,8,0,23113,23,627,481,641,505,14,24,person
18518,8,person,9,0,23113,35,524,469,548,516,24,47,person
18519,9,person,10,0,23113,22,514,483,524,515,10,32,person
18520,4,person,5,0,23116,38,534,546,556,603,22,57,person
18521,5,dog,6,0,23116,40,593,574,622,597,29,23,dog
18522,2,car,3,0,23117,32,386,409,482,473,96,64,car
18523,11,person,12,1,23117,26,133,382,164,427,31,45,person
18524,12,person,13,1,23117,18,162,386,182,421,20,35,person
18525,3,person,4,0,23122,48,838,183,910,416,72,233,person
18526,5,person,6,1,121,80,495,256,650,640,155,384,person
18527,6,person,7,1,121,37,637,336,682,627,45,291,person
18528,7,person,8,0,121,77,636,74,773,691,137,617,person
18529,5,person,6,0,6230,75,291,414,463,808,172,394,person
18530,5,person,5,1,6232,56,182,26,344,240,162,214,person
18531,0,person,1,0,6234,16,945,379,1060,629,115,250,person
18532,1,person,2,0,6234,16,814,377,916,683,102,306,person
18533,2,person,3,0,6234,18,658,387,750,668,92,281,person
18534,3,person,4,0,6234,19,375,425,491,685,116,260,person
18535,4,person,5,0,6234,18,96,393,233,675,137,282,person
18536,8,person,9,1,6234,21,228,409,302,653,74,244,person
18537,9,person,10,0,6234,27,265,406,369,693,104,287,person
18538,10,person,11,0,6234,23,487,384,582,688,95,304,person
18539,11,person,12,0,6234,18,584,431,659,668,75,237,person
18540,1,person,2,0,6235,58,1017,352,1390,1032,373,680,person
18541,3,cow,4,0,23153,54,468,529,699,709,231,180,cow
18542,16,dog,17,0,572,109,1335,918,1759,1238,424,320,dog
18543,12,horse,13,1,573,45,1045,588,1418,780,373,192,horse
18544,13,horse,14,1,573,47,917,646,1254,793,337,147,horse
18545,5,horse,6,0,6244,62,51,44,192,168,141,124,horse
18546,6,horse,7,0,6244,64,85,87,199,170,114,83,horse
18547,7,horse,8,1,6244,19,36,78,64,122,28,44,horse
18548,6,sheep,7,0,6245,49,164,172,263,250,99,78,sheep
18549,7,sheep,8,1,6245,20,237,183,300,250,63,67,sheep
18550,8,sheep,9,0,6245,18,127,149,178,176,51,27,sheep
18551,9,sheep,10,0,6245,19,4,137,36,164,32,27,sheep
18552,11,truck,12,1,6246,20,199,129,269,160,70,31,truck
18553,12,car,13,0,6246,20,251,137,306,165,55,28,car
18554,15,cow,16,0,6246,24,3,155,65,206,62,51,cow
18555,16,person,17,0,6246,20,238,141,260,182,22,41,person
18556,17,person,18,1,6246,17,320,151,346,191,26,40,person
18557,18,person,19,1,6246,15,344,148,361,180,17,32,person
18558,19,person,20,1,6246,15,423,149,441,184,18,35,person
18559,23,cow,24,1,6246,18,91,174,184,208,93,34,cow
18560,25,cow,26,1,6246,23,153,204,264,288,111,84,cow
18561,26,cow,27,0,6246,42,249,213,402,335,153,122,cow
18562,28,cow,29,0,6246,53,53,214,213,337,160,123,cow
18563,8,person,9,1,6250,16,2,298,34,403,32,105,person
18564,9,person,10,0,6250,30,31,287,72,397,41,110,person
18565,10,person,11,1,6250,17,191,290,227,409,36,119,person
18566,16,sheep,17,0,6250,21,235,412,282,485,47,73,sheep
18567,17,sheep,18,0,6250,16,332,444,415,485,83,41,sheep
18568,5,horse,6,0,6252,87,317,160,621,597,304,437,horse
18569,3,horse,4,0,6253,65,191,428,474,646,283,218,horse
18570,4,person,5,0,6253,29,451,434,506,640,55,206,person
18571,9,person,10,1,6253,21,496,393,550,547,54,154,person
18572,14,person,15,0,6253,17,692,411,721,490,29,79,person
18573,17,person,18,0,6253,17,747,403,777,473,30,70,person
18574,19,person,20,0,6253,17,871,411,896,491,25,80,person
18575,21,person,22,0,6253,27,618,408,642,473,24,65,person
18576,22,person,23,0,6253,29,973,423,1004,496,31,73,person
18577,5,person,6,0,6254,18,468,298,497,392,29,94,person
18578,5,horse,6,0,23157,74,589,266,684,338,95,72,horse
18579,6,person,7,0,23157,32,623,239,653,309,30,70,person
18580,7,horse,8,0,23157,52,525,266,580,351,55,85,horse
18581,8,person,9,0,23157,26,533,248,566,318,33,70,person
18582,9,horse,10,0,23157,58,421,270,500,331,79,61,horse
18583,10,person,11,0,23157,31,450,241,487,309,37,68,person
18584,11,horse,12,1,23157,37,379,260,452,335,73,75,horse
18585,12,person,13,1,23157,23,418,229,446,278,28,49,person
18586,13,horse,14,0,23157,72,273,284,379,363,106,79,horse
18587,14,person,15,0,23157,31,318,259,341,336,23,77,person
18588,15,horse,16,0,23157,67,155,299,234,403,79,104,horse
18589,16,person,17,0,23157,28,184,276,221,368,37,92,person
18590,17,person,18,1,23157,15,208,282,225,311,17,29,person
18591,18,horse,19,1,23157,22,225,295,241,386,16,91,horse
18592,19,horse,20,1,23157,32,36,402,86,527,50,125,horse
18593,20,person,21,0,23157,63,23,338,100,473,77,135,person
18594,3,person,4,1,23158,30,1,60,230,767,229,707,person
18595,4,person,5,1,23158,54,173,174,297,688,124,514,person
18596,5,person,6,0,23158,61,329,166,485,701,156,535,person
18597,6,person,7,0,23158,50,445,260,607,691,162,431,person
18598,7,person,8,0,23158,73,743,224,946,705,203,481,person
18599,2,horse,3,1,23159,104,169,68,918,672,749,604,horse
18600,3,horse,4,1,23159,64,1,95,579,671,578,576,horse
18601,9,door,10,0,23160,29,46,753,396,1411,350,658,door
18602,10,person,11,1,23160,18,3,611,127,1648,124,1037,person
18603,11,person,12,1,23160,30,52,921,186,1467,134,546,person
18604,12,person,13,0,23160,79,468,688,721,1513,253,825,person
18605,13,person,14,0,23160,69,676,665,972,1499,296,834,person
18606,14,person,15,0,23160,85,957,743,1262,1534,305,791,person
18607,15,person,16,1,23160,72,1363,764,1592,1561,229,797,person
18608,16,person,17,0,23160,69,1512,775,1820,1615,308,840,person
18609,17,person,18,1,23160,47,1714,724,1860,1508,146,784,person
18610,18,person,19,0,23160,68,1890,751,2166,1529,276,778,person
18611,11,person,12,1,23161,33,265,306,319,552,54,246,person
18612,3,horse,4,0,23162,187,2,90,630,494,628,404,horse
18613,5,cow,6,0,23163,74,172,348,601,1113,429,765,cow
18614,6,cow,7,0,23163,102,515,381,1407,933,892,552,cow
18615,3,person,4,0,23164,96,179,121,338,501,159,380,person
18616,4,dog,5,0,23164,91,425,378,718,563,293,185,dog
18617,4,person,5,0,23165,81,419,88,549,527,130,439,person
18618,5,horse,6,0,23165,298,51,280,827,727,776,447,horse
18619,4,horse,5,0,23166,115,869,493,1458,948,589,455,horse
18620,5,horse,6,0,23166,145,1338,446,2133,1014,795,568,horse
18621,6,person,7,0,23166,58,1488,278,1795,822,307,544,person
18622,7,person,8,0,23166,58,1070,331,1284,810,214,479,person
18623,4,horse,5,0,23167,121,504,226,882,761,378,535,horse
18624,5,person,6,0,23167,87,563,92,873,552,310,460,person
18625,1,horse,2,1,23168,24,0,239,77,529,77,290,horse
18626,2,horse,3,0,23168,160,51,49,1151,1014,1100,965,horse
18627,8,horse,9,0,23169,23,690,267,797,445,107,178,horse
18628,9,horse,10,0,23169,50,615,221,800,335,185,114,horse
18629,10,horse,11,0,23169,145,225,22,603,599,378,577,horse
18630,9,person,10,0,23170,70,776,269,895,675,119,406,person
18631,10,horse,11,1,23170,107,740,246,1024,664,284,418,horse
18632,19,person,20,0,6373,21,77,244,92,303,15,59,person
18633,23,person,24,0,6373,19,955,277,981,327,26,50,person
18634,24,person,25,0,6373,21,934,275,958,326,24,51,person
18635,25,person,26,0,6373,16,916,272,932,317,16,45,person
18636,26,person,27,0,6373,16,212,234,226,277,14,43,person
18637,14,person,15,1,6379,17,61,89,76,110,15,21,person
18638,15,person,16,0,6379,19,147,84,156,110,9,26,person
18639,16,person,17,1,6379,15,35,94,43,110,8,16,person
18640,4,person,5,1,6380,18,151,302,206,385,55,83,person
18641,5,person,6,1,6380,15,205,315,250,377,45,62,person
18642,3,flowerpot,4,1,6381,15,807,541,1008,767,201,226,potted plant
18643,4,flowerpot,5,1,6381,15,461,570,628,767,167,197,potted plant
18644,6,person,7,1,122,108,200,310,1294,1079,1094,769,person
18645,15,boat,16,1,122,53,295,783,1328,1080,1033,297,boat
18646,5,boat,6,0,123,116,614,830,1684,1207,1070,377,boat
18647,6,person,7,1,123,47,717,427,908,744,191,317,person
18648,13,person,14,1,123,42,513,558,738,874,225,316,person
18649,20,person,21,1,123,41,592,621,858,993,266,372,person
18650,27,person,28,1,123,57,800,655,1140,1112,340,457,person
18651,36,person,37,1,123,64,1036,564,1385,1000,349,436,person
18652,44,person,45,1,123,80,1187,600,1503,1029,316,429,person
18653,52,person,53,1,123,65,1275,667,1712,1103,437,436,person
18654,4,boat,5,0,124,47,212,452,803,593,591,141,boat
18655,8,person,9,1,124,39,695,339,802,507,107,168,person
18656,9,person,10,1,124,25,600,390,674,507,74,117,person
18657,10,person,11,1,124,25,549,369,611,517,62,148,person
18658,11,person,12,1,124,38,489,368,560,525,71,157,person
18659,12,person,13,1,124,29,367,365,481,514,114,149,person
18660,13,person,14,1,124,29,254,358,369,494,115,136,person
18661,7,boat,8,0,125,22,131,315,208,346,77,31,boat
18662,8,person,9,1,125,15,146,317,156,330,10,13,person
18663,8,person,9,0,126,35,360,312,398,368,38,56,person
18664,9,person,10,1,126,17,599,584,630,612,31,28,person
18665,10,person,11,1,126,30,699,690,757,771,58,81,person
18666,11,person,12,1,126,16,367,632,395,654,28,22,person
18667,12,person,13,0,126,38,34,440,82,544,48,104,person
18668,13,person,14,0,126,64,277,527,357,750,80,223,person
18669,14,person,15,1,126,46,552,638,629,711,77,73,person
18670,15,person,16,1,126,43,506,641,636,772,130,131,person
18671,16,person,17,0,126,52,532,652,685,794,153,142,person
18672,22,person,23,0,126,43,420,638,495,772,75,134,person
18673,27,person,28,0,126,61,154,565,341,786,187,221,person
18674,35,person,36,1,126,20,312,699,425,799,113,100,person
18675,2,person,3,0,23214,47,116,412,181,647,65,235,person
18676,3,dog,4,0,23214,37,226,552,301,665,75,113,dog
18677,4,dog,5,1,23214,29,87,542,181,623,94,81,dog
18678,8,person,9,0,23215,61,454,304,546,460,92,156,person
18679,13,person,14,1,23219,18,716,306,747,348,31,42,person
18680,14,person,15,1,23219,16,768,299,792,336,24,37,person
18681,1,dog,2,0,23223,84,378,38,586,386,208,348,dog
18682,1,person,2,0,127,135,226,42,446,243,220,201,person
18683,2,backpack,3,0,127,32,316,24,393,141,77,117,backpack
18684,2,person,3,1,6507,16,611,929,699,1161,88,232,person
18685,3,person,4,1,6507,28,485,1037,667,1255,182,218,person
18686,4,person,5,1,6507,29,477,1177,703,1596,226,419,person
18687,3,person,4,0,6508,34,48,35,83,105,35,70,person
18688,4,person,5,0,6508,36,130,51,148,106,18,55,person
18689,5,person,6,0,6508,28,145,50,166,111,21,61,person
18690,6,person,7,0,6508,35,178,38,206,114,28,76,person
18691,7,person,8,0,6508,53,209,73,245,200,36,127,person
18692,8,backpack,9,0,6508,18,226,93,257,140,31,47,backpack
18693,10,person,11,1,6508,19,141,24,152,50,11,26,person
18694,11,person,12,0,6508,22,149,23,160,49,11,26,person
18695,12,person,13,1,6508,18,174,26,184,47,10,21,person
18696,13,person,14,0,6508,23,198,28,216,98,18,70,person
18697,15,person,16,1,6508,27,247,48,274,147,27,99,person
18698,18,person,19,0,6508,17,239,29,248,49,9,20,person
18699,4,person,5,0,6509,15,711,664,877,721,166,57,person
18700,5,person,6,0,6509,20,877,587,1008,705,131,118,person
18701,4,person,5,1,6511,17,318,533,410,690,92,157,person
18702,5,person,6,1,6511,24,294,622,427,817,133,195,person
18703,6,person,7,1,6511,23,203,773,535,1022,332,249,person
18704,2,person,3,0,6512,40,187,95,531,437,344,342,person
18705,3,person,4,0,6512,44,422,41,789,529,367,488,person
18706,4,person,5,1,6512,44,1374,2,1594,858,220,856,person
18707,3,person,4,0,6513,46,174,226,400,785,226,559,person
18708,4,person,5,1,6514,27,127,273,221,441,94,168,person
18709,3,person,4,0,6515,66,549,672,1177,2024,628,1352,person
18710,4,person,5,1,6516,36,777,140,1186,958,409,818,person
18711,5,backpack,6,0,6516,35,846,281,1275,956,429,675,backpack
18712,2,person,3,1,20597,63,712,140,1061,772,349,632,person
18713,2,person,3,1,23224,35,299,187,367,272,68,85,person
18714,3,backpack,4,0,23224,18,320,176,350,203,30,27,backpack
18715,4,person,5,0,23225,37,496,174,557,464,61,290,person
18716,5,person,6,0,23225,65,156,762,218,918,62,156,person
18717,6,person,7,0,23225,55,94,741,154,920,60,179,person
18718,7,person,8,0,23225,66,34,739,114,952,80,213,person
18719,5,person,6,0,6592,24,203,48,218,86,15,38,person
18720,6,person,7,0,6592,21,226,44,237,86,11,42,person
18721,7,person,8,0,6592,22,242,45,254,85,12,40,person
18722,8,person,9,0,6592,26,259,40,275,84,16,44,person
18723,7,person,8,0,6599,17,199,354,221,394,22,40,person
18724,8,person,9,0,6599,15,261,352,272,392,11,40,person
18725,9,person,10,1,6599,15,235,357,249,391,14,34,person
18726,9,car,10,0,23236,16,454,942,488,961,34,19,car
18727,10,car,11,0,23236,16,503,932,536,953,33,21,car
18728,11,bus,12,0,23236,17,569,909,611,939,42,30,bus
18729,2,person,3,0,577,79,1271,391,1415,834,144,443,person
18730,3,person,4,1,577,41,934,186,1099,431,165,245,person
18731,4,person,5,1,577,18,519,204,587,309,68,105,person
18732,7,person,8,1,577,71,450,114,843,727,393,613,person
18733,9,person,10,1,577,51,56,277,328,702,272,425,person
18734,6,person,7,0,6677,15,65,96,71,119,6,23,person
18735,7,person,8,0,6677,15,107,97,114,118,7,21,person
18736,8,person,9,0,6677,18,114,100,122,125,8,25,person
18737,9,person,10,0,6677,19,96,105,107,132,11,27,person
18738,4,person,4,0,6683,29,0,163,32,209,32,46,person
18739,4,person,5,0,6688,18,118,69,126,85,8,16,person
18740,5,person,6,0,6688,16,127,68,134,85,7,17,person
18741,3,person,4,0,24921,45,225,296,430,437,205,141,person
18742,4,person,5,0,24921,41,506,279,736,431,230,152,person
18743,4,car,5,0,24922,15,459,256,480,275,21,19,car
18744,5,car,6,0,24922,23,410,264,451,301,41,37,car
18745,6,car,7,0,24922,47,170,316,272,396,102,80,car
18746,7,car,8,0,24922,71,22,404,248,591,226,187,car
18747,8,car,9,0,24922,36,295,273,368,336,73,63,car
18748,3,person,4,1,24923,96,626,61,820,766,194,705,person
18749,1,person,2,0,24926,70,172,80,351,626,179,546,person
18750,2,person,3,0,24926,113,197,37,451,605,254,568,person
18751,3,person,4,0,24926,130,421,39,709,626,288,587,person
18752,4,person,5,0,24926,94,561,96,724,673,163,577,person
18753,6,person,7,0,24926,25,781,199,810,232,29,33,person
18754,7,person,8,0,24926,23,756,197,786,228,30,31,person
18755,8,person,9,0,24926,20,734,201,765,230,31,29,person
18756,10,person,11,0,24926,19,93,304,105,332,12,28,person
18757,1,person,2,1,24927,74,683,176,1023,682,340,506,person
18758,3,person,4,0,24929,60,776,416,843,556,67,140,person
18759,4,person,5,0,24929,40,695,448,791,561,96,113,person
18760,1,car,2,1,24931,53,57,283,1023,682,966,399,car
18761,2,person,3,1,24931,36,513,289,584,388,71,99,person
18762,3,person,4,1,24931,59,193,290,397,681,204,391,person
18763,1,car,2,0,24932,69,0,1,670,609,670,608,car
18764,3,person,4,1,24940,93,580,242,877,569,297,327,person
18765,8,person,9,0,24941,41,239,693,299,824,60,131,person
18766,5,person,6,0,24942,17,548,960,565,1015,17,55,person
18767,6,person,7,0,24942,20,528,955,546,1008,18,53,person
18768,8,person,9,0,7275,47,22,47,107,251,85,204,person
18769,8,person,9,0,7281,21,214,85,227,121,13,36,person
18770,3,boat,4,0,137,58,37,2,1971,1311,1934,1309,boat
18771,27,person,28,0,138,23,431,424,464,459,33,35,person
18772,4,person,5,1,139,32,401,214,438,250,37,36,person
18773,5,person,6,0,139,24,418,174,443,211,25,37,person
18774,6,person,7,0,139,16,361,174,371,193,10,19,person
18775,7,person,8,0,139,22,338,173,354,193,16,20,person
18776,8,person,9,1,139,22,298,175,315,198,17,23,person
18777,10,person,11,1,139,156,0,62,494,375,494,313,person
18778,20,bottle,21,0,139,50,31,119,85,296,54,177,bottle
18779,4,person,5,1,7283,49,98,128,208,505,110,377,person
18780,0,boat,1,0,7285,20,342,175,589,275,247,100,boat
18781,1,boat,2,0,7286,24,165,206,550,360,385,154,boat
18782,1,boat,2,0,7289,38,1147,58,1494,462,347,404,boat
18783,2,boat,3,0,20684,26,428,199,560,353,132,154,boat
18784,12,sheep,13,0,7291,25,155,124,195,181,40,57,sheep
18785,13,sheep,14,0,7291,38,260,152,348,209,88,57,sheep
18786,4,person,5,1,7292,22,34,100,53,151,19,51,person
18787,5,person,6,0,7511,62,30,195,221,545,191,350,person
18788,2,car,3,0,7513,20,219,123,261,147,42,24,car
18789,5,person,6,0,7513,38,65,137,125,276,60,139,person
18790,17,person,18,0,7514,42,277,244,341,397,64,153,person
18791,18,person,19,0,7514,38,199,243,263,417,64,174,person
18792,4,person,5,0,7517,19,227,190,274,254,47,64,person
18793,4,person,5,0,7518,55,3,33,112,148,109,115,person
18794,5,person,6,0,7518,61,168,135,230,267,62,132,person
18795,6,person,7,0,7651,18,918,761,947,836,29,75,person
18796,4,boat,5,0,7652,29,47,67,170,247,123,180,boat
18797,14,person,15,0,24968,53,981,524,1066,826,85,302,person
18798,15,person,16,0,24968,47,575,506,662,728,87,222,person
18799,8,person,9,0,24971,33,636,337,666,404,30,67,person
18800,9,person,10,0,24971,20,689,385,725,420,36,35,person
18801,1,person,2,1,24972,97,109,103,445,576,336,473,person
18802,2,person,3,0,7813,23,117,139,127,174,10,35,person
18803,3,person,4,0,7813,29,129,135,145,175,16,40,person
18804,13,person,14,0,7911,49,548,380,796,931,248,551,person
18805,14,person,15,0,7911,37,142,507,541,1118,399,611,person
18806,15,person,16,1,7911,35,36,536,245,890,209,354,person
18807,2,chair,3,0,7913,23,1887,592,2189,886,302,294,chair
18808,3,car,4,1,7919,15,640,461,826,538,186,77,car
18809,30,person,30,0,7919,68,630,649,1396,1212,766,563,person
18810,8,person,9,1,23386,91,721,147,1007,677,286,530,person
18811,7,boat,8,0,23389,17,165,269,314,399,149,130,boat
18812,0,person,1,0,23390,108,74,59,818,1024,744,965,person
18813,1,dog,2,0,23390,62,398,501,738,857,340,356,dog
18814,18,bench,19,0,23392,42,75,272,227,375,152,103,bench
18815,19,plant pot,20,0,23392,23,29,320,94,382,65,62,potted plant
18816,0,person,1,0,8132,36,159,80,203,173,44,93,person
18817,2,person,3,0,25002,34,374,295,430,461,56,166,person
18818,3,backpack,4,0,25002,20,402,318,446,381,44,63,backpack
18819,0,horse,1,0,8175,23,21,226,64,256,43,30,horse
18820,6,person,5,0,8175,23,156,222,162,239,6,17,person
18821,7,horse,6,0,8175,42,152,231,171,244,19,13,horse
18822,8,person,7,0,8175,24,134,222,142,239,8,17,person
18823,9,horse,8,0,8175,38,128,230,151,246,23,16,horse
18824,10,person,9,0,8175,23,83,223,92,244,9,21,person
18825,11,horse,10,0,8175,43,71,232,101,250,30,18,horse
18826,12,person,11,0,8175,21,108,222,116,242,8,20,person
18827,13,horse,12,0,8175,39,101,230,123,248,22,18,horse
18828,14,person,13,0,8175,22,41,213,50,243,9,30,person
18829,15,horse,14,0,8175,27,184,230,205,244,21,14,horse
18830,16,person,15,0,8175,18,189,219,197,238,8,19,person
18831,2,person,3,0,8190,35,409,70,721,860,312,790,person
18832,3,car,4,1,147,82,235,236,540,448,305,212,car
18833,4,person,5,1,147,43,476,266,662,448,186,182,person
18834,5,person,6,1,147,36,269,233,458,446,189,213,person
18835,6,person,7,1,147,44,1,161,266,448,265,287,person
18836,2,person,3,0,148,90,387,105,566,481,179,376,person
18837,1,person,2,1,149,95,269,1,747,908,478,907,person
18838,6,person,7,0,150,38,237,210,281,312,44,102,person
18839,7,person,8,0,150,49,338,253,400,384,62,131,person
18840,4,person,5,0,23400,44,521,274,581,437,60,163,person
18841,4,person,5,0,23402,15,321,246,352,309,31,63,person
18842,5,person,6,0,23402,26,253,336,324,456,71,120,person
18843,6,bicycle,7,1,23402,21,258,401,319,487,61,86,bicycle
18844,4,dog,5,0,23404,47,258,747,380,852,122,105,dog
18845,5,person,6,0,23404,37,187,635,267,853,80,218,person
18846,2,bicycle,3,1,23405,15,537,610,682,930,145,320,bicycle
18847,3,person,4,1,23405,33,211,58,330,272,119,214,person
18848,4,person,5,0,23405,75,200,143,439,594,239,451,person
18849,5,bicycle,6,0,23405,46,231,358,407,707,176,349,bicycle
18850,17,person,18,0,8233,22,61,168,78,226,17,58,person
18851,34,person,35,0,8237,34,563,697,659,903,96,206,person
18852,35,person,36,0,8237,39,660,685,759,920,99,235,person
18853,36,person,37,1,8237,15,725,656,771,779,46,123,person
18854,37,person,38,1,8237,20,682,637,792,745,110,108,person
18855,38,person,39,0,8237,25,1056,494,1114,678,58,184,person
18856,39,person,40,1,8237,18,1090,475,1120,618,30,143,person
18857,6,ball,7,0,23422,20,915,555,1008,633,93,78,sports ball
18858,9,ball,10,0,23422,16,941,488,976,518,35,30,sports ball
18859,37,person,38,0,23422,18,93,449,104,480,11,31,person
18860,13,person,14,0,23423,27,50,800,71,860,21,60,person
18861,14,person,15,0,23423,30,93,800,118,863,25,63,person
18862,78,car,79,0,23424,16,249,362,259,369,10,7,car
18863,79,car,80,0,23424,15,364,267,376,273,12,6,car
18864,85,car,86,0,23424,32,315,209,334,235,19,26,car
18865,1,bench,2,0,23425,24,298,702,1098,1023,800,321,bench
18866,2,plant pot,3,0,23425,32,1007,694,1248,917,241,223,potted plant
18867,7,bench,8,0,23425,16,587,411,737,500,150,89,bench
18868,14,bench,15,0,23425,17,1214,662,1279,901,65,239,bench
18869,28,person,29,1,23426,23,357,322,383,367,26,45,person
18870,5,dog,6,0,8651,24,135,421,200,459,65,38,dog
18871,4,person,5,0,8654,38,395,487,473,725,78,238,person
18872,5,person,6,0,8654,41,307,473,401,743,94,270,person
18873,8,person,9,0,23463,23,383,261,406,318,23,57,person
18874,2,airplane,3,0,23468,69,14,534,431,642,417,108,airplane
18875,3,person,4,0,23468,23,212,594,231,647,19,53,person
18876,4,person,5,0,23468,26,234,597,246,648,12,51,person
18877,5,person,6,0,23468,24,244,601,261,652,17,51,person
18878,4,person,5,0,23470,56,223,283,358,453,135,170,person
18879,3,person,4,0,23472,51,38,403,196,630,158,227,person
18880,4,boat,5,0,8693,15,563,576,628,641,65,65,boat
18881,6,boat,7,0,8695,16,0,916,1017,1066,1017,150,boat
18882,7,person,8,1,8695,16,884,886,939,945,55,59,person
18883,10,person,11,1,8695,15,736,854,779,914,43,60,person
18884,4,person,5,0,8759,19,305,143,329,171,24,28,person
18885,5,person,6,0,8759,16,280,140,296,158,16,18,person
18886,7,person,8,1,8759,17,296,137,311,159,15,22,person
18887,4,person,5,1,8762,26,277,269,335,326,58,57,person
18888,1,person,2,0,23490,83,674,307,808,735,134,428,person
18889,7,boat,8,0,23493,28,566,616,880,656,314,40,boat
18890,8,person,9,0,23493,42,650,526,787,625,137,99,person
18891,3,person,3,0,8774,49,77,136,196,224,119,88,person
18892,4,person,4,1,8774,34,107,95,154,150,47,55,person
18893,5,person,5,1,8774,19,117,66,141,105,24,39,person
18894,6,person,6,1,8774,23,136,100,176,130,40,30,person
18895,7,person,7,0,8774,25,134,36,150,95,16,59,person
18896,8,person,8,1,8774,22,146,36,169,97,23,61,person
18897,9,person,9,0,8774,16,158,70,179,100,21,30,person
18898,4,person,5,1,8776,15,572,181,592,222,20,41,person
18899,5,person,6,0,8776,20,534,160,551,210,17,50,person
18900,6,person,7,0,8776,17,479,151,496,187,17,36,person
18901,5,person,6,0,8778,23,417,991,574,1376,157,385,person
18902,6,person,7,1,8778,23,303,985,442,1303,139,318,person
18903,7,dog,8,0,8778,27,268,1206,477,1426,209,220,dog
18904,6,person,7,0,8779,21,1351,1567,1425,1832,74,265,person
18905,7,backpack,8,0,8779,17,1359,1579,1473,1705,114,126,backpack
18906,5,person,6,1,8781,27,197,817,392,1183,195,366,person
18907,6,person,7,1,8781,27,453,714,653,1181,200,467,person
18908,4,person,5,0,8947,42,118,123,149,230,31,107,person
18909,5,person,6,0,8947,39,149,119,189,235,40,116,person
18910,3,horse,4,0,20892,31,676,332,746,402,70,70,horse
18911,0,truck,1,0,8978,24,446,82,566,122,120,40,truck
18912,6,person,7,1,8981,28,468,56,585,211,117,155,person
18913,7,person,8,1,8981,54,643,32,795,490,152,458,person
18914,16,person,17,0,8981,57,0,25,157,555,157,530,person
18915,17,person,18,1,8981,54,97,115,362,665,265,550,person
18916,18,person,19,1,8981,49,358,206,665,597,307,391,person
18917,4,chair,5,1,8985,16,1607,501,1723,621,116,120,chair
18918,5,chair,6,1,8985,16,1718,512,1838,628,120,116,chair
18919,20,person,21,0,8987,79,221,7,299,192,78,185,person
18920,4,cow,5,0,9295,35,128,135,162,167,34,32,cow
18921,7,person,8,0,9298,18,84,146,94,160,10,14,person
18922,2,person,3,0,9437,23,2,371,40,438,38,67,person
18923,3,person,4,0,9437,24,32,381,81,453,49,72,person
18924,4,person,5,0,9437,25,62,398,95,475,33,77,person
18925,5,person,6,0,9437,31,85,406,119,496,34,90,person
18926,6,person,7,0,9437,29,116,422,152,508,36,86,person
18927,7,person,8,1,9437,22,150,444,174,505,24,61,person
18928,8,person,9,1,9437,21,171,425,202,495,31,70,person
18929,9,person,10,1,9437,20,198,433,224,484,26,51,person
18930,11,person,12,1,183,19,478,340,550,411,72,71,person
18931,14,person,15,1,183,17,498,261,518,287,20,26,person
18932,16,person,17,0,183,15,339,220,358,236,19,16,person
18933,20,person,21,0,183,15,177,202,197,220,20,18,person
18934,22,person,23,0,183,18,148,223,169,241,21,18,person
18935,7,person,8,0,9471,20,313,153,411,193,98,40,person
18936,12,person,13,1,9471,16,327,277,353,356,26,79,person
18937,13,person,14,1,9471,19,163,322,203,401,40,79,person
18938,14,person,15,1,9471,20,207,338,308,401,101,63,person
18939,7,person,8,0,9472,23,290,162,359,297,69,135,person
18940,8,person,9,1,9472,15,195,275,246,320,51,45,person
18941,4,person,5,1,9474,39,142,125,289,364,147,239,person
18942,5,person,6,1,9474,55,165,31,316,474,151,443,person
18943,4,person,5,1,9475,77,0,24,433,958,433,934,person
18944,5,person,6,1,9475,62,327,347,717,958,390,611,person
18945,11,person,12,1,9477,39,421,267,690,564,269,297,person
18946,12,person,13,1,9477,35,622,225,813,513,191,288,person
18947,13,person,14,1,9477,38,875,200,1069,505,194,305,person
18948,14,person,15,1,9477,36,1102,210,1318,505,216,295,person
18949,15,hat,16,0,9477,18,1145,212,1268,287,123,75,hat
18950,16,hat,17,0,9477,17,893,197,1008,277,115,80,hat
18951,12,person,13,1,9478,28,567,983,1105,1194,538,211,person
18952,13,person,14,1,9478,25,1162,808,1367,1218,205,410,person
18953,14,person,15,1,9478,15,1343,1070,1488,1269,145,199,person
18954,6,person,7,1,23552,60,143,716,353,874,210,158,person
18955,8,person,8,0,23552,33,255,688,436,906,181,218,person
18956,9,person,10,0,9775,18,551,248,560,276,9,28,person
18957,3,boat,4,0,9777,27,207,72,279,115,72,43,boat
18958,4,person,5,0,23592,36,1514,695,1562,804,48,109,person
18959,5,person,6,0,23592,23,1200,716,1217,753,17,37,person
18960,7,boat,8,1,23594,15,607,195,673,221,66,26,boat
18961,11,person,12,1,23594,17,567,170,598,205,31,35,person
18962,12,person,13,1,23594,16,575,153,599,189,24,36,person
18963,4,car,5,1,23595,22,302,186,479,349,177,163,car
18964,5,person,6,0,23595,63,138,119,221,361,83,242,person
18965,2,person,3,0,23596,107,548,232,935,1035,387,803,person
18966,3,boat,4,0,9782,20,496,248,695,346,199,98,boat
18967,6,person,7,0,9782,15,601,276,625,320,24,44,person
18968,1,person,2,0,23598,53,670,204,722,378,52,174,person
18969,2,person,3,0,23598,53,624,228,675,371,51,143,person
18970,3,person,4,0,23598,59,570,216,632,373,62,157,person
18971,4,person,5,0,23598,56,499,190,565,357,66,167,person
18972,5,person,6,0,23598,50,441,205,498,346,57,141,person
18973,6,person,7,0,23598,59,328,213,382,373,54,160,person
18974,7,person,8,0,23598,57,186,219,247,376,61,157,person
18975,8,person,9,0,23598,81,90,212,173,370,83,158,person
18976,2,person,3,1,23600,113,39,2,720,772,681,770,person
18977,6,boat,7,0,23603,21,102,588,212,658,110,70,boat
18978,3,person,4,1,23604,25,203,429,245,479,42,50,person
18979,4,person,5,1,23604,24,301,433,332,478,31,45,person
18980,5,person,6,1,23604,22,245,414,285,466,40,52,person
18981,9,person,10,0,23605,34,829,548,875,651,46,103,person
18982,12,boat,13,0,9906,18,182,196,269,228,87,32,boat
18983,5,boat,6,0,9911,18,120,224,265,248,145,24,boat
18984,1,person,2,0,9914,26,404,475,538,631,134,156,person
18985,58,person,59,0,9917,17,391,276,402,304,11,28,person
18986,59,person,60,0,9917,20,377,267,390,293,13,26,person
18987,66,person,67,0,9917,15,240,265,252,290,12,25,person
18988,67,person,68,1,9917,17,68,307,89,335,21,28,person
18989,4,boat,5,0,23634,32,166,278,559,418,393,140,boat
18990,5,person,6,0,23634,28,231,254,323,339,92,85,person
18991,12,person,13,0,10790,29,374,249,418,362,44,113,person
18992,13,person,14,0,10790,25,347,254,382,367,35,113,person
18993,5,person,6,1,10791,28,222,359,317,408,95,49,person
18994,19,person,20,0,10795,23,1285,778,1332,926,47,148,person
18995,20,person,21,1,10795,18,1616,778,1659,918,43,140,person
18996,21,person,22,0,10795,23,1541,742,1626,941,85,199,person
18997,23,boat,24,0,10795,15,885,760,1068,812,183,52,boat
18998,9,boat,10,0,10796,28,241,492,1048,1102,807,610,boat
18999,5,person,6,1,10797,31,118,169,154,224,36,55,person
19000,4,person,5,0,23696,18,606,385,613,413,7,28,person
19001,5,person,6,0,23696,18,627,385,635,415,8,30,person
19002,6,person,7,0,23696,25,723,381,738,432,15,51,person
19003,7,person,8,0,23696,17,882,371,897,399,15,28,person
19004,8,person,9,0,23696,18,755,397,780,414,25,17,person
19005,9,person,10,0,23696,17,752,377,760,407,8,30,person
19006,11,person,12,0,23696,21,986,361,1003,402,17,41,person
19007,2,bird,3,0,23697,85,307,275,672,535,365,260,bird
19008,5,person,6,0,23698,32,308,190,440,348,132,158,person
19009,6,person,7,1,23698,84,297,170,521,347,224,177,person
19010,8,boat,9,0,23701,45,3,986,1600,1199,1597,213,boat
19011,9,person,10,1,23701,118,600,463,1380,1197,780,734,person
19012,10,person,11,1,23701,56,523,541,984,1199,461,658,person
19013,30,boat,31,0,23703,26,607,347,840,464,233,117,boat
19014,31,boat,32,1,23703,22,650,339,819,396,169,57,boat
19015,32,boat,33,1,23703,20,686,334,828,374,142,40,boat
19016,33,boat,34,0,23703,18,709,329,831,356,122,27,boat
19017,34,boat,35,1,23703,17,735,326,839,350,104,24,boat
19018,4,person,5,1,23704,82,0,179,551,768,551,589,person
19019,5,person,6,0,23704,18,110,422,129,470,19,48,person
19020,6,person,7,0,23704,20,121,421,141,471,20,50,person
19021,4,person,5,1,23714,94,425,397,606,767,181,370,person
19022,2,umbrella,3,0,23716,25,494,175,615,294,121,119,umbrella
19023,3,umbrella,4,0,23716,26,280,186,437,300,157,114,umbrella
19024,5,umbrella,6,0,23716,15,129,240,191,300,62,60,umbrella
19025,20,person,21,0,23716,34,654,373,696,459,42,86,person
19026,21,person,22,0,23716,38,582,359,620,439,38,80,person
19027,23,person,24,0,23716,21,658,259,670,292,12,33,person
19028,24,person,25,0,23716,17,705,268,718,300,13,32,person
19029,24,chair,25,0,23717,15,992,917,1043,980,51,63,chair
19030,3,person,4,1,10805,17,167,34,180,57,13,23,person
19031,4,person,5,0,10805,22,153,35,168,59,15,24,person
19032,5,person,6,0,10805,19,130,33,152,58,22,25,person
19033,6,person,7,0,10805,61,169,120,262,192,93,72,person
19034,7,person,8,0,10805,38,162,127,212,189,50,62,person
19035,8,car,9,0,10806,15,1984,792,2039,817,55,25,car
19036,9,car,10,0,10806,15,1890,793,1953,813,63,20,car
19037,10,car,11,0,10806,15,1825,787,1890,809,65,22,car
19038,13,car,14,0,10806,15,2130,803,2185,823,55,20,car
19039,1,person,2,1,25106,93,488,257,958,681,470,424,person
19040,14,person,15,1,25107,16,563,366,583,388,20,22,person
19041,15,person,16,1,25107,15,511,364,529,385,18,21,person
19042,16,person,17,1,25107,15,302,329,316,351,14,22,person
19043,17,person,18,1,25107,17,316,330,329,353,13,23,person
19044,1,boat,2,0,11700,16,232,65,251,87,19,22,boat
19045,9,person,10,1,11708,33,374,150,483,476,109,326,person
19046,10,person,11,1,11708,42,334,107,409,449,75,342,person
19047,11,person,12,0,11708,39,201,226,326,416,125,190,person
19048,9,person,10,0,11710,45,107,93,195,160,88,67,person
19049,10,person,11,0,11710,28,73,91,131,149,58,58,person
19050,11,backpack,12,0,11710,22,150,93,206,131,56,38,backpack
19051,9,person,10,1,23848,33,129,970,263,1200,134,230,person
19052,2,bird,3,0,23849,100,260,144,579,372,319,228,bird
19053,3,person,4,1,23850,27,661,1225,1196,1721,535,496,person
19054,2,bird,3,0,23851,31,456,333,584,404,128,71,bird
19055,6,boat,7,0,23853,17,1644,410,1769,457,125,47,boat
19056,7,person,8,1,23853,24,1584,390,1602,460,18,70,person
19057,10,person,11,0,23853,80,1545,392,1637,571,92,179,person
19058,13,boat,14,0,23853,18,1279,434,1444,451,165,17,boat
19059,14,person,15,1,23853,18,1385,417,1414,438,29,21,person
19060,15,person,16,1,23853,18,1316,417,1350,441,34,24,person
19061,16,person,17,0,23853,94,827,398,945,642,118,244,person
19062,19,person,20,0,23853,93,236,410,324,665,88,255,person
19063,23,person,24,0,23853,18,469,436,508,460,39,24,person
19064,25,person,26,1,23853,21,754,432,795,462,41,30,person
19065,3,person,4,0,11890,26,150,27,180,115,30,88,person
19066,4,dog,5,0,11890,25,174,81,207,120,33,39,dog
19067,5,bird,6,0,11890,33,115,186,242,296,127,110,bird
19068,7,person,8,0,11898,50,698,651,941,1157,243,506,person
19069,8,person,9,0,11898,75,1024,518,1293,1157,269,639,person
19070,9,backpack,10,0,11898,15,772,604,917,716,145,112,backpack
19071,6,car,7,1,11899,19,1288,608,1573,726,285,118,car
19072,7,car,8,1,11899,28,1274,591,1599,866,325,275,car
19073,12,sheep,13,0,11900,20,828,935,902,992,74,57,sheep
19074,3,horse,4,0,11901,95,90,534,831,1108,741,574,horse
19075,4,person,5,0,11902,48,236,270,382,538,146,268,person
19076,5,bicycle,6,0,11902,41,274,411,353,605,79,194,bicycle
19077,12,person,13,0,211,56,472,195,525,312,53,117,person
19078,14,bicycle,15,0,211,75,446,251,543,345,97,94,bicycle
19079,3,person,4,1,212,22,32,1,295,129,263,128,person
19080,4,person,5,1,212,40,0,1,203,351,203,350,person
19081,10,person,11,1,212,49,359,167,640,328,281,161,person
19082,3,person,4,0,11956,15,226,142,235,159,9,17,person
19083,5,person,6,0,11956,16,189,176,201,191,12,15,person
19084,8,car,9,0,12011,15,38,230,54,244,16,14,car
19085,5,person,5,1,12028,44,454,911,714,1510,260,599,person
19086,6,person,6,1,12028,52,538,875,916,1507,378,632,person
19087,7,person,7,1,12028,48,870,911,1179,1508,309,597,person
19088,8,person,8,1,12028,41,1025,919,1254,1508,229,589,person
19089,0,person,1,0,21569,47,651,291,815,725,164,434,person
19090,0,person,1,0,21571,51,694,133,857,499,163,366,person
19091,6,car,7,0,23894,33,274,438,363,476,89,38,car
19092,7,car,8,1,23894,19,357,442,406,475,49,33,car
19093,8,car,9,0,23894,22,388,443,436,476,48,33,car
19094,9,car,10,1,23894,24,427,445,472,477,45,32,car
19095,10,person,11,0,23894,29,632,447,647,496,15,49,person
19096,11,person,12,0,23894,41,669,431,694,497,25,66,person
19097,12,person,13,1,23894,19,686,430,704,477,18,47,person
19098,13,person,14,0,23894,33,708,441,728,495,20,54,person
19099,10,person,11,1,23895,28,508,525,558,601,50,76,person
19100,11,person,12,1,23895,29,454,507,502,598,48,91,person
19101,12,person,13,1,23895,27,429,483,468,570,39,87,person
19102,13,person,14,1,23895,25,398,451,436,525,38,74,person
19103,14,person,15,1,23895,33,377,444,412,528,35,84,person
19104,16,person,17,1,23895,22,337,419,376,489,39,70,person
19105,17,person,18,1,23895,19,312,412,341,460,29,48,person
19106,18,person,19,1,23895,16,307,412,322,457,15,45,person
19107,3,person,4,1,23897,80,519,368,1023,684,504,316,person
19108,9,person,10,1,23900,41,185,490,367,896,182,406,person
19109,10,person,11,1,23900,70,339,497,595,898,256,401,person
19110,5,person,6,0,23903,54,705,516,824,723,119,207,person
19111,6,person,7,0,23903,62,561,436,681,611,120,175,person
19112,1,boat,2,0,23904,60,135,172,559,341,424,169,boat
19113,2,person,3,1,23904,16,382,177,420,225,38,48,person
19114,3,train,4,0,23908,22,736,258,1022,361,286,103,train
19115,6,car,7,0,213,33,275,614,517,801,242,187,car
19116,14,car,15,0,213,35,537,680,851,905,314,225,car
19117,23,car,24,0,213,35,862,728,1209,914,347,186,car
19118,35,car,36,1,213,33,468,2,2198,1649,1730,1647,car
19119,8,person,9,0,214,50,414,218,447,303,33,85,person
19120,9,bicycle,10,0,214,47,420,258,449,310,29,52,bicycle
19121,10,car,11,0,214,41,171,235,279,310,108,75,car
19122,8,person,9,0,12029,31,745,509,807,636,62,127,person
19123,9,backpack,10,0,12029,21,738,477,808,519,70,42,backpack
19124,13,backpack,14,0,12029,19,727,410,784,443,57,33,backpack
19125,7,person,8,0,12030,44,253,245,308,396,55,151,person
19126,8,person,9,1,12030,23,332,255,385,326,53,71,person
19127,9,person,10,0,12030,37,339,277,395,446,56,169,person
19128,6,person,7,0,12032,28,113,199,135,257,22,58,person
19129,10,person,11,0,12034,39,432,276,485,425,53,149,person
19130,11,backpack,12,0,12034,17,431,263,495,302,64,39,backpack
19131,6,person,7,0,12035,24,301,119,320,174,19,55,person
19132,7,person,8,0,12035,25,261,118,292,187,31,69,person
19133,8,person,9,0,12037,21,565,397,601,495,36,98,person
19134,3,person,4,0,23910,99,166,90,382,452,216,362,person
19135,15,person,16,0,23911,71,948,528,1209,1040,261,512,person
19136,16,person,17,0,23911,33,716,450,809,707,93,257,person
19137,17,person,18,0,23911,75,175,115,585,1200,410,1085,person
19138,18,backpack,19,0,23911,39,1,278,372,707,371,429,backpack
19139,1,bicycle,2,0,23912,56,299,181,501,428,202,247,bicycle
19140,2,person,3,0,23912,73,260,53,493,423,233,370,person
19141,13,person,14,0,23913,24,232,429,242,464,10,35,person
19142,14,person,15,0,23913,17,226,442,234,464,8,22,person
19143,15,person,16,0,23913,20,213,434,224,461,11,27,person
19144,16,person,17,0,23913,19,202,437,210,460,8,23,person
19145,5,person,6,0,23914,55,1014,507,1130,829,116,322,person
19146,6,backpack,7,0,23914,26,1025,552,1101,666,76,114,backpack
19147,7,person,8,1,23914,21,1002,614,1038,742,36,128,person
19148,8,person,9,1,23914,20,918,628,966,742,48,114,person
19149,9,person,10,0,23914,25,1118,558,1161,748,43,190,person
19150,10,backpack,11,0,23914,15,1131,582,1182,646,51,64,backpack
19151,11,person,12,1,23914,16,680,631,724,698,44,67,person
19152,12,person,13,1,23914,41,1469,556,1599,1198,130,642,person
19153,11,person,12,1,215,57,752,430,824,680,72,250,person
19154,12,backpack,13,0,215,24,761,450,821,546,60,96,backpack
19155,5,person,6,1,216,48,0,0,119,348,119,348,person
19156,10,glasses,11,0,216,30,15,0,118,51,103,51,eye glasses
19157,11,dog,12,0,216,54,142,182,198,249,56,67,dog
19158,6,person,7,0,217,35,260,171,297,233,37,62,person
19159,7,person,8,0,217,27,373,207,400,252,27,45,person
19160,5,person,6,1,12055,21,242,156,255,207,13,51,person
19161,4,person,5,1,12066,26,2,207,25,248,23,41,person
19162,5,person,6,0,12066,42,24,200,52,247,28,47,person
19163,6,person,7,0,12066,61,73,175,113,240,40,65,person
19164,0,person,1,0,12084,25,52,178,93,243,41,65,person
19165,2,person,3,0,12084,41,2,202,34,250,32,48,person
19166,2,person,3,0,12087,24,7,170,25,203,18,33,person
19167,3,person,4,0,12087,31,30,168,54,208,24,40,person
19168,4,person,5,0,12087,34,59,171,75,212,16,41,person
19169,5,person,6,0,12087,37,80,173,102,218,22,45,person
19170,6,person,7,0,12087,43,127,176,152,227,25,51,person
19171,7,person,8,0,12087,46,166,175,193,236,27,61,person
19172,8,person,9,0,12087,55,191,173,225,239,34,66,person
19173,7,person,8,1,12089,19,40,235,56,255,16,20,person
19174,8,person,9,0,12089,19,156,204,165,220,9,16,person
19175,4,person,5,0,12099,25,35,203,49,233,14,30,person
19176,5,person,6,0,12099,31,67,189,87,232,20,43,person
19177,6,person,7,0,12099,57,132,135,174,221,42,86,person
19178,5,car,6,0,12102,19,110,229,143,251,33,22,car
19179,3,person,4,0,12104,35,137,182,169,235,32,53,person
19180,4,person,5,0,12104,39,163,181,193,237,30,56,person
19181,4,person,5,0,12169,40,123,204,157,240,34,36,person
19182,5,person,6,0,12169,23,23,190,38,210,15,20,person
19183,6,person,7,0,12169,20,167,198,177,225,10,27,person
19184,7,person,8,1,12169,15,110,201,119,218,9,17,person
19185,2,person,3,0,12171,21,138,172,154,207,16,35,person
19186,3,person,4,0,12171,25,159,172,174,208,15,36,person
19187,4,person,5,0,12171,31,189,175,203,214,14,39,person
19188,5,person,6,0,12171,32,209,177,229,217,20,40,person
19189,3,person,4,0,12176,23,158,148,172,192,14,44,person
19190,5,person,6,0,12181,16,820,1351,851,1425,31,74,person
19191,6,car,7,1,12181,23,1598,1375,1798,1431,200,56,car
19192,7,car,8,0,12181,15,1995,1385,2162,1433,167,48,car
19193,1,person,2,0,23917,48,79,283,170,578,91,295,person
19194,2,person,3,0,23917,40,341,322,422,599,81,277,person
19195,3,backpack,4,0,23917,29,307,358,400,449,93,91,backpack
19196,4,backpack,5,0,23917,24,59,321,123,413,64,92,backpack
19197,3,person,4,0,23918,95,324,447,489,721,165,274,person
19198,4,backpack,5,0,23918,51,312,403,437,552,125,149,backpack
19199,3,person,4,0,23921,24,305,181,347,232,42,51,person
19200,4,snowboard,5,0,23921,16,292,207,366,235,74,28,snowboard
19201,5,person,6,0,23921,22,502,323,518,376,16,53,person
19202,6,person,7,1,23921,19,533,334,548,375,15,41,person
19203,7,person,8,0,23921,24,545,312,560,362,15,50,person
19204,8,person,9,0,23921,21,562,338,578,379,16,41,person
19205,9,person,10,1,23921,17,594,341,614,382,20,41,person
19206,10,person,11,0,23921,23,611,313,626,360,15,47,person
19207,11,person,12,0,23921,22,637,311,650,358,13,47,person
19208,12,person,13,0,23921,20,638,345,655,385,17,40,person
19209,13,person,14,0,23921,18,675,328,688,379,13,51,person
19210,14,person,15,1,23921,21,673,315,686,362,13,47,person
19211,15,person,16,0,23921,19,692,317,706,366,14,49,person
19212,16,person,17,0,23921,20,709,336,724,386,15,50,person
19213,4,bicycle,5,0,12212,30,197,211,290,256,93,45,bicycle
19214,8,person,9,0,13934,29,214,1029,284,1221,70,192,person
19215,9,person,10,1,13934,18,143,1030,209,1109,66,79,person
19216,11,person,12,1,13934,16,61,999,92,1063,31,64,person
19217,12,person,13,1,13934,18,22,1001,53,1093,31,92,person
19218,6,car,7,0,13935,27,255,129,318,171,63,42,car
19219,7,person,8,0,13935,20,239,139,257,172,18,33,person
19220,18,person,19,0,13937,16,916,441,933,503,17,62,person
19221,20,person,21,0,13937,17,629,523,671,588,42,65,person
19222,21,person,22,0,13937,33,733,513,877,693,144,180,person
19223,22,person,23,0,13937,26,855,545,929,703,74,158,person
19224,24,person,25,0,13937,34,153,500,240,605,87,105,person
19225,25,person,26,0,13937,17,7,474,60,521,53,47,person
19226,1,bird,2,0,222,37,112,82,273,261,161,179,bird
19227,2,bird,3,0,222,31,445,164,583,242,138,78,bird
19228,2,person,3,0,224,64,347,668,1054,1593,707,925,person
19229,50,person,51,0,225,16,860,969,871,1003,11,34,person
19230,51,person,52,0,225,15,908,979,920,1012,12,33,person
19231,1,boat,2,0,226,68,1,164,479,360,478,196,boat
19232,2,person,3,1,226,138,127,42,412,359,285,317,person
19233,1,surfboard,2,0,227,29,203,85,262,217,59,132,surfboard
19234,2,person,3,0,227,51,181,129,320,210,139,81,person
19235,3,boat,4,1,13986,54,167,185,256,255,89,70,boat
19236,0,boat,1,0,13991,22,176,75,197,99,21,24,boat
19237,0,boat,1,0,13993,22,22,87,162,128,140,41,boat
19238,3,person,4,0,13993,18,200,138,232,174,32,36,person
19239,4,person,5,0,13993,16,212,129,234,153,22,24,person
19240,8,umbrella,9,0,23948,25,850,456,986,620,136,164,umbrella
19241,12,table,13,0,23948,15,803,560,860,625,57,65,dining table
19242,15,chair,16,0,23948,16,450,516,558,624,108,108,chair
19243,16,chair,17,0,23948,19,291,417,384,535,93,118,chair
19244,17,chair,18,0,23948,16,247,394,311,470,64,76,chair
19245,18,chair,19,0,23948,15,192,345,262,402,70,57,chair
19246,19,chair,20,0,23948,18,82,381,184,455,102,74,chair
19247,24,table,25,0,23948,23,346,510,427,585,81,75,dining table
19248,25,chair,26,1,23948,39,159,472,287,593,128,121,chair
19249,26,person,27,0,23948,55,167,450,345,577,178,127,person
19250,7,person,8,0,23949,16,274,564,288,587,14,23,person
19251,9,person,10,0,23949,22,358,573,380,608,22,35,person
19252,10,person,11,1,23949,16,375,577,397,600,22,23,person
19253,12,person,13,0,23949,30,559,575,596,612,37,37,person
19254,13,person,14,1,23949,22,595,577,622,604,27,27,person
19255,5,boat,6,0,23954,22,155,189,195,202,40,13,boat
19256,2,dog,3,0,23955,85,83,268,683,828,600,560,dog
19257,5,person,6,1,23956,90,64,104,549,733,485,629,person
19258,4,person,5,0,23957,52,264,213,425,438,161,225,person
19259,5,surfboard,6,0,23957,26,286,328,456,479,170,151,surfboard
19260,6,horse,7,0,23959,21,134,463,155,504,21,41,horse
19261,8,horse,9,0,23959,29,510,492,549,524,39,32,horse
19262,9,horse,10,1,23959,28,475,491,521,523,46,32,horse
19263,10,horse,11,0,23959,32,784,526,855,567,71,41,horse
19264,2,boat,3,0,23960,21,321,327,672,399,351,72,boat
19265,6,umbrella,7,0,23960,19,461,408,537,477,76,69,umbrella
19266,8,umbrella,9,0,23960,24,269,417,348,502,79,85,umbrella
19267,9,umbrella,10,0,23960,19,185,411,271,504,86,93,umbrella
19268,11,umbrella,12,0,23960,15,90,384,174,477,84,93,umbrella
19269,12,chair,13,0,23960,18,334,464,369,511,35,47,chair
19270,14,person,15,0,23960,25,298,422,337,507,39,85,person
19271,15,person,16,1,23960,22,129,409,153,476,24,67,person
19272,17,chair,18,0,23960,16,259,462,295,507,36,45,chair
19273,18,chair,19,0,23960,20,927,453,949,493,22,40,chair
19274,1,person,2,1,23997,105,480,226,933,682,453,456,person
19275,2,apple,3,0,23997,50,545,306,865,630,320,324,apple
19276,28,person,29,1,23998,96,392,55,639,767,247,712,person
19277,29,person,30,1,23998,88,524,118,781,768,257,650,person
19278,2,person,3,0,24005,91,579,131,955,676,376,545,person
19279,2,apple,3,0,24006,33,423,199,608,383,185,184,apple
19280,3,apple,4,0,24006,54,277,269,474,475,197,206,apple
19281,4,apple,5,0,24006,29,21,163,188,320,167,157,apple
19282,5,apple,6,0,24006,36,446,482,560,561,114,79,apple
19283,6,apple,7,1,24006,49,677,352,817,496,140,144,apple
19284,2,person,3,0,14184,40,135,145,179,244,44,99,person
19285,3,person,4,0,14184,47,163,155,207,282,44,127,person
19286,4,person,5,0,14184,39,198,147,237,275,39,128,person
19287,8,person,9,1,14185,24,306,341,338,385,32,44,person
19288,9,person,10,0,14185,27,301,358,331,447,30,89,person
19289,4,person,5,0,14187,31,208,136,272,274,64,138,person
19290,5,bicycle,6,0,14187,55,217,179,312,265,95,86,bicycle
19291,6,person,7,0,14187,36,341,98,404,227,63,129,person
19292,7,bicycle,8,0,14187,63,299,153,429,233,130,80,bicycle
19293,4,person,5,0,14188,77,127,171,229,434,102,263,person
19294,1,person,2,0,21962,35,349,217,428,323,79,106,person
19295,7,cow,8,0,15239,28,1225,380,1475,552,250,172,cow
19296,8,cow,9,0,15239,45,1481,248,1925,563,444,315,cow
19297,9,cow,10,0,15239,60,135,363,929,934,794,571,cow
19298,8,cow,9,0,15251,17,366,664,477,711,111,47,cow
19299,0,horse,1,0,15253,33,446,309,590,505,144,196,horse
19300,4,cow,5,0,15260,59,31,426,453,659,422,233,cow
19301,5,cow,6,1,15260,28,371,435,541,629,170,194,cow
19302,0,cow,1,0,15264,19,207,494,665,651,458,157,cow
19303,5,cow,6,1,15264,72,1028,283,1481,583,453,300,cow
19304,6,cow,7,1,15264,73,1233,459,1828,718,595,259,cow
19305,7,cow,8,0,15264,48,990,549,1453,695,463,146,cow
19306,3,cow,4,0,15265,24,75,724,441,978,366,254,cow
19307,4,cow,5,0,15265,24,811,704,1093,932,282,228,cow
19308,5,cow,6,0,15265,20,1185,716,1419,914,234,198,cow
19309,0,cow,1,0,15266,67,739,401,1530,902,791,501,cow
19310,1,cow,2,0,15266,41,1671,390,2193,880,522,490,cow
19311,6,horse,7,0,15273,15,323,727,493,903,170,176,horse
19312,7,horse,8,0,15273,24,726,681,761,739,35,58,horse
19313,8,horse,9,0,15273,42,639,687,725,746,86,59,horse
19314,9,horse,10,0,15273,74,635,738,829,906,194,168,horse
19315,10,horse,11,0,15273,52,1536,681,1660,763,124,82,horse
19316,11,horse,12,0,15273,84,1623,718,1896,907,273,189,horse
19317,12,horse,13,0,15273,29,1068,702,1146,869,78,167,horse
19318,13,horse,14,0,15273,32,1165,673,1206,713,41,40,horse
19319,0,horse,1,0,15275,30,216,369,334,467,118,98,horse
19320,1,horse,2,0,15275,26,361,358,462,435,101,77,horse
19321,2,horse,3,0,15275,23,452,330,546,391,94,61,horse
19322,0,horse,1,0,15277,65,903,345,1373,737,470,392,horse
19323,2,horse,3,0,15277,40,384,432,668,695,284,263,horse
19324,3,horse,4,0,15277,31,124,487,363,645,239,158,horse
19325,0,person,1,0,15278,50,650,330,1010,1152,360,822,person
19326,1,horse,2,0,15278,109,416,585,1249,1533,833,948,horse
19327,0,cow,1,0,15280,50,951,583,1587,948,636,365,cow
19328,1,cow,2,0,15280,25,921,446,1310,722,389,276,cow
19329,2,person,3,0,15280,40,1439,435,1654,924,215,489,person
19330,3,person,4,0,15280,37,736,518,980,977,244,459,person
19331,0,cow,1,0,15281,97,519,612,1906,1515,1387,903,cow
19332,12,person,13,0,15281,95,301,208,542,750,241,542,person
19333,13,person,14,1,15281,70,482,251,704,751,222,500,person
19334,0,cow,1,0,15283,29,1774,618,2194,1018,420,400,cow
19335,1,cow,2,0,15283,26,1415,698,1760,943,345,245,cow
19336,3,cow,4,0,15283,25,0,689,441,1121,441,432,cow
19337,9,cow,10,0,15283,73,857,679,1234,1144,377,465,cow
19338,10,cow,11,1,15283,54,1128,759,1321,995,193,236,cow
19339,1,cow,2,0,15284,15,557,502,624,591,67,89,cow
19340,2,cow,3,0,15284,43,806,467,1023,744,217,277,cow
19341,0,sheep,1,0,22031,51,0,106,256,174,256,68,sheep
19342,0,cow,1,0,22033,34,441,281,754,449,313,168,cow
19343,3,person,4,1,24066,109,0,218,839,1533,839,1315,person
19344,5,glasses,6,0,24066,18,152,198,240,379,88,181,eye glasses
19345,6,person,7,0,24067,66,290,351,900,1190,610,839,person
19346,7,person,8,0,24067,70,535,681,978,1368,443,687,person
19347,8,person,9,0,24067,49,1010,532,1453,1119,443,587,person
19348,9,person,10,0,24067,59,1406,584,2002,1543,596,959,person
19349,12,cow,13,0,24069,35,497,275,560,330,63,55,cow
19350,13,cow,14,0,24069,18,321,296,385,329,64,33,cow
19351,14,cow,15,0,24069,17,288,280,342,308,54,28,cow
19352,6,person,7,0,24070,62,227,73,425,312,198,239,person
19353,9,car,10,1,239,16,1,1,242,161,241,160,car
19354,19,table,20,1,239,83,1,266,832,660,831,394,dining table
19355,27,person,28,0,239,83,549,45,782,460,233,415,person
19356,37,person,38,0,239,129,268,49,651,661,383,612,person
19357,45,dog,46,1,239,65,582,514,878,624,296,110,dog
19358,4,person,5,0,24098,74,399,221,580,590,181,369,person
19359,6,bench,7,0,24098,66,216,312,1024,582,808,270,bench
19360,7,table,8,0,24098,22,3,274,318,454,315,180,dining table
19361,5,person,6,0,24099,29,273,417,330,570,57,153,person
19362,6,person,7,0,24099,25,337,417,380,564,43,147,person
19363,7,person,8,1,24099,32,414,409,450,523,36,114,person
19364,8,person,9,0,24099,23,425,425,462,502,37,77,person
19365,21,person,22,1,24099,16,353,389,380,432,27,43,person
19366,6,chair,7,0,24100,27,439,797,717,1080,278,283,chair
19367,7,chair,8,0,24100,21,1193,832,1508,1080,315,248,chair
19368,8,bench,9,1,24100,51,686,709,1350,940,664,231,bench
19369,9,table,10,0,24100,24,745,786,1199,1056,454,270,dining table
19370,10,person,11,0,24100,134,808,0,1239,829,431,829,person
19371,11,person,12,1,24100,84,1076,339,1262,860,186,521,person
19372,18,person,19,1,24101,16,442,310,457,340,15,30,person
19373,19,person,20,1,24101,18,434,312,444,346,10,34,person
19374,23,person,24,1,24101,27,72,303,113,374,41,71,person
19375,24,person,25,1,24101,18,51,345,88,387,37,42,person
19376,9,plant pot,10,1,24102,27,841,469,909,507,68,38,potted plant
19377,10,plant pot,11,0,24102,15,871,506,966,571,95,65,potted plant
19378,19,table,20,0,24102,26,339,436,474,490,135,54,dining table
19379,20,bench,21,0,24102,20,328,461,456,491,128,30,bench
19380,21,chair,22,0,24102,21,309,428,350,480,41,52,chair
19381,22,chair,23,0,24102,26,491,431,532,487,41,56,chair
19382,25,chair,26,0,24102,30,4,532,111,668,107,136,chair
19383,27,umbrella,28,0,24102,18,477,341,567,414,90,73,umbrella
19384,28,umbrella,29,0,24102,18,535,350,608,399,73,49,umbrella
19385,30,chair,31,0,24102,19,569,408,594,448,25,40,chair
19386,3,table,4,0,24103,17,96,316,462,480,366,164,dining table
19387,4,bench,5,0,24103,17,179,361,490,462,311,101,bench
19388,5,bench,6,0,24103,19,53,380,383,518,330,138,bench
19389,18,bench,19,0,24104,43,211,460,379,526,168,66,bench
19390,19,bench,20,0,24104,32,9,430,99,459,90,29,bench
19391,5,person,6,0,15471,19,1789,399,1851,636,62,237,person
19392,6,person,7,1,15471,15,1591,438,1656,671,65,233,person
19393,7,person,8,0,15471,35,1464,399,1620,798,156,399,person
19394,5,person,6,1,24145,23,938,286,962,339,24,53,person
19395,5,person,6,0,24146,47,812,307,884,549,72,242,person
19396,3,bird,4,0,24147,32,297,184,380,295,83,111,bird
19397,4,bird,5,0,24147,24,270,439,382,527,112,88,bird
19398,1,person,2,1,24148,90,196,135,437,443,241,308,person
19399,2,person,3,1,24148,122,591,171,954,589,363,418,person
19400,3,person,4,0,24149,59,178,54,503,525,325,471,person
19401,2,bird,3,0,24150,95,96,116,759,571,663,455,bird
19402,7,person,8,0,24151,75,434,47,628,640,194,593,person
19403,3,boat,4,0,24152,77,68,377,562,753,494,376,boat
19404,4,person,5,1,24152,54,145,267,284,471,139,204,person
19405,2,person,3,0,15645,65,97,91,212,413,115,322,person
19406,3,person,4,0,15646,97,26,37,276,373,250,336,person
19407,5,person,6,0,15647,40,77,57,128,207,51,150,person
19408,6,person,7,0,15647,49,126,117,194,248,68,131,person
19409,4,person,5,0,15648,18,447,296,497,387,50,91,person
19410,5,person,6,1,15648,23,372,329,421,408,49,79,person
19411,6,person,7,0,15648,22,884,283,906,374,22,91,person
19412,7,person,8,0,15648,18,965,296,986,379,21,83,person
19413,2,boat,3,0,15656,24,311,459,1175,893,864,434,boat
19414,3,person,4,1,15656,30,627,302,909,495,282,193,person
19415,4,person,5,1,15656,24,828,407,1016,638,188,231,person
19416,5,person,6,1,15656,34,643,432,960,730,317,298,person
19417,6,person,7,1,15656,28,472,421,638,685,166,264,person
19418,7,person,8,1,15656,27,356,493,580,752,224,259,person
19419,6,person,7,0,15657,49,133,110,231,178,98,68,person
19420,7,person,8,0,15657,31,51,104,115,177,64,73,person
19421,8,person,9,1,15657,33,187,91,234,159,47,68,person
19422,9,person,10,1,15657,54,69,48,178,148,109,100,person
19423,10,person,11,1,24199,41,180,297,394,483,214,186,person
19424,11,person,12,1,24199,20,305,436,380,545,75,109,person
19425,12,person,13,1,24199,21,377,414,451,521,74,107,person
19426,13,person,14,1,24199,15,503,391,555,463,52,72,person
19427,14,person,15,1,24199,15,520,420,567,478,47,58,person
19428,15,person,16,1,24199,25,564,431,707,505,143,74,person
19429,3,boat,4,1,24200,16,893,358,993,393,100,35,boat
19430,6,boat,7,1,24200,17,217,287,352,325,135,38,boat
19431,7,boat,8,0,24200,15,142,330,281,365,139,35,boat
19432,9,person,10,1,24200,24,871,314,940,391,69,77,person
19433,10,person,11,0,24200,17,821,287,855,322,34,35,person
19434,12,person,13,1,24200,24,475,310,530,353,55,43,person
19435,13,person,14,1,24200,18,283,283,315,318,32,35,person
19436,14,person,15,1,24200,25,175,300,244,344,69,44,person
19437,2,person,3,1,24201,48,783,75,992,367,209,292,person
19438,3,person,4,1,24201,51,498,134,708,388,210,254,person
19439,4,person,5,1,24201,26,128,237,211,349,83,112,person
19440,5,person,6,1,24201,25,279,170,353,299,74,129,person
19441,6,person,7,1,24201,71,147,228,474,551,327,323,person
19442,7,person,8,1,24201,57,2,209,312,520,310,311,person
19443,3,person,4,1,24202,44,470,133,650,305,180,172,person
19444,4,person,5,1,24202,30,645,198,771,349,126,151,person
19445,5,person,6,1,24202,30,635,228,757,446,122,218,person
19446,6,person,7,1,24202,42,426,210,567,439,141,229,person
19447,7,person,8,1,24202,21,521,258,572,416,51,158,person
19448,8,person,9,1,24202,32,507,269,695,465,188,196,person
19449,9,person,10,1,24202,47,274,242,481,437,207,195,person
19450,2,person,3,1,24203,66,384,107,577,446,193,339,person
19451,3,person,4,1,24203,25,333,371,441,504,108,133,person
19452,4,person,5,1,24203,53,411,360,679,555,268,195,person
19453,5,person,6,1,24203,39,631,250,733,405,102,155,person
19454,6,person,7,1,24203,55,604,286,866,486,262,200,person
19455,1,boat,2,1,24204,56,0,448,1023,684,1023,236,boat
19456,2,person,3,1,24204,69,673,187,828,638,155,451,person
19457,3,person,4,1,24204,59,385,332,702,683,317,351,person
19458,4,person,5,1,24204,27,222,331,334,448,112,117,person
19459,5,person,6,1,24204,60,110,350,391,682,281,332,person
19460,2,person,3,1,24205,31,468,220,595,358,127,138,person
19461,3,person,4,1,24205,37,576,174,748,352,172,178,person
19462,4,person,5,1,24205,34,507,111,650,293,143,182,person
19463,2,boat,3,0,24206,35,109,328,557,484,448,156,boat
19464,3,person,4,1,24206,45,142,173,318,372,176,199,person
19465,4,person,5,1,24206,19,231,180,270,266,39,86,person
19466,6,person,6,1,24206,33,246,205,348,326,102,121,person
19467,7,person,7,1,24206,40,322,215,409,334,87,119,person
19468,8,person,8,1,24206,63,335,189,531,366,196,177,person
19469,9,person,9,1,24206,57,497,197,610,364,113,167,person
19470,3,boat,4,0,24207,30,584,364,834,487,250,123,boat
19471,4,person,5,1,24207,29,683,375,757,460,74,85,person
19472,2,person,3,0,24208,58,352,227,536,473,184,246,person
19473,3,person,4,1,24208,26,618,333,721,497,103,164,person
19474,4,person,5,1,24208,31,575,335,684,558,109,223,person
19475,6,person,6,1,24208,38,415,381,600,599,185,218,person
19476,7,person,7,1,24208,64,211,288,485,469,274,181,person
19477,8,person,8,1,24208,29,327,320,421,506,94,186,person
19478,9,person,9,1,24208,46,409,366,630,590,221,224,person
19479,10,person,10,1,24208,33,191,355,404,524,213,169,person
19480,5,person,6,1,24209,96,23,203,598,1024,575,821,person
19481,6,boat,7,0,24209,33,1,820,767,1024,766,204,boat
19482,6,boat,7,1,24210,23,298,218,559,362,261,144,boat
19483,7,person,8,1,24210,16,289,257,388,325,99,68,person
19484,2,person,3,0,24211,123,3,91,688,536,685,445,person
19485,5,bottle,6,1,24211,17,641,102,677,226,36,124,bottle
19486,4,person,5,1,24212,44,643,205,767,332,124,127,person
19487,5,person,6,1,24212,42,533,240,694,350,161,110,person
19488,7,person,7,1,24212,62,438,246,599,327,161,81,person
19489,8,person,8,1,24212,44,295,250,457,350,162,100,person
19490,4,boat,5,0,24213,36,2,364,952,575,950,211,boat
19491,5,person,6,1,24213,28,768,292,900,411,132,119,person
19492,6,person,7,1,24213,30,729,319,805,440,76,121,person
19493,7,person,8,1,24213,59,614,277,802,484,188,207,person
19494,8,person,9,1,24213,35,605,220,673,424,68,204,person
19495,9,person,10,1,24213,35,464,261,627,489,163,228,person
19496,10,person,11,1,24213,48,443,199,575,477,132,278,person
19497,11,person,12,1,24213,38,379,231,462,437,83,206,person
19498,12,person,13,1,24213,42,273,230,458,478,185,248,person
19499,13,person,14,1,24213,37,232,223,337,413,105,190,person
19500,14,person,15,1,24213,44,107,226,287,461,180,235,person
19501,15,person,16,1,24213,46,13,165,165,421,152,256,person
19502,7,boat,8,0,24214,58,74,394,664,583,590,189,boat
19503,8,person,9,0,24214,34,371,402,575,466,204,64,person
19504,9,person,10,0,24214,34,271,330,396,435,125,105,person
19505,10,person,11,1,24214,33,509,318,585,440,76,122,person
19506,1,boat,2,0,24215,40,120,122,1022,682,902,560,boat
19507,2,person,3,0,24215,69,267,288,673,679,406,391,person
19508,3,person,4,1,24215,81,181,96,476,451,295,355,person
19509,4,person,5,0,24215,59,395,14,607,312,212,298,person
19510,5,person,6,0,24215,79,580,4,870,349,290,345,person
19511,3,person,4,1,24216,64,556,347,813,527,257,180,person
19512,4,person,5,1,24216,49,729,293,880,498,151,205,person
19513,5,person,6,1,24216,71,565,201,759,470,194,269,person
19514,6,person,7,1,24216,27,352,379,485,446,133,67,person
19515,7,person,8,1,24216,37,296,310,429,442,133,132,person
19516,8,person,9,1,24216,91,229,206,481,484,252,278,person
19517,9,person,10,1,24216,83,199,21,429,295,230,274,person
19518,3,person,4,1,24217,70,246,67,469,281,223,214,person
19519,4,person,5,1,24217,49,421,52,559,260,138,208,person
19520,1,boat,2,0,24218,118,19,105,568,403,549,298,boat
19521,2,person,3,1,24218,44,284,165,397,317,113,152,person
19522,3,person,4,1,24218,37,416,228,573,321,157,93,person
19523,4,person,5,1,24218,34,714,220,784,390,70,170,person
19524,6,bird,7,0,24218,25,974,107,1012,167,38,60,bird
19525,2,boat,3,0,24219,18,201,311,364,407,163,96,boat
19526,5,person,6,0,24219,39,191,172,367,333,176,161,person
19527,3,person,4,0,24220,67,495,98,713,316,218,218,person
19528,4,person,5,1,24220,45,593,265,752,452,159,187,person
19529,5,person,6,1,24220,30,522,309,599,446,77,137,person
19530,6,person,7,1,24220,28,609,355,729,478,120,123,person
19531,7,person,8,1,24220,24,524,394,671,501,147,107,person
19532,8,person,9,1,24220,30,365,357,530,486,165,129,person
19533,2,person,3,1,24221,24,317,31,500,292,183,261,person
19534,3,person,4,1,24221,79,22,5,418,674,396,669,person
19535,4,person,5,1,24221,69,717,2,1022,626,305,624,person
19536,5,person,6,1,24221,82,629,103,1001,679,372,576,person
19537,6,person,7,1,24221,71,109,206,852,679,743,473,person
19538,7,person,8,1,24221,19,1,255,162,680,161,425,person
19539,1,bird,2,0,24239,62,336,306,716,579,380,273,bird
19540,4,person,5,0,24241,47,359,388,438,581,79,193,person
19541,6,person,7,1,24242,43,157,302,288,599,131,297,person
19542,7,person,8,1,24242,33,258,320,435,599,177,279,person
19543,1,boat,2,1,24243,35,532,1151,1509,1467,977,316,boat
19544,2,person,3,0,24243,82,829,289,1222,1460,393,1171,person
19545,2,person,3,1,24244,50,336,777,567,1066,231,289,person
19546,4,horse,5,0,15876,30,180,153,223,180,43,27,horse
19547,7,boat,8,0,15882,16,126,236,186,246,60,10,boat
19548,10,person,11,0,15882,15,163,221,180,239,17,18,person
19549,3,boat,4,0,15903,18,81,107,425,178,344,71,boat
19550,5,person,6,1,15903,15,133,96,146,113,13,17,person
19551,6,person,7,1,15903,23,74,96,88,135,14,39,person
19552,7,person,8,0,15903,27,36,107,54,159,18,52,person
19553,8,person,9,0,15903,29,0,114,24,180,24,66,person
19554,2,person,3,1,24302,53,321,188,481,439,160,251,person
19555,3,person,4,1,24302,20,481,283,496,320,15,37,person
19556,4,person,5,1,24302,19,496,280,514,310,18,30,person
19557,11,person,12,0,24306,135,101,152,508,711,407,559,person
19558,12,backpack,13,0,24306,22,199,463,313,559,114,96,backpack
19559,12,person,13,0,24307,24,528,381,557,410,29,29,person
19560,13,person,14,0,24307,21,505,376,528,408,23,32,person
19561,14,person,15,0,24307,30,483,377,506,425,23,48,person
19562,15,person,16,0,24307,43,451,374,489,420,38,46,person
19563,7,person,8,0,15920,78,2,833,591,2047,589,1214,person
19564,28,glasses,29,0,15920,32,206,929,358,976,152,47,eye glasses
19565,1,person,2,0,15922,30,414,533,447,606,33,73,person
19566,1,person,2,0,22066,30,414,533,447,606,33,73,person
19567,11,person,12,0,252,43,634,1266,663,1318,29,52,person
19568,12,person,13,0,252,42,609,1274,632,1323,23,49,person
19569,13,person,14,0,252,50,572,1276,612,1331,40,55,person
19570,14,person,15,0,252,37,547,1283,570,1337,23,54,person
19571,15,person,16,0,252,42,480,1290,504,1347,24,57,person
19572,16,person,17,0,252,45,456,1298,479,1351,23,53,person
19573,17,person,18,0,252,41,418,1298,438,1356,20,58,person
19574,18,person,19,1,252,22,205,1130,223,1159,18,29,person
19575,20,person,21,1,252,19,172,1136,192,1159,20,23,person
19576,21,person,22,1,252,17,153,1131,173,1158,20,27,person
19577,22,person,23,1,252,18,137,1126,151,1157,14,31,person
19578,23,person,24,1,252,26,110,1120,143,1154,33,34,person
19579,24,person,25,1,252,22,42,1122,78,1152,36,30,person
19580,26,person,27,0,252,19,1107,923,1116,944,9,21,person
19581,6,person,7,0,253,43,991,699,1084,848,93,149,person
19582,7,person,8,0,253,58,610,737,688,886,78,149,person
19583,9,person,10,1,253,20,2038,458,2090,557,52,99,person
19584,10,person,11,1,253,19,1,339,46,388,45,49,person
19585,9,person,10,1,254,51,983,559,1201,860,218,301,person
19586,10,person,11,1,254,86,939,728,1575,1647,636,919,person
19587,5,person,6,0,15949,25,97,122,108,160,11,38,person
19588,6,person,7,0,15949,25,130,103,148,137,18,34,person
19589,7,person,8,0,15949,24,166,73,187,103,21,30,person
19590,6,person,7,1,15950,35,201,124,240,270,39,146,person
19591,7,backpack,8,0,15950,15,224,206,246,243,22,37,backpack
19592,8,person,9,0,15950,43,134,109,218,298,84,189,person
19593,5,person,6,0,15951,22,221,326,278,427,57,101,person
19594,2,person,3,0,15952,32,171,125,211,252,40,127,person
19595,6,person,3,0,15953,18,187,345,222,429,35,84,person
19596,6,person,7,0,15954,33,290,219,319,327,29,108,person
19597,14,person,15,0,15955,29,205,139,238,255,33,116,person
19598,4,person,5,0,15956,45,433,501,666,848,233,347,person
19599,6,person,7,0,15956,17,577,322,608,444,31,122,person
19600,7,person,8,1,15956,28,512,410,627,543,115,133,person
19601,8,person,9,1,15956,17,506,293,546,376,40,83,person
19602,9,person,10,1,15956,17,441,237,506,332,65,95,person
19603,5,person,6,0,15957,27,223,205,257,266,34,61,person
19604,3,person,4,1,15958,23,80,9,105,80,25,71,person
19605,4,person,5,0,15958,24,98,32,133,110,35,78,person
19606,2,person,3,0,15959,36,215,121,250,279,35,158,person
19607,3,backpack,4,0,15959,18,204,145,232,200,28,55,backpack
19608,7,motorbike,8,1,15960,21,1321,705,1511,827,190,122,motorcycle
19609,9,person,10,1,15960,16,1466,537,1546,694,80,157,person
19610,10,person,11,1,15960,19,1539,548,1593,708,54,160,person
19611,12,person,13,1,15960,18,530,379,665,575,135,196,person
19612,13,person,14,1,15960,17,606,451,734,583,128,132,person
19613,16,person,17,0,15960,24,1079,131,1140,275,61,144,person
19614,5,person,6,0,15961,49,176,236,306,597,130,361,person
19615,5,person,6,0,15962,20,39,54,51,94,12,40,person
19616,6,person,3,0,22074,18,187,345,222,429,35,84,person
19617,2,person,3,0,22077,27,280,345,362,550,82,205,person
19618,2,bus,3,0,16062,17,89,121,160,153,71,32,bus
19619,3,person,4,0,16064,41,521,151,588,375,67,224,person
19620,4,person,5,0,16064,41,453,178,527,375,74,197,person
19621,5,person,6,0,16064,49,387,149,450,375,63,226,person
19622,6,person,7,0,16064,49,321,162,393,375,72,213,person
19623,7,person,8,0,16064,43,242,175,310,375,68,200,person
19624,8,person,9,0,16064,41,165,177,242,375,77,198,person
19625,9,person,10,0,16064,41,105,160,172,373,67,213,person
19626,2,car,3,0,16065,34,366,143,537,254,171,111,car
19627,4,person,5,0,16065,24,339,187,368,230,29,43,person
19628,3,person,4,0,22089,49,324,119,385,291,61,172,person
19629,6,person,7,0,16076,27,374,55,403,129,29,74,person
19630,7,person,8,1,16076,22,422,58,462,125,40,67,person
19631,8,person,9,0,16076,24,452,29,484,128,32,99,person
19632,10,person,11,0,16076,17,609,71,622,109,13,38,person
19633,6,person,7,0,16077,26,295,203,318,256,23,53,person
19634,4,bird,5,0,16081,22,613,932,828,1096,215,164,bird
19635,5,person,6,0,16083,34,140,193,185,311,45,118,person
19636,3,elephant,4,1,16117,25,148,144,196,185,48,41,elephant
19637,4,elephant,5,0,16117,22,183,160,208,184,25,24,elephant
19638,5,elephant,6,0,16117,35,220,140,271,184,51,44,elephant
19639,4,elephant,5,0,16119,98,210,107,666,449,456,342,elephant
19640,3,person,4,1,256,86,299,260,565,564,266,304,person
19641,4,person,5,0,256,69,356,252,554,512,198,260,person
19642,7,person,8,0,257,40,401,338,446,430,45,92,person
19643,2,boat,3,0,258,18,1661,1084,1774,1119,113,35,boat
19644,3,boat,4,0,258,21,1805,1046,1970,1098,165,52,boat
19645,4,person,5,1,258,28,1975,1061,2018,1126,43,65,person
19646,7,person,8,1,258,15,2131,1089,2157,1134,26,45,person
19647,8,person,9,0,258,38,1230,113,1280,224,50,111,person
19648,16,person,17,1,258,30,984,85,1035,173,51,88,person
19649,17,person,18,1,258,24,959,39,993,112,34,73,person
19650,18,person,19,0,258,35,939,96,1012,163,73,67,person
19651,10,person,11,0,16315,27,664,601,737,764,73,163,person
19652,11,person,12,0,16315,24,750,600,799,755,49,155,person
19653,12,person,13,0,16315,23,428,538,474,688,46,150,person
19654,13,person,14,0,16315,18,322,570,371,717,49,147,person
19655,14,person,15,1,16315,15,851,657,909,746,58,89,person
19656,16,person,17,0,16315,41,1214,687,1324,1052,110,365,person
19657,17,person,18,0,16315,31,1308,703,1370,858,62,155,person
19658,18,person,19,0,16315,19,1388,706,1433,864,45,158,person
19659,19,person,20,0,16315,21,1569,611,1613,789,44,178,person
19660,20,person,21,0,16315,22,1456,678,1542,803,86,125,person
19661,21,person,22,1,16315,17,1517,628,1574,723,57,95,person
19662,22,person,23,0,16315,46,1984,1226,2136,1646,152,420,person
19663,23,person,24,1,16315,21,2093,1349,2195,1553,102,204,person
19664,24,person,25,1,16315,16,2154,1033,2198,1335,44,302,person
19665,1,airplane,2,0,24433,22,466,448,541,478,75,30,airplane
19666,2,airplane,3,0,24433,26,369,350,446,381,77,31,airplane
19667,3,airplane,4,0,24433,26,311,285,391,317,80,32,airplane
19668,5,airplane,6,0,24433,25,250,220,330,255,80,35,airplane
19669,6,airplane,7,0,24433,26,371,179,452,213,81,34,airplane
19670,1,bird,2,0,24435,95,154,174,859,457,705,283,bird
19671,10,car,11,0,16696,17,206,155,218,167,12,12,car
19672,11,car,12,0,16696,15,224,154,244,166,20,12,car
19673,6,person,7,0,16698,15,171,181,180,200,9,19,person
19674,2,person,3,0,16701,40,6,137,32,177,26,40,person
19675,2,person,3,0,16703,28,166,75,188,129,22,54,person
19676,3,person,4,0,16703,24,190,71,207,128,17,57,person
19677,4,person,5,0,16703,38,199,121,233,193,34,72,person
19678,5,person,6,0,16704,27,189,343,224,443,35,100,person
19679,8,person,9,0,24461,94,50,65,285,496,235,431,person
19680,9,person,10,0,24461,78,240,115,410,497,170,382,person
19681,10,person,11,1,24461,54,476,168,570,390,94,222,person
19682,11,person,12,0,24461,48,527,243,689,475,162,232,person
19683,12,backpack,13,0,24461,20,507,389,589,475,82,86,backpack
19684,3,person,4,0,24463,17,294,231,314,248,20,17,person
19685,4,person,5,0,24464,30,542,309,606,514,64,205,person
19686,5,person,6,0,24465,41,391,312,428,375,37,63,person
19687,6,backpack,7,0,24465,16,404,313,427,343,23,30,backpack
19688,8,skis,9,0,24465,21,361,367,454,376,93,9,skis
19689,3,person,4,0,24466,22,947,444,998,542,51,98,person
19690,2,bird,3,0,24467,27,311,220,376,298,65,78,bird
19691,5,airplane,6,0,24468,108,398,355,1463,554,1065,199,airplane
19692,7,person,8,0,24468,32,1544,540,1567,590,23,50,person
19693,8,person,9,0,24468,52,1352,530,1398,656,46,126,person
19694,9,person,10,0,24468,38,1387,538,1417,652,30,114,person
19695,10,backpack,11,0,24468,16,1412,554,1426,604,14,50,backpack
19696,12,person,13,1,24468,29,1186,523,1227,593,41,70,person
19697,13,person,14,1,24468,19,1309,538,1337,580,28,42,person
19698,14,person,15,1,24468,18,1410,522,1423,556,13,34,person
19699,15,person,16,1,24468,17,1381,523,1397,552,16,29,person
19700,16,person,17,0,24468,18,1340,517,1352,560,12,43,person
19701,17,person,18,1,24468,16,1329,515,1341,555,12,40,person
19702,18,person,19,1,24468,16,1318,513,1330,539,12,26,person
19703,20,person,21,0,24468,40,1040,530,1072,628,32,98,person
19704,21,person,22,0,24468,37,1122,531,1167,628,45,97,person
19705,22,person,23,1,24468,33,1149,528,1180,606,31,78,person
19706,26,person,27,1,24468,15,1149,504,1164,533,15,29,person
19707,27,person,28,0,24468,15,1172,507,1185,544,13,37,person
19708,29,person,30,0,24468,28,954,506,987,619,33,113,person
19709,30,person,31,1,24468,19,852,502,884,542,32,40,person
19710,31,person,32,1,24468,16,822,493,840,534,18,41,person
19711,32,person,33,1,24468,20,782,466,806,528,24,62,person
19712,34,person,35,1,24468,15,701,434,720,466,19,32,person
19713,35,person,36,1,24468,15,681,430,701,473,20,43,person
19714,37,person,38,1,24468,19,630,405,659,446,29,41,person
19715,38,person,39,1,24468,17,620,399,643,438,23,39,person
19716,39,person,40,0,24468,15,599,396,621,432,22,36,person
19717,5,person,6,0,24470,47,1948,760,2024,965,76,205,person
19718,5,person,6,1,24471,18,212,299,253,362,41,63,person
19719,6,person,7,1,24471,25,260,300,307,359,47,59,person
19720,7,person,8,0,24471,29,313,294,352,408,39,114,person
19721,2,person,3,0,24473,26,311,318,347,367,36,49,person
19722,3,person,4,0,24473,58,132,338,207,443,75,105,person
19723,4,backpack,5,0,24473,18,142,346,182,378,40,32,backpack
19724,2,person,3,1,24474,65,2,30,452,575,450,545,person
19725,0,bird,1,0,24509,215,150,148,958,559,808,411,bird
19726,2,bird,3,0,24512,52,126,521,419,848,293,327,bird
19727,2,boat,3,0,24515,31,130,883,1066,1087,936,204,boat
19728,7,person,8,0,19010,28,246,787,317,905,71,118,person
19729,8,person,9,0,19010,19,487,863,534,978,47,115,person
19730,9,person,10,0,19010,23,571,871,632,967,61,96,person
19731,10,person,11,0,19010,43,755,853,869,1034,114,181,person
19732,11,person,12,0,19010,21,1119,875,1192,964,73,89,person
19733,13,person,14,0,19010,16,972,888,1023,951,51,63,person
19734,16,person,17,1,19010,20,384,978,487,1083,103,105,person
19735,18,chair,19,0,19010,17,532,840,574,892,42,52,chair
19736,3,person,4,0,19012,44,662,260,759,594,97,334,person
19737,4,person,5,1,19012,26,350,298,411,387,61,89,person
19738,7,person,8,1,19012,25,214,312,296,387,82,75,person
19739,4,person,5,1,19014,24,378,863,467,979,89,116,person
19740,6,person,7,0,19014,25,1024,1114,1234,1168,210,54,person
19741,7,person,8,0,19014,21,1394,1073,1609,1127,215,54,person
19742,3,person,4,0,22233,34,399,210,489,361,90,151,person
19743,2,person,3,1,22234,51,0,193,120,335,120,142,person
19744,3,dog,4,0,24518,41,128,835,299,1007,171,172,dog
19745,4,dog,5,1,24518,32,2,887,151,1023,149,136,dog
19746,6,person,7,0,24518,76,362,279,463,612,101,333,person
19747,4,person,5,0,24519,36,403,266,434,346,31,80,person
19748,5,person,6,1,24519,27,339,285,369,332,30,47,person
19749,3,person,4,1,24522,84,425,325,646,767,221,442,person
19750,14,person,14,0,24523,54,550,445,665,616,115,171,person
19751,1,boat,2,0,24524,16,450,1,1024,86,574,85,boat
19752,2,boat,3,1,24524,40,1,275,427,582,426,307,boat
19753,4,person,5,1,24524,80,611,231,1018,550,407,319,person
19754,5,person,6,0,24524,76,149,86,499,399,350,313,person
19755,6,person,7,0,24524,51,0,1,183,352,183,351,person
19756,3,person,4,0,24525,44,251,154,342,412,91,258,person
19757,4,person,5,0,24525,41,674,147,768,408,94,261,person
19758,5,person,6,0,24525,32,887,260,1003,422,116,162,person
19759,1,person,2,1,24527,67,244,316,448,583,204,267,person
19760,2,person,3,1,24527,117,654,279,829,662,175,383,person
19761,3,person,4,1,24527,68,717,138,853,363,136,225,person
19762,4,person,5,1,24527,55,666,126,748,351,82,225,person
19763,7,person,6,1,24527,28,837,104,919,180,82,76,person
19764,8,person,7,1,24527,32,852,86,923,200,71,114,person
19765,9,person,8,1,24527,25,589,133,666,200,77,67,person
19766,10,person,9,1,24527,47,349,121,436,326,87,205,person
19767,11,person,10,1,24527,50,355,133,507,340,152,207,person
19768,12,person,11,1,24527,17,81,160,134,211,53,51,person
19769,4,person,5,0,24530,48,393,137,453,217,60,80,person
19770,5,person,6,0,24532,114,209,183,510,540,301,357,person
19771,9,dog,10,0,24533,45,375,485,580,637,205,152,dog
19772,10,person,11,0,24533,105,545,51,742,715,197,664,person
19773,2,flowerpot,3,0,19223,24,128,435,336,561,208,126,potted plant
19774,7,person,8,1,24556,16,648,262,662,290,14,28,person
19775,11,person,12,0,24556,61,283,359,344,532,61,173,person
19776,12,person,13,0,24556,70,323,242,385,525,62,283,person
19777,14,backpack,15,0,24556,36,295,282,356,365,61,83,backpack
19778,15,person,16,0,24556,57,689,415,738,559,49,144,person
19779,16,person,17,0,24556,78,734,293,834,631,100,338,person
19780,17,person,18,0,24556,54,818,276,918,521,100,245,person
19781,18,person,19,0,24556,58,914,305,980,515,66,210,person
19782,24,backpack,25,0,24556,20,869,309,917,380,48,71,backpack
19783,17,person,18,0,24559,41,691,678,901,1520,210,842,person
19784,18,person,19,1,24559,61,852,663,1110,1449,258,786,person
19785,19,person,20,0,24559,52,979,742,1135,1462,156,720,person
19786,20,person,21,0,24559,41,1114,727,1285,1446,171,719,person
19787,21,person,22,0,24559,46,1284,755,1572,1449,288,694,person
19788,19,person,20,0,24560,31,849,779,1026,1021,177,242,person
19789,28,person,29,0,24560,51,1598,714,1692,1030,94,316,person
19790,29,backpack,30,0,24560,31,1603,761,1713,884,110,123,backpack
19791,16,person,17,0,24561,31,1636,936,1675,1054,39,118,person
19792,17,person,18,0,24561,29,1681,929,1729,1052,48,123,person
19793,18,person,19,0,24561,19,1752,934,1783,1051,31,117,person
19794,19,person,20,0,24561,24,1799,939,1834,1048,35,109,person
19795,20,person,21,0,24561,25,1852,938,1893,1047,41,109,person
19796,21,person,22,0,24561,26,1897,934,1938,1052,41,118,person
19797,22,person,23,1,24561,46,2041,890,2120,1223,79,333,person
19798,23,backpack,24,0,24561,21,2018,935,2094,1043,76,108,backpack
19799,24,person,25,0,24561,50,2079,929,2197,1301,118,372,person
19800,25,backpack,26,0,24561,22,2071,985,2143,1137,72,152,backpack
19801,2,car,3,0,24581,15,438,539,479,563,41,24,car
19802,7,person,8,0,24582,44,559,294,640,574,81,280,person
19803,8,person,9,0,24582,71,460,267,569,632,109,365,person
19804,9,person,10,1,24582,87,320,254,477,767,157,513,person
19805,10,person,11,1,24582,95,113,217,472,766,359,549,person
19806,13,bottle,14,0,24582,18,325,338,449,395,124,57,bottle
19807,2,dog,3,0,24583,61,798,414,907,498,109,84,dog
19808,3,horse,4,0,24583,100,64,233,354,639,290,406,horse
19809,4,horse,5,0,24583,74,401,235,641,639,240,404,horse
19810,2,plant pot,3,0,24587,16,587,1731,930,2029,343,298,potted plant
19811,7,person,8,0,19355,40,183,153,245,376,62,223,person
19812,11,person,12,0,19357,16,221,337,247,416,26,79,person
19813,12,person,13,0,19357,15,256,334,278,411,22,77,person
19814,5,person,6,0,24589,36,1137,595,1399,857,262,262,person
19815,1,bird,2,0,24599,65,362,118,707,645,345,527,bird
19816,2,bird,3,0,24600,28,705,285,798,339,93,54,bird
19817,3,bird,4,0,24600,32,443,340,567,399,124,59,bird
19818,4,bird,5,0,24600,32,289,428,401,500,112,72,bird
19819,7,person,8,0,24601,26,738,410,759,446,21,36,person
19820,8,person,9,0,24601,49,602,403,653,485,51,82,person
19821,9,person,10,0,24601,42,546,415,600,487,54,72,person
19822,10,backpack,11,0,24601,18,569,400,595,425,26,25,backpack
19823,11,backpack,12,0,24601,16,626,393,649,422,23,29,backpack
19824,4,car,5,0,24602,130,122,137,741,575,619,438,car
19825,1,horse,2,0,24605,156,117,96,623,920,506,824,horse
19826,2,horse,3,0,24605,51,508,664,895,936,387,272,horse
19827,4,person,4,0,24607,79,453,1112,781,2042,328,930,person
19828,6,person,6,0,24607,91,1390,1007,1649,2087,259,1080,person
19829,2,car,3,0,24609,20,391,427,418,439,27,12,car
19830,2,horse,3,0,24610,82,585,328,801,730,216,402,horse
19831,3,person,4,0,19394,60,42,114,258,326,216,212,person
19832,4,person,5,1,19395,32,161,281,316,471,155,190,person
19833,5,person,6,1,19395,21,303,272,377,365,74,93,person
19834,7,person,8,0,19400,39,107,37,181,76,74,39,person
19835,2,person,3,0,25257,49,187,45,372,214,185,169,person
19836,1,person,2,0,19401,44,154,32,256,254,102,222,person
19837,6,person,7,1,19449,31,214,139,255,194,41,55,person
19838,18,person,19,0,19467,16,1983,721,2005,764,22,43,person
19839,5,person,6,0,24618,74,220,179,411,511,191,332,person
19840,7,person,8,1,24622,49,143,258,361,731,218,473,person
19841,1,boat,2,0,24628,172,98,245,756,659,658,414,boat
19842,2,boat,3,0,24628,59,374,571,1024,665,650,94,boat
19843,19,car,20,0,24675,19,322,342,368,380,46,38,car
19844,20,car,21,0,24675,20,404,347,453,387,49,40,car
19845,21,car,22,0,24675,15,285,337,319,369,34,32,car
19846,22,person,23,0,24675,37,482,341,525,471,43,130,person
19847,23,person,24,0,24675,29,707,350,741,469,34,119,person
19848,24,person,25,0,24675,29,742,367,789,474,47,107,person
19849,25,person,26,0,24675,29,767,331,799,460,32,129,person
19850,28,person,29,0,24675,27,41,335,69,424,28,89,person
19851,30,person,31,0,24675,27,73,360,99,412,26,52,person
19852,31,person,32,0,24675,16,98,339,124,409,26,70,person
19853,5,person,6,0,24676,53,308,179,429,548,121,369,person
19854,3,table,4,1,19831,44,149,175,207,226,58,51,dining table
19855,4,bench,5,0,19831,45,152,182,256,256,104,74,bench
19856,6,oven,7,0,19831,56,218,106,239,159,21,53,oven
19857,0,person,1,0,19836,30,144,31,160,63,16,32,person
19858,1,person,2,0,19836,22,125,169,145,194,20,25,person
19859,9,person,9,0,22348,17,146,255,150,262,4,7,person
19860,16,person,14,1,22354,17,1640,472,1693,512,53,40,person
19861,17,person,15,1,22354,29,1764,546,1788,601,24,55,person
19862,18,person,16,0,22354,44,1764,507,1824,591,60,84,person
19863,19,person,17,1,22354,32,1728,499,1775,553,47,54,person
19864,9,person,9,1,22356,23,87,248,97,265,10,17,person
19865,10,person,10,0,22356,19,42,250,47,264,5,14,person
19866,7,person,8,1,19850,22,362,568,491,699,129,131,person
19867,8,person,9,1,19850,18,288,599,379,699,91,100,person
19868,9,person,10,1,19850,15,182,665,272,699,90,34,person
19869,5,person,5,0,22375,30,34,26,52,60,18,34,person
19870,6,person,6,0,22375,32,43,158,65,204,22,46,person
19871,3,person,3,1,22376,23,185,413,199,450,14,37,person
19872,4,person,4,1,22376,28,198,417,212,449,14,32,person
19873,5,person,5,1,22376,34,201,414,228,449,27,35,person
19874,7,person,4,0,22381,36,97,119,110,151,13,32,person
19875,8,person,5,0,22381,37,114,147,134,180,20,33,person
19876,9,person,6,0,22381,29,112,181,122,219,10,38,person
19877,8,person,7,1,22395,39,32,934,79,1054,47,120,person
19878,9,backpack,8,0,22395,21,32,956,61,1002,29,46,backpack
19879,6,person,6,0,22398,63,540,108,631,323,91,215,person
19880,2,person,2,0,22438,28,208,162,218,207,10,45,person
19881,4,person,3,0,22457,37,19,82,47,121,28,39,person
19882,5,person,4,1,22457,39,35,76,55,114,20,38,person
19883,6,person,5,0,22457,51,39,68,71,116,32,48,person
19884,2,person,2,0,22475,17,90,35,96,50,6,15,person
19885,3,person,3,0,22475,20,94,37,102,50,8,13,person
19886,5,person,5,0,22487,90,68,546,199,882,131,336,person
19887,2,person,3,0,22502,31,97,241,116,289,19,48,person
19888,3,person,4,1,22502,16,138,244,143,263,5,19,person
19889,4,person,5,0,22502,38,136,240,152,292,16,52,person
19890,1,person,2,1,22516,70,9,136,86,299,77,163,person
19891,4,person,5,1,19879,61,502,420,1094,1461,592,1041,person
19892,7,person,6,1,22554,32,0,213,40,300,40,87,person
19893,11,person,12,0,22558,18,700,1373,723,1411,23,38,person
19894,13,person,14,1,22558,16,930,1353,944,1389,14,36,person
19895,14,person,15,1,22558,16,347,1664,383,1692,36,28,person
19896,20,person,21,0,22558,17,1013,1337,1029,1376,16,39,person
19897,21,person,22,0,22558,16,711,1290,723,1325,12,35,person
19898,5,person,5,0,19881,21,171,76,186,132,15,56,person
19899,6,person,6,0,19881,27,157,74,173,135,16,61,person
19900,7,person,7,0,19881,32,139,60,160,142,21,82,person
19901,8,person,8,1,19881,27,127,60,142,132,15,72,person
19902,9,person,9,1,19881,30,109,62,136,142,27,80,person
19903,10,person,10,0,19881,36,88,54,119,153,31,99,person
19904,11,person,11,0,19881,38,58,54,89,166,31,112,person
19905,12,person,12,1,19881,22,85,58,93,136,8,78,person
19906,13,person,13,1,19881,21,54,55,73,140,19,85,person
19907,14,person,14,1,19881,17,54,47,67,82,13,35,person
19908,15,person,15,1,19881,18,43,41,57,88,14,47,person
19909,16,person,16,0,19881,34,32,56,60,174,28,118,person
19910,17,person,17,1,19881,24,7,32,33,92,26,60,person
19911,18,person,18,1,19881,38,0,46,34,172,34,126,person
19912,19,person,19,1,19881,18,0,144,56,215,56,71,person
19913,25,person,25,0,19881,18,183,78,194,124,11,46,person
19914,26,person,26,0,19881,18,201,86,210,125,9,39,person
19915,8,person,9,1,19889,48,1562,710,2115,1652,553,942,person
19916,9,person,10,0,19889,65,858,1291,1002,1635,144,344,person
19917,10,person,11,0,19889,74,1314,1322,1444,1654,130,332,person
19918,11,person,12,1,19889,27,1573,1243,1633,1546,60,303,person
19919,13,person,14,1,19889,25,1605,1409,1685,1628,80,219,person
19920,14,person,15,1,19889,22,2142,1295,2198,1464,56,169,person
19921,1,elephant,2,0,22560,123,86,113,434,344,348,231,elephant
19922,2,bird,3,0,24712,62,52,67,882,628,830,561,bird
19923,5,bird,6,0,24713,34,228,252,270,387,42,135,bird
19924,6,bird,7,0,24713,37,438,301,548,394,110,93,bird
19925,7,bird,8,0,24713,53,526,340,678,453,152,113,bird
19926,8,bird,9,1,24713,16,601,310,654,362,53,52,bird
19927,9,bird,10,0,24713,54,645,279,761,391,116,112,bird
19928,12,bird,13,0,24713,19,291,487,337,527,46,40,bird
19929,13,bird,14,0,24713,18,235,427,277,453,42,26,bird
19930,5,dog,6,0,24714,131,531,51,997,674,466,623,dog
19931,0,boat,1,1,306,27,1,1,173,412,172,411,boat
19932,1,person,2,0,307,86,924,714,1402,1169,478,455,person
19933,2,surfboard,3,0,307,51,620,1011,1466,1267,846,256,surfboard
19934,1,surfboard,2,1,308,29,321,233,453,312,132,79,surfboard
19935,2,person,3,0,308,70,225,74,409,280,184,206,person
19936,1,person,2,0,24717,124,328,441,1276,1333,948,892,person
19937,2,person,3,0,24720,68,524,515,672,776,148,261,person
19938,3,person,4,0,24720,70,0,429,151,773,151,344,person
19939,2,person,3,1,24724,23,722,456,814,538,92,82,person
19940,3,person,4,0,24724,47,292,177,410,317,118,140,person
19941,1,person,2,1,24726,55,436,147,686,402,250,255,person
19942,2,person,3,1,24727,43,437,237,610,295,173,58,person
19943,2,person,3,0,24728,60,364,137,477,252,113,115,person
19944,3,surfboard,4,0,24728,20,427,141,500,259,73,118,surfboard
19945,2,person,3,1,24729,28,470,228,522,271,52,43,person
19946,3,person,4,1,24729,17,773,278,799,304,26,26,person
19947,2,person,3,0,24730,73,402,174,572,339,170,165,person
19948,3,surfboard,4,0,24730,29,349,280,569,375,220,95,surfboard
19949,2,person,3,1,24731,49,339,145,531,306,192,161,person
19950,3,person,4,1,24731,28,565,162,668,198,103,36,person
19951,3,person,4,0,24732,19,364,317,410,382,46,65,person
19952,4,person,5,0,24732,19,888,351,927,403,39,52,person
19953,1,person,2,1,24733,65,327,158,432,295,105,137,person
19954,2,surfboard,3,1,24733,20,420,306,539,331,119,25,surfboard
19955,1,person,2,0,24734,48,588,169,794,302,206,133,person
19956,2,surfboard,3,0,24734,19,569,197,621,281,52,84,surfboard
19957,1,surfboard,2,0,24735,17,1002,626,1291,790,289,164,surfboard
19958,2,person,3,0,24735,67,999,424,1258,738,259,314,person
19959,9,person,10,1,309,15,512,173,520,184,8,11,person
19960,6,person,7,1,310,44,1,1,554,315,553,314,person
19961,10,person,11,0,311,69,517,715,730,1219,213,504,person
19962,21,truck,22,0,311,49,495,572,890,622,395,50,truck
19963,9,person,10,1,19957,99,529,128,1273,1465,744,1337,person
19964,2,person,3,0,24739,69,619,106,776,564,157,458,person
19965,3,person,4,0,24739,65,357,147,685,504,328,357,person
19966,4,person,5,1,24748,79,406,380,658,797,252,417,person
19967,4,car,4,1,2042,16,1416,376,2085,538,669,162,car
19968,6,car,6,0,2042,21,1073,349,1316,556,243,207,car
19969,7,car,7,0,2042,18,633,340,876,550,243,210,car
19970,8,car,8,0,2042,21,0,340,527,653,527,313,car
19971,35,door,35,0,2042,16,51,364,186,585,135,221,door
19972,6,car,7,1,2043,28,253,247,385,297,132,50,car
19973,10,chair,11,1,2043,19,316,284,352,343,36,59,chair
19974,11,car,12,0,2043,30,146,257,272,334,126,77,car
19975,12,person,13,1,2043,15,224,242,256,275,32,33,person
19976,14,car,15,1,2043,27,52,238,123,307,71,69,car
19977,15,chair,16,1,2043,19,346,297,398,346,52,49,chair
19978,18,car,19,1,2043,16,0,251,81,346,81,95,car
19979,12,person,13,1,2044,16,255,160,285,214,30,54,person
19980,4,table,5,0,2045,30,208,171,404,202,196,31,dining table
19981,5,chair,6,0,2045,19,191,185,269,257,78,72,chair
19982,6,chair,7,0,2045,15,246,196,314,274,68,78,chair
19983,7,chair,8,0,2045,16,325,198,395,276,70,78,chair
19984,6,car,7,1,2046,15,284,101,346,130,62,29,car
19985,10,car,11,1,2046,16,185,99,257,209,72,110,car
19986,11,car,12,1,2046,24,123,97,252,244,129,147,car
19987,12,car,13,1,2046,42,0,105,243,388,243,283,car
19988,16,car,17,1,2046,30,316,131,599,251,283,120,car
19989,17,car,18,1,2046,41,286,155,599,445,313,290,car
19990,1,car,2,0,2047,82,921,326,2137,1224,1216,898,car
19991,2,car,3,1,2047,58,320,301,1344,880,1024,579,car
19992,3,car,4,1,2047,54,31,281,784,684,753,403,car
19993,4,car,5,1,2047,30,1,220,302,440,301,220,car
19994,6,window,7,1,2048,33,2007,1,2199,548,192,547,window
19995,8,window,9,1,2048,28,1420,0,1819,499,399,499,window
19996,11,table,12,1,2048,22,2063,397,2199,727,136,330,dining table
19997,12,chair,13,0,2048,68,1936,348,2161,658,225,310,chair
19998,14,car,15,0,2048,86,251,193,1775,1187,1524,994,car
19999,15,car,16,1,2048,42,1,197,820,757,819,560,car
20000,20,window,21,0,2048,21,536,240,1369,468,833,228,window
20001,3,desk,4,1,2049,18,1152,518,1775,778,623,260,desk
20002,4,desk,5,0,2049,20,678,625,940,813,262,188,desk
20003,7,person,8,1,2049,30,766,502,925,635,159,133,person
20004,16,person,17,1,2049,28,1285,428,1401,635,116,207,person
20005,22,car,23,1,2049,50,1462,355,2198,1073,736,718,car
20006,25,door,26,1,2049,19,3,350,381,938,378,588,door
20007,26,car,27,1,2049,35,0,761,615,1649,615,888,car
20008,23,car,24,0,2050,56,0,342,576,687,576,345,car
20009,24,car,25,1,2050,26,290,461,1269,924,979,463,car
20010,3,window,4,0,2051,27,100,0,299,72,199,72,window
20011,4,car,5,1,2051,25,124,44,191,83,67,39,car
20012,5,car,6,1,2051,20,158,50,239,96,81,46,car
20013,6,car,7,1,2051,23,191,61,299,111,108,50,car
20014,7,car,8,1,2051,31,147,105,299,211,152,106,car
20015,8,car,9,1,2051,30,7,55,122,122,115,67,car
20016,9,car,10,0,2051,31,26,85,192,159,166,74,car
20017,5,motorbike,6,0,2052,102,287,278,1487,1020,1200,742,motorcycle
20018,6,mirror,7,0,2052,21,4,2,577,724,573,722,mirror
20019,2,table,3,1,2053,17,864,146,1390,396,526,250,dining table
20020,9,person,10,1,2053,29,1969,0,2099,196,130,196,person
20021,10,car,11,0,2053,83,190,224,2079,1541,1889,1317,car
20022,14,mirror,15,0,2053,19,343,536,577,648,234,112,mirror
20023,10,car,11,1,2054,30,1055,508,1279,903,224,395,car
20024,11,car,12,1,2054,31,564,399,903,535,339,136,car
20025,12,car,13,1,2054,24,319,404,558,485,239,81,car
20026,13,car,14,1,2054,75,39,437,972,688,933,251,car
20027,14,car,15,1,2054,46,2,511,865,958,863,447,car
20028,42,door,43,0,2054,31,364,686,626,935,262,249,door
20029,6,car,7,1,2055,16,1740,594,1933,875,193,281,car
20030,7,car,8,0,2055,61,372,491,1469,1278,1097,787,car
20031,9,person,10,1,2055,37,673,421,880,662,207,241,person
20032,31,mirror,32,0,2055,16,1371,582,1439,653,68,71,mirror
20033,7,car,8,1,2056,29,310,421,773,584,463,163,car
20034,8,car,9,1,2056,37,689,409,1120,671,431,262,car
20035,9,car,10,1,2056,46,2,485,761,874,759,389,car
20036,10,car,11,1,2056,19,0,681,535,959,535,278,car
20037,9,car,10,1,2057,20,233,548,354,638,121,90,car
20038,34,car,35,1,2057,26,220,571,467,701,247,130,car
20039,35,car,36,1,2057,42,233,574,624,768,391,194,car
20040,36,car,37,0,2057,52,396,571,988,929,592,358,car
20041,37,car,38,1,2057,25,978,600,1278,959,300,359,car
20042,50,door,51,0,2057,18,418,591,537,743,119,152,door
20043,70,door,70,0,2057,21,810,588,909,819,99,231,door
20044,71,window,71,0,2057,21,820,601,876,683,56,82,window
20045,6,car,7,1,2058,31,744,199,1202,395,458,196,car
20046,7,car,8,1,2058,15,1260,170,1502,282,242,112,car
20047,8,car,9,1,2058,59,486,113,887,412,401,299,car
20048,9,car,10,1,2058,34,282,124,615,308,333,184,car
20049,10,car,11,1,2058,41,0,226,693,563,693,337,car
20050,11,car,12,1,2058,40,681,276,1503,575,822,299,car
20051,12,car,13,1,2058,22,406,505,1502,974,1096,469,car
20052,13,car,14,1,2058,20,2,643,453,971,451,328,car
20053,8,car,9,0,2059,45,383,485,1098,777,715,292,car
20054,4,bus,5,1,2060,21,0,71,58,133,58,62,bus
20055,5,bus,6,1,2060,15,46,76,94,110,48,34,bus
20056,6,bus,7,1,2060,28,88,60,176,139,88,79,bus
20057,7,bus,8,1,2060,19,162,57,231,147,69,90,bus
20058,8,bus,9,1,2060,62,197,0,403,197,206,197,bus
20059,10,umbrella,11,0,2060,15,61,85,88,117,27,32,umbrella
20060,3,car,4,0,2061,67,67,264,968,614,901,350,car
20061,7,door,8,0,2061,28,310,308,617,532,307,224,door
20062,8,mirror,9,0,2061,16,359,362,439,395,80,33,mirror
20063,9,window,10,0,2061,15,407,320,606,396,199,76,window
20064,8,car,9,1,2062,17,946,688,1279,959,333,271,car
20065,9,car,10,1,2062,40,2,486,644,908,642,422,car
20066,29,door,30,0,2062,18,416,502,535,782,119,280,door
20067,33,door,34,0,2062,17,491,499,608,738,117,239,door
20068,6,car,7,0,22731,70,17,76,623,422,606,346,car
20069,3,car,4,0,22732,59,178,268,851,603,673,335,car
20070,2,car,3,0,22733,66,23,268,972,636,949,368,car
20071,4,car,5,1,22734,24,35,149,251,272,216,123,car
20072,5,car,6,0,22734,73,52,151,771,537,719,386,car
20073,6,car,7,1,22734,24,604,145,800,344,196,199,car
20074,8,person,9,1,22734,21,488,159,560,233,72,74,person
20075,0,car,1,0,22735,61,75,31,958,658,883,627,car
20076,3,car,4,1,22735,55,735,15,950,166,215,151,car
20077,4,person,5,1,22735,15,134,0,217,64,83,64,person
20078,7,car,8,1,22735,28,395,1,547,68,152,67,car
20079,9,person,10,0,22735,22,537,2,589,101,52,99,person
20080,10,person,11,1,22735,21,594,20,627,123,33,103,person
20081,11,person,12,1,22735,22,611,2,700,163,89,161,person
20082,12,person,13,1,22735,19,688,1,718,166,30,165,person
20083,13,person,14,1,22735,30,698,2,743,173,45,171,person
20084,14,person,15,1,22735,37,708,1,794,191,86,190,person
20085,15,person,16,1,22735,31,772,9,818,193,46,184,person
20086,16,person,17,1,22735,29,783,2,877,201,94,199,person
20087,18,person,19,1,22735,27,953,39,1011,169,58,130,person
20088,19,person,20,1,22735,28,978,39,1023,268,45,229,person
20089,0,car,1,0,22736,70,23,149,613,425,590,276,car
20090,1,car,2,0,22737,74,65,140,1539,896,1474,756,car
20091,5,person,6,1,22738,19,108,139,152,189,44,50,person
20092,6,person,7,1,22738,33,31,118,82,337,51,219,person
20093,7,person,8,1,22738,23,563,161,633,216,70,55,person
20094,10,person,11,1,22738,22,940,147,1010,233,70,86,person
20095,11,person,12,1,22738,19,873,156,918,209,45,53,person
20096,12,person,13,1,22738,23,842,154,888,224,46,70,person
20097,14,person,15,1,22738,25,635,157,687,217,52,60,person
20098,15,person,16,1,22738,21,715,170,750,224,35,54,person
20099,16,person,17,1,22738,28,753,167,821,236,68,69,person
20100,17,person,18,1,22738,24,795,162,836,239,41,77,person
20101,19,car,20,1,22738,32,822,207,1024,463,202,256,car
20102,20,car,21,0,22738,100,39,126,982,665,943,539,car
20103,1,car,2,0,22739,97,1,1,699,491,698,490,car
20104,2,car,3,0,22739,32,529,125,843,247,314,122,car
20105,3,car,4,1,22739,28,648,143,900,319,252,176,car
20106,4,car,5,1,22739,17,809,117,899,174,90,57,car
20107,5,car,6,1,22739,16,725,110,864,149,139,39,car
20108,0,car,1,0,22740,48,180,361,2080,1121,1900,760,car
20109,2,car,3,0,22741,59,74,361,1568,931,1494,570,car
20110,5,car,6,0,22742,48,116,135,872,693,756,558,car
20111,0,car,1,0,22743,62,77,284,1545,911,1468,627,car
20112,3,car,4,0,22744,71,18,89,629,320,611,231,car
20113,1,car,2,0,22745,30,1,63,435,269,434,206,car
20114,2,car,3,1,22745,24,582,64,1024,211,442,147,car
20115,3,car,4,0,22745,47,0,149,1022,508,1022,359,car
20116,7,person,8,1,22745,31,695,27,779,94,84,67,person
20117,8,person,9,1,22745,18,976,10,1001,85,25,75,person
20118,9,person,10,1,22745,15,983,8,1023,88,40,80,person
20119,3,person,4,1,2140,35,2,0,69,255,67,255,person
20120,4,person,5,0,2140,22,25,14,45,73,20,59,person
20121,7,cake,8,0,2141,21,9,189,114,220,105,31,cake
20122,9,cake,10,0,2141,25,114,201,288,225,174,24,cake
20123,11,cake,12,0,2141,28,81,245,294,279,213,34,cake
20124,24,cake,25,0,2141,15,411,270,492,297,81,27,cake
20125,8,person,9,1,2142,26,198,222,274,336,76,114,person
20126,9,person,10,1,2142,33,146,256,253,386,107,130,person
20127,10,person,11,1,2142,67,173,223,349,485,176,262,person
20128,11,person,12,1,2142,16,315,258,357,297,42,39,person
20129,12,person,13,1,2142,20,419,247,482,352,63,105,person
20130,13,person,14,1,2142,29,465,248,526,484,61,236,person
20131,8,person,9,1,2143,73,356,12,699,464,343,452,person
20132,0,oven,1,0,2144,24,30,127,364,370,334,243,oven
20133,6,person,7,0,2144,57,353,60,499,420,146,360,person
20134,0,person,1,0,2145,81,0,21,99,224,99,203,person
20135,2,person,3,0,2146,45,116,75,217,388,101,313,person
20136,6,cake,7,0,2146,23,15,160,77,231,62,71,cake
20137,8,person,9,0,2147,71,71,57,216,371,145,314,person
20138,5,person,6,1,2148,56,0,22,140,223,140,201,person
20139,15,cake,16,0,2151,15,224,287,309,319,85,32,cake
20140,0,person,1,1,2152,54,203,199,498,375,295,176,person
20141,4,person,5,1,2153,23,135,46,169,84,34,38,person
20142,0,person,1,1,2154,56,168,37,339,182,171,145,person
20143,3,person,4,1,2156,47,435,23,499,240,64,217,person
20144,7,person,8,1,2156,15,309,33,340,74,31,41,person
20145,17,person,18,1,2157,24,105,25,161,116,56,91,person
20146,19,person,20,1,2157,45,76,5,159,336,83,331,person
20147,20,person,21,1,2157,44,16,1,130,335,114,334,person
20148,21,person,22,1,2157,22,2,44,99,336,97,292,person
20149,4,cake,5,0,2159,15,199,238,277,281,78,43,cake
20150,3,cake,4,1,2160,23,387,122,494,201,107,79,cake
20151,4,cake,5,1,2160,22,286,123,383,193,97,70,cake
20152,6,cake,7,1,2160,15,133,127,212,181,79,54,cake
20153,7,cake,8,1,2160,37,497,251,598,378,101,127,cake
20154,8,cake,9,0,2160,30,371,288,514,391,143,103,cake
20155,10,cake,11,1,2160,30,261,269,379,370,118,101,cake
20156,12,cake,13,1,2160,26,175,230,256,322,81,92,cake
20157,13,cake,14,0,2160,15,82,221,168,256,86,35,cake
20158,14,cake,15,1,2160,36,125,262,230,337,105,75,cake
20159,15,cake,16,1,2160,35,40,252,134,318,94,66,cake
20160,5,cake,6,0,2162,22,144,158,231,277,87,119,cake
20161,6,cake,7,0,2162,16,106,192,158,242,52,50,cake
20162,8,cake,9,0,2164,24,239,232,311,282,72,50,cake
20163,1,person,2,1,2165,32,153,115,233,190,80,75,person
20164,5,person,6,1,2165,23,216,97,267,171,51,74,person
20165,6,person,7,1,2165,27,253,103,299,194,46,91,person
20166,7,person,8,1,2165,31,302,87,359,202,57,115,person
20167,16,person,17,1,2165,32,43,97,120,190,77,93,person
20168,17,cake,18,0,2166,17,34,121,59,160,25,39,cake
20169,3,table,4,0,2168,22,2,217,69,310,67,93,dining table
20170,22,chair,23,1,2168,15,52,320,166,479,114,159,chair
20171,0,cake,1,0,2169,20,145,161,240,214,95,53,cake
20172,9,person,10,1,2169,74,279,35,440,331,161,296,person
20173,10,person,11,0,2169,46,438,75,495,276,57,201,person
20174,14,person,15,1,2169,21,391,88,432,148,41,60,person
20175,15,person,16,1,2169,21,38,67,62,132,24,65,person
20176,16,person,17,1,2169,19,24,77,46,123,22,46,person
20177,21,person,22,1,2169,31,0,93,100,208,100,115,person
20178,26,person,27,0,2171,43,276,19,372,254,96,235,person
20179,28,person,29,1,2171,35,144,16,225,191,81,175,person
20180,10,person,11,1,2172,37,279,211,337,374,58,163,person
20181,16,person,17,0,2172,41,377,194,419,375,42,181,person
20182,6,plate,7,0,2173,24,239,179,377,268,138,89,plate
20183,11,person,12,0,2173,129,33,27,311,375,278,348,person
20184,12,person,13,1,2176,46,164,30,221,184,57,154,person
20185,13,person,14,1,2176,49,114,18,173,175,59,157,person
20186,14,person,15,0,2176,25,11,36,39,110,28,74,person
20187,20,cake,21,0,2177,15,300,222,363,251,63,29,cake
20188,2,person,3,1,2179,42,25,29,116,219,91,190,person
20189,3,person,4,1,2179,45,115,48,205,238,90,190,person
20190,7,chair,8,1,2179,32,209,138,249,238,40,100,chair
20191,11,person,12,1,2181,40,322,135,393,285,71,150,person
20192,15,person,16,1,2181,26,0,150,53,258,53,108,person
20193,16,person,17,1,2181,25,24,164,74,259,50,95,person
20194,18,person,19,1,2181,20,262,151,287,180,25,29,person
20195,19,person,20,0,2181,25,270,166,299,211,29,45,person
20196,25,person,26,1,2181,18,396,156,436,191,40,35,person
20197,26,person,27,1,2181,21,437,150,484,193,47,43,person
20198,35,person,36,1,2181,15,208,150,235,179,27,29,person
20199,39,person,40,1,2181,28,130,163,179,262,49,99,person
20200,40,person,41,1,2181,44,77,147,132,273,55,126,person
20201,44,person,45,0,2181,18,108,144,133,192,25,48,person
20202,49,cake,50,0,2182,20,40,169,116,197,76,28,cake
20203,5,person,6,1,2183,51,149,58,325,401,176,343,person
20204,7,person,8,1,2184,29,21,156,71,249,50,93,person
20205,8,person,9,1,2184,41,81,69,164,296,83,227,person
20206,9,person,10,1,2184,41,128,78,202,284,74,206,person
20207,10,person,11,1,2184,25,245,101,276,202,31,101,person
20208,11,person,12,1,2184,35,198,91,282,281,84,190,person
20209,12,person,13,1,2184,47,275,58,344,277,69,219,person
20210,13,person,14,1,2184,38,292,77,379,277,87,200,person
20211,14,person,15,1,2184,40,368,103,456,270,88,167,person
20212,14,person,15,1,2186,22,54,61,89,109,35,48,person
20213,22,person,23,1,2188,30,171,180,238,299,67,119,person
20214,0,person,1,1,2189,42,242,107,383,374,141,267,person
20215,1,person,2,1,2189,29,455,123,499,375,44,252,person
20216,7,cake,8,0,2191,21,520,242,646,337,126,95,cake
20217,9,cake,10,0,2191,16,472,178,568,250,96,72,cake
20218,15,cake,16,0,2191,15,273,299,336,371,63,72,cake
20219,16,cake,17,0,2191,22,201,306,269,378,68,72,cake
20220,18,cake,19,0,2191,16,240,118,287,153,47,35,cake
20221,19,cake,20,0,2191,16,206,150,257,195,51,45,cake
20222,22,cake,23,0,2191,15,133,323,198,377,65,54,cake
20223,23,cake,24,0,2191,19,54,337,129,403,75,66,cake
20224,24,cake,25,0,2191,15,79,110,125,154,46,44,cake
20225,0,cake,1,0,2193,23,368,235,466,316,98,81,cake
20226,4,cake,5,0,2193,16,6,207,113,269,107,62,cake
20227,6,cake,7,0,2193,49,64,147,238,243,174,96,cake
20228,18,person,19,1,2194,34,222,142,290,233,68,91,person
20229,0,cake,1,0,2195,58,17,99,163,278,146,179,cake
20230,6,person,7,1,2196,48,332,75,440,333,108,258,person
20231,10,person,11,1,2196,16,114,116,153,199,39,83,person
20232,15,person,16,1,2196,47,234,74,348,332,114,258,person
20233,17,person,18,1,2196,41,2,64,203,333,201,269,person
20234,4,person,5,1,2198,15,93,117,133,166,40,49,person
20235,7,person,8,1,2198,33,152,112,206,318,54,206,person
20236,8,person,9,0,2198,61,173,85,279,378,106,293,person
20237,9,person,10,1,2199,25,147,69,198,140,51,71,person
20238,7,person,8,1,2200,23,393,110,449,188,56,78,person
20239,8,person,9,1,2200,51,395,111,495,373,100,262,person
20240,2,plate,3,0,24825,30,638,261,1466,1034,828,773,plate
20241,3,knife,4,0,24825,15,697,257,1347,464,650,207,knife
20242,14,fork,15,1,24825,25,1363,853,1537,932,174,79,fork
20243,3,bowl,4,0,24826,28,39,94,1165,1060,1126,966,bowl
20244,2,bowl,3,0,24827,23,830,638,1431,1224,601,586,bowl
20245,16,knife,17,1,24827,32,865,430,1554,592,689,162,knife
20246,2,plate,3,0,24828,41,97,269,687,676,590,407,plate
20247,3,plate,4,1,24828,17,852,269,999,533,147,264,plate
20248,4,plate,5,1,24828,26,803,286,999,631,196,345,plate
20249,5,plate,6,0,24828,19,793,378,997,658,204,280,plate
20250,6,bowl,7,1,24828,15,929,257,999,477,70,220,bowl
20251,9,plate,10,0,24828,22,635,52,944,229,309,177,plate
20252,10,spoon,11,1,24828,16,697,112,999,226,302,114,spoon
20253,5,person,6,0,2303,29,183,99,231,236,48,137,person
20254,6,person,7,0,2303,22,298,87,332,193,34,106,person
20255,7,person,8,0,2303,26,341,88,366,183,25,95,person
20256,8,person,9,0,2303,25,439,85,474,204,35,119,person
20257,5,person,6,0,2304,30,150,273,198,430,48,157,person
20258,8,person,9,0,2304,40,794,300,912,556,118,256,person
20259,10,person,11,1,2304,25,610,305,680,496,70,191,person
20260,12,person,13,0,2304,29,513,304,593,461,80,157,person
20261,14,person,15,0,2304,24,387,298,445,421,58,123,person
20262,13,chair,14,0,2306,25,77,250,144,334,67,84,chair
20263,3,window,4,0,2309,20,484,301,1859,1168,1375,867,window
20264,8,person,9,0,2310,31,373,250,411,374,38,124,person
20265,9,person,10,0,2310,31,410,253,450,376,40,123,person
20266,13,chair,14,1,2310,20,81,315,158,463,77,148,chair
20267,15,chair,16,1,2310,19,591,326,639,405,48,79,chair
20268,39,window,40,0,2310,18,521,247,580,285,59,38,window
20269,12,person,13,1,2311,16,195,177,224,215,29,38,person
20270,24,chair,25,0,2312,20,381,574,467,692,86,118,chair
20271,0,door,1,0,2326,29,120,78,367,300,247,222,door
20272,0,person,1,0,2327,24,765,914,864,1185,99,271,person
20273,8,person,9,1,2327,17,547,603,587,988,40,385,person
20274,7,person,8,0,2330,36,346,80,390,228,44,148,person
20275,8,clock,9,0,22766,16,571,516,680,646,109,130,clock
20276,12,chair,13,0,22766,31,0,503,86,746,86,243,chair
20277,3,person,4,1,2334,35,372,41,497,236,125,195,person
20278,4,person,5,1,2334,24,509,48,567,334,58,286,person
20279,5,table,6,1,2334,15,63,300,566,425,503,125,dining table
20280,6,person,7,1,2334,42,380,162,483,343,103,181,person
20281,8,person,9,1,2334,31,190,183,327,315,137,132,person
20282,9,person,10,1,2334,36,24,174,203,423,179,249,person
20283,10,person,11,1,2334,28,218,111,293,223,75,112,person
20284,11,person,12,1,2334,23,187,92,241,176,54,84,person
20285,12,person,13,1,2334,26,139,120,231,212,92,92,person
20286,13,person,14,1,2334,19,118,93,168,163,50,70,person
20287,14,person,15,1,2334,21,4,113,89,240,85,127,person
20288,15,person,16,1,2334,17,143,78,179,152,36,74,person
20289,16,person,17,1,2334,17,65,79,91,120,26,41,person
20290,18,person,19,1,2334,15,18,98,64,160,46,62,person
20291,33,person,34,1,2334,28,70,78,134,230,64,152,person
20292,77,bowl,78,0,2334,15,300,332,327,357,27,25,bowl
20293,85,bowl,86,0,2334,18,467,326,488,360,21,34,bowl
20294,93,bowl,94,0,2334,17,101,339,130,378,29,39,bowl
20295,3,table,4,1,2335,18,3,98,618,318,615,220,dining table
20296,4,person,5,1,2335,28,43,138,223,339,180,201,person
20297,5,person,6,1,2335,20,202,128,308,277,106,149,person
20298,6,person,7,1,2335,22,306,110,430,257,124,147,person
20299,7,person,8,1,2335,43,240,171,492,526,252,355,person
20300,8,person,9,1,2335,32,461,137,608,517,147,380,person
20301,9,person,10,1,2335,26,565,141,685,398,120,257,person
20302,12,chair,13,1,2335,23,553,259,687,508,134,249,chair
20303,13,chair,14,1,2335,15,658,240,753,459,95,219,chair
20304,14,chair,15,1,2335,16,710,216,795,396,85,180,chair
20305,33,person,31,0,2335,18,325,12,403,110,78,98,person
20306,34,person,32,1,2335,17,250,17,297,127,47,110,person
20307,36,person,34,1,2335,21,108,7,198,149,90,142,person
20308,40,person,37,1,2335,17,583,92,649,174,66,82,person
20309,41,person,38,1,2335,16,641,83,688,147,47,64,person
20310,62,plate,59,0,2335,19,314,292,352,307,38,15,plate
20311,72,plate,69,0,2335,20,179,335,223,351,44,16,plate
20312,77,plate,74,0,2335,18,37,366,80,389,43,23,plate
20313,82,plate,79,0,2335,16,442,257,474,269,32,12,plate
20314,5,window,6,0,2336,15,620,97,860,210,240,113,window
20315,30,chair,31,1,2336,18,60,387,238,640,178,253,chair
20316,31,chair,32,1,2336,19,169,335,308,546,139,211,chair
20317,32,chair,33,1,2336,16,308,348,427,446,119,98,chair
20318,34,chair,35,1,2336,15,789,345,910,457,121,112,chair
20319,35,table,36,1,2336,19,692,270,934,367,242,97,dining table
20320,37,chair,38,1,2336,19,657,288,777,418,120,130,chair
20321,38,chair,39,1,2336,18,906,285,996,473,90,188,chair
20322,39,table,40,1,2336,28,93,312,409,478,316,166,dining table
20323,52,chair,53,1,2336,16,363,225,407,303,44,78,chair
20324,61,chair,62,1,2336,16,606,251,656,333,50,82,chair
20325,67,chair,68,1,2336,15,472,244,523,345,51,101,chair
20326,84,bowl,85,0,2336,15,767,398,802,448,35,50,bowl
20327,92,bowl,93,0,2336,17,693,478,742,542,49,64,bowl
20328,96,bowl,97,0,2336,19,381,418,420,472,39,54,bowl
20329,99,knife,100,0,2336,15,283,540,382,559,99,19,knife
20330,101,bowl,102,0,2336,16,403,455,445,511,42,56,bowl
20331,105,bowl,106,0,2336,16,826,425,866,483,40,58,bowl
20332,108,fork,109,0,2336,19,768,565,845,619,77,54,fork
20333,2,tables,3,0,2337,20,2,242,798,352,796,110,dining table
20334,3,chair,4,1,2337,16,104,310,136,367,32,57,chair
20335,4,person,5,1,2337,15,230,251,258,326,28,75,person
20336,6,chair,7,0,2337,17,206,355,254,439,48,84,chair
20337,8,chair,9,0,2337,19,324,415,400,527,76,112,chair
20338,9,chair,10,1,2337,18,396,405,458,526,62,121,chair
20339,10,chair,11,1,2337,15,452,399,516,515,64,116,chair
20340,11,chair,12,1,2337,16,512,390,582,501,70,111,chair
20341,7,table,8,0,2338,22,11,137,84,157,73,20,dining table
20342,8,chair,9,0,2338,20,2,139,27,176,25,37,chair
20343,9,chair,10,0,2338,15,30,144,52,178,22,34,chair
20344,10,chair,11,0,2338,19,62,140,83,172,21,32,chair
20345,12,table,13,0,2338,23,105,145,198,178,93,33,dining table
20346,13,chair,14,0,2338,17,99,154,133,202,34,48,chair
20347,16,chair,17,0,2338,20,176,151,208,203,32,52,chair
20348,17,table,18,0,2338,21,179,134,239,148,60,14,dining table
20349,18,chair,19,0,2338,15,215,137,232,162,17,25,chair
20350,20,chair,21,1,2338,16,233,131,248,162,15,31,chair
20351,25,table,26,1,2338,15,104,129,146,142,42,13,dining table
20352,5,person,6,1,2339,47,338,156,499,312,161,156,person
20353,6,person,7,1,2339,42,222,143,369,312,147,169,person
20354,7,person,8,1,2339,43,83,166,241,386,158,220,person
20355,8,person,9,1,2339,33,2,196,139,424,137,228,person
20356,46,bowl,47,0,2339,17,255,312,278,343,23,31,bowl
20357,50,bowl,51,0,2339,16,488,305,509,334,21,29,bowl
20358,54,bowl,55,0,2339,16,517,322,539,350,22,28,bowl
20359,63,bowl,64,0,2339,17,194,358,217,386,23,28,bowl
20360,77,bowl,78,0,2339,17,434,303,451,328,17,25,bowl
20361,2,person,3,1,2340,26,2,66,88,237,86,171,person
20362,3,person,4,1,2340,32,121,69,244,204,123,135,person
20363,4,person,5,1,2340,33,267,98,405,225,138,127,person
20364,7,bowl,8,0,2340,15,58,275,149,330,91,55,bowl
20365,53,bowl,54,0,2340,15,69,204,89,227,20,23,bowl
20366,7,person,8,1,2341,33,447,146,508,262,61,116,person
20367,8,person,9,1,2341,34,522,140,610,261,88,121,person
20368,10,person,11,1,2341,18,598,193,638,257,40,64,person
20369,11,person,12,1,2341,16,501,202,544,272,43,70,person
20370,12,table,13,1,2341,16,476,264,638,340,162,76,dining table
20371,13,person,14,1,2341,39,486,216,601,411,115,195,person
20372,14,person,15,1,2341,23,421,214,488,336,67,122,person
20373,18,person,19,1,2341,15,351,194,387,250,36,56,person
20374,19,table,20,1,2341,19,249,239,387,300,138,61,dining table
20375,20,person,21,1,2341,17,285,194,330,238,45,44,person
20376,21,person,22,1,2341,20,311,201,370,263,59,62,person
20377,22,person,23,1,2341,19,241,193,282,249,41,56,person
20378,23,person,24,1,2341,24,207,200,254,297,47,97,person
20379,25,table,26,1,2341,33,121,314,386,478,265,164,dining table
20380,28,person,29,1,2341,30,362,227,464,404,102,177,person
20381,29,chair,30,1,2341,17,383,314,485,423,102,109,chair
20382,30,person,31,1,2341,25,134,209,230,318,96,109,person
20383,31,person,32,1,2341,24,8,226,67,366,59,140,person
20384,32,person,33,1,2341,47,6,226,176,478,170,252,person
20385,36,chair,37,0,2341,24,500,299,592,437,92,138,chair
20386,44,person,42,1,2341,18,103,200,155,286,52,86,person
20387,49,person,47,1,2341,16,271,182,291,223,20,41,person
20388,50,person,48,1,2341,17,6,203,44,261,38,58,person
20389,75,plate,71,0,2341,16,289,372,326,384,37,12,plate
20390,0,table,1,1,2342,15,0,111,436,247,436,136,dining table
20391,1,person,2,1,2342,18,0,19,49,167,49,148,person
20392,2,person,3,1,2342,30,42,14,146,131,104,117,person
20393,3,person,4,1,2342,22,171,13,251,115,80,102,person
20394,4,person,5,1,2342,25,235,7,336,122,101,115,person
20395,5,person,6,1,2342,26,323,27,444,212,121,185,person
20396,6,person,7,1,2342,39,413,71,494,246,81,175,person
20397,7,person,8,1,2342,19,449,122,494,246,45,124,person
20398,17,person,16,1,2342,24,150,9,203,111,53,102,person
20399,18,person,17,1,2342,24,111,3,153,112,42,109,person
20400,57,bowl,56,0,2342,15,30,147,50,166,20,19,bowl
20401,63,bowl,62,0,2342,16,348,149,370,176,22,27,bowl
20402,67,bowl,66,0,2342,17,301,171,329,206,28,35,bowl
20403,73,bowl,72,0,2342,18,129,168,156,201,27,33,bowl
20404,77,bowl,76,0,2342,19,95,150,124,188,29,38,bowl
20405,83,bowl,82,0,2342,15,389,165,410,184,21,19,bowl
20406,85,bowl,84,0,2342,15,294,103,313,129,19,26,bowl
20407,89,bowl,88,0,2342,16,269,108,287,129,18,21,bowl
20408,94,bowl,93,0,2342,15,178,101,195,121,17,20,bowl
20409,99,bowl,98,0,2342,16,241,96,257,120,16,24,bowl
20410,1,table,2,0,22768,50,167,327,731,602,564,275,dining table
20411,3,person,4,1,22768,15,995,157,1023,227,28,70,person
20412,4,person,5,1,22768,27,916,121,950,206,34,85,person
20413,5,person,6,1,22768,15,891,129,931,174,40,45,person
20414,6,person,7,1,22768,34,927,143,1008,300,81,157,person
20415,8,person,9,1,22768,35,345,71,403,183,58,112,person
20416,9,person,10,1,22768,31,118,49,221,160,103,111,person
20417,10,person,11,1,22768,43,1,62,107,303,106,241,person
20418,11,person,12,1,22768,32,513,130,573,215,60,85,person
20419,12,person,13,1,22768,54,429,128,546,237,117,109,person
20420,13,person,14,1,22768,29,216,130,258,227,42,97,person
20421,14,person,15,1,22768,27,249,138,307,237,58,99,person
20422,15,person,16,1,22768,33,267,146,329,284,62,138,person
20423,16,person,17,1,22768,27,375,136,440,219,65,83,person
20424,17,person,18,1,22768,15,574,128,625,158,51,30,person
20425,18,person,19,1,22768,26,574,153,606,242,32,89,person
20426,19,person,20,1,22768,21,649,133,701,187,52,54,person
20427,20,person,21,1,22768,44,635,172,710,350,75,178,person
20428,21,person,22,1,22768,88,538,152,686,346,148,194,person
20429,22,person,23,1,22768,79,592,164,825,404,233,240,person
20430,23,person,24,1,22768,106,604,134,1008,683,404,549,person
20431,24,person,25,1,22768,67,422,133,561,336,139,203,person
20432,25,person,26,1,22768,46,282,151,418,345,136,194,person
20433,26,person,27,1,22768,43,184,139,286,345,102,206,person
20434,27,person,28,1,22768,52,165,184,241,393,76,209,person
20435,28,person,29,1,22768,99,1,146,189,431,188,285,person
20436,29,person,30,1,22768,133,19,188,406,683,387,495,person
20437,30,chair,31,1,22768,45,11,419,341,683,330,264,chair
20438,31,chair,32,1,22768,16,0,460,61,683,61,223,chair
20439,35,plate,36,0,22768,17,219,379,275,394,56,15,plate
20440,43,fork,44,0,22768,19,495,417,537,446,42,29,fork
20441,49,bottle,50,0,22768,18,504,257,534,349,30,92,bottle
20442,50,bottle,51,0,22768,17,543,262,577,350,34,88,bottle
20443,51,fork,52,0,22768,17,615,393,681,415,66,22,fork
20444,56,bottle,57,1,22768,19,279,280,317,351,38,71,bottle
20445,57,bottle,58,1,22768,15,412,193,431,247,19,54,bottle
20446,9,person,10,1,22769,34,1,257,86,506,85,249,person
20447,10,person,11,1,22769,30,52,255,132,440,80,185,person
20448,11,person,12,0,22769,34,111,255,180,447,69,192,person
20449,12,person,13,1,22769,76,309,322,516,766,207,444,person
20450,13,person,14,1,22769,79,419,278,591,767,172,489,person
20451,14,table,15,1,22769,16,508,332,603,396,95,64,dining table
20452,15,person,16,1,22769,29,580,301,654,440,74,139,person
20453,16,chair,17,1,22769,17,587,392,646,488,59,96,chair
20454,17,person,18,0,22769,44,630,297,715,458,85,161,person
20455,18,chair,19,1,22769,23,653,342,721,457,68,115,chair
20456,19,person,20,1,22769,19,641,281,677,372,36,91,person
20457,20,person,21,1,22769,25,382,298,432,415,50,117,person
20458,21,person,22,1,22769,20,415,291,445,364,30,73,person
20459,22,person,23,0,22769,43,166,249,211,426,45,177,person
20460,23,person,24,0,22769,37,207,238,275,417,68,179,person
20461,24,person,25,1,22769,27,257,285,319,398,62,113,person
20462,25,person,26,1,22769,21,273,278,314,373,41,95,person
20463,26,table,27,1,22769,17,302,298,389,354,87,56,dining table
20464,27,person,28,1,22769,21,575,284,616,343,41,59,person
20465,28,table,29,1,22769,23,944,350,1022,510,78,160,dining table
20466,29,person,30,0,22769,40,897,324,968,528,71,204,person
20467,30,person,31,1,22769,23,851,311,912,405,61,94,person
20468,31,chair,32,1,22769,18,854,369,910,516,56,147,chair
20469,35,chair,36,1,22769,27,775,300,819,389,44,89,chair
20470,36,person,37,1,22769,29,781,269,836,385,55,116,person
20471,37,person,38,1,22769,20,836,276,887,338,51,62,person
20472,39,person,40,1,22769,21,932,282,988,347,56,65,person
20473,41,person,42,1,22769,16,984,263,1006,310,22,47,person
20474,42,person,43,1,22769,18,953,251,987,292,34,41,person
20475,43,person,44,1,22769,22,827,266,857,316,30,50,person
20476,44,table,45,1,22769,18,893,299,953,334,60,35,dining table
20477,45,person,46,1,22769,19,818,249,853,300,35,51,person
20478,47,person,48,1,22769,18,753,250,786,320,33,70,person
20479,48,person,49,1,22769,21,701,278,733,343,32,65,person
20480,49,chair,50,1,22769,17,719,304,740,391,21,87,chair
20481,50,chair,51,1,22769,17,731,286,758,377,27,91,chair
20482,52,person,53,1,22769,25,511,221,543,303,32,82,person
20483,53,person,54,1,22769,17,412,256,445,304,33,48,person
20484,54,person,55,1,22769,17,482,252,509,284,27,32,person
20485,55,person,56,1,22769,17,374,256,402,303,28,47,person
20486,56,person,57,1,22769,24,308,228,338,300,30,72,person
20487,58,person,59,1,22769,16,402,221,429,265,27,44,person
20488,59,person,60,1,22769,16,470,225,489,278,19,53,person
20489,61,person,62,1,22769,21,339,228,375,293,36,65,person
20490,28,table,29,0,22770,41,2,330,372,459,370,129,dining table
20491,30,chair,31,0,22770,20,296,336,367,461,71,125,chair
20492,38,chair,39,1,22770,19,35,336,105,452,70,116,chair
20493,40,chair,41,0,22770,24,167,344,257,466,90,122,chair
20494,41,table,42,0,22770,42,442,314,600,397,158,83,dining table
20495,42,chair,43,0,22770,16,474,317,523,408,49,91,chair
20496,44,chair,45,1,22770,21,573,305,629,397,56,92,chair
20497,45,chair,46,1,22770,19,415,308,455,390,40,82,chair
20498,49,table,50,0,22770,22,218,308,336,339,118,31,dining table
20499,58,chair,59,1,22770,19,630,293,668,359,38,66,chair
20500,59,chair,60,1,22770,15,663,289,680,336,17,47,chair
20501,61,table,62,0,22770,19,380,296,408,349,28,53,dining table
20502,63,chair,64,1,22770,17,355,294,386,351,31,57,chair
20503,7,chair,8,0,22771,50,180,400,384,655,204,255,chair
20504,8,person,9,0,22771,102,173,224,455,593,282,369,person
20505,9,chair,10,0,22771,40,453,428,658,654,205,226,chair
20506,10,person,11,1,22771,65,432,255,601,508,169,253,person
20507,11,chair,12,1,22771,35,631,392,781,596,150,204,chair
20508,12,person,13,1,22771,59,599,254,779,475,180,221,person
20509,13,person,14,1,22771,43,638,232,721,406,83,174,person
20510,14,person,15,1,22771,26,399,205,479,314,80,109,person
20511,16,person,17,1,22771,32,217,207,293,325,76,118,person
20512,17,person,18,1,22771,70,62,216,264,441,202,225,person
20513,18,chair,19,1,22771,37,48,364,206,566,158,202,chair
20514,20,person,21,1,22771,23,360,181,409,281,49,100,person
20515,21,person,22,1,22771,16,400,173,427,255,27,82,person
20516,22,person,23,1,22771,19,344,172,381,259,37,87,person
20517,23,person,24,1,22771,20,280,164,325,225,45,61,person
20518,28,chair,29,0,22771,23,904,379,1024,563,120,184,chair
20519,29,person,30,1,22771,25,955,263,1024,414,69,151,person
20520,30,person,31,1,22771,35,810,238,941,441,131,203,person
20521,31,chair,32,1,22771,24,800,339,916,485,116,146,chair
20522,32,person,33,1,22771,33,765,218,872,348,107,130,person
20523,33,person,34,1,22771,18,842,210,883,287,41,77,person
20524,35,person,36,1,22771,21,527,206,585,277,58,71,person
20525,36,person,37,1,22771,31,581,208,655,341,74,133,person
20526,37,person,38,1,22771,26,699,208,745,291,46,83,person
20527,39,person,40,1,22771,38,577,134,652,250,75,116,person
20528,40,person,41,1,22771,18,741,206,798,265,57,59,person
20529,41,person,42,1,22771,18,783,192,823,246,40,54,person
20530,42,person,43,1,22771,16,660,202,703,257,43,55,person
20531,44,table,45,1,22771,100,233,307,641,556,408,249,dining table
20532,45,table,46,1,22771,15,931,330,1014,382,83,52,dining table
20533,46,table,47,1,22771,33,760,264,830,416,70,152,dining table
20534,47,table,48,1,22771,16,639,257,675,315,36,58,dining table
20535,48,table,49,1,22771,15,268,224,303,272,35,48,dining table
20536,54,person,55,1,22771,27,939,256,1018,337,79,81,person
20537,55,person,56,1,22771,18,952,221,993,291,41,70,person
20538,56,person,57,1,22771,16,923,213,958,303,35,90,person
20539,58,person,59,1,22771,16,862,201,899,261,37,60,person
20540,2,chair,3,1,22772,28,0,517,204,679,204,162,chair
20541,3,chair,4,1,22772,35,504,525,724,728,220,203,chair
20542,4,chair,5,1,22772,18,586,487,722,639,136,152,chair
20543,5,vase,6,0,22772,23,289,446,383,814,94,368,vase
20544,8,plate,9,0,22772,19,153,967,278,1032,125,65,plate
20545,10,plate,11,0,22772,15,259,889,376,947,117,58,plate
20546,13,fork,14,0,22772,21,95,887,205,920,110,33,fork
20547,14,spoon,15,0,22772,17,120,872,206,917,86,45,spoon
20548,16,fork,17,1,22772,20,367,927,458,1015,91,88,fork
20549,17,fork,18,1,22772,22,402,935,493,1027,91,92,fork
20550,19,fork,20,1,22772,19,415,890,536,939,121,49,fork
20551,20,spoon,21,0,22772,17,415,902,509,925,94,23,spoon
20552,21,plate,22,0,22772,20,518,842,624,885,106,43,plate
20553,23,plate,24,0,22772,15,643,908,733,966,90,58,plate
20554,24,spoon,25,1,22772,16,597,920,683,984,86,64,spoon
20555,46,table,47,0,22772,56,115,478,590,676,475,198,dining table
20556,48,chair,49,1,22772,18,254,562,321,663,67,101,chair
20557,6,table,7,0,22773,57,823,553,1511,865,688,312,dining table
20558,7,chair,8,1,22773,15,1428,673,1520,851,92,178,chair
20559,8,chair,9,0,22773,34,1116,558,1334,900,218,342,chair
20560,10,chair,11,1,22773,18,1272,508,1367,584,95,76,chair
20561,12,chair,13,1,22773,32,976,548,1169,812,193,264,chair
20562,14,chair,15,1,22773,20,868,538,955,737,87,199,chair
20563,15,chair,16,1,22773,25,769,527,883,704,114,177,chair
20564,17,table,18,0,22773,38,615,539,781,671,166,132,dining table
20565,18,chair,19,1,22773,28,560,514,642,653,82,139,chair
20566,24,table,25,0,22773,36,451,514,608,610,157,96,dining table
20567,25,chair,26,1,22773,15,520,532,571,643,51,111,chair
20568,26,chair,27,1,22773,26,532,535,617,713,85,178,chair
20569,27,chair,28,1,22773,30,160,563,281,805,121,242,chair
20570,28,table,29,0,22773,40,227,588,544,834,317,246,dining table
20571,29,table,30,0,22773,24,332,513,404,563,72,50,dining table
20572,30,chair,31,1,22773,15,313,500,345,548,32,48,chair
20573,36,table,37,1,22773,27,163,535,285,585,122,50,dining table
20574,37,chair,38,1,22773,15,112,520,149,630,37,110,chair
20575,40,chair,41,0,22773,20,125,534,175,695,50,161,chair
20576,41,table,42,0,22773,33,349,683,1182,1012,833,329,dining table
20577,42,chair,43,1,22773,42,80,706,488,1013,408,307,chair
20578,43,chair,44,1,22773,26,112,768,533,1012,421,244,chair
20579,44,plate,45,0,22773,21,896,755,986,791,90,36,plate
20580,51,plate,52,0,22773,15,509,802,586,842,77,40,plate
20581,53,spoon,54,0,22773,16,669,816,740,861,71,45,spoon
20582,54,fork,55,0,22773,15,666,828,721,861,55,33,fork
20583,13,person,14,1,27,75,627,317,1562,1270,935,953,person
20584,24,bowl,25,0,27,15,1496,867,1642,1126,146,259,bowl
20585,27,plate,28,0,27,29,1432,1290,1704,1405,272,115,plate
20586,30,bowl,31,0,27,16,1140,859,1274,1124,134,265,bowl
20587,33,plate,34,0,27,25,1069,1293,1334,1397,265,104,plate
20588,4,person,5,1,28,57,1,3,400,600,399,597,person
20589,2,person,3,1,29,81,230,30,403,425,173,395,person
20590,4,table,5,0,2365,22,438,390,838,690,400,300,dining table
20591,6,person,7,1,2365,22,303,265,419,385,116,120,person
20592,7,person,8,1,2365,22,449,226,579,386,130,160,person
20593,8,person,9,1,2365,18,557,233,675,392,118,159,person
20594,9,person,10,1,2365,31,640,214,782,401,142,187,person
20595,10,person,11,0,2365,55,774,225,995,654,221,429,person
20596,11,person,12,0,2365,29,134,175,264,375,130,200,person
20597,12,person,13,1,2365,30,205,252,364,516,159,264,person
20598,13,person,14,1,2365,38,0,243,260,511,260,268,person
20599,28,chair,29,0,2365,29,490,445,685,713,195,268,chair
20600,38,clock,37,0,2366,39,513,42,556,87,43,45,clock
20601,50,glasses,49,0,2366,20,338,238,373,269,35,31,eye glasses
20602,10,person,11,0,2368,48,427,140,498,268,71,128,person
20603,17,person,18,1,2368,19,67,232,107,264,40,32,person
20604,19,person,20,1,2368,17,234,231,266,259,32,28,person
20605,21,table,22,0,2368,19,66,273,304,384,238,111,dining table
20606,24,chair,25,0,2368,21,373,257,412,310,39,53,chair
20607,26,chair,27,1,2368,29,12,280,106,381,94,101,chair
20608,4,person,5,1,2369,18,324,167,364,216,40,49,person
20609,5,person,6,1,2369,18,301,166,332,222,31,56,person
20610,13,person,14,1,2369,18,258,176,278,221,20,45,person
20611,16,person,17,1,2369,18,218,171,243,204,25,33,person
20612,17,person,18,1,2369,22,197,177,228,229,31,52,person
20613,1,person,2,1,2370,27,57,75,138,174,81,99,person
20614,25,glasses,26,0,2370,16,17,56,40,96,23,40,eye glasses
20615,38,bottle,39,0,2370,15,233,167,255,200,22,33,bottle
20616,6,chair,7,1,2371,17,104,153,154,223,50,70,chair
20617,4,bottle,5,0,2373,15,25,146,50,189,25,43,bottle
20618,21,bottle,22,0,2373,17,19,279,38,336,19,57,bottle
20619,16,person,17,1,2374,31,2,241,130,362,128,121,person
20620,17,person,18,1,2374,55,114,173,257,330,143,157,person
20621,26,person,27,1,2374,20,347,140,402,196,55,56,person
20622,27,person,28,1,2374,15,399,148,447,199,48,51,person
20623,28,person,29,1,2374,16,435,192,486,285,51,93,person
20624,29,person,30,1,2374,18,414,258,485,364,71,106,person
20625,5,person,6,0,2375,29,1260,585,1503,1002,243,417,person
20626,9,person,10,1,2375,25,1364,520,1535,813,171,293,person
20627,9,bottle,10,0,2376,19,189,119,224,205,35,86,bottle
20628,3,person,4,1,2377,36,227,77,305,193,78,116,person
20629,21,person,22,1,2378,44,1410,708,1797,1410,387,702,person
20630,25,table,26,0,2378,28,1795,1024,2018,1345,223,321,dining table
20631,0,person,1,1,2380,29,246,94,320,199,74,105,person
20632,1,person,2,1,2380,26,144,89,207,168,63,79,person
20633,2,person,3,1,2380,44,0,93,95,237,95,144,person
20634,3,person,4,1,2380,27,81,107,146,240,65,133,person
20635,4,person,5,1,2380,38,115,127,197,240,82,113,person
20636,6,chair,7,1,2380,15,33,196,102,240,69,44,chair
20637,2,bottle,3,0,2381,23,212,66,232,119,20,53,bottle
20638,0,person,1,1,2382,41,111,139,173,290,62,151,person
20639,1,person,2,1,2382,28,183,134,260,178,77,44,person
20640,4,table,5,0,2382,21,125,183,372,300,247,117,dining table
20641,5,chair,6,1,2382,18,100,185,119,284,19,99,chair
20642,6,chair,7,0,2382,28,120,183,180,300,60,117,chair
20643,7,chair,8,0,2382,28,172,178,238,300,66,122,chair
20644,8,chair,9,0,2382,35,224,174,327,300,103,126,chair
20645,3,person,4,0,2383,36,70,99,123,205,53,106,person
20646,5,person,6,0,2383,36,127,118,189,236,62,118,person
20647,7,person,8,0,2383,52,179,113,264,237,85,124,person
20648,17,person,18,1,2383,20,0,55,33,237,33,182,person
20649,5,chair,6,0,2384,29,179,152,223,241,44,89,chair
20650,6,chair,7,1,2384,24,76,176,144,256,68,80,chair
20651,7,chair,8,1,2384,16,2,184,49,256,47,72,chair
20652,8,chair,9,1,2384,23,221,150,253,220,32,70,chair
20653,0,bottle,1,0,2385,17,2,209,70,458,68,249,bottle
20654,1,bottle,2,0,2385,17,70,203,146,460,76,257,bottle
20655,3,bottle,4,0,2385,17,194,179,259,467,65,288,bottle
20656,5,bottle,6,0,2385,15,322,162,389,478,67,316,bottle
20657,6,bottle,7,0,2385,18,383,158,464,480,81,322,bottle
20658,7,bottle,8,0,2385,18,451,157,533,488,82,331,bottle
20659,8,bottle,9,0,2385,17,522,178,615,495,93,317,bottle
20660,10,bottle,11,0,2385,21,661,12,738,334,77,322,bottle
20661,11,bottle,12,1,2385,17,717,34,767,268,50,234,bottle
20662,13,bottle,14,1,2385,16,516,129,583,244,67,115,bottle
20663,14,bottle,15,1,2385,20,513,34,567,198,54,164,bottle
20664,21,bottle,22,1,2385,15,502,1,578,149,76,148,bottle
20665,32,bottle,33,1,2385,17,216,72,272,227,56,155,bottle
20666,0,chair,1,0,2387,27,251,135,317,265,66,130,chair
20667,1,chair,2,0,2387,24,175,142,244,283,69,141,chair
20668,2,chair,3,0,2387,27,100,148,169,292,69,144,chair
20669,4,person,5,0,2389,38,337,189,420,303,83,114,person
20670,5,person,6,1,2389,26,160,167,198,210,38,43,person
20671,6,person,7,1,2389,18,226,163,264,213,38,50,person
20672,7,chair,8,0,2389,25,364,246,403,318,39,72,chair
20673,8,person,9,1,2389,49,8,138,124,374,116,236,person
20674,18,chair,19,0,2389,25,416,248,473,329,57,81,chair
20675,6,person,7,1,2390,45,263,145,376,224,113,79,person
20676,8,person,9,1,2390,47,218,117,285,304,67,187,person
20677,14,person,15,1,2390,26,173,103,245,206,72,103,person
20678,16,person,17,1,2390,29,128,94,184,185,56,91,person
20679,18,person,19,1,2390,24,73,102,120,155,47,53,person
20680,19,person,20,1,2390,19,49,95,79,157,30,62,person
20681,20,person,21,1,2390,15,34,93,54,131,20,38,person
20682,15,person,16,1,2391,87,109,66,307,315,198,249,person
20683,18,person,19,1,2391,16,266,130,298,167,32,37,person
20684,3,chair,4,0,2393,22,10,272,91,414,81,142,chair
20685,4,chair,5,0,2393,26,65,278,155,446,90,168,chair
20686,5,chair,6,0,2393,24,133,283,223,428,90,145,chair
20687,6,chair,7,0,2393,30,207,285,303,481,96,196,chair
20688,7,chair,8,0,2393,29,291,296,388,488,97,192,chair
20689,8,chair,9,1,2393,18,126,405,242,491,116,86,chair
20690,6,chair,7,1,2394,16,315,201,358,297,43,96,chair
20691,19,chair,20,1,2394,18,35,195,60,294,25,99,chair
20692,29,chair,30,1,2394,20,120,170,139,206,19,36,chair
20693,3,table,4,0,2395,18,233,243,438,360,205,117,dining table
20694,13,person,14,1,2395,21,10,183,42,220,32,37,person
20695,14,person,15,1,2395,15,0,186,35,224,35,38,person
20696,15,person,16,1,2395,22,0,207,60,340,60,133,person
20697,17,person,18,1,2395,20,71,180,105,225,34,45,person
20698,18,person,19,0,2395,38,43,186,127,305,84,119,person
20699,19,chair,20,0,2395,31,84,234,131,308,47,74,chair
20700,0,person,1,1,2396,52,4,6,253,199,249,193,person
20701,5,person,6,1,2396,31,167,18,238,182,71,164,person
20702,6,person,7,1,2396,18,222,47,264,157,42,110,person
20703,3,chair,4,0,2397,27,16,180,79,250,63,70,chair
20704,8,chair,9,0,2397,35,92,145,139,232,47,87,chair
20705,9,chair,10,0,2397,35,60,143,103,226,43,83,chair
20706,13,chair,14,0,2397,16,291,143,316,182,25,39,chair
20707,16,table,17,0,2398,16,281,248,378,344,97,96,dining table
20708,17,chair,18,0,2398,17,250,255,299,331,49,76,chair
20709,20,chair,21,1,2398,23,375,294,491,375,116,81,chair
20710,22,chair,23,0,2398,39,93,258,162,371,69,113,chair
20711,25,chair,26,1,2398,27,27,260,102,375,75,115,chair
20712,31,chair,31,1,2398,21,403,253,423,286,20,33,chair
20713,32,chair,32,1,2398,19,373,258,406,285,33,27,chair
20714,24,chair,25,1,2400,16,440,193,529,435,89,242,chair
20715,5,person,6,0,2402,31,59,165,168,298,109,133,person
20716,9,chair,10,1,2402,23,271,232,309,299,38,67,chair
20717,3,person,4,1,2404,18,479,202,600,351,121,149,person
20718,16,person,16,1,2404,36,182,99,260,213,78,114,person
20719,17,person,17,1,2404,17,161,102,196,156,35,54,person
20720,18,person,18,1,2404,19,152,103,180,154,28,51,person
20721,28,person,27,0,2404,31,431,111,483,288,52,177,person
20722,7,person,8,1,2405,54,18,71,145,242,127,171,person
20723,18,person,19,1,2405,36,223,125,294,188,71,63,person
20724,2,person,3,1,2406,40,244,162,371,460,127,298,person
20725,4,person,5,1,2406,45,58,133,209,459,151,326,person
20726,6,person,7,1,2406,47,412,162,677,461,265,299,person
20727,7,chair,8,1,2406,18,458,341,691,461,233,120,chair
20728,9,chair,10,1,2406,16,2,353,47,461,45,108,chair
20729,3,person,4,1,2407,74,109,72,276,221,167,149,person
20730,5,pot,6,1,2407,17,241,137,278,190,37,53,potted plant
20731,8,plate,9,0,2409,15,141,30,210,93,69,63,plate
20732,4,person,5,1,2410,33,410,129,459,345,49,216,person
20733,1,person,2,1,2411,29,120,198,238,308,118,110,person
20734,2,person,3,1,2411,43,243,215,383,308,140,93,person
20735,6,person,7,1,2411,25,76,146,112,189,36,43,person
20736,7,person,8,1,2411,29,103,158,150,279,47,121,person
20737,8,chair,9,0,2411,18,79,211,130,287,51,76,chair
20738,9,person,10,1,2411,27,145,156,180,230,35,74,person
20739,11,person,12,1,2411,20,166,149,195,228,29,79,person
20740,12,person,13,1,2411,15,188,149,208,187,20,38,person
20741,13,person,14,1,2411,38,193,153,241,289,48,136,person
20742,14,person,15,1,2411,27,227,156,253,236,26,80,person
20743,15,chair,16,1,2411,20,237,235,277,293,40,58,chair
20744,16,person,17,1,2411,23,19,151,51,194,32,43,person
20745,24,person,25,1,2411,20,272,150,301,199,29,49,person
20746,26,person,27,1,2411,15,268,181,307,210,39,29,person
20747,27,person,28,1,2411,19,303,186,355,257,52,71,person
20748,28,person,29,1,2411,22,245,156,265,230,20,74,person
20749,34,person,35,1,2411,25,0,184,121,308,121,124,person
20750,15,clock,16,0,2413,20,184,27,206,63,22,36,clock
20751,1,chair,2,1,2414,17,107,152,163,198,56,46,chair
20752,5,chair,6,1,2415,15,1,145,61,196,60,51,chair
20753,6,glasses,7,0,2416,20,231,147,368,178,137,31,eye glasses
20754,9,bottle,10,0,2416,16,159,21,183,76,24,55,bottle
20755,11,person,12,1,2416,26,376,151,499,333,123,182,person
20756,12,person,13,1,2416,21,380,202,444,331,64,129,person
20757,13,person,14,1,2416,24,254,208,402,330,148,122,person
20758,14,person,15,1,2416,22,94,194,201,332,107,138,person
20759,25,glasses,26,0,2416,19,244,188,372,216,128,28,eye glasses
20760,0,mirror,1,1,2417,15,316,1,450,205,134,204,mirror
20761,1,person,2,1,2417,28,249,138,288,265,39,127,person
20762,2,person,3,1,2417,28,198,112,259,241,61,129,person
20763,3,person,4,1,2417,62,0,61,222,318,222,257,person
20764,6,bottle,7,0,2417,17,185,184,220,307,35,123,bottle
20765,8,bottle,9,1,2417,16,292,186,357,338,65,152,bottle
20766,18,bottle,19,0,2417,15,2,177,45,338,43,161,bottle
20767,5,chair,6,0,2418,22,2,156,33,245,31,89,chair
20768,6,chair,7,0,2418,22,42,154,90,237,48,83,chair
20769,7,chair,8,0,2418,20,80,158,130,248,50,90,chair
20770,8,chair,9,0,2418,25,125,163,177,256,52,93,chair
20771,9,chair,10,0,2418,29,181,170,235,256,54,86,chair
20772,5,person,6,0,2419,34,215,156,270,284,55,128,person
20773,6,person,7,1,2419,23,336,174,372,243,36,69,person
20774,12,person,13,1,2419,18,158,169,184,218,26,49,person
20775,13,person,14,1,2419,16,150,175,176,221,26,46,person
20776,14,person,15,1,2419,17,110,173,150,219,40,46,person
20777,15,person,16,1,2419,22,112,195,159,241,47,46,person
20778,16,person,17,1,2419,42,45,177,141,257,96,80,person
20779,17,person,18,1,2419,18,11,202,115,324,104,122,person
20780,28,glasses,29,1,2419,25,302,19,343,140,41,121,eye glasses
20781,32,table,33,0,22774,20,832,486,1023,635,191,149,dining table
20782,34,person,35,0,22774,55,707,393,836,671,129,278,person
20783,35,person,36,1,22774,16,875,575,1023,682,148,107,person
20784,36,person,37,1,22774,69,436,261,563,683,127,422,person
20785,38,person,39,1,22774,25,219,334,289,421,70,87,person
20786,9,person,10,0,2420,46,111,53,226,228,115,175,person
20787,10,person,11,0,2420,50,75,43,139,235,64,192,person
20788,6,mirror,7,0,2421,26,198,55,599,209,401,154,mirror
20789,8,person,9,0,2421,36,5,159,117,331,112,172,person
20790,9,person,10,1,2421,22,14,126,66,235,52,109,person
20791,11,person,12,0,2421,45,92,178,252,402,160,224,person
20792,13,person,14,0,2421,49,252,167,529,432,277,265,person
20793,14,person,15,1,2421,27,493,71,599,447,106,376,person
20794,7,chair,8,0,2422,29,1074,622,1291,985,217,363,chair
20795,9,person,10,0,2422,29,1244,427,1429,781,185,354,person
20796,2,person,3,1,2423,50,316,403,814,960,498,557,person
20797,3,person,4,1,2423,129,120,142,749,675,629,533,person
20798,4,mirror,5,0,2423,21,295,39,626,555,331,516,mirror
20799,17,pot,18,1,2423,15,112,521,157,617,45,96,potted plant
20800,4,person,5,1,2424,21,533,0,778,515,245,515,person
20801,6,person,7,1,2424,16,1048,3,1619,291,571,288,person
20802,13,person,14,1,2425,58,126,62,425,594,299,532,person
20803,14,person,15,1,2425,34,272,178,797,599,525,421,person
20804,5,person,6,1,2426,57,183,35,315,236,132,201,person
20805,6,person,7,1,2426,35,31,74,252,236,221,162,person
20806,7,mirror,8,0,2427,23,0,4,171,149,171,145,mirror
20807,13,chair,14,0,2428,23,153,429,249,561,96,132,chair
20808,15,chair,16,1,2428,15,51,477,193,598,142,121,chair
20809,4,person,5,1,2429,25,209,175,318,238,109,63,person
20810,7,person,8,1,2429,31,124,82,201,212,77,130,person
20811,11,person,12,0,3057,21,212,92,224,132,12,40,person
20812,12,person,13,0,3057,22,185,84,202,136,17,52,person
20813,11,person,12,1,3058,32,301,269,466,597,165,328,person
20814,12,person,13,1,3058,33,453,321,594,600,141,279,person
20815,14,bicycle,15,1,3058,35,503,453,585,598,82,145,bicycle
20816,15,person,16,1,3058,23,549,326,603,432,54,106,person
20817,18,person,19,0,3058,41,621,357,714,596,93,239,person
20818,19,person,20,0,3058,43,711,340,784,596,73,256,person
20819,5,person,6,0,3059,36,26,151,69,258,43,107,person
20820,6,person,7,0,3059,28,65,150,99,235,34,85,person
20821,10,table,11,0,3059,16,276,158,386,246,110,88,dining table
20822,11,person,12,1,3059,21,207,131,235,180,28,49,person
20823,12,person,13,1,3059,19,174,141,202,179,28,38,person
20824,13,person,14,1,3059,20,147,156,176,207,29,51,person
20825,14,person,15,1,3059,21,262,121,280,159,18,38,person
20826,15,table,16,0,3059,20,71,137,127,174,56,37,dining table
20827,18,person,19,0,3059,40,293,141,328,236,35,95,person
20828,19,person,20,1,3059,23,318,130,348,181,30,51,person
20829,21,person,22,0,3059,26,137,104,160,147,23,43,person
20830,22,person,23,0,3059,25,99,101,117,141,18,40,person
20831,23,person,24,0,3059,23,247,101,261,134,14,33,person
20832,24,chair,25,0,3059,19,351,144,371,164,20,20,chair
20833,25,person,26,0,3059,17,220,98,229,127,9,29,person
20834,26,person,27,1,3059,18,72,102,90,133,18,31,person
20835,7,person,8,1,3060,32,266,182,341,400,75,218,person
20836,8,person,9,1,3060,34,216,175,274,382,58,207,person
20837,9,person,10,1,3060,37,158,147,237,319,79,172,person
20838,10,person,11,1,3060,30,41,157,89,380,48,223,person
20839,14,chair,15,1,3060,17,81,273,175,377,94,104,chair
20840,5,person,6,0,3061,23,25,44,52,108,27,64,person
20841,7,person,8,1,3061,15,62,27,90,66,28,39,person
20842,11,person,12,1,3061,19,118,62,153,109,35,47,person
20843,13,person,14,0,3061,23,113,106,140,197,27,91,person
20844,14,person,15,1,3061,16,160,88,194,128,34,40,person
20845,15,person,16,1,3061,16,181,124,208,178,27,54,person
20846,16,person,17,1,3061,18,158,148,188,194,30,46,person
20847,17,person,18,0,3061,19,153,183,190,267,37,84,person
20848,19,motorbike,20,1,3061,32,216,211,320,264,104,53,motorcycle
20849,20,person,21,1,3061,22,212,165,271,221,59,56,person
20850,21,motorbike,22,1,3061,23,238,223,326,290,88,67,motorcycle
20851,22,motorbike,23,1,3061,26,250,271,302,351,52,80,motorcycle
20852,23,person,24,0,3061,23,304,253,332,347,28,94,person
20853,25,person,26,1,3061,22,181,213,214,263,33,50,person
20854,26,person,27,0,3061,27,181,237,220,338,39,101,person
20855,27,person,28,0,3061,27,213,271,257,358,44,87,person
20856,28,person,29,0,3061,25,28,104,55,174,27,70,person
20857,29,person,30,0,3061,18,2,118,34,203,32,85,person
20858,30,person,31,0,3061,24,47,141,83,222,36,81,person
20859,31,motorbike,32,1,3061,23,28,208,101,260,73,52,motorcycle
20860,32,person,33,0,3061,23,60,229,87,325,27,96,person
20861,33,person,34,0,3061,18,38,251,61,314,23,63,person
20862,34,person,35,0,3061,25,6,244,35,356,29,112,person
20863,36,person,37,0,3061,16,129,259,161,313,32,54,person
20864,37,person,38,1,3061,16,141,248,189,316,48,68,person
20865,38,person,39,1,3061,15,90,292,118,373,28,81,person
20866,39,person,40,1,3061,17,33,304,76,373,43,69,person
20867,40,motorbike,41,0,3061,23,330,279,386,374,56,95,motorcycle
20868,41,car,42,1,3061,19,368,157,497,280,129,123,car
20869,43,person,44,1,3061,16,431,255,469,313,38,58,person
20870,46,person,47,1,3061,18,275,25,309,73,34,48,person
20871,4,person,5,1,3062,38,74,26,118,177,44,151,person
20872,5,person,6,0,3062,42,0,31,41,157,41,126,person
20873,6,person,7,1,3062,26,203,36,231,96,28,60,person
20874,7,person,8,1,3062,25,165,34,186,92,21,58,person
20875,8,person,9,0,3062,24,248,41,264,66,16,25,person
20876,10,chair,11,0,3062,19,228,72,249,108,21,36,chair
20877,11,chair,12,1,3062,17,241,134,279,206,38,72,chair
20878,12,person,13,1,3062,18,56,49,74,69,18,20,person
20879,13,person,14,1,3062,18,21,35,42,71,21,36,person
20880,14,person,15,1,3062,20,66,34,82,67,16,33,person
20881,17,person,18,1,3062,17,157,33,167,71,10,38,person
20882,11,person,12,0,3063,18,183,495,207,574,24,79,person
20883,12,person,13,0,3063,34,109,564,196,746,87,182,person
20884,13,person,14,1,3063,16,0,577,75,756,75,179,person
20885,17,person,18,0,3063,28,363,493,419,632,56,139,person
20886,18,chair,19,0,3063,15,439,548,483,622,44,74,chair
20887,13,person,14,0,3064,21,202,209,219,254,17,45,person
20888,19,bottle,20,0,3065,25,204,662,266,813,62,151,bottle
20889,5,person,6,1,3066,39,855,495,1842,1647,987,1152,person
20890,0,person,1,0,3067,48,773,761,1072,1484,299,723,person
20891,19,bowl,16,0,3067,16,592,1080,767,1164,175,84,bowl
20892,12,chair,13,0,3158,17,124,98,147,130,23,32,chair
20893,20,chair,21,1,3158,20,158,150,244,226,86,76,chair
20894,4,hair dryer,5,0,3160,36,969,2,1307,377,338,375,hair drier
20895,5,mirror,6,0,3160,15,1689,492,1930,871,241,379,mirror
20896,9,hair dryer,10,0,3160,25,202,303,527,551,325,248,hair drier
20897,9,person,10,1,3161,51,55,113,133,268,78,155,person
20898,10,person,11,1,3161,33,102,185,257,269,155,84,person
20899,6,hair dryer,7,0,3162,15,2,1,131,231,129,230,hair drier
20900,10,chair,11,0,3162,20,56,284,197,376,141,92,chair
20901,7,person,8,1,3164,23,248,92,300,166,52,74,person
20902,8,person,9,1,3164,27,216,76,250,171,34,95,person
20903,9,person,10,1,3164,33,173,60,239,194,66,134,person
20904,10,chair,11,1,3164,20,151,135,207,215,56,80,chair
20905,11,person,12,0,3164,37,138,23,195,212,57,189,person
20906,12,person,13,1,3164,31,65,30,101,125,36,95,person
20907,13,person,14,1,3164,38,10,78,138,215,128,137,person
20908,14,chair,15,1,3164,15,8,146,57,213,49,67,chair
20909,13,hair dryer,14,0,3165,23,164,63,269,117,105,54,hair drier
20910,14,hair dryer,15,0,3165,22,52,55,152,117,100,62,hair drier
20911,7,person,8,1,3166,27,71,87,125,149,54,62,person
20912,8,person,9,0,3166,22,188,83,202,144,14,61,person
20913,9,person,10,0,3166,36,155,70,183,168,28,98,person
20914,7,sink,8,0,3167,42,138,319,265,515,127,196,sink
20915,11,chair,12,1,3167,17,344,428,449,519,105,91,chair
20916,26,hair dryer,27,0,3168,18,978,1080,1116,1165,138,85,hair drier
20917,27,person,28,1,3168,28,1358,691,1489,994,131,303,person
20918,33,chair,34,1,3168,16,2052,980,2146,1237,94,257,chair
20919,41,hair dryer,42,0,3168,16,1793,738,1895,888,102,150,hair drier
20920,2,sink,3,0,3174,21,294,185,435,261,141,76,sink
20921,3,sink,4,0,3174,20,166,157,282,221,116,64,sink
20922,5,chair,6,0,3176,16,33,147,127,254,94,107,chair
20923,6,hair dryer,7,0,3176,18,50,56,118,144,68,88,hair drier
20924,7,chair,8,0,3176,29,74,153,198,333,124,180,chair
20925,8,hair dryer,9,0,3176,20,119,46,190,150,71,104,hair drier
20926,9,hair dryer,10,0,3176,19,216,27,299,162,83,135,hair drier
20927,10,hair dryer,11,0,3176,21,388,3,502,132,114,129,hair drier
20928,11,chair,12,0,3176,47,144,162,308,379,164,217,chair
20929,12,person,13,0,3176,54,297,88,502,403,205,315,person
20930,13,chair,14,1,3176,24,407,225,507,403,100,178,chair
20931,1,chair,2,0,3177,34,3,97,73,197,70,100,chair
20932,3,sofa,4,1,3178,17,0,183,87,287,87,104,couch
20933,7,sink,8,1,3178,16,250,186,379,222,129,36,sink
20934,11,chair,12,1,3180,24,240,279,295,369,55,90,chair
20935,12,chair,13,0,3180,33,263,293,332,413,69,120,chair
20936,13,chair,14,0,3180,36,316,322,412,479,96,157,chair
20937,14,chair,15,1,3180,27,418,381,596,524,178,143,chair
20938,32,chair,33,1,3180,24,222,267,263,350,41,83,chair
20939,17,person,18,0,3183,21,360,128,394,180,34,52,person
20940,0,chair,1,0,3185,19,172,656,311,821,139,165,chair
20941,1,chair,2,0,3185,36,914,678,1093,983,179,305,chair
20942,3,chair,4,0,3185,20,865,598,947,745,82,147,chair
20943,39,chair,39,0,3185,16,595,581,635,645,40,64,chair
20944,60,chair,60,1,3185,24,737,593,772,698,35,105,chair
20945,13,sink,14,0,3186,16,185,114,256,157,71,43,sink
20946,14,sink,15,1,3186,20,161,118,235,150,74,32,sink
20947,9,sink,10,0,3187,17,191,160,225,215,34,55,sink
20948,12,chair,13,1,3190,20,56,377,248,499,192,122,chair
20949,13,chair,14,1,22870,24,1715,849,1824,1259,109,410,chair
20950,14,chair,15,1,22870,32,1752,864,2081,1322,329,458,chair
20951,23,sofa,24,1,22870,25,1977,828,2168,949,191,121,couch
20952,27,window,28,0,22870,20,1786,582,1862,718,76,136,window
20953,28,person,29,1,22870,31,1752,665,1852,846,100,181,person
20954,29,person,30,1,22870,35,1823,652,1905,916,82,264,person
20955,12,person,13,0,4240,19,53,147,65,183,12,36,person
20956,13,person,14,0,4240,17,87,145,98,182,11,37,person
20957,14,person,15,0,4240,21,112,149,123,185,11,36,person
20958,15,person,16,0,4240,20,128,144,139,178,11,34,person
20959,16,person,17,0,4240,21,139,146,149,180,10,34,person
20960,17,person,18,0,4240,24,149,147,160,181,11,34,person
20961,15,person,16,1,4241,17,30,113,53,154,23,41,person
20962,17,person,18,1,4241,29,46,112,83,155,37,43,person
20963,18,person,19,1,4241,28,71,93,88,155,17,62,person
20964,19,person,20,1,4241,16,90,110,107,137,17,27,person
20965,20,person,21,1,4241,20,84,122,128,160,44,38,person
20966,21,person,22,1,4241,18,100,131,138,174,38,43,person
20967,22,person,23,1,4241,21,123,132,162,199,39,67,person
20968,23,person,24,1,4241,27,157,126,203,169,46,43,person
20969,24,person,25,1,4241,15,194,112,214,131,20,19,person
20970,25,person,26,1,4241,17,195,128,224,159,29,31,person
20971,26,person,27,1,4241,17,165,113,182,140,17,27,person
20972,27,person,28,1,4241,16,150,112,169,136,19,24,person
20973,15,person,16,1,4242,31,715,303,880,511,165,208,person
20974,16,person,17,1,4242,23,1086,296,1233,509,147,213,person
20975,17,table,18,1,4242,15,113,501,1018,954,905,453,dining table
20976,18,person,19,1,4242,35,840,349,1086,628,246,279,person
20977,19,person,20,1,4242,23,628,325,776,537,148,212,person
20978,20,person,21,1,4242,25,613,372,756,577,143,205,person
20979,21,person,22,1,4242,28,449,360,659,615,210,255,person
20980,22,person,23,1,4242,39,284,394,532,724,248,330,person
20981,24,person,25,1,4242,51,0,355,364,954,364,599,person
20982,25,person,26,1,4242,50,784,391,1278,953,494,562,person
20983,35,person,36,1,4242,21,106,318,195,493,89,175,person
20984,20,person,21,1,4243,22,583,808,764,1021,181,213,person
20985,21,person,22,1,4243,20,495,700,629,818,134,118,person
20986,23,person,24,1,4243,28,70,708,168,947,98,239,person
20987,24,person,25,1,4243,18,145,691,216,819,71,128,person
20988,28,person,29,0,4243,18,334,633,383,754,49,121,person
20989,29,person,30,1,4243,20,472,633,505,746,33,113,person
20990,8,person,9,1,4244,34,306,607,632,1107,326,500,person
20991,23,person,24,1,4244,15,1736,815,1836,912,100,97,person
20992,24,person,25,1,4244,16,1568,808,1667,903,99,95,person
20993,32,chair,33,1,4244,17,104,1337,320,1646,216,309,chair
20994,33,chair,34,1,4244,19,241,1409,474,1641,233,232,chair
20995,36,chair,37,1,4244,38,1091,1259,1473,1645,382,386,chair
20996,37,chair,38,1,4244,33,1457,1270,1821,1639,364,369,chair
20997,38,chair,39,0,4244,33,1765,1169,2106,1641,341,472,chair
20998,45,chair,46,0,4244,24,100,952,234,1128,134,176,chair
20999,51,window,52,0,4244,17,186,363,374,468,188,105,window
21000,52,window,53,0,4244,16,722,399,871,495,149,96,window
21001,1,person,2,1,4246,34,0,0,298,1198,298,1198,person
21002,2,window,3,0,4246,46,248,5,1037,640,789,635,window
21003,3,window,4,0,4246,29,1270,0,1596,655,326,655,window
21004,7,table,8,1,4246,15,573,634,1505,1198,932,564,dining table
21005,8,person,9,1,4246,25,1361,322,1598,1195,237,873,person
21006,9,person,10,1,4246,29,1088,494,1397,979,309,485,person
21007,10,person,11,1,4246,32,2,610,603,1198,601,588,person
21008,11,person,12,1,4246,40,289,447,743,1023,454,576,person
21009,13,person,14,1,4246,23,1392,560,1505,825,113,265,person
21010,16,person,17,1,4246,17,1380,598,1430,731,50,133,person
21011,17,person,18,1,4246,23,985,550,1143,768,158,218,person
21012,18,person,19,1,4246,23,995,456,1149,657,154,201,person
21013,19,person,20,1,4246,30,849,505,1001,758,152,253,person
21014,20,person,21,1,4246,23,812,561,898,744,86,183,person
21015,23,person,24,1,4246,17,507,486,585,668,78,182,person
21016,24,person,25,1,4246,37,493,512,750,860,257,348,person
21017,1,person,2,1,4283,19,480,262,616,636,136,374,person
21018,2,person,3,1,4283,16,215,239,365,586,150,347,person
21019,4,person,5,1,4283,41,672,498,922,1190,250,692,person
21020,5,person,6,0,4283,53,371,569,701,1591,330,1022,person
21021,8,person,9,1,4283,34,949,516,1187,1376,238,860,person
21022,15,chair,16,1,4294,27,122,319,213,468,91,149,chair
21023,16,chair,17,1,4294,23,134,377,259,477,125,100,chair
21024,17,chair,18,0,4294,33,22,254,93,361,71,107,chair
21025,18,chair,19,0,4294,26,84,240,130,327,46,87,chair
21026,19,chair,20,1,4294,22,280,302,358,477,78,175,chair
21027,20,chair,21,1,4294,26,230,274,307,378,77,104,chair
21028,21,chair,22,0,4294,29,162,239,215,325,53,86,chair
21029,25,chair,26,1,4294,17,97,215,116,274,19,59,chair
21030,6,chair,7,0,4295,17,995,1081,1339,1336,344,255,chair
21031,9,table,10,0,4295,21,1221,893,1647,1176,426,283,dining table
21032,11,chair,12,1,4295,22,1176,840,1374,1083,198,243,chair
21033,14,table,15,1,4295,27,649,875,1021,1191,372,316,dining table
21034,15,chair,16,1,4295,15,920,835,1076,1096,156,261,chair
21035,20,table,21,1,4295,34,15,958,692,1246,677,288,dining table
21036,30,chair,31,1,4295,33,529,995,895,1339,366,344,chair
21037,31,chair,32,1,4295,20,108,1073,524,1336,416,263,chair
21038,8,table,9,0,4297,22,149,294,306,381,157,87,dining table
21039,11,table,12,1,4297,18,379,277,489,324,110,47,dining table
21040,13,table,14,0,4297,20,79,269,191,325,112,56,dining table
21041,14,chair,15,0,4297,24,311,288,370,359,59,71,chair
21042,16,chair,17,0,4297,25,66,283,134,373,68,90,chair
21043,14,chair,15,0,4298,26,224,243,295,335,71,92,chair
21044,15,chair,16,1,4298,19,163,224,218,309,55,85,chair
21045,19,chair,20,1,4298,19,284,253,343,380,59,127,chair
21046,21,chair,22,1,4298,15,312,292,407,382,95,90,chair
21047,5,chair,6,1,4299,16,240,153,281,262,41,109,chair
21048,7,chair,8,0,4299,26,75,145,142,249,67,104,chair
21049,12,chair,13,0,4299,18,22,124,56,184,34,60,chair
21050,15,chair,16,1,4299,19,150,132,191,222,41,90,chair
21051,6,table,7,0,4300,27,66,116,178,180,112,64,dining table
21052,10,chair,11,0,4300,24,212,115,249,181,37,66,chair
21053,11,chair,12,1,4300,17,185,120,200,188,15,68,chair
21054,12,chair,13,1,4300,28,150,129,190,198,40,69,chair
21055,13,chair,14,1,4300,18,110,158,154,199,44,41,chair
21056,2,plate,3,0,4301,25,705,493,756,518,51,25,plate
21057,9,tables,10,0,4301,36,261,318,634,422,373,104,dining table
21058,10,tables,11,0,4301,22,0,378,332,520,332,142,dining table
21059,12,table,13,1,4301,15,60,339,166,390,106,51,dining table
21060,13,table,14,0,4301,15,173,304,273,344,100,40,dining table
21061,31,chair,32,1,4301,19,412,446,508,531,96,85,chair
21062,32,chair,33,1,4301,19,510,416,583,489,73,73,chair
21063,33,chair,34,0,4301,24,430,344,500,450,70,106,chair
21064,34,chair,35,1,4301,19,495,352,571,447,76,95,chair
21065,35,chair,36,0,4301,23,378,338,433,442,55,104,chair
21066,36,chair,37,0,4301,20,312,329,368,414,56,85,chair
21067,37,chair,38,0,4301,34,208,383,305,529,97,146,chair
21068,38,chair,39,1,4301,29,77,405,191,530,114,125,chair
21069,39,chair,40,1,4301,19,83,342,137,399,54,57,chair
21070,40,chair,41,1,4301,16,141,314,174,361,33,47,chair
21071,46,mirror,47,0,4301,15,42,132,108,292,66,160,mirror
21072,51,chair,52,1,4301,15,2,352,48,404,46,52,chair
21073,15,chair,16,1,4302,19,258,150,301,221,43,71,chair
21074,16,chair,17,1,4302,17,239,155,268,234,29,79,chair
21075,21,chair,22,1,4302,17,0,182,73,234,73,52,chair
21076,10,chair,11,0,51,43,0,265,396,413,396,148,chair
21077,11,person,12,1,51,76,79,36,366,413,287,377,person
21078,23,book,24,0,51,17,214,300,417,354,203,54,book
21079,5,person,6,1,52,69,210,19,575,480,365,461,person
21080,7,book,8,0,52,17,477,260,654,419,177,159,book
21081,62,person,63,1,53,129,834,13,1860,1480,1026,1467,person
21082,3,person,4,1,4377,17,127,114,169,203,42,89,person
21083,4,person,5,1,4383,35,114,43,156,155,42,112,person
21084,5,person,6,0,4383,48,87,43,147,184,60,141,person
21085,6,person,7,1,4383,26,60,33,92,91,32,58,person
21086,7,person,8,1,4383,29,40,47,75,100,35,53,person
21087,8,person,9,0,4383,78,149,35,215,210,66,175,person
21088,10,person,11,1,4384,36,363,225,435,333,72,108,person
21089,1,table,2,0,4385,23,284,169,435,332,151,163,dining table
21090,2,person,3,1,4385,43,373,109,464,277,91,168,person
21091,3,chair,4,1,4385,19,451,189,496,290,45,101,chair
21092,4,person,5,0,4385,36,264,78,327,323,63,245,person
21093,6,person,7,1,4385,24,138,101,183,155,45,54,person
21094,7,person,8,1,4385,19,2,94,47,230,45,136,person
21095,1,person,2,1,4386,52,132,65,349,334,217,269,person
21096,9,person,10,1,4387,26,336,233,425,345,89,112,person
21097,11,person,12,0,4387,48,236,221,355,573,119,352,person
21098,41,person,42,1,4388,26,179,63,209,147,30,84,person
21099,21,person,22,1,4392,20,215,81,232,131,17,50,person
21100,22,person,23,0,4392,28,207,91,224,160,17,69,person
21101,23,person,24,1,4392,32,252,131,329,257,77,126,person
21102,24,person,25,1,4392,30,23,134,69,257,46,123,person
21103,26,person,27,1,4392,21,61,154,108,220,47,66,person
21104,27,person,28,1,4392,23,81,127,117,171,36,44,person
21105,28,person,29,1,4392,25,107,96,134,149,27,53,person
21106,1,person,2,1,4395,28,0,92,83,165,83,73,person
21107,2,person,3,1,4395,23,68,95,120,164,52,69,person
21108,3,person,4,1,4395,34,108,79,162,145,54,66,person
21109,4,clock,5,0,4395,15,83,40,101,60,18,20,clock
21110,4,chair,5,0,4396,26,310,182,372,278,62,96,chair
21111,44,person,45,1,4397,36,115,53,154,228,39,175,person
21112,11,person,12,1,4399,47,200,133,267,362,67,229,person
21113,18,person,19,0,4403,24,14,201,35,257,21,56,person
21114,20,backpack,21,0,4403,21,0,235,51,339,51,104,backpack
21115,5,table,6,0,4404,20,70,164,186,256,116,92,dining table
21116,8,table,9,0,20433,29,79,255,236,323,157,68,dining table
21117,15,vase,16,0,20434,22,1664,1069,1748,1219,84,150,vase
21118,92,mirror,93,0,20434,23,644,247,777,411,133,164,mirror
21119,2,person,3,0,22930,36,425,309,503,641,78,332,person
21120,0,person,1,0,22931,34,1212,1,1630,1124,418,1123,person
21121,1,person,2,0,22931,120,771,117,1390,1182,619,1065,person
21122,5,book,6,0,22931,20,664,592,856,946,192,354,book
21123,12,chair,13,0,22933,16,443,525,532,682,89,157,chair
21124,13,person,14,0,22933,31,474,452,581,642,107,190,person
21125,23,book,24,0,22933,15,562,516,624,552,62,36,book
21126,9,table,10,0,4518,18,86,138,264,192,178,54,dining table
21127,10,chair,11,0,4518,16,227,159,275,220,48,61,chair
21128,12,chair,13,0,4518,15,53,126,83,158,30,32,chair
21129,14,table,15,0,4518,16,0,162,224,243,224,81,dining table
21130,16,chair,17,1,4518,19,0,190,58,243,58,53,chair
21131,23,person,24,1,4519,34,202,136,251,251,49,115,person
21132,24,table,25,0,4519,16,185,217,276,291,91,74,dining table
21133,25,chair,26,1,4519,18,175,216,228,259,53,43,chair
21134,27,table,28,1,4519,17,25,232,135,270,110,38,dining table
21135,28,chair,29,1,4519,18,9,246,69,316,60,70,chair
21136,29,table,30,0,4519,23,53,260,225,374,172,114,dining table
21137,30,chair,31,1,4519,22,156,262,249,370,93,108,chair
21138,31,table,32,1,4519,15,201,310,500,374,299,64,dining table
21139,32,chair,33,0,4519,15,267,212,304,292,37,80,chair
21140,33,chair,34,1,4519,15,227,225,288,292,61,67,chair
21141,34,table,35,0,4519,19,268,199,331,260,63,61,dining table
21142,35,table,36,1,4519,15,343,209,434,239,91,30,dining table
21143,37,chair,38,0,4519,22,337,217,388,304,51,87,chair
21144,40,table,41,1,4519,15,391,248,500,325,109,77,dining table
21145,44,chair,45,1,4519,16,384,268,487,332,103,64,chair
21146,13,chair,14,1,4520,22,884,1232,1240,1641,356,409,chair
21147,14,chair,15,1,4520,21,486,1419,924,1641,438,222,chair
21148,15,chair,16,1,4520,20,327,1195,582,1638,255,443,chair
21149,17,chair,18,1,4520,15,0,1108,231,1632,231,524,chair
21150,35,coffee pot,36,0,4520,17,1172,870,1244,943,72,73,potted plant
21151,69,door,70,0,4520,15,545,656,763,1185,218,529,door
21152,77,door,78,0,4520,23,1071,961,1216,1235,145,274,door
21153,89,chair,90,0,4520,51,881,1087,1219,1467,338,380,chair
21154,93,chair,94,1,4520,37,521,1085,820,1436,299,351,chair
21155,12,table,13,0,4521,25,120,390,467,595,347,205,dining table
21156,13,chair,14,1,4521,20,119,450,224,602,105,152,chair
21157,15,table,16,0,4521,37,315,439,789,782,474,343,dining table
21158,16,chair,17,1,4521,16,335,655,574,781,239,126,chair
21159,17,chair,18,1,4521,15,775,539,841,775,66,236,chair
21160,14,table,15,0,4522,27,689,383,857,547,168,164,dining table
21161,15,chair,16,0,4522,17,750,407,890,580,140,173,chair
21162,18,table,19,0,4522,33,157,458,413,707,256,249,dining table
21163,19,chair,20,0,4522,26,72,476,262,701,190,225,chair
21164,20,chair,21,1,4522,17,374,440,511,637,137,197,chair
21165,21,chair,22,1,4522,16,265,532,444,705,179,173,chair
21166,22,table,23,0,4522,26,472,363,603,491,131,128,dining table
21167,23,chair,24,1,4522,20,426,365,514,467,88,102,chair
21168,24,table,25,0,4522,18,39,408,228,561,189,153,dining table
21169,29,table,30,0,4522,27,907,350,1038,469,131,119,dining table
21170,30,chair,31,0,4522,19,874,366,981,488,107,122,chair
21171,31,chair,32,0,4522,20,506,380,609,517,103,137,chair
21172,36,chair,37,1,4522,18,170,390,250,475,80,85,chair
21173,19,chair,20,0,4523,18,158,108,178,131,20,23,chair
21174,20,chair,21,0,4523,23,147,133,190,190,43,57,chair
21175,21,chair,22,0,4523,21,84,145,134,205,50,60,chair
21176,22,chair,23,0,4523,23,22,147,75,214,53,67,chair
21177,24,person,25,0,4523,25,101,80,111,118,10,38,person
21178,13,chair,14,1,4524,16,222,155,265,229,43,74,chair
21179,19,chair,20,1,4524,25,138,152,180,222,42,70,chair
21180,21,chair,22,1,4524,24,54,147,93,212,39,65,chair
21181,22,chair,23,1,4524,19,86,163,124,215,38,52,chair
21182,6,refrigerator,7,0,4525,19,913,211,1277,956,364,745,refrigerator
21183,16,table,17,0,4525,41,103,529,399,822,296,293,dining table
21184,17,chair,18,0,4525,27,32,570,291,843,259,273,chair
21185,18,chair,19,1,4525,18,388,697,641,954,253,257,chair
21186,19,table,20,0,4525,17,315,591,705,699,390,108,dining table
21187,20,chair,21,1,4525,23,589,583,772,895,183,312,chair
21188,13,person,13,1,68,18,1983,262,2023,305,40,43,person
21189,29,person,29,1,68,47,824,237,942,364,118,127,person
21190,39,person,39,1,68,24,1411,261,1475,350,64,89,person
21191,44,person,44,1,68,23,1693,263,1758,320,65,57,person
21192,45,person,45,1,68,16,1813,279,1871,312,58,33,person
21193,72,vegetables,72,0,68,26,697,377,795,448,98,71,carrot
21194,98,chair,98,0,68,96,789,404,888,595,99,191,chair
21195,125,vegetables,124,0,68,24,1664,437,1800,561,136,124,carrot
21196,136,vegetables,135,0,68,29,1388,496,1485,578,97,82,carrot
21197,139,vegetables,138,0,68,53,1390,478,1609,667,219,189,carrot
21198,144,bottle,143,0,68,16,1293,601,1322,658,29,57,bottle
21199,145,bottle,144,1,68,17,1266,592,1298,623,32,31,bottle
21200,146,bottle,145,1,68,16,1236,598,1267,668,31,70,bottle
21201,148,bottle,147,1,68,16,1264,610,1295,651,31,41,bottle
21202,150,bottle,149,1,68,16,1183,607,1216,667,33,60,bottle
21203,151,bottle,150,1,68,15,1181,592,1213,623,32,31,bottle
21204,152,bottle,151,1,68,16,1155,590,1182,643,27,53,bottle
21205,7,person,8,0,4903,66,318,102,446,549,128,447,person
21206,8,person,9,0,4903,57,434,118,561,512,127,394,person
21207,9,person,10,1,4903,48,525,74,606,467,81,393,person
21208,10,person,11,1,4903,54,559,69,717,468,158,399,person
21209,11,person,12,0,4903,46,584,154,792,574,208,420,person
21210,17,person,18,1,4904,58,163,125,410,404,247,279,person
21211,15,person,16,1,4906,40,4,32,141,390,137,358,person
21212,21,door,22,0,4906,22,464,15,638,478,174,463,door
21213,5,person,6,1,4907,21,87,72,122,140,35,68,person
21214,6,person,7,1,4907,16,125,84,180,134,55,50,person
21215,7,person,8,1,4907,18,219,65,254,117,35,52,person
21216,8,person,9,1,4907,15,270,71,304,117,34,46,person
21217,3,person,4,1,4908,28,288,297,391,459,103,162,person
21218,4,person,5,1,4908,26,385,322,470,444,85,122,person
21219,5,person,6,1,4908,36,119,365,227,599,108,234,person
21220,6,person,7,1,4908,45,638,336,721,599,83,263,person
21221,7,person,8,0,4908,27,751,350,799,514,48,164,person
21222,13,person,14,0,4909,67,197,79,339,443,142,364,person
21223,14,person,15,0,4909,65,362,82,479,448,117,366,person
21224,9,person,10,0,4911,59,205,513,899,2126,694,1613,person
21225,0,person,1,1,4912,56,95,255,224,531,129,276,person
21226,1,person,2,1,4912,51,215,182,395,514,180,332,person
21227,2,person,3,1,4912,53,175,344,354,532,179,188,person
21228,2,person,3,1,22992,73,2,124,785,1196,783,1072,person
21229,3,person,4,1,22992,101,137,1,804,1199,667,1198,person
21230,4,person,5,1,22992,39,671,1,1233,700,562,699,person
21231,12,truck,13,0,71,103,36,73,488,290,452,217,truck
21232,15,door,16,0,71,16,427,127,487,229,60,102,door
21233,20,person,21,1,71,44,72,142,151,309,79,167,person
21234,21,person,22,0,71,72,32,150,129,351,97,201,person
21235,29,person,30,0,71,57,0,156,59,336,59,180,person
21236,13,person,14,1,4948,18,127,402,212,535,85,133,person
21237,14,person,15,1,4948,20,199,474,264,620,65,146,person
21238,15,person,16,1,4948,25,332,419,436,602,104,183,person
21239,16,person,17,1,4948,24,106,551,224,727,118,176,person
21240,17,person,18,1,4948,29,307,599,461,836,154,237,person
21241,18,person,19,1,4948,35,258,376,349,687,91,311,person
21242,19,person,20,1,4948,26,216,649,355,865,139,216,person
21243,20,person,21,1,4948,32,6,654,244,914,238,260,person
21244,21,person,22,1,4948,31,801,396,897,720,96,324,person
21245,22,person,23,1,4948,78,459,273,818,1015,359,742,person
21246,23,person,24,1,4948,61,813,327,1173,1015,360,688,person
21247,26,person,27,1,4948,24,1068,307,1137,442,69,135,person
21248,27,person,28,1,4948,18,757,362,826,463,69,101,person
21249,28,person,29,1,4948,16,731,355,777,430,46,75,person
21250,29,person,30,1,4948,15,527,379,592,470,65,91,person
21251,30,person,31,1,4948,16,486,405,534,473,48,68,person
21252,31,person,32,0,4948,20,1151,314,1204,422,53,108,person
21253,32,person,33,0,4948,16,1194,325,1242,422,48,97,person
21254,12,person,13,0,4949,24,1327,806,1398,1142,71,336,person
21255,13,person,14,0,4949,26,1234,795,1359,1173,125,378,person
21256,14,person,15,0,4949,30,791,1013,918,1305,127,292,person
21257,17,person,18,1,4949,40,797,1287,1096,1539,299,252,person
21258,18,person,19,1,4949,26,643,1342,945,1637,302,295,person
21259,19,bench,20,0,4949,18,154,1222,776,1635,622,413,bench
21260,21,person,22,1,4949,35,0,791,413,1644,413,853,person
21261,22,person,23,0,4949,40,219,1013,483,1376,264,363,person
21262,23,person,24,1,4949,22,1305,1481,1585,1641,280,160,person
21263,31,person,32,1,4949,25,73,946,261,1125,188,179,person
21264,43,bench,44,0,4949,26,912,1109,1165,1306,253,197,bench
21265,28,person,29,0,4950,26,165,109,179,142,14,33,person
21266,32,person,33,1,4950,15,206,104,212,123,6,19,person
21267,33,person,34,1,4950,16,211,98,224,122,13,24,person
21268,34,person,35,1,4950,22,245,98,255,127,10,29,person
21269,36,person,37,1,4950,19,0,98,29,129,29,31,person
21270,37,person,38,1,4950,16,27,85,44,115,17,30,person
21271,10,person,11,1,4952,21,1208,328,1414,458,206,130,person
21272,14,person,15,1,4952,18,272,317,402,529,130,212,person
21273,15,person,16,1,4952,19,393,311,591,603,198,292,person
21274,18,person,19,1,4952,26,1816,501,2006,953,190,452,person
21275,20,person,21,1,4952,25,17,277,238,597,221,320,person
21276,23,person,24,1,4952,17,348,472,461,741,113,269,person
21277,24,person,25,1,4952,20,286,566,455,950,169,384,person
21278,25,person,26,1,4952,21,167,594,368,1041,201,447,person
21279,26,person,27,1,4952,25,3,614,269,1177,266,563,person
21280,27,table,28,0,4952,19,614,563,1621,1443,1007,880,dining table
21281,30,person,31,1,4952,16,738,540,866,718,128,178,person
21282,31,person,32,1,4952,18,622,526,789,781,167,255,person
21283,32,person,33,1,4952,24,470,583,820,854,350,271,person
21284,33,person,34,1,4952,47,328,721,902,1528,574,807,person
21285,34,person,35,1,4952,20,1194,487,1324,679,130,192,person
21286,36,person,37,1,4952,21,1293,535,1474,832,181,297,person
21287,37,person,38,1,4952,53,1233,603,1864,1536,631,933,person
21288,62,person,63,0,4952,32,1561,178,1816,877,255,699,person
21289,7,bench,8,0,4953,25,100,247,596,360,496,113,bench
21290,17,bench,18,0,4953,15,74,221,335,248,261,27,bench
21291,29,table,30,0,4953,15,220,208,361,232,141,24,dining table
21292,13,table,14,0,4954,19,494,381,1017,549,523,168,dining table
21293,15,table,16,0,4954,27,262,405,897,656,635,251,dining table
21294,18,table,19,0,4954,28,3,450,597,765,594,315,dining table
21295,20,bench,21,0,4954,22,450,597,628,721,178,124,bench
21296,10,table,11,0,4955,17,600,544,986,844,386,300,dining table
21297,12,table,13,0,4955,15,999,528,1277,770,278,242,dining table
21298,15,chair,16,1,4955,20,52,736,328,958,276,222,chair
21299,16,chair,17,0,4955,24,755,587,950,841,195,254,chair
21300,17,chair,18,1,4955,18,322,645,516,951,194,306,chair
21301,19,chair,20,1,4955,16,522,526,619,697,97,171,chair
21302,9,bench,9,0,4956,17,2,533,503,752,501,219,bench
21303,11,bench,11,0,4956,17,688,546,999,695,311,149,bench
21304,12,table,12,0,4956,58,259,496,804,766,545,270,dining table
21305,22,table,22,0,4956,24,709,464,1023,580,314,116,dining table
21306,23,table,23,0,4956,15,478,452,767,512,289,60,dining table
21307,28,table,28,0,4956,23,324,441,544,499,220,58,dining table
21308,31,table,31,0,4956,18,209,434,376,474,167,40,dining table
21309,8,table,9,0,22999,35,701,330,869,401,168,71,dining table
21310,9,table,10,0,22999,35,780,363,1004,490,224,127,dining table
21311,10,table,11,1,22999,20,469,322,609,349,140,27,dining table
21312,11,table,12,0,22999,28,435,346,643,399,208,53,dining table
21313,12,table,13,0,22999,45,364,388,714,557,350,169,dining table
21314,13,table,14,0,22999,31,215,331,384,413,169,82,dining table
21315,14,table,15,0,22999,41,55,360,317,481,262,121,dining table
21316,15,table,16,0,22999,18,2,435,97,623,95,188,dining table
21317,16,table,17,0,22999,19,81,547,1005,700,924,153,dining table
21318,32,chair,33,1,22999,16,485,464,607,549,122,85,chair
21319,34,chair,35,1,22999,25,693,384,769,560,76,176,chair
21320,35,chair,36,1,22999,22,315,379,375,566,60,187,chair
21321,37,chair,38,1,22999,17,939,443,1005,658,66,215,chair
21322,43,chair,44,1,22999,18,678,323,727,412,49,89,chair
21323,49,chair,50,1,22999,23,365,319,395,406,30,87,chair
21324,54,chair,55,1,22999,17,6,352,58,436,52,84,chair
21325,55,chair,56,1,22999,23,133,406,174,625,41,219,chair
21326,56,chair,57,1,22999,27,16,445,153,647,137,202,chair
21327,70,chair,71,1,22999,23,747,352,805,496,58,144,chair
21328,30,person,31,1,5024,31,521,106,736,370,215,264,person
21329,6,table,7,1,5025,22,162,576,332,721,170,145,dining table
21330,22,person,23,0,5025,54,688,237,783,573,95,336,person
21331,32,person,32,1,5025,17,467,282,540,350,73,68,person
21332,55,table,54,1,5025,25,471,558,913,767,442,209,dining table
21333,56,chair,55,1,5025,25,436,543,663,766,227,223,chair
21334,57,chair,56,1,5025,34,485,497,669,764,184,267,chair
21335,58,chair,57,0,5025,22,663,599,901,768,238,169,chair
21336,59,chair,58,1,5025,44,730,512,930,767,200,255,chair
21337,71,person,67,1,5025,21,966,369,1023,506,57,137,person
21338,72,chair,68,1,5025,19,991,432,1023,621,32,189,chair
21339,73,chair,69,1,5025,19,950,412,1017,596,67,184,chair
21340,0,person,1,0,5026,28,766,311,1059,1197,293,886,person
21341,1,person,2,0,5026,41,487,338,843,1197,356,859,person
21342,13,pot,14,0,5029,16,544,219,610,284,66,65,potted plant
21343,14,pot,15,0,5029,16,500,213,564,281,64,68,potted plant
21344,3,person,4,1,5031,22,369,124,399,297,30,173,person
21345,6,person,7,1,5031,33,357,153,394,299,37,146,person
21346,0,person,1,1,5032,62,658,212,1134,960,476,748,person
21347,1,person,2,0,5032,48,318,138,684,620,366,482,person
21348,2,person,3,1,5032,35,346,563,803,958,457,395,person
21349,0,person,1,1,5033,33,1804,555,2198,1648,394,1093,person
21350,1,person,2,0,5033,47,76,649,597,1378,521,729,person
21351,2,person,3,1,5033,31,415,675,801,1357,386,682,person
21352,7,person,8,1,23023,55,36,90,484,1019,448,929,person
21353,26,chair,27,1,5035,20,2,256,53,413,51,157,chair
21354,27,table,28,0,5035,19,257,231,460,389,203,158,dining table
21355,28,person,29,1,5035,26,68,166,146,310,78,144,person
21356,29,person,30,1,5035,46,113,155,278,336,165,181,person
21357,31,chair,32,1,5035,22,149,277,316,408,167,131,chair
21358,32,chair,33,0,5035,33,367,229,511,399,144,170,chair
21359,34,chair,35,1,5035,28,494,216,560,343,66,127,chair
21360,35,chair,36,1,5035,17,541,228,599,337,58,109,chair
21361,58,person,59,1,5035,72,269,155,394,336,125,181,person
21362,70,chair,71,1,5035,20,60,223,114,381,54,158,chair
21363,10,person,11,1,5036,40,19,202,136,359,117,157,person
21364,13,chair,14,1,5036,22,409,234,467,347,58,113,chair
21365,14,chair,15,1,5036,18,474,229,531,337,57,108,chair
21366,15,chair,16,1,5036,18,366,218,411,310,45,92,chair
21367,16,chair,17,0,5036,22,208,242,294,403,86,161,chair
21368,22,person,23,1,5036,19,213,180,241,225,28,45,person
21369,23,person,24,1,5036,24,233,175,285,227,52,52,person
21370,24,person,25,1,5036,17,380,179,406,232,26,53,person
21371,26,person,27,1,5036,24,386,184,435,263,49,79,person
21372,27,person,28,1,5036,17,464,155,490,183,26,28,person
21373,36,chair,37,1,5036,17,562,224,609,317,47,93,chair
21374,37,chair,38,1,5036,15,527,212,568,290,41,78,chair
21375,39,person,40,0,5036,22,508,165,534,233,26,68,person
21376,11,table,12,0,5037,22,25,306,261,464,236,158,dining table
21377,19,chair,20,1,5038,17,422,229,460,332,38,103,chair
21378,20,chair,21,1,5038,15,247,239,304,329,57,90,chair
21379,21,chair,22,1,5038,18,359,242,431,336,72,94,chair
21380,22,chair,23,1,5038,21,293,244,375,335,82,91,chair
21381,26,chair,27,1,5038,15,481,282,563,421,82,139,chair
21382,27,chair,28,1,5038,21,546,296,639,454,93,158,chair
21383,29,chair,30,1,5038,21,432,335,511,477,79,142,chair
21384,32,chair,33,1,5038,16,37,371,210,475,173,104,chair
21385,36,chair,37,1,5038,21,91,254,164,361,73,107,chair
21386,37,chair,38,0,5038,21,6,278,93,421,87,143,chair
21387,13,table,14,0,5039,21,153,363,464,476,311,113,dining table
21388,14,table,15,0,5039,15,579,293,639,363,60,70,dining table
21389,12,person,13,1,5040,18,318,116,355,152,37,36,person
21390,13,person,14,1,5040,16,359,122,398,159,39,37,person
21391,14,person,15,0,5040,18,282,122,326,168,44,46,person
21392,15,person,16,1,5040,21,230,117,283,178,53,61,person
21393,16,sofa,17,1,5040,15,329,170,376,245,47,75,couch
21394,17,person,18,1,5040,36,316,129,367,256,51,127,person
21395,20,sofa,21,1,5040,15,0,189,101,374,101,185,couch
21396,27,person,28,1,5040,19,186,120,233,202,47,82,person
21397,28,person,29,1,5040,19,82,123,125,173,43,50,person
21398,29,person,30,1,5040,36,154,125,234,315,80,190,person
21399,60,sofa,61,1,5040,31,205,164,302,296,97,132,couch
21400,16,chair,17,0,5041,42,210,710,445,964,235,254,chair
21401,17,chair,18,0,5041,42,551,682,739,935,188,253,chair
21402,18,table,19,0,5041,25,2,936,271,1151,269,215,dining table
21403,19,table,20,1,5041,18,495,800,642,906,147,106,dining table
21404,20,chair,21,1,5041,46,406,668,581,882,175,214,chair
21405,21,chair,22,1,5041,37,703,655,819,865,116,210,chair
21406,22,chair,23,1,5041,25,813,636,919,793,106,157,chair
21407,23,chair,24,0,5041,34,858,640,998,810,140,170,chair
21408,24,table,25,1,5041,17,959,722,1064,793,105,71,dining table
21409,25,chair,26,0,5041,36,1066,627,1195,795,129,168,chair
21410,26,table,27,0,5041,25,1317,671,1533,1016,216,345,dining table
21411,28,chair,29,1,5041,30,1498,598,1609,733,111,135,chair
21412,29,chair,30,1,5041,20,1682,595,1768,693,86,98,chair
21413,30,table,31,1,5041,16,1531,640,1691,732,160,92,dining table
21414,36,chair,37,1,5041,25,2005,582,2105,707,100,125,chair
21415,44,table,45,0,5041,43,1448,955,2034,1469,586,514,dining table
21416,45,chair,46,1,5041,18,1456,864,1805,994,349,130,chair
21417,46,chair,47,0,5041,50,1099,923,1510,1465,411,542,chair
21418,47,chair,48,1,5041,24,1414,1203,2086,1469,672,266,chair
21419,3,person,4,1,5042,19,1582,499,1742,814,160,315,person
21420,27,person,28,1,5042,30,416,533,827,903,411,370,person
21421,31,person,32,0,5042,35,1033,311,1363,1088,330,777,person
21422,34,chair,35,1,5042,16,1478,851,1804,1404,326,553,chair
21423,35,chair,36,1,5042,18,1601,995,1913,1601,312,606,chair
21424,36,chair,37,1,5042,22,1719,1048,2197,1625,478,577,chair
21425,19,chair,20,1,5043,15,142,114,170,168,28,54,chair
21426,20,chair,21,1,5043,19,160,122,206,179,46,57,chair
21427,23,chair,24,1,5043,17,210,152,282,229,72,77,chair
21428,32,chair,33,1,5043,17,16,153,94,224,78,71,chair
21429,15,person,16,1,5044,16,464,401,521,459,57,58,person
21430,19,person,20,1,5044,23,294,433,388,563,94,130,person
21431,20,person,21,1,5044,41,74,448,177,756,103,308,person
21432,21,person,22,0,5044,54,156,437,331,764,175,327,person
21433,22,person,23,1,5044,36,351,470,521,760,170,290,person
21434,23,person,24,1,5044,30,489,462,667,760,178,298,person
21435,24,chair,25,1,5044,18,31,536,110,744,79,208,chair
21436,25,chair,26,1,5044,26,130,575,279,768,149,193,chair
21437,26,chair,27,1,5044,20,324,619,485,766,161,147,chair
21438,17,person,18,1,5397,23,153,76,227,169,74,93,person
21439,18,person,19,1,5397,35,306,16,388,182,82,166,person
21440,5,person,6,1,5398,26,294,188,391,341,97,153,person
21441,6,person,7,1,5398,28,364,202,446,359,82,157,person
21442,7,person,8,1,5398,33,445,199,550,344,105,145,person
21443,8,person,9,1,5398,29,457,256,593,477,136,221,person
21444,12,person,13,1,5398,32,139,184,246,478,107,294,person
21445,13,person,14,1,5398,37,43,180,212,479,169,299,person
21446,4,person,5,1,5399,18,198,171,235,224,37,53,person
21447,6,person,7,1,5399,30,0,172,55,332,55,160,person
21448,2,person,3,1,5400,37,0,20,128,224,128,204,person
21449,5,person,6,1,5400,51,112,16,227,191,115,175,person
21450,6,person,7,1,5400,21,90,112,123,158,33,46,person
21451,1,person,2,1,5401,36,286,90,425,323,139,233,person
21452,7,glasses,8,0,5404,28,9,182,115,1301,106,1119,eye glasses
21453,8,person,9,1,5404,40,737,227,1249,996,512,769,person
21454,3,person,4,1,5405,35,187,143,617,905,430,762,person
21455,6,person,7,1,5405,42,786,661,1288,1330,502,669,person
21456,9,person,10,1,5663,26,416,341,529,520,113,179,person
21457,10,person,11,1,5663,44,489,353,687,571,198,218,person
21458,11,person,12,1,5663,26,643,368,834,610,191,242,person
21459,12,person,13,1,5663,15,978,341,1023,765,45,424,person
21460,16,person,17,1,5663,23,157,324,239,522,82,198,person
21461,17,person,18,0,5663,41,60,335,160,638,100,303,person
21462,19,person,20,1,5663,29,2,354,63,564,61,210,person
21463,20,person,21,0,5663,17,140,456,226,563,86,107,person
21464,21,person,22,0,5663,36,145,422,302,681,157,259,person
21465,22,bench,23,1,5663,15,214,564,324,683,110,119,bench
21466,7,person,8,1,5664,19,112,383,234,580,122,197,person
21467,8,person,9,1,5664,25,215,315,362,562,147,247,person
21468,11,person,12,1,5664,22,456,376,526,525,70,149,person
21469,12,person,13,1,5664,22,507,333,580,468,73,135,person
21470,13,person,14,1,5664,32,592,346,693,761,101,415,person
21471,14,person,15,1,5664,31,506,391,646,764,140,373,person
21472,16,person,17,1,5664,28,682,368,741,549,59,181,person
21473,18,person,19,0,5664,40,796,344,928,734,132,390,person
21474,19,person,20,1,5664,21,939,349,1022,764,83,415,person
21475,3,bench,4,0,5665,20,181,125,320,161,139,36,bench
21476,4,bench,5,0,5665,15,0,125,183,233,183,108,bench
21477,11,backpack,12,0,5666,16,41,115,105,220,64,105,backpack
21478,6,person,7,1,5669,36,164,146,264,253,100,107,person
21479,7,person,8,1,5669,27,255,136,327,213,72,77,person
21480,8,person,9,1,5669,20,298,137,324,193,26,56,person
21481,13,backpack,14,0,5669,15,73,111,117,165,44,54,backpack
21482,23,backpack,24,1,5669,15,219,112,250,157,31,45,backpack
21483,5,person,6,0,5670,44,51,102,120,242,69,140,person
21484,8,person,9,1,5672,38,676,433,986,1193,310,760,person
21485,9,person,10,1,5672,48,923,377,1326,1193,403,816,person
21486,1,person,2,1,111,104,52,7,319,401,267,394,person
21487,10,person,11,1,111,94,293,67,541,403,248,336,person
21488,4,person,5,1,5776,50,1015,120,1363,714,348,594,person
21489,0,hat,1,0,5781,19,2,13,39,59,37,46,hat
21490,1,hat,2,0,5781,18,18,70,53,115,35,45,hat
21491,2,hat,3,0,5781,16,64,18,97,55,33,37,hat
21492,3,hat,4,0,5781,16,113,24,139,56,26,32,hat
21493,4,hat,5,0,5781,15,124,65,144,96,20,31,hat
21494,7,hat,8,0,5781,15,173,30,191,59,18,29,hat
21495,11,hat,12,0,5781,18,31,135,78,176,47,41,hat
21496,11,person,12,1,5783,16,156,48,176,77,20,29,person
21497,12,person,13,1,5783,22,191,56,232,95,41,39,person
21498,5,table,6,0,5786,18,44,231,417,401,373,170,dining table
21499,8,person,9,1,5786,60,35,105,163,398,128,293,person
21500,11,person,12,1,5786,40,255,74,327,254,72,180,person
21501,12,person,13,1,5786,29,316,106,392,252,76,146,person
21502,8,person,9,1,5790,16,455,164,506,239,51,75,person
21503,9,person,10,0,5790,46,493,154,565,448,72,294,person
21504,18,bench,19,0,5791,34,272,170,390,234,118,64,bench
21505,4,table,5,0,5793,16,34,117,94,176,60,59,dining table
21506,8,table,9,0,5793,39,215,170,426,314,211,144,dining table
21507,22,chair,23,0,5793,21,388,117,432,182,44,65,chair
21508,4,tables,5,0,5800,35,12,149,199,234,187,85,dining table
21509,3,person,4,1,5801,31,336,46,599,464,263,418,person
21510,4,person,5,1,5801,45,486,155,820,546,334,391,person
21511,5,person,6,1,5801,19,729,149,801,333,72,184,person
21512,6,table,7,1,5803,15,183,930,1262,1322,1079,392,dining table
21513,8,chair,9,1,5803,18,98,1005,288,1625,190,620,chair
21514,9,chair,10,1,5803,21,215,1072,649,1625,434,553,chair
21515,27,vase,28,0,5803,15,1864,2,2011,155,147,153,vase
21516,28,vase,29,0,5803,15,1160,122,1262,267,102,145,vase
21517,3,person,4,0,5805,50,256,94,302,234,46,140,person
21518,4,person,5,0,5805,25,110,98,143,174,33,76,person
21519,10,person,11,1,5805,36,3,95,52,180,49,85,person
21520,10,person,11,0,118,87,29,375,431,918,402,543,person
21521,21,glasses,22,0,118,15,431,674,502,719,71,45,eye glasses
21522,23,person,24,0,118,74,486,323,754,789,268,466,person
21523,37,person,38,0,118,71,815,388,1036,702,221,314,person
21524,38,chair,39,0,118,31,764,529,946,750,182,221,chair
21525,40,book,41,1,118,25,952,523,1047,575,95,52,book
21526,41,table,42,1,118,22,996,522,1059,660,63,138,dining table
21527,42,table,43,1,118,23,1229,552,1333,805,104,253,dining table
21528,52,person,53,0,118,76,1028,387,1295,829,267,442,person
21529,61,person,62,1,118,25,1232,382,1296,485,64,103,person
21530,62,person,63,1,118,32,1209,371,1257,507,48,136,person
21531,63,person,64,1,118,81,1248,386,1407,791,159,405,person
21532,72,person,73,1,118,56,1324,302,1405,453,81,151,person
21533,80,chair,81,1,118,16,1375,408,1392,450,17,42,chair
21534,82,person,83,1,118,31,1381,416,1434,483,53,67,person
21535,83,person,84,0,118,60,1384,418,1531,634,147,216,person
21536,93,person,94,0,118,52,1488,357,1599,570,111,213,person
21537,94,person,95,1,118,61,1450,356,1599,424,149,68,person
21538,95,person,96,0,118,24,1427,231,1600,380,173,149,person
21539,4,person,5,1,119,32,2,633,396,1324,394,691,person
21540,5,person,6,1,119,15,4,475,162,648,158,173,person
21541,6,person,7,0,119,53,2,4,569,604,567,600,person
21542,14,person,15,0,119,36,573,4,996,547,423,543,person
21543,22,person,23,0,119,40,1081,8,1469,557,388,549,person
21544,31,person,32,0,119,34,1510,11,1978,594,468,583,person
21545,44,plate,45,1,119,22,1140,528,1374,592,234,64,plate
21546,51,plate,52,0,119,15,659,527,867,579,208,52,plate
21547,61,bowl,62,0,119,15,11,538,191,703,180,165,bowl
21548,62,plate,63,0,119,17,425,633,714,755,289,122,plate
21549,65,plate,66,0,119,38,652,606,1060,704,408,98,plate
21550,67,plate,68,1,119,27,934,666,1128,790,194,124,plate
21551,69,bowl,70,0,119,22,1064,726,1517,967,453,241,bowl
21552,71,bowl,72,0,119,18,1070,713,1510,958,440,245,bowl
21553,74,plate,75,1,119,23,1084,857,1509,996,425,139,plate
21554,75,plate,76,1,119,41,529,729,990,850,461,121,plate
21555,77,plate,78,0,119,22,174,850,710,1058,536,208,plate
21556,79,plate,80,1,119,25,8,1008,295,1262,287,254,plate
21557,81,plate,82,0,119,23,239,1101,980,1543,741,442,plate
21558,83,plate,84,0,119,26,976,1117,1711,1582,735,465,plate
21559,85,plate,86,0,119,41,1790,1065,2197,1442,407,377,plate
21560,87,plate,88,0,119,29,1976,785,2200,975,224,190,plate
21561,91,bowl,92,0,119,22,1771,668,2031,1051,260,383,bowl
21562,95,bowl,96,0,119,24,1486,686,1745,1107,259,421,bowl
21563,97,person,98,1,119,19,2108,294,2199,620,91,326,person
21564,98,plate,99,0,119,21,681,893,1089,1050,408,157,plate
21565,99,cake,100,0,119,36,702,748,1057,1031,355,283,cake
21566,11,clock,12,0,5929,27,385,120,429,231,44,111,clock
21567,23,chair,24,1,5929,23,430,328,514,496,84,168,chair
21568,25,chair,26,1,5929,15,529,307,578,397,49,90,chair
21569,29,chair,30,0,5929,19,292,364,378,499,86,135,chair
21570,30,chair,31,1,5929,38,9,392,137,499,128,107,chair
21571,41,chair,42,1,5929,18,582,408,681,499,99,91,chair
21572,65,chair,66,1,5929,24,644,320,728,410,84,90,chair
21573,8,chair,9,1,5930,15,921,464,1030,774,109,310,chair
21574,9,person,10,1,5930,37,960,194,1518,1005,558,811,person
21575,10,person,11,1,5930,49,511,206,948,893,437,687,person
21576,14,person,15,1,5930,21,531,353,680,515,149,162,person
21577,16,person,17,1,5930,20,415,372,525,513,110,141,person
21578,17,person,18,1,5930,21,337,376,443,541,106,165,person
21579,18,person,19,0,5930,37,249,370,552,756,303,386,person
21580,19,chair,20,0,5930,27,229,476,507,834,278,358,chair
21581,22,person,23,1,5930,15,1408,266,1518,541,110,275,person
21582,9,chair,9,0,5931,25,63,249,136,343,73,94,chair
21583,15,chair,15,1,5931,16,392,302,518,391,126,89,chair
21584,16,table,16,1,5931,17,284,383,599,449,315,66,dining table
21585,17,chair,17,1,5931,27,172,334,324,449,152,115,chair
21586,7,table,8,0,5933,21,140,178,268,329,128,151,dining table
21587,8,table,9,0,5933,19,346,149,431,241,85,92,dining table
21588,9,chair,10,0,5933,23,317,168,392,280,75,112,chair
21589,10,chair,11,1,5933,21,268,161,328,293,60,132,chair
21590,11,chair,12,1,5933,26,43,180,150,329,107,149,chair
21591,12,person,13,0,5933,57,69,112,200,329,131,217,person
21592,13,person,14,1,5933,60,204,99,302,303,98,204,person
21593,14,person,15,1,5933,20,375,101,411,158,36,57,person
21594,15,person,16,0,5933,37,406,116,472,261,66,145,person
21595,21,chair,22,1,5933,17,459,150,498,255,39,105,chair
21596,23,chair,24,1,5933,22,2,155,60,251,58,96,chair
21597,14,chair,15,0,5934,26,493,580,793,914,300,334,chair
21598,13,table,13,0,5937,25,167,315,302,455,135,140,dining table
21599,14,table,14,0,5937,19,87,282,181,384,94,102,dining table
21600,15,person,15,1,5937,34,70,224,136,379,66,155,person
21601,16,chair,16,1,5937,21,144,297,203,402,59,105,chair
21602,18,person,18,1,5937,24,149,223,215,321,66,98,person
21603,19,chair,19,1,5937,16,305,312,374,462,69,150,chair
21604,20,person,20,0,5937,36,277,258,368,442,91,184,person
21605,24,chair,24,1,5937,19,7,356,94,463,87,107,chair
21606,27,chair,27,0,5937,28,199,337,287,463,88,126,chair
21607,13,sofa,14,0,5938,27,157,203,327,277,170,74,couch
21608,14,table,15,0,5938,16,149,269,285,377,136,108,dining table
21609,29,refrigerator,30,0,23123,29,757,298,907,441,150,143,refrigerator
21610,33,clock,34,0,23123,24,387,232,438,281,51,49,clock
21611,37,table,38,0,23123,16,343,411,444,443,101,32,dining table
21612,38,chair,39,1,23123,15,350,430,435,444,85,14,chair
21613,39,chair,40,1,23123,28,342,439,454,556,112,117,chair
21614,40,chair,41,1,23123,25,290,507,461,713,171,206,chair
21615,41,chair,42,1,23123,43,242,606,479,762,237,156,chair
21616,42,table,43,0,23123,27,241,553,489,709,248,156,dining table
21617,44,chair,45,1,23123,39,50,516,255,766,205,250,chair
21618,45,table,46,0,23123,24,2,566,243,731,241,165,dining table
21619,46,chair,47,1,23123,25,1,630,211,768,210,138,chair
21620,1,bench,2,0,23125,42,0,504,619,785,619,281,bench
21621,2,person,3,1,23125,107,55,230,642,767,587,537,person
21622,3,table,4,0,23125,18,342,611,679,1024,337,413,dining table
21623,1,table,2,0,23126,34,514,536,837,719,323,183,dining table
21624,2,chair,3,0,23126,16,795,490,1022,720,227,230,chair
21625,5,chair,6,1,23126,19,338,507,619,777,281,270,chair
21626,16,person,17,1,23127,72,571,173,664,493,93,320,person
21627,17,door,18,0,23127,20,503,151,602,192,99,41,door
21628,19,person,20,1,23127,72,542,181,625,524,83,343,person
21629,20,person,21,1,23127,75,495,180,598,534,103,354,person
21630,21,person,22,1,23127,61,426,185,558,534,132,349,person
21631,22,person,23,1,23127,56,342,198,485,534,143,336,person
21632,23,person,24,1,23127,61,188,204,398,535,210,331,person
21633,4,table,5,1,23128,36,37,446,458,650,421,204,dining table
21634,5,chair,6,0,23128,48,396,434,522,633,126,199,chair
21635,6,chair,7,0,23128,46,196,448,309,662,113,214,chair
21636,8,chair,9,1,23128,28,120,431,195,588,75,157,chair
21637,9,chair,10,0,23128,61,66,448,188,660,122,212,chair
21638,10,chair,11,1,23128,37,1,446,72,663,71,217,chair
21639,11,chair,12,1,23128,25,27,432,101,537,74,105,chair
21640,3,plant pot,4,0,23129,15,745,392,788,437,43,45,potted plant
21641,8,person,9,1,23129,44,384,170,529,447,145,277,person
21642,10,person,11,1,23129,90,37,130,345,534,308,404,person
21643,11,bowl,12,0,23129,16,213,358,309,455,96,97,bowl
21644,12,bowl,13,0,23129,16,235,486,361,589,126,103,bowl
21645,15,person,16,0,23129,66,788,204,1001,681,213,477,person
21646,5,chair,6,1,6211,17,901,923,1106,1187,205,264,chair
21647,6,refrigerator,7,0,6211,15,314,419,674,1296,360,877,refrigerator
21648,15,person,16,1,6213,24,0,220,72,303,72,83,person
21649,17,bottle,18,0,6215,15,487,177,509,217,22,40,bottle
21650,0,person,1,1,6560,20,41,82,162,248,121,166,person
21651,1,person,2,1,6560,18,152,75,242,248,90,173,person
21652,10,person,11,1,6560,16,163,88,179,120,16,32,person
21653,5,person,6,1,6561,27,19,39,87,132,68,93,person
21654,10,person,11,1,6561,17,103,77,141,128,38,51,person
21655,17,person,18,1,6561,25,65,279,231,348,166,69,person
21656,21,person,22,0,6561,39,205,171,314,313,109,142,person
21657,25,person,26,1,6561,24,283,114,342,208,59,94,person
21658,33,person,34,1,6561,19,338,81,377,162,39,81,person
21659,36,person,37,1,6561,21,373,28,406,130,33,102,person
21660,37,person,38,1,6561,21,406,56,450,151,44,95,person
21661,38,person,39,1,6561,25,383,141,467,314,84,173,person
21662,41,person,42,1,6561,19,427,61,465,127,38,66,person
21663,9,person,10,0,6563,34,95,278,256,791,161,513,person
21664,10,person,11,1,6563,18,353,338,485,480,132,142,person
21665,11,person,12,1,6563,20,565,282,698,481,133,199,person
21666,13,person,14,1,6563,39,802,386,1005,684,203,298,person
21667,15,person,16,0,6563,49,1015,439,1323,1010,308,571,person
21668,28,person,29,1,6563,21,630,442,720,683,90,241,person
21669,29,person,30,1,6563,25,694,468,887,919,193,451,person
21670,30,person,31,1,6563,36,265,499,745,1194,480,695,person
21671,31,chair,32,1,6563,29,367,909,745,1197,378,288,chair
21672,4,person,5,0,6564,57,1515,73,1842,1323,327,1250,person
21673,5,person,6,1,6564,21,1300,307,1548,615,248,308,person
21674,6,person,7,1,6564,23,1250,420,1521,1058,271,638,person
21675,7,chair,8,1,6564,22,1240,628,1560,1435,320,807,chair
21676,8,person,9,1,6564,52,883,143,1309,1554,426,1411,person
21677,9,person,10,1,6564,27,658,493,1200,1458,542,965,person
21678,10,chair,11,1,6564,27,678,751,1204,1644,526,893,chair
21679,16,person,17,1,6564,34,0,503,595,1528,595,1025,person
21680,17,chair,18,1,6564,16,324,850,698,1637,374,787,chair
21681,61,chair,62,1,6564,15,1771,463,1933,977,162,514,chair
21682,6,table,7,0,6565,39,464,413,910,743,446,330,dining table
21683,7,table,8,1,6565,19,0,385,118,565,118,180,dining table
21684,8,person,9,1,6565,19,0,355,57,547,57,192,person
21685,11,person,12,1,6565,38,153,254,311,507,158,253,person
21686,16,person,17,1,6565,36,304,244,433,501,129,257,person
21687,18,chair,19,0,6565,19,353,349,465,518,112,169,chair
21688,20,person,21,1,6565,25,471,270,569,450,98,180,person
21689,23,person,24,1,6565,26,649,271,772,419,123,148,person
21690,28,table,29,0,6565,20,796,388,1018,582,222,194,dining table
21691,6,person,7,1,6566,80,97,435,1032,1458,935,1023,person
21692,9,person,10,1,6566,41,952,524,1393,1414,441,890,person
21693,10,person,11,1,6566,58,1322,440,1754,1443,432,1003,person
21694,12,person,13,1,6566,40,1647,420,2123,1179,476,759,person
21695,15,chair,16,1,6566,23,1485,1000,2144,1464,659,464,chair
21696,16,chair,17,1,6566,19,1754,854,2194,1227,440,373,chair
21697,19,person,20,1,6566,17,2020,864,2197,1419,177,555,person
21698,5,person,6,1,6625,85,81,26,235,199,154,173,person
21699,0,person,1,1,6626,42,119,32,213,236,94,204,person
21700,3,person,4,1,6627,38,255,186,497,327,242,141,person
21701,1,person,2,1,6628,18,0,214,20,333,20,119,person
21702,7,person,7,1,6628,19,154,188,184,229,30,41,person
21703,8,person,8,1,6628,16,218,195,255,233,37,38,person
21704,26,person,26,1,6628,36,80,187,145,374,65,187,person
21705,3,person,4,1,6629,24,144,139,191,201,47,62,person
21706,4,person,5,1,6629,43,283,131,350,299,67,168,person
21707,0,person,1,1,6630,39,94,149,188,315,94,166,person
21708,0,person,1,1,6631,79,20,4,180,346,160,342,person
21709,14,person,15,1,6631,23,326,64,363,169,37,105,person
21710,0,person,1,1,6633,47,21,16,135,195,114,179,person
21711,5,person,6,1,6633,21,185,39,209,96,24,57,person
21712,6,person,7,1,6633,34,219,38,299,128,80,90,person
21713,7,person,8,1,6633,20,272,40,300,124,28,84,person
21714,7,person,8,0,6634,55,279,77,335,266,56,189,person
21715,9,person,10,1,6636,27,454,160,497,233,43,73,person
21716,10,person,11,1,6636,16,530,160,598,217,68,57,person
21717,17,person,18,0,6637,37,125,142,160,249,35,107,person
21718,26,person,27,0,6637,32,320,79,360,197,40,118,person
21719,6,person,7,1,6638,27,139,134,180,248,41,114,person
21720,11,person,12,0,6638,61,233,73,341,399,108,326,person
21721,8,person,9,1,6639,32,47,32,121,163,74,131,person
21722,10,person,11,1,6639,29,86,55,151,144,65,89,person
21723,11,person,12,1,6639,38,97,40,210,252,113,212,person
21724,12,person,13,1,6639,37,82,27,209,197,127,170,person
21725,3,chair,4,0,6640,38,95,268,185,375,90,107,chair
21726,1,person,2,1,6641,62,321,54,499,332,178,278,person
21727,4,person,5,1,6641,40,208,96,287,211,79,115,person
21728,5,person,6,1,6641,46,0,27,160,291,160,264,person
21729,3,person,4,0,6643,52,228,135,309,323,81,188,person
21730,28,person,29,1,23240,20,567,945,621,1005,54,60,person
21731,29,person,30,1,23240,21,516,963,562,1000,46,37,person
21732,1,bowl,2,0,23241,35,14,1,739,496,725,495,bowl
21733,2,fork,3,0,23241,33,386,60,749,195,363,135,fork
21734,1,plate,2,0,23242,25,2,1,1023,679,1021,678,plate
21735,4,person,5,1,6666,16,184,137,211,166,27,29,person
21736,10,person,11,0,6666,28,0,150,21,209,21,59,person
21737,11,person,12,0,6666,24,23,148,41,205,18,57,person
21738,12,person,13,1,6666,23,38,147,50,217,12,70,person
21739,13,person,14,1,6666,15,49,134,65,185,16,51,person
21740,14,person,15,1,6666,29,55,125,108,254,53,129,person
21741,9,person,10,0,6667,30,85,144,120,257,35,113,person
21742,10,person,11,0,6667,26,111,136,144,264,33,128,person
21743,11,chair,12,0,6667,19,396,184,441,254,45,70,chair
21744,26,person,27,1,23243,43,191,249,533,480,342,231,person
21745,27,person,28,1,23243,57,548,191,719,480,171,289,person
21746,28,person,29,1,23243,78,344,89,572,480,228,391,person
21747,29,person,30,1,23243,90,90,25,555,479,465,454,person
21748,32,person,33,1,23243,55,9,64,173,480,164,416,person
21749,33,person,34,1,23243,21,1,188,39,479,38,291,person
21750,34,table,35,1,23243,20,554,424,668,480,114,56,dining table
21751,13,person,14,1,23244,27,793,293,821,508,28,215,person
21752,14,person,15,0,23244,48,924,252,1022,616,98,364,person
21753,19,chair,20,0,6717,15,22,92,39,118,17,26,chair
21754,8,person,9,1,6718,25,247,115,282,190,35,75,person
21755,13,person,14,1,6718,24,177,113,211,163,34,50,person
21756,14,person,15,0,6718,41,132,117,190,251,58,134,person
21757,22,person,23,0,6718,38,32,111,114,322,82,211,person
21758,14,table,15,1,6719,16,682,298,799,503,117,205,dining table
21759,11,person,12,0,6721,25,78,97,108,167,30,70,person
21760,14,person,15,1,6721,18,267,163,319,240,52,77,person
21761,15,person,16,1,6721,32,202,147,283,239,81,92,person
21762,20,person,21,1,6721,16,126,103,135,126,9,23,person
21763,24,person,25,1,6721,31,156,131,195,221,39,90,person
21764,26,person,27,1,6721,26,176,140,218,213,42,73,person
21765,28,person,29,1,6721,15,91,167,129,208,38,41,person
21766,29,person,30,1,6721,23,39,140,103,211,64,71,person
21767,31,person,32,1,6721,22,21,129,64,172,43,43,person
21768,32,person,33,1,6721,21,102,116,129,158,27,42,person
21769,0,chair,1,0,6723,17,79,254,297,475,218,221,chair
21770,8,person,9,1,6723,23,51,28,87,77,36,49,person
21771,11,person,12,1,6723,22,245,2,301,46,56,44,person
21772,4,person,5,1,136,47,649,114,720,460,71,346,person
21773,5,person,6,1,136,61,614,123,699,355,85,232,person
21774,12,person,13,1,136,38,594,155,624,288,30,133,person
21775,13,person,14,1,136,76,566,115,634,285,68,170,person
21776,18,person,19,1,136,48,509,124,593,279,84,155,person
21777,25,person,26,1,136,58,469,104,525,320,56,216,person
21778,26,person,27,0,136,80,438,79,508,323,70,244,person
21779,32,person,33,1,136,91,392,30,466,325,74,295,person
21780,38,person,39,1,136,133,261,0,482,427,221,427,person
21781,46,person,47,0,136,119,210,24,312,442,102,418,person
21782,51,person,52,1,136,138,33,0,330,437,297,437,person
21783,57,person,58,1,136,48,1,1,298,480,297,479,person
21784,65,bowl,66,1,136,16,587,308,665,351,78,43,bowl
21785,67,bowl,68,1,136,20,568,313,653,358,85,45,bowl
21786,68,bowl,69,0,136,16,551,347,644,404,93,57,bowl
21787,69,bowl,70,0,136,15,485,312,568,345,83,33,bowl
21788,70,bowl,71,0,136,19,515,386,610,451,95,65,bowl
21789,75,plate,76,0,136,16,211,208,332,228,121,20,plate
21790,11,person,12,1,6837,19,295,123,329,165,34,42,person
21791,13,person,14,1,6837,17,393,131,457,212,64,81,person
21792,14,person,15,1,6837,24,373,140,455,250,82,110,person
21793,16,person,17,1,6837,15,234,139,280,190,46,51,person
21794,17,person,18,1,6837,24,220,162,324,259,104,97,person
21795,20,person,21,1,6837,19,170,149,232,219,62,70,person
21796,21,person,22,1,6837,36,90,130,223,255,133,125,person
21797,22,person,23,1,6837,23,2,171,98,371,96,200,person
21798,24,person,25,1,6837,27,20,207,258,389,238,182,person
21799,28,person,29,1,6837,41,330,191,471,388,141,197,person
21800,30,person,31,1,6837,25,246,79,295,150,49,71,person
21801,31,person,32,1,6837,16,84,127,125,192,41,65,person
21802,32,person,33,1,6837,15,41,129,78,170,37,41,person
21803,7,table,8,0,6838,18,195,184,290,203,95,19,dining table
21804,8,table,9,0,6838,16,22,182,115,199,93,17,dining table
21805,7,bench,8,1,6839,16,2,524,592,947,590,423,bench
21806,11,person,12,1,6839,34,659,457,844,729,185,272,person
21807,12,person,13,1,6839,22,725,481,817,603,92,122,person
21808,13,person,14,1,6839,31,1133,333,1196,616,63,283,person
21809,17,person,18,1,6839,20,869,392,906,477,37,85,person
21810,18,person,19,0,6839,39,312,451,447,659,135,208,person
21811,19,person,20,1,6839,17,416,442,500,603,84,161,person
21812,20,person,21,1,6839,18,162,434,257,536,95,102,person
21813,21,person,22,1,6839,32,57,484,228,790,171,306,person
21814,23,person,24,1,6839,21,4,429,101,564,97,135,person
21815,24,person,25,1,6839,20,121,356,177,500,56,144,person
21816,25,person,26,1,6839,15,174,382,231,467,57,85,person
21817,26,person,27,1,6839,24,227,333,273,503,46,170,person
21818,27,person,28,1,6839,18,276,347,320,455,44,108,person
21819,28,person,29,1,6839,15,270,428,335,501,65,73,person
21820,31,person,32,1,6839,15,524,416,587,521,63,105,person
21821,33,person,34,0,6839,25,586,363,637,540,51,177,person
21822,34,person,35,1,6839,26,653,365,702,538,49,173,person
21823,35,person,36,1,6839,15,709,378,747,465,38,87,person
21824,36,person,37,1,6839,15,734,356,782,438,48,82,person
21825,14,table,15,0,6840,32,291,422,660,656,369,234,dining table
21826,15,person,16,0,6840,67,640,131,865,765,225,634,person
21827,16,table,17,1,6840,20,800,494,1017,765,217,271,dining table
21828,18,chair,19,0,6840,23,195,485,403,754,208,269,chair
21829,19,person,20,0,6840,28,0,202,113,574,113,372,person
21830,24,person,25,1,6840,27,115,317,205,504,90,187,person
21831,25,person,26,1,6840,24,353,313,468,426,115,113,person
21832,28,person,29,1,6840,16,224,307,285,381,61,74,person
21833,31,person,32,1,6840,16,194,298,236,366,42,68,person
21834,37,chair,38,1,6840,22,228,403,313,516,85,113,chair
21835,38,chair,39,1,6840,19,190,445,364,565,174,120,chair
21836,44,chair,45,1,6840,16,573,511,666,648,93,137,chair
21837,46,person,47,1,6840,17,922,312,982,378,60,66,person
21838,47,person,48,1,6840,16,867,303,913,372,46,69,person
21839,48,person,49,1,6840,19,825,298,885,377,60,79,person
21840,49,person,50,1,6840,18,502,292,552,349,50,57,person
21841,65,clock,66,0,6840,15,656,180,682,210,26,30,clock
21842,17,chair,18,1,6841,16,99,172,160,215,61,43,chair
21843,18,chair,19,1,6841,18,170,170,229,215,59,45,chair
21844,19,chair,20,1,6841,27,223,165,282,214,59,49,chair
21845,25,person,26,1,6841,26,105,58,141,147,36,89,person
21846,27,person,28,1,6841,15,38,84,68,122,30,38,person
21847,32,person,33,1,6841,20,362,91,392,148,30,57,person
21848,35,chair,36,0,6841,17,276,115,312,164,36,49,chair
21849,36,person,37,1,6841,25,265,84,307,156,42,72,person
21850,37,person,38,1,6841,26,252,82,280,148,28,66,person
21851,44,person,45,0,6841,21,165,49,184,108,19,59,person
21852,5,person,6,1,6842,24,795,119,906,266,111,147,person
21853,6,person,7,0,6842,18,457,143,538,257,81,114,person
21854,7,table,8,0,6842,18,383,344,1025,743,642,399,dining table
21855,8,chair,9,1,6842,21,238,402,460,744,222,342,chair
21856,10,chair,11,1,6842,23,932,397,1162,743,230,346,chair
21857,11,chair,12,1,6842,19,72,347,250,646,178,299,chair
21858,13,person,14,1,6842,15,365,228,463,349,98,121,person
21859,14,person,15,1,6842,35,286,271,511,739,225,468,person
21860,15,person,16,1,6842,27,774,215,922,397,148,182,person
21861,16,person,17,1,6842,23,1025,215,1179,443,154,228,person
21862,17,person,18,1,6842,15,1109,254,1250,581,141,327,person
21863,18,person,19,0,6842,47,833,276,1083,741,250,465,person
21864,25,person,26,1,6842,32,34,204,187,554,153,350,person
21865,7,table,8,1,6843,15,11,188,206,305,195,117,dining table
21866,12,chair,13,1,6843,18,40,211,112,304,72,93,chair
21867,13,chair,14,0,6843,20,117,209,185,296,68,87,chair
21868,32,chair,33,1,6844,17,75,149,95,233,20,84,chair
21869,2,table,3,0,23253,24,788,309,1023,631,235,322,dining table
21870,4,chair,5,1,23253,22,641,242,806,469,165,227,chair
21871,5,chair,6,1,23253,27,641,277,759,492,118,215,chair
21872,7,bottle,8,0,23253,41,713,440,836,696,123,256,bottle
21873,19,person,20,1,23253,67,457,271,732,617,275,346,person
21874,20,person,21,1,23253,72,203,216,504,581,301,365,person
21875,4,table,5,0,23254,27,559,841,1144,1200,585,359,dining table
21876,5,person,6,1,23254,44,184,593,675,1200,491,607,person
21877,6,person,7,1,23254,46,923,508,1599,1200,676,692,person
21878,10,person,11,1,23254,24,1109,565,1211,764,102,199,person
21879,11,person,12,1,23254,63,818,624,1183,976,365,352,person
21880,12,person,13,1,23254,55,810,529,991,855,181,326,person
21881,13,person,14,1,23254,47,584,535,806,844,222,309,person
21882,14,person,15,1,23254,19,479,556,592,736,113,180,person
21883,15,person,16,1,23254,46,52,565,456,1199,404,634,person
21884,16,person,17,1,23254,39,34,508,250,1196,216,688,person
21885,22,plate,23,0,23254,17,890,1021,1052,1104,162,83,plate
21886,23,bowl,24,0,23254,15,674,1001,861,1117,187,116,bowl
21887,24,bowl,25,0,23254,18,799,946,934,1035,135,89,bowl
21888,32,chair,33,1,23255,15,401,313,455,357,54,44,chair
21889,33,chair,34,0,23255,54,380,341,525,530,145,189,chair
21890,34,chair,35,1,23255,26,213,319,264,474,51,155,chair
21891,35,chair,36,0,23255,48,254,356,413,572,159,216,chair
21892,36,table,37,0,23255,26,230,347,477,433,247,86,dining table
21893,2,person,3,1,23256,61,0,253,362,682,362,429,person
21894,3,person,4,1,23256,75,158,207,436,630,278,423,person
21895,4,person,5,1,23256,58,268,151,435,455,167,304,person
21896,5,person,6,1,23256,32,736,1,839,128,103,127,person
21897,6,person,7,1,23256,99,717,95,922,475,205,380,person
21898,7,person,8,1,23256,115,637,138,1023,682,386,544,person
21899,11,plate,12,0,23256,29,646,521,832,620,186,99,plate
21900,12,bowl,13,0,23256,18,659,506,760,576,101,70,bowl
21901,14,bowl,15,0,23256,19,564,503,663,560,99,57,bowl
21902,15,spoon,16,0,23256,19,599,649,711,679,112,30,spoon
21903,21,bowl,22,0,23256,16,581,454,670,502,89,48,bowl
21904,23,plate,24,0,23256,16,669,421,756,456,87,35,plate
21905,29,plate,30,0,23256,24,611,318,704,351,93,33,plate
21906,30,bowl,31,0,23256,15,633,307,693,338,60,31,bowl
21907,34,plate,35,0,23256,18,376,333,483,376,107,43,plate
21908,38,plate,39,0,23256,17,363,457,456,501,93,44,plate
21909,40,plate,41,0,23256,37,298,540,486,647,188,107,plate
21910,49,table,50,0,23256,26,2,205,313,263,311,58,dining table
21911,5,chair,6,1,23257,23,551,609,729,851,178,242,chair
21912,6,chair,7,1,23257,33,0,537,275,693,275,156,chair
21913,7,person,8,1,23257,32,616,151,721,622,105,471,person
21914,8,person,9,1,23257,33,44,171,174,551,130,380,person
21915,9,person,10,1,23257,48,307,156,414,766,107,610,person
21916,11,person,12,1,23257,63,65,53,340,724,275,671,person
21917,12,person,13,1,23257,77,281,39,683,801,402,762,person
21918,13,plate,14,0,23257,17,345,797,729,1024,384,227,plate
21919,18,plate,19,0,23257,18,53,683,355,831,302,148,plate
21920,21,table,22,0,23258,23,288,257,464,383,176,126,dining table
21921,22,table,23,0,23258,15,370,249,512,344,142,95,dining table
21922,35,table,36,0,23258,21,181,291,221,379,40,88,dining table
21923,36,chair,37,0,23258,23,151,289,200,378,49,89,chair
21924,37,chair,38,1,23258,21,109,289,159,372,50,83,chair
21925,10,window,11,0,23259,34,192,23,323,274,131,251,window
21926,12,window,13,0,23259,16,0,1,144,281,144,280,window
21927,14,clock,15,1,23259,34,357,87,390,181,33,94,clock
21928,15,person,16,1,23259,47,396,62,530,310,134,248,person
21929,16,person,17,1,23259,84,353,67,496,390,143,323,person
21930,17,person,18,1,23259,61,305,132,394,388,89,256,person
21931,18,person,19,1,23259,44,185,185,333,340,148,155,person
21932,19,person,20,1,23259,111,516,105,966,523,450,418,person
21933,20,person,21,1,23259,17,60,267,141,337,81,70,person
21934,21,person,22,1,23259,28,1,1,119,678,118,677,person
21935,22,chair,23,1,23259,18,312,271,368,382,56,111,chair
21936,23,chair,24,1,23259,15,131,278,204,331,73,53,chair
21937,24,chair,25,1,23259,36,409,272,543,407,134,135,chair
21938,25,table,26,0,23259,20,46,323,1024,678,978,355,dining table
21939,26,plate,27,0,23259,18,217,499,443,591,226,92,plate
21940,29,plate,30,0,23259,19,623,532,901,657,278,125,plate
21941,31,plate,32,1,23259,22,517,443,678,506,161,63,plate
21942,37,bowl,38,0,23259,15,282,418,375,460,93,42,bowl
21943,38,bowl,39,0,23259,17,146,417,278,474,132,57,bowl
21944,39,plate,40,0,23259,19,305,386,427,420,122,34,plate
21945,43,bottle,44,1,23259,22,165,337,202,418,37,81,bottle
21946,44,plate,45,1,23259,20,54,413,176,457,122,44,plate
21947,45,bowl,46,0,23259,18,73,360,159,407,86,47,bowl
21948,10,person,11,1,7266,17,276,269,295,302,19,33,person
21949,11,person,12,1,7266,18,272,290,291,331,19,41,person
21950,13,person,14,1,7266,18,255,284,271,331,16,47,person
21951,14,person,15,1,7266,18,292,291,317,331,25,40,person
21952,17,person,18,1,7266,15,145,295,171,331,26,36,person
21953,18,person,19,1,7266,17,164,283,185,330,21,47,person
21954,19,person,20,1,7266,18,143,281,160,322,17,41,person
21955,20,person,21,1,7266,17,180,282,197,327,17,45,person
21956,22,person,23,1,7266,16,264,253,279,279,15,26,person
21957,23,person,24,1,7266,19,239,283,257,331,18,48,person
21958,14,table,15,0,7267,15,32,149,90,165,58,16,dining table
21959,15,sofa,16,0,7267,15,155,100,228,120,73,20,couch
21960,8,person,9,1,7268,43,58,145,175,316,117,171,person
21961,9,person,10,1,7268,29,144,153,243,315,99,162,person
21962,10,person,11,1,7268,24,221,187,310,315,89,128,person
21963,11,person,12,1,7268,37,290,123,394,314,104,191,person
21964,12,person,13,1,7268,18,321,159,471,315,150,156,person
21965,13,person,14,1,7268,20,390,122,442,234,52,112,person
21966,14,person,15,1,7268,32,263,108,321,217,58,109,person
21967,15,person,16,1,7268,17,199,145,252,212,53,67,person
21968,16,person,17,1,7268,29,141,122,210,241,69,119,person
21969,17,person,18,1,7268,16,2,155,33,315,31,160,person
21970,18,person,19,1,7268,36,23,100,85,315,62,215,person
21971,19,person,20,1,7268,37,78,106,149,244,71,138,person
21972,21,person,22,1,7268,19,230,133,264,188,34,55,person
21973,22,person,23,1,7268,16,378,111,403,147,25,36,person
21974,23,person,24,1,7268,18,376,138,411,210,35,72,person
21975,26,person,27,1,7268,28,39,57,82,100,43,43,person
21976,0,bottle,1,0,7270,17,1169,1045,1322,1341,153,296,bottle
21977,1,person,2,1,7270,44,446,787,1147,1650,701,863,person
21978,2,person,3,1,7270,33,1286,1122,1971,1650,685,528,person
21979,4,person,5,1,7270,40,11,830,550,1650,539,820,person
21980,5,person,6,1,7270,38,1131,753,1676,1643,545,890,person
21981,7,person,8,1,7270,34,1684,801,2073,1641,389,840,person
21982,9,person,10,1,7270,44,968,654,1288,1647,320,993,person
21983,10,person,11,1,7270,91,1,414,670,1647,669,1233,person
21984,11,person,12,1,7270,31,392,516,713,989,321,473,person
21985,12,person,13,1,7270,25,313,358,499,803,186,445,person
21986,13,person,14,1,7270,59,611,617,1101,1357,490,740,person
21987,14,person,15,1,7270,43,1120,373,1386,1004,266,631,person
21988,15,person,16,1,7270,33,1989,567,2197,1549,208,982,person
21989,16,person,17,1,7270,28,1945,441,2197,841,252,400,person
21990,17,hat,18,1,7270,15,1521,851,1748,1159,227,308,hat
21991,18,person,19,1,7270,34,1426,549,1782,1049,356,500,person
21992,19,person,20,1,7270,49,1726,255,2145,929,419,674,person
21993,20,person,21,1,7270,15,1652,568,1780,744,128,176,person
21994,21,person,22,1,7270,23,1289,456,1473,766,184,310,person
21995,22,person,23,1,7270,32,1926,273,2197,725,271,452,person
21996,23,person,24,1,7270,30,1564,197,1821,613,257,416,person
21997,24,person,25,1,7270,21,1135,317,1342,605,207,288,person
21998,25,person,26,1,7270,30,783,458,1094,885,311,427,person
21999,26,person,27,1,7270,22,1,552,208,859,207,307,person
22000,27,person,28,1,7270,25,1,388,215,821,214,433,person
22001,28,person,29,1,7270,34,529,371,803,851,274,480,person
22002,30,person,31,1,7270,17,655,358,778,537,123,179,person
22003,31,person,32,1,7270,21,726,322,877,561,151,239,person
22004,32,person,33,1,7270,19,815,282,936,471,121,189,person
22005,33,person,34,1,7270,27,936,392,1140,704,204,312,person
22006,34,person,35,1,7270,17,896,342,1051,455,155,113,person
22007,35,person,36,1,7270,17,1020,342,1138,555,118,213,person
22008,36,person,37,1,7270,17,1107,342,1232,549,125,207,person
22009,37,person,38,1,7270,17,1061,279,1140,460,79,181,person
22010,38,person,39,1,7270,35,1176,148,1393,465,217,317,person
22011,39,person,40,1,7270,22,478,256,659,516,181,260,person
22012,40,person,41,1,7270,24,640,218,809,375,169,157,person
22013,41,person,42,1,7270,16,322,204,452,392,130,188,person
22014,42,person,43,1,7270,18,1798,346,1988,503,190,157,person
22015,43,person,44,1,7270,19,1708,301,1868,570,160,269,person
22016,45,person,46,1,7270,19,1360,266,1465,477,105,211,person
22017,46,person,47,1,7270,20,1422,401,1614,605,192,204,person
22018,2,person,3,1,23274,41,409,47,660,539,251,492,person
22019,3,person,4,1,23274,56,226,48,444,539,218,491,person
22020,4,person,5,1,23274,50,6,78,258,540,252,462,person
22021,5,person,6,1,23274,26,2,88,77,540,75,452,person
22022,3,table,4,1,7437,17,85,676,439,1059,354,383,dining table
22023,4,chair,5,1,7437,21,354,552,599,1041,245,489,chair
22024,7,person,8,0,7437,52,776,111,1596,1063,820,952,person
22025,6,person,7,0,7442,70,516,123,1102,2187,586,2064,person
22026,7,chair,8,1,7442,22,4,983,481,1936,477,953,chair
22027,4,person,5,1,7443,31,20,90,132,248,112,158,person
22028,5,person,6,1,7443,30,167,1,249,250,82,249,person
22029,5,person,6,1,7490,36,253,123,376,280,123,157,person
22030,2,person,3,0,7491,54,1203,72,1929,1300,726,1228,person
22031,3,person,4,1,7491,50,222,124,1271,1464,1049,1340,person
22032,0,person,1,1,7493,41,232,35,355,260,123,225,person
22033,1,person,2,1,7493,42,103,81,224,260,121,179,person
22034,3,person,4,1,7493,17,227,81,252,134,25,53,person
22035,2,person,3,0,7494,26,483,174,518,290,35,116,person
22036,13,person,14,1,7494,22,266,150,313,215,47,65,person
22037,14,person,15,1,7494,17,413,173,448,213,35,40,person
22038,15,person,16,1,7494,21,218,147,262,218,44,71,person
22039,4,table,5,0,7496,15,85,269,237,385,152,116,dining table
22040,21,person,22,1,7496,23,260,175,302,232,42,57,person
22041,15,person,16,1,23299,41,644,436,754,705,110,269,person
22042,16,person,17,1,23299,32,742,462,803,568,61,106,person
22043,3,person,4,1,579,16,376,530,464,640,88,110,person
22044,5,person,6,1,579,16,596,579,648,636,52,57,person
22045,6,person,7,1,579,22,18,471,127,634,109,163,person
22046,7,person,8,1,579,21,157,487,220,632,63,145,person
22047,10,person,11,1,579,20,883,615,948,766,65,151,person
22048,11,person,12,1,579,25,890,663,1011,844,121,181,person
22049,12,person,13,1,579,33,897,640,1070,922,173,282,person
22050,13,person,14,1,579,27,870,702,1013,937,143,235,person
22051,14,person,15,1,579,42,687,623,1279,1023,592,400,person
22052,17,person,18,1,579,23,817,620,887,886,70,266,person
22053,7,person,8,1,7617,27,0,26,41,124,41,98,person
22054,8,person,9,1,7617,24,27,58,63,161,36,103,person
22055,9,person,10,1,7617,17,15,192,48,276,33,84,person
22056,10,person,11,0,7617,18,146,284,172,338,26,54,person
22057,11,person,12,0,7617,16,123,289,145,335,22,46,person
22058,12,person,13,0,7617,17,128,131,152,182,24,51,person
22059,13,person,14,0,7617,17,134,87,155,136,21,49,person
22060,14,person,15,0,7617,23,182,169,209,224,27,55,person
22061,15,person,16,0,7617,21,197,216,226,262,29,46,person
22062,16,person,17,0,7617,21,188,401,205,449,17,48,person
22063,17,person,18,0,7617,15,206,406,224,439,18,33,person
22064,18,person,19,0,7617,18,121,367,149,405,28,38,person
22065,19,person,20,0,7617,16,143,3,158,50,15,47,person
22066,20,person,21,0,7617,18,156,10,174,59,18,49,person
22067,21,person,22,0,7617,20,192,25,210,79,18,54,person
22068,22,person,23,0,7617,20,295,126,334,221,39,95,person
22069,5,person,6,0,7618,33,203,57,242,152,39,95,person
22070,6,person,7,1,7618,16,37,72,51,91,14,19,person
22071,9,person,10,0,7619,37,233,392,377,614,144,222,person
22072,10,person,11,1,7619,46,147,319,285,581,138,262,person
22073,12,person,13,0,7619,33,155,495,260,639,105,144,person
22074,15,airplane,16,0,7619,44,0,3,344,178,344,175,airplane
22075,5,person,6,1,7621,22,766,2,907,294,141,292,person
22076,5,person,6,0,7624,26,192,158,231,269,39,111,person
22077,6,person,7,0,7624,21,229,163,269,261,40,98,person
22078,7,person,8,1,7624,16,103,162,145,226,42,64,person
22079,18,person,19,1,7625,34,33,164,118,242,85,78,person
22080,9,person,10,0,7626,51,313,682,508,1265,195,583,person
22081,10,person,11,0,7626,27,721,716,841,1039,120,323,person
22082,12,person,13,0,7626,33,272,384,328,580,56,196,person
22083,13,person,14,0,7626,31,320,356,408,490,88,134,person
22084,14,person,15,0,7626,21,850,767,886,903,36,136,person
22085,16,person,17,0,7626,19,694,879,741,1008,47,129,person
22086,17,person,18,0,7626,31,875,732,939,962,64,230,person
22087,8,person,9,0,24967,73,298,302,431,762,133,460,person
22088,5,person,6,0,7664,36,12,100,47,204,35,104,person
22089,7,person,8,0,7664,31,133,100,164,188,31,88,person
22090,8,person,9,0,7664,25,154,113,185,184,31,71,person
22091,9,person,10,1,7664,16,213,107,227,155,14,48,person
22092,10,person,11,1,7664,37,93,100,139,232,46,132,person
22093,11,person,12,0,7664,53,210,90,261,232,51,142,person
22094,14,person,15,1,7664,17,68,99,90,140,22,41,person
22095,16,person,17,1,7664,18,2,106,16,178,14,72,person
22096,17,person,18,1,7664,26,288,103,308,179,20,76,person
22097,19,table,20,1,7664,16,196,158,223,208,27,50,dining table
22098,10,person,11,1,7665,16,330,216,339,258,9,42,person
22099,12,person,13,0,7665,19,244,298,276,353,32,55,person
22100,16,person,17,1,7665,19,78,411,112,478,34,67,person
22101,16,person,17,0,7666,23,276,199,291,236,15,37,person
22102,17,person,18,0,7666,24,302,183,313,217,11,34,person
22103,18,person,19,0,7666,19,314,180,323,215,9,35,person
22104,19,person,20,0,7666,21,321,187,334,220,13,33,person
22105,20,person,21,0,7666,18,344,149,353,173,9,24,person
22106,14,chair,15,0,7668,16,47,597,116,663,69,66,chair
22107,15,person,16,1,7669,26,976,790,1074,988,98,198,person
22108,16,person,17,1,7669,16,1128,808,1198,913,70,105,person
22109,18,person,19,1,7669,20,1245,798,1343,1010,98,212,person
22110,19,person,20,1,7669,19,1313,797,1384,1013,71,216,person
22111,20,person,21,1,7669,24,1372,791,1501,1026,129,235,person
22112,21,person,22,1,7669,26,1451,779,1537,1024,86,245,person
22113,22,person,23,1,7669,23,1508,801,1569,1024,61,223,person
22114,23,person,24,1,7669,24,1556,820,1635,1030,79,210,person
22115,24,person,25,1,7669,26,1624,808,1705,1037,81,229,person
22116,25,person,26,1,7669,19,1669,827,1737,1037,68,210,person
22117,26,person,27,1,7669,22,1764,820,1870,974,106,154,person
22118,27,person,28,1,7669,24,1893,786,2040,1062,147,276,person
22119,28,person,29,1,7669,18,1998,813,2091,1062,93,249,person
22120,29,person,30,1,7669,30,342,798,453,1073,111,275,person
22121,30,person,31,1,7669,29,403,790,528,1069,125,279,person
22122,31,person,32,1,7669,18,498,791,548,1037,50,246,person
22123,32,person,33,0,7669,30,525,790,614,1130,89,340,person
22124,33,person,34,1,7669,19,589,779,661,906,72,127,person
22125,34,person,35,1,7669,17,895,784,978,897,83,113,person
22126,35,person,36,1,7669,26,777,765,908,1298,131,533,person
22127,37,person,38,1,7669,19,643,777,722,912,79,135,person
22128,38,person,39,0,7669,43,614,827,852,1441,238,614,person
22129,40,person,41,0,7669,47,4,765,211,1223,207,458,person
22130,9,person,10,0,7670,35,880,430,991,728,111,298,person
22131,11,person,12,0,7670,20,838,430,885,584,47,154,person
22132,14,person,15,1,7670,23,650,417,707,625,57,208,person
22133,15,person,16,1,7670,18,689,433,741,587,52,154,person
22134,16,person,17,1,7670,16,714,436,759,587,45,151,person
22135,17,person,18,1,7670,16,360,439,401,640,41,201,person
22136,0,person,1,0,7671,27,1226,755,1354,1154,128,399,person
22137,1,person,2,0,7671,43,971,916,1122,1395,151,479,person
22138,2,person,3,0,7671,31,410,997,590,1460,180,463,person
22139,3,person,4,0,7671,35,626,833,758,1292,132,459,person
22140,4,person,5,1,7671,27,1352,771,1485,1095,133,324,person
22141,12,person,13,1,7671,22,750,819,824,1222,74,403,person
22142,13,person,14,0,7671,28,752,852,903,1306,151,454,person
22143,14,person,15,1,7671,20,586,814,700,1259,114,445,person
22144,16,car,17,1,7671,29,987,603,1494,820,507,217,car
22145,17,person,18,1,7671,33,1466,650,1556,1003,90,353,person
22146,18,person,19,1,7671,38,1039,842,1176,1238,137,396,person
22147,24,person,25,1,7671,24,1359,683,1444,911,85,228,person
22148,25,person,26,1,7671,20,1499,835,1601,1003,102,168,person
22149,27,person,28,1,7671,23,1550,663,1654,885,104,222,person
22150,35,person,36,1,7671,19,1498,386,1543,496,45,110,person
22151,36,person,37,1,7671,20,1531,393,1574,547,43,154,person
22152,37,person,38,1,7671,18,1459,419,1516,537,57,118,person
22153,38,person,39,1,7671,19,1406,418,1461,550,55,132,person
22154,43,person,44,1,7671,23,1249,485,1324,605,75,120,person
22155,45,person,46,1,7671,20,1113,508,1195,621,82,113,person
22156,46,person,47,1,7671,19,1186,498,1230,602,44,104,person
22157,48,person,49,1,7671,22,957,451,1015,645,58,194,person
22158,49,person,50,1,7671,21,977,525,1037,691,60,166,person
22159,50,person,51,1,7671,32,915,673,993,1021,78,348,person
22160,51,person,52,1,7671,21,1030,455,1081,592,51,137,person
22161,59,person,60,1,7671,26,1623,490,1700,669,77,179,person
22162,60,person,61,1,7671,17,1632,627,1727,743,95,116,person
22163,61,person,62,1,7671,15,1688,581,1724,671,36,90,person
22164,62,person,63,1,7671,18,1716,592,1807,736,91,144,person
22165,63,person,64,1,7671,22,1709,512,1785,646,76,134,person
22166,64,person,65,1,7671,30,1783,549,1881,781,98,232,person
22167,66,person,67,1,7671,23,1810,439,1883,588,73,149,person
22168,67,person,68,1,7671,21,1873,442,1926,625,53,183,person
22169,68,person,69,1,7671,22,1748,363,1814,507,66,144,person
22170,70,person,71,1,7671,16,1975,345,2022,428,47,83,person
22171,71,person,72,1,7671,17,1930,431,1981,605,51,174,person
22172,8,person,9,0,143,53,236,246,286,350,50,104,person
22173,17,person,18,0,143,72,324,244,381,357,57,113,person
22174,9,person,10,1,7715,20,1132,745,1241,948,109,203,person
22175,10,person,11,1,7715,20,1062,801,1191,972,129,171,person
22176,11,person,12,1,7715,23,1187,774,1370,963,183,189,person
22177,12,person,13,1,7715,19,1329,813,1468,965,139,152,person
22178,2,person,3,0,7718,66,2,193,89,360,87,167,person
22179,11,person,12,1,7718,21,341,234,386,310,45,76,person
22180,24,table,25,1,7718,16,171,285,306,323,135,38,dining table
22181,25,person,26,1,7718,38,222,222,308,349,86,127,person
22182,26,person,27,1,7718,15,169,222,204,295,35,73,person
22183,27,person,28,1,7718,37,102,227,217,358,115,131,person
22184,28,person,29,1,7718,15,235,221,249,248,14,27,person
22185,29,person,30,1,7718,17,236,237,254,273,18,36,person
22186,30,person,31,0,7718,21,208,217,231,272,23,55,person
22187,31,chair,32,1,7718,20,265,273,331,359,66,86,chair
22188,33,chair,34,1,7718,31,0,270,51,358,51,88,chair
22189,36,chair,37,0,7718,29,458,267,525,357,67,90,chair
22190,9,chair,10,0,7719,22,196,190,258,276,62,86,chair
22191,11,chair,12,0,7719,21,346,174,394,239,48,65,chair
22192,9,person,10,1,7720,20,85,164,115,194,30,30,person
22193,11,person,12,1,7720,15,76,162,88,195,12,33,person
22194,12,person,13,1,7720,24,30,176,56,248,26,72,person
22195,21,chair,22,0,7720,17,167,210,193,243,26,33,chair
22196,24,chair,25,0,7720,18,246,212,270,240,24,28,chair
22197,29,chair,30,0,7720,16,287,251,325,296,38,45,chair
22198,32,chair,33,0,7720,17,371,232,411,277,40,45,chair
22199,2,person,3,1,7721,27,172,99,202,182,30,83,person
22200,3,person,4,1,7721,16,149,101,162,131,13,30,person
22201,4,person,5,1,7721,19,225,110,240,162,15,52,person
22202,6,chair,7,1,7721,18,217,188,257,265,40,77,chair
22203,7,chair,8,1,7721,21,169,192,221,270,52,78,chair
22204,13,chair,14,1,7721,20,332,206,395,271,63,65,chair
22205,15,person,16,1,7721,33,299,112,346,182,47,70,person
22206,9,person,10,1,7723,18,59,132,92,185,33,53,person
22207,8,person,9,0,7724,42,175,238,271,398,96,160,person
22208,11,person,12,1,7724,26,0,267,70,403,70,136,person
22209,13,person,14,0,7726,46,440,151,486,344,46,193,person
22210,15,chair,16,1,7726,15,391,245,431,322,40,77,chair
22211,16,person,17,1,7726,29,390,199,433,314,43,115,person
22212,17,chair,18,1,7726,20,334,255,384,336,50,81,chair
22213,18,person,19,1,7726,39,330,204,397,327,67,123,person
22214,20,person,21,1,7726,41,275,208,332,351,57,143,person
22215,21,chair,22,0,7726,17,240,277,336,372,96,95,chair
22216,22,chair,23,1,7726,27,168,263,241,369,73,106,chair
22217,23,person,24,1,7726,34,195,209,260,348,65,139,person
22218,24,person,25,1,7726,21,159,207,208,300,49,93,person
22219,25,chair,26,1,7726,25,147,252,172,353,25,101,chair
22220,27,person,28,1,7726,33,91,202,151,329,60,127,person
22221,35,person,36,1,7726,24,2,195,59,271,57,76,person
22222,36,person,37,1,7726,19,60,192,91,248,31,56,person
22223,37,person,38,1,7726,17,73,167,98,199,25,32,person
22224,38,chair,39,1,7726,29,0,288,94,372,94,84,chair
22225,10,chair,11,1,7727,32,225,1093,540,1536,315,443,chair
22226,12,chair,13,1,7727,17,631,1032,892,1130,261,98,chair
22227,13,chair,14,1,7727,31,875,1097,1241,1534,366,437,chair
22228,14,chair,15,1,7727,21,488,1234,876,1533,388,299,chair
22229,55,chair,56,1,7727,62,1330,925,1608,1293,278,368,chair
22230,104,chair,105,1,7727,26,1651,1127,1994,1257,343,130,chair
22231,10,table,11,0,7729,17,434,220,538,328,104,108,dining table
22232,17,person,18,0,7729,62,194,121,279,411,85,290,person
22233,18,person,19,0,7729,59,274,108,377,399,103,291,person
22234,4,person,5,1,7730,17,345,183,369,228,24,45,person
22235,8,person,9,1,7731,16,253,138,282,187,29,49,person
22236,11,person,12,1,7731,24,359,158,414,232,55,74,person
22237,12,person,13,1,7731,23,463,158,500,229,37,71,person
22238,13,person,14,1,7731,35,411,169,470,243,59,74,person
22239,15,person,16,0,7731,36,0,144,97,336,97,192,person
22240,16,person,17,1,7731,47,62,165,320,375,258,210,person
22241,13,person,14,1,7733,18,560,1028,732,1199,172,171,person
22242,14,person,15,1,7733,22,747,962,973,1196,226,234,person
22243,15,person,16,1,7733,21,1055,971,1219,1196,164,225,person
22244,16,person,17,1,7733,24,1257,907,1483,1194,226,287,person
22245,8,chair,9,0,7734,27,178,168,258,295,80,127,chair
22246,9,chair,10,0,7734,24,270,187,371,299,101,112,chair
22247,10,chair,11,1,7734,20,277,147,346,217,69,70,chair
22248,19,chair,20,0,7734,29,37,163,113,276,76,113,chair
22249,20,chair,21,1,7734,15,82,136,145,227,63,91,chair
22250,6,person,7,0,7735,56,657,317,756,545,99,228,person
22251,7,person,8,1,7735,27,765,288,798,583,33,295,person
22252,2,car,3,0,23352,31,145,1398,474,1550,329,152,car
22253,7,car,8,0,23352,19,2004,1438,2075,1469,71,31,car
22254,4,person,5,1,7906,46,108,27,265,178,157,151,person
22255,6,person,7,0,7907,15,1431,327,1485,513,54,186,person
22256,8,person,9,1,7907,16,1270,330,1333,531,63,201,person
22257,10,person,11,1,7907,24,1110,312,1297,759,187,447,person
22258,15,person,16,1,7907,21,1754,328,1807,635,53,307,person
22259,16,person,17,0,7907,28,1688,322,1779,668,91,346,person
22260,17,person,18,1,7907,25,1567,359,1687,635,120,276,person
22261,18,person,19,0,7907,75,1787,325,2098,951,311,626,person
22262,21,person,22,1,7907,25,465,480,609,639,144,159,person
22263,22,person,23,1,7907,15,312,544,414,714,102,170,person
22264,23,person,24,1,7907,21,372,534,527,810,155,276,person
22265,39,person,40,1,7907,18,728,481,805,770,77,289,person
22266,40,person,41,1,7907,18,794,409,892,606,98,197,person
22267,47,person,48,1,7907,30,2044,359,2173,758,129,399,person
22268,51,person,52,1,7907,28,1484,326,1537,491,53,165,person
22269,9,person,10,1,7908,19,821,285,957,531,136,246,person
22270,4,person,5,1,7909,28,978,0,1150,861,172,861,person
22271,5,person,6,1,7909,30,703,554,1065,862,362,308,person
22272,6,person,7,1,7909,22,937,149,1034,381,97,232,person
22273,8,person,9,1,7909,45,274,62,623,731,349,669,person
22274,14,person,15,1,7909,22,674,152,809,332,135,180,person
22275,11,person,12,1,7910,15,1225,579,1467,900,242,321,person
22276,12,person,13,1,7910,32,1549,372,2056,1339,507,967,person
22277,14,person,15,1,7910,15,6,712,228,1183,222,471,person
22278,18,person,19,1,7910,84,360,315,1939,1464,1579,1149,person
22279,6,chair,7,0,7927,20,83,230,106,294,23,64,chair
22280,3,person,4,1,7930,55,217,98,369,334,152,236,person
22281,5,person,6,0,7932,74,70,4,186,398,116,394,person
22282,6,person,7,0,7933,88,340,269,895,1597,555,1328,person
22283,4,person,5,0,7934,73,90,2,279,599,189,597,person
22284,6,person,7,1,7935,20,37,297,201,404,164,107,person
22285,7,person,8,1,7935,64,330,1,608,405,278,404,person
22286,6,person,7,0,7936,81,557,0,1002,1143,445,1143,person
22287,9,person,10,1,7938,42,4,530,432,2036,428,1506,person
22288,4,person,5,1,7939,56,178,78,396,697,218,619,person
22289,6,chair,7,1,7940,20,264,200,368,299,104,99,chair
22290,7,person,8,1,7941,65,519,167,1145,1193,626,1026,person
22291,6,person,7,1,7952,23,440,51,485,165,45,114,person
22292,7,person,8,1,7952,22,203,74,242,167,39,93,person
22293,8,person,9,1,7952,21,146,73,203,173,57,100,person
22294,9,person,10,1,7952,32,114,72,157,198,43,126,person
22295,11,person,12,1,7952,22,2,56,71,300,69,244,person
22296,12,person,13,1,7952,17,86,67,114,137,28,70,person
22297,13,person,14,1,7952,18,73,79,104,195,31,116,person
22298,14,person,15,1,7952,23,45,60,83,202,38,142,person
22299,5,person,6,0,7953,35,410,69,467,269,57,200,person
22300,11,person,12,1,7953,28,44,80,158,298,114,218,person
22301,13,person,14,1,7953,17,159,114,239,150,80,36,person
22302,15,person,16,1,7953,15,200,69,241,125,41,56,person
22303,16,person,17,1,7953,19,229,63,269,141,40,78,person
22304,17,person,18,1,7953,17,255,65,281,138,26,73,person
22305,18,person,19,1,7953,18,161,78,197,122,36,44,person
22306,19,person,20,1,7953,19,135,72,166,118,31,46,person
22307,20,person,21,1,7953,23,7,76,38,142,31,66,person
22308,23,person,24,1,7953,26,326,53,398,279,72,226,person
22309,24,person,25,1,7953,21,392,69,437,140,45,71,person
22310,25,person,26,1,7953,23,493,78,549,292,56,214,person
22311,27,person,28,1,7953,15,446,62,472,113,26,51,person
22312,4,person,5,1,7954,45,315,64,366,248,51,184,person
22313,8,vase,9,1,7954,26,219,113,255,177,36,64,vase
22314,9,vase,10,0,7954,24,120,112,152,172,32,60,vase
22315,11,table,12,1,7954,27,57,187,186,278,129,91,dining table
22316,13,chair,14,1,7954,29,141,149,212,279,71,130,chair
22317,14,chair,15,1,7954,31,175,179,248,279,73,100,chair
22318,15,chair,16,1,7954,34,2,181,68,278,66,97,chair
22319,18,chair,19,1,7954,24,340,167,384,277,44,110,chair
22320,25,clock,26,0,7954,15,190,95,225,121,35,26,clock
22321,26,vase,27,0,7954,15,80,27,93,52,13,25,vase
22322,27,chair,28,1,7954,16,312,173,329,234,17,61,chair
22323,28,bicycle,29,0,7955,50,124,278,276,438,152,160,bicycle
22324,29,bicycle,30,1,7955,33,173,282,308,432,135,150,bicycle
22325,31,pot,32,0,7955,15,331,388,418,477,87,89,potted plant
22326,33,chair,34,1,7955,21,373,319,466,458,93,139,chair
22327,37,chair,38,1,7955,15,471,302,542,366,71,64,chair
22328,39,chair,40,1,7955,15,634,269,686,336,52,67,chair
22329,40,person,41,1,7955,23,616,223,707,319,91,96,person
22330,44,pot,45,1,7955,16,678,388,738,460,60,72,potted plant
22331,46,person,47,0,7955,19,620,191,640,247,20,56,person
22332,9,person,10,1,7956,32,224,249,389,541,165,292,person
22333,10,person,11,1,7956,27,393,296,529,480,136,184,person
22334,11,sofa,12,1,7956,16,730,437,1018,579,288,142,couch
22335,12,person,13,1,7956,17,635,369,771,500,136,131,person
22336,46,person,47,1,24988,51,1,215,325,523,324,308,person
22337,4,door,5,0,24989,15,1007,576,1133,738,126,162,door
22338,5,person,6,1,24989,18,1113,619,1149,791,36,172,person
22339,6,person,7,1,24989,19,1067,625,1101,782,34,157,person
22340,7,person,8,0,24989,18,1084,635,1136,793,52,158,person
22341,8,person,9,0,24989,20,999,638,1035,793,36,155,person
22342,15,person,16,1,24989,41,30,538,259,1243,229,705,person
22343,16,person,17,1,24989,19,487,603,580,802,93,199,person
22344,17,person,18,1,24989,16,449,564,562,810,113,246,person
22345,18,person,19,1,24989,96,189,216,684,1642,495,1426,person
22346,19,person,20,1,24989,104,645,469,1107,1642,462,1173,person
22347,20,person,21,1,24989,105,1254,481,1633,1640,379,1159,person
22348,21,person,22,1,24989,105,1528,314,2000,1642,472,1328,person
22349,22,person,23,1,24989,35,1978,502,2197,1399,219,897,person
22350,0,table,1,0,7996,20,128,329,435,486,307,157,dining table
22351,8,flowerpot,9,0,7996,17,344,327,380,375,36,48,potted plant
22352,14,person,15,1,7996,58,195,80,323,486,128,406,person
22353,15,person,16,1,7996,54,288,97,404,486,116,389,person
22354,1,flowerpot,2,0,7998,19,175,217,232,265,57,48,potted plant
22355,2,flowerpot,3,0,7998,16,126,209,162,241,36,32,potted plant
22356,5,flowerpot,6,0,7998,17,36,176,76,214,40,38,potted plant
22357,7,flowerpot,8,0,7998,15,249,234,313,295,64,61,potted plant
22358,8,flowerpot,9,0,7998,18,307,282,383,365,76,83,potted plant
22359,9,flowerpot,10,0,7998,16,380,269,426,343,46,74,potted plant
22360,12,plant pots,13,1,7998,17,284,151,337,175,53,24,potted plant
22361,13,flowerpot,14,0,7998,15,419,244,454,312,35,68,potted plant
22362,16,flowerpot,17,0,7998,16,2,194,32,220,30,26,potted plant
22363,55,plant pots,56,1,7998,19,351,125,449,154,98,29,potted plant
22364,68,person,69,1,7998,15,3,79,15,113,12,34,person
22365,9,person,10,1,8001,16,543,263,682,474,139,211,person
22366,4,person,5,0,8002,62,28,55,118,375,90,320,person
22367,5,backpack,6,0,8002,19,7,121,47,224,40,103,backpack
22368,67,person,68,1,8003,21,133,35,157,117,24,82,person
22369,68,person,69,1,8003,43,79,34,128,129,49,95,person
22370,69,person,70,0,8003,45,21,29,74,179,53,150,person
22371,3,person,4,1,8004,61,296,1,496,372,200,371,person
22372,4,table,5,1,8004,45,92,118,323,343,231,225,dining table
22373,7,flowerpot,8,0,8005,19,197,208,223,239,26,31,potted plant
22374,4,table,5,1,8006,15,79,106,257,203,178,97,dining table
22375,2,person,3,1,8007,38,104,73,251,204,147,131,person
22376,3,vase,4,0,8007,17,303,143,369,269,66,126,vase
22377,1,person,2,1,8008,70,170,125,341,251,171,126,person
22378,4,person,5,1,8008,27,406,0,445,172,39,172,person
22379,5,flowerpot,6,0,8008,15,210,221,257,270,47,49,potted plant
22380,6,bottle,7,0,8008,19,388,163,445,272,57,109,bottle
22381,3,flowerpot,4,0,8009,16,163,84,200,119,37,35,potted plant
22382,1,vase,2,0,24996,28,522,664,728,766,206,102,vase
22383,0,table,1,0,24997,34,3,1392,1963,1957,1960,565,dining table
22384,2,person,3,1,8011,35,429,132,500,344,71,212,person
22385,3,person,4,1,8011,50,315,149,433,298,118,149,person
22386,9,vase,10,0,8012,15,117,138,149,175,32,37,vase
22387,22,person,23,1,8012,21,28,72,48,140,20,68,person
22388,25,person,26,1,8012,19,0,79,15,163,15,84,person
22389,26,person,27,0,8012,28,14,77,39,165,25,88,person
22390,27,person,28,0,8012,33,41,95,66,161,25,66,person
22391,3,bicycle,4,1,8016,24,272,121,324,201,52,80,bicycle
22392,5,chair,6,0,8017,15,61,147,96,188,35,41,chair
22393,6,chair,7,0,8017,17,51,126,71,151,20,25,chair
22394,2,person,3,1,8018,16,382,141,398,256,16,115,person
22395,11,person,12,1,8019,48,183,107,308,374,125,267,person
22396,7,table,8,0,8028,22,365,613,623,863,258,250,dining table
22397,8,table,9,0,8028,19,38,536,333,765,295,229,dining table
22398,9,chair,10,0,8028,24,235,534,411,782,176,248,chair
22399,10,table,11,0,8028,19,684,560,890,771,206,211,dining table
22400,11,table,12,0,8028,19,583,545,756,740,173,195,dining table
22401,16,chair,17,0,8028,20,947,490,1057,627,110,137,chair
22402,17,chair,18,1,8028,17,797,551,924,765,127,214,chair
22403,19,person,20,1,8028,18,795,343,846,432,51,89,person
22404,24,chair,25,1,8028,18,91,462,171,539,80,77,chair
22405,26,person,27,1,8028,20,284,364,347,439,63,75,person
22406,27,person,28,1,8028,17,360,370,411,442,51,72,person
22407,35,table,36,1,8028,16,1080,530,1219,668,139,138,dining table
22408,36,chair,37,0,8028,15,1052,516,1172,694,120,178,chair
22409,37,chair,38,1,8028,19,1166,498,1262,660,96,162,chair
22410,41,person,42,1,8028,16,1210,405,1276,481,66,76,person
22411,47,chair,48,0,8028,26,629,579,815,802,186,223,chair
22412,48,chair,49,1,8028,19,528,549,660,756,132,207,chair
22413,18,person,19,1,8029,19,340,186,365,267,25,81,person
22414,19,person,20,1,8029,16,400,180,444,221,44,41,person
22415,20,person,21,0,8029,18,388,187,408,274,20,87,person
22416,24,person,25,0,8029,20,40,196,75,263,35,67,person
22417,27,person,28,1,8029,24,2,206,47,285,45,79,person
22418,38,chair,39,0,8029,16,278,282,324,361,46,79,chair
22419,39,chair,40,0,8029,19,345,279,400,365,55,86,chair
22420,40,person,41,1,8029,20,210,226,263,291,53,65,person
22421,4,table,5,0,8030,19,116,836,651,1191,535,355,dining table
22422,5,chair,6,0,8030,20,407,869,689,1188,282,319,chair
22423,6,chair,7,0,8030,22,57,850,379,1188,322,338,chair
22424,11,table,12,0,8030,21,573,717,911,999,338,282,dining table
22425,12,chair,13,1,8030,18,748,753,899,1020,151,267,chair
22426,14,person,15,1,8030,17,888,632,994,750,106,118,person
22427,15,chair,16,1,8030,17,667,625,767,748,100,123,chair
22428,21,person,22,1,8030,25,317,613,466,838,149,225,person
22429,22,person,23,1,8030,17,436,611,535,788,99,177,person
22430,7,chair,8,0,8031,17,296,257,366,344,70,87,chair
22431,8,chair,9,0,8031,21,170,260,253,367,83,107,chair
22432,9,table,10,1,8031,15,97,285,162,354,65,69,dining table
22433,10,person,11,1,8031,19,10,195,53,255,43,60,person
22434,15,chair,16,0,8031,19,516,238,590,357,74,119,chair
22435,19,person,20,1,8031,17,565,202,605,239,40,37,person
22436,20,chair,21,0,8031,21,396,240,448,328,52,88,chair
22437,10,person,11,0,8034,62,146,290,908,1647,762,1357,person
22438,11,table,12,1,8034,16,1910,732,2197,1201,287,469,dining table
22439,12,person,13,0,8034,51,1673,299,2080,1158,407,859,person
22440,13,chair,14,1,8034,15,1819,784,2190,1363,371,579,chair
22441,20,chair,21,0,8034,16,1084,531,1237,736,153,205,chair
22442,21,person,22,0,8034,23,1126,426,1266,719,140,293,person
22443,24,person,25,1,8034,17,1337,426,1461,583,124,157,person
22444,26,person,27,1,8034,16,1172,307,1230,422,58,115,person
22445,27,person,28,1,8034,22,2027,449,2141,564,114,115,person
22446,30,person,31,0,8034,32,958,347,1040,615,82,268,person
22447,31,person,32,0,8034,36,900,343,982,625,82,282,person
22448,32,person,33,1,8034,31,452,317,587,662,135,345,person
22449,21,person,22,1,8035,24,1969,662,2063,929,94,267,person
22450,22,chair,23,1,8035,18,1992,845,2139,1092,147,247,chair
22451,23,chair,24,0,8035,19,1789,924,2003,1261,214,337,chair
22452,24,chair,25,0,8035,19,1382,929,1576,1250,194,321,chair
22453,26,table,27,0,8035,16,1501,941,1807,1188,306,247,dining table
22454,27,chair,28,0,8035,18,1444,859,1564,1023,120,164,chair
22455,28,person,29,1,8035,24,1512,808,1636,982,124,174,person
22456,29,person,30,1,8035,15,1496,764,1583,893,87,129,person
22457,31,person,32,1,8035,27,1690,783,1866,1000,176,217,person
22458,32,person,33,1,8035,23,1693,749,1779,887,86,138,person
22459,33,person,34,1,8035,27,1814,655,1914,865,100,210,person
22460,34,person,35,1,8035,26,1711,658,1794,829,83,171,person
22461,35,person,36,1,8035,16,1686,675,1727,811,41,136,person
22462,39,chair,40,0,8035,18,754,931,954,1229,200,298,chair
22463,42,chair,43,0,8035,17,1103,929,1282,1237,179,308,chair
22464,43,person,44,0,8035,57,1039,790,1242,1252,203,462,person
22465,44,person,45,1,8035,24,1040,771,1158,950,118,179,person
22466,46,chair,47,0,8035,17,496,924,663,1213,167,289,chair
22467,47,chair,48,0,8035,15,649,914,761,1165,112,251,chair
22468,48,table,49,1,8035,15,424,941,616,1153,192,212,dining table
22469,50,person,51,1,8035,23,1306,668,1393,900,87,232,person
22470,51,person,52,0,8035,23,1215,720,1288,916,73,196,person
22471,53,person,54,1,8035,15,1072,713,1124,836,52,123,person
22472,54,person,55,1,8035,23,969,707,1044,857,75,150,person
22473,55,person,56,1,8035,18,912,729,1000,868,88,139,person
22474,56,person,57,1,8035,32,461,719,655,959,194,240,person
22475,57,person,58,1,8035,19,640,690,707,902,67,212,person
22476,60,person,61,1,8035,16,389,705,450,833,61,128,person
22477,61,person,62,0,8035,62,197,731,552,1421,355,690,person
22478,73,person,74,1,8035,17,1672,660,1721,863,49,203,person
22479,5,chair,6,1,8036,19,38,126,70,194,32,68,chair
22480,6,person,7,0,8036,41,45,106,87,194,42,88,person
22481,7,chair,8,1,8036,21,122,122,156,184,34,62,chair
22482,8,person,9,0,8036,49,103,105,142,190,39,85,person
22483,9,chair,10,0,8036,22,180,114,217,175,37,61,chair
22484,10,person,11,1,8036,29,194,97,224,169,30,72,person
22485,11,person,12,0,8036,21,191,77,203,115,12,38,person
22486,12,person,13,1,8036,21,114,78,131,114,17,36,person
22487,14,person,15,1,8036,24,71,76,92,124,21,48,person
22488,15,person,16,1,8036,25,50,78,73,125,23,47,person
22489,16,person,17,1,8036,30,28,75,53,137,25,62,person
22490,17,person,18,0,8036,23,16,85,27,130,11,45,person
22491,18,person,19,1,8036,19,0,101,15,144,15,43,person
22492,19,person,20,1,8036,17,6,86,15,113,9,27,person
22493,8,chair,9,0,8037,15,457,274,510,347,53,73,chair
22494,27,person,28,1,8037,23,13,213,65,266,52,53,person
22495,31,chair,32,1,8037,16,539,291,592,383,53,92,chair
22496,1,table,2,0,23393,16,73,749,681,1022,608,273,dining table
22497,3,person,4,1,23393,86,23,211,335,1023,312,812,person
22498,5,bowl,6,0,23393,15,303,724,459,775,156,51,bowl
22499,12,person,13,1,8583,18,218,189,258,241,40,52,person
22500,13,person,14,1,8583,24,166,209,244,242,78,33,person
22501,14,person,15,1,8583,27,90,188,165,242,75,54,person
22502,15,person,16,1,8583,20,45,179,100,242,55,63,person
22503,16,person,17,1,8583,17,2,195,50,241,48,46,person
22504,15,chair,16,1,8585,17,262,270,358,371,96,101,chair
22505,19,person,20,1,8585,21,160,150,215,213,55,63,person
22506,27,chair,28,1,8586,15,759,908,917,955,158,47,chair
22507,0,door,1,1,8587,19,1,358,185,1612,184,1254,door
22508,4,pots,4,0,8589,20,174,157,227,216,53,59,potted plant
22509,10,person,11,1,8639,41,9,203,122,404,113,201,person
22510,13,person,14,1,8639,28,87,185,280,431,193,246,person
22511,15,person,16,1,8639,24,203,210,277,364,74,154,person
22512,17,person,18,1,8639,22,261,205,311,321,50,116,person
22513,18,person,19,1,8639,24,305,207,357,319,52,112,person
22514,19,person,20,1,8639,23,315,224,372,327,57,103,person
22515,20,person,21,1,8639,21,388,205,428,321,40,116,person
22516,21,person,22,1,8639,21,464,191,505,284,41,93,person
22517,22,person,23,1,8639,29,398,192,476,319,78,127,person
22518,24,person,25,1,8639,26,536,201,585,290,49,89,person
22519,25,person,26,1,8639,34,433,229,576,429,143,200,person
22520,26,person,27,1,8639,17,571,219,608,378,37,159,person
22521,29,door,30,1,8639,24,482,172,569,236,87,64,door
22522,6,table,7,0,8640,16,159,285,461,554,302,269,dining table
22523,7,table,8,0,8640,19,281,345,544,596,263,251,dining table
22524,3,person,4,1,8641,57,192,146,642,803,450,657,person
22525,4,person,5,1,8641,82,826,79,1424,978,598,899,person
22526,10,vase,11,0,8641,15,225,38,292,157,67,119,vase
22527,15,chair,16,1,8642,17,5,234,55,287,50,53,chair
22528,16,chair,17,1,8642,18,267,207,286,297,19,90,chair
22529,27,vase,28,0,8642,15,106,184,138,282,32,98,vase
22530,26,bowl,27,0,8643,16,1064,886,1121,956,57,70,bowl
22531,38,pot,39,0,8643,15,859,789,905,844,46,55,potted plant
22532,40,vase,41,0,8643,17,847,616,927,689,80,73,vase
22533,52,mirror,45,0,8643,31,817,275,912,467,95,192,mirror
22534,55,bowl,47,0,8643,19,784,52,884,128,100,76,bowl
22535,56,bottle,48,0,8643,15,733,34,783,139,50,105,bottle
22536,78,plate,70,1,8643,16,643,353,681,396,38,43,plate
22537,90,plate,82,1,8643,15,842,581,908,630,66,49,plate
22538,91,plate,83,0,8643,15,776,404,831,470,55,66,plate
22539,99,bottle,88,0,8643,18,664,485,697,548,33,63,bottle
22540,106,bowl,95,0,8643,25,713,686,815,740,102,54,bowl
22541,115,pot,104,0,8643,17,530,644,614,794,84,150,potted plant
22542,124,table,110,1,8643,55,268,680,489,959,221,279,dining table
22543,142,plate,126,0,8643,15,6,160,82,243,76,83,plate
22544,151,plate,135,1,8643,18,1,274,73,354,72,80,plate
22545,156,bowl,140,1,8643,16,118,389,209,453,91,64,bowl
22546,176,bowl,158,1,8643,15,101,759,193,805,92,46,bowl
22547,8,chair,9,0,8645,20,714,347,758,408,44,61,chair
22548,4,person,5,1,8646,36,157,322,436,675,279,353,person
22549,5,person,6,1,8646,22,2,330,183,951,181,621,person
22550,72,bowl,73,0,8646,18,951,744,1053,816,102,72,bowl
22551,3,person,4,0,23456,28,917,71,989,242,72,171,person
22552,4,person,5,1,23456,32,549,43,643,198,94,155,person
22553,7,ball,8,1,23456,20,195,424,320,541,125,117,sports ball
22554,4,window,5,0,8710,21,868,1086,1066,1649,198,563,window
22555,7,bench,8,0,8710,16,708,1623,1051,2026,343,403,bench
22556,8,bench,9,1,8710,21,1175,1699,1453,2197,278,498,bench
22557,23,person,24,0,8713,16,287,357,300,394,13,37,person
22558,4,sofa,5,1,8796,22,1000,492,1279,768,279,276,couch
22559,9,person,10,0,8903,100,373,629,773,1674,400,1045,person
22560,10,person,11,0,8903,74,713,1049,1105,1607,392,558,person
22561,15,person,16,0,8904,52,194,99,274,328,80,229,person
22562,5,person,6,1,8905,17,35,41,55,67,20,26,person
22563,6,person,7,0,8905,25,77,37,110,119,33,82,person
22564,16,person,17,1,23504,17,275,193,342,259,67,66,person
22565,17,person,18,1,23504,30,341,216,496,328,155,112,person
22566,18,person,19,1,23504,41,484,202,669,426,185,224,person
22567,19,person,20,0,23504,83,488,376,754,767,266,391,person
22568,20,person,21,1,23504,92,46,158,310,767,264,609,person
22569,3,person,4,1,8907,35,172,186,349,466,177,280,person
22570,16,hat,17,0,8907,15,89,106,144,151,55,45,hat
22571,17,hat,18,0,8907,15,47,109,90,154,43,45,hat
22572,18,hat,19,0,8907,15,20,157,81,207,61,50,hat
22573,5,person,6,1,8908,29,187,399,340,582,153,183,person
22574,7,hat,8,0,8909,16,193,117,262,160,69,43,hat
22575,8,hat,9,0,8909,24,330,91,404,170,74,79,hat
22576,9,hat,10,0,8909,19,280,132,360,186,80,54,hat
22577,10,hat,11,0,8909,16,336,163,400,210,64,47,hat
22578,11,hat,12,1,8909,17,252,160,321,204,69,44,hat
22579,12,hat,13,0,8909,17,284,203,376,267,92,64,hat
22580,15,hat,16,0,8909,15,194,169,249,213,55,44,hat
22581,16,hat,17,0,8909,16,199,231,248,271,49,40,hat
22582,17,hat,18,0,8909,17,238,237,307,285,69,48,hat
22583,18,hat,19,0,8909,16,281,291,341,349,60,58,hat
22584,21,hat,22,0,8909,16,377,361,456,420,79,59,hat
22585,22,hat,23,0,8909,25,432,325,525,402,93,77,hat
22586,23,table,24,0,8909,23,378,299,461,365,83,66,dining table
22587,24,hat,25,0,8909,16,402,285,454,330,52,45,hat
22588,25,hat,26,0,8909,19,501,161,586,236,85,75,hat
22589,26,hat,27,0,8909,19,238,360,314,423,76,63,hat
22590,27,hat,28,0,8909,19,429,169,509,221,80,52,hat
22591,34,hat,35,0,8909,15,574,246,627,281,53,35,hat
22592,35,hat,36,0,8909,16,399,140,440,173,41,33,hat
22593,37,hat,38,1,8909,18,467,223,535,264,68,41,hat
22594,38,hat,39,0,8909,15,465,256,547,324,82,68,hat
22595,41,hat,42,0,8909,17,173,262,231,302,58,40,hat
22596,42,hat,43,1,8909,17,83,95,149,139,66,44,hat
22597,43,hat,44,0,8909,20,33,117,124,167,91,50,hat
22598,44,hat,45,0,8909,20,32,199,136,261,104,62,hat
22599,45,hat,46,0,8909,17,100,250,165,302,65,52,hat
22600,46,hat,47,0,8909,20,23,313,123,385,100,72,hat
22601,47,hat,48,1,8909,18,85,340,158,407,73,67,hat
22602,48,hat,49,0,8909,15,161,215,205,249,44,34,hat
22603,49,chair,50,1,8909,20,128,150,188,234,60,84,chair
22604,51,hat,52,0,8909,20,10,51,99,108,89,57,hat
22605,0,person,1,1,8910,54,270,446,838,1533,568,1087,person
22606,1,person,2,1,8910,42,719,576,1266,1530,547,954,person
22607,2,person,3,1,8910,31,1105,671,1738,1533,633,862,person
22608,3,hat,4,0,8910,34,1171,354,1806,790,635,436,hat
22609,5,hat,6,0,8910,15,948,582,1171,746,223,164,hat
22610,7,hat,8,0,8910,21,15,12,297,258,282,246,hat
22611,8,hat,9,0,8910,28,184,261,564,636,380,375,hat
22612,11,hat,12,0,8910,17,945,30,1206,285,261,255,hat
22613,12,hat,13,0,8910,19,65,912,303,1224,238,312,hat
22614,28,hat,29,1,8910,24,0,618,232,930,232,312,hat
22615,3,person,4,1,8911,43,438,115,598,479,160,364,person
22616,4,hat,5,0,8911,54,428,66,616,185,188,119,hat
22617,5,person,6,1,8911,29,73,232,205,384,132,152,person
22618,6,hat,7,0,8911,25,97,219,184,278,87,59,hat
22619,7,person,8,1,8911,17,0,276,57,415,57,139,person
22620,8,chair,9,1,8911,15,40,292,97,387,57,95,chair
22621,4,person,5,1,8912,54,476,441,747,1198,271,757,person
22622,5,person,6,1,8912,53,710,323,1098,1193,388,870,person
22623,10,hat,11,0,8912,16,144,919,316,1035,172,116,hat
22624,11,hat,12,0,8912,15,114,1024,299,1149,185,125,hat
22625,17,hat,18,0,8913,16,309,121,451,185,142,64,hat
22626,19,hat,20,0,8913,15,552,136,675,207,123,71,hat
22627,20,hat,21,0,8913,17,181,113,305,175,124,62,hat
22628,5,person,6,1,8914,38,645,265,1493,1635,848,1370,person
22629,6,hat,7,0,8914,21,916,265,1471,741,555,476,hat
22630,22,hat,23,0,8914,15,1630,435,1781,622,151,187,hat
22631,30,hat,31,0,8914,15,1785,854,1929,1027,144,173,hat
22632,31,hat,32,0,8914,16,1931,877,2089,1014,158,137,hat
22633,32,hat,33,0,8914,15,1790,1045,1923,1187,133,142,hat
22634,33,hat,34,0,8914,15,1923,1085,2059,1227,136,142,hat
22635,7,eyeglasses,8,0,8915,16,181,302,322,366,141,64,eye glasses
22636,15,hat,16,0,8915,15,155,1148,302,1266,147,118,hat
22637,22,hat,23,0,8915,16,206,1273,343,1370,137,97,hat
22638,25,person,26,1,8915,64,296,575,643,1483,347,908,person
22639,28,hat,29,0,8915,28,353,561,522,681,169,120,hat
22640,30,eyeglasses,31,0,8915,28,388,644,497,696,109,52,eye glasses
22641,4,hat,5,0,8916,17,12,365,257,659,245,294,hat
22642,5,hat,6,0,8916,17,6,616,275,990,269,374,hat
22643,7,hat,8,0,8916,20,3,1151,306,1411,303,260,hat
22644,8,hat,9,1,8916,19,232,223,427,458,195,235,hat
22645,9,hat,10,0,8916,17,399,167,634,474,235,307,hat
22646,10,hat,11,1,8916,15,244,501,489,746,245,245,hat
22647,11,hat,12,1,8916,15,393,430,656,560,263,130,hat
22648,12,hat,13,0,8916,20,399,495,749,820,350,325,hat
22649,13,hat,14,0,8916,20,665,204,922,458,257,254,hat
22650,14,hat,15,1,8916,27,848,155,1139,424,291,269,hat
22651,16,hat,17,1,8916,17,313,721,557,969,244,248,hat
22652,17,hat,18,1,8916,17,294,956,532,1182,238,226,hat
22653,18,hat,19,1,8916,19,548,764,842,1040,294,276,hat
22654,19,hat,20,0,8916,18,362,1018,668,1260,306,242,hat
22655,20,hat,21,1,8916,15,334,1210,610,1445,276,235,hat
22656,22,hat,23,1,8916,16,279,1386,569,1588,290,202,hat
22657,23,hat,24,0,8916,20,783,464,1111,755,328,291,hat
22658,26,hat,27,1,8916,16,882,947,1089,1117,207,170,hat
22659,27,hat,28,0,8916,19,690,993,1034,1281,344,288,hat
22660,28,hat,29,1,8916,16,774,1247,1012,1439,238,192,hat
22661,29,hat,30,0,8916,17,542,1256,808,1526,266,270,hat
22662,33,hat,34,1,8916,17,233,1126,373,1292,140,166,hat
22663,34,hat,35,1,8916,16,155,214,264,346,109,132,hat
22664,9,chair,10,0,9511,16,209,216,267,298,58,82,chair
22665,8,table,9,0,9513,30,134,134,228,231,94,97,dining table
22666,9,chair,10,0,9513,21,243,124,282,186,39,62,chair
22667,10,chair,11,0,9513,19,281,129,322,201,41,72,chair
22668,11,chair,12,1,9513,20,315,138,349,231,34,93,chair
22669,8,table,9,0,9514,26,5,131,91,230,86,99,dining table
22670,9,chair,10,1,9514,21,2,121,47,219,45,98,chair
22671,10,chair,11,0,9514,23,41,133,127,241,86,108,chair
22672,11,table,12,0,9514,30,124,114,210,192,86,78,dining table
22673,12,table,13,0,9514,16,192,112,258,173,66,61,dining table
22674,13,chair,14,1,9514,15,257,111,277,148,20,37,chair
22675,8,person,9,1,9516,22,87,72,124,118,37,46,person
22676,9,person,10,1,9516,33,106,69,163,179,57,110,person
22677,10,chair,11,1,9517,17,0,140,60,257,60,117,chair
22678,10,table,11,0,9518,21,264,151,338,209,74,58,dining table
22679,11,chair,12,0,9518,25,243,147,289,207,46,60,chair
22680,12,chair,13,1,9518,19,293,152,338,219,45,67,chair
22681,11,chair,12,1,9519,18,92,102,126,134,34,32,chair
22682,13,chair,14,1,9519,15,132,103,161,136,29,33,chair
22683,14,table,15,0,9519,21,76,132,153,213,77,81,dining table
22684,15,chair,16,1,9519,21,67,121,113,201,46,80,chair
22685,16,chair,17,0,9519,24,110,131,170,222,60,91,chair
22686,17,table,18,0,9519,15,171,152,288,256,117,104,dining table
22687,18,chair,19,1,9519,19,168,137,242,254,74,117,chair
22688,19,chair,20,0,9519,30,229,157,318,255,89,98,chair
22689,22,chair,23,1,9519,19,190,115,233,155,43,40,chair
22690,24,chair,25,1,9519,19,238,113,287,163,49,50,chair
22691,28,person,29,1,186,18,526,322,557,354,31,32,person
22692,29,person,30,1,186,28,551,296,603,358,52,62,person
22693,31,person,32,1,186,19,469,317,501,350,32,33,person
22694,36,chair,37,0,186,26,45,461,232,642,187,181,chair
22695,5,person,6,1,9762,65,292,27,590,297,298,270,person
22696,9,person,10,1,9762,39,93,106,281,314,188,208,person
22697,10,person,11,1,9762,62,3,100,222,428,219,328,person
22698,7,person,8,1,9764,26,326,160,368,196,42,36,person
22699,8,person,9,1,9764,34,54,156,145,354,91,198,person
22700,9,person,10,1,9764,45,149,172,228,355,79,183,person
22701,12,door,13,1,9764,19,62,136,145,205,83,69,door
22702,1,person,2,1,9765,67,192,86,425,319,233,233,person
22703,10,person,11,1,9765,50,44,68,197,199,153,131,person
22704,10,person,11,1,9766,26,126,95,165,170,39,75,person
22705,11,person,12,0,9766,57,190,80,250,283,60,203,person
22706,10,person,11,1,9767,49,36,104,191,241,155,137,person
22707,11,person,12,1,9767,57,189,108,337,299,148,191,person
22708,3,person,4,1,9768,42,178,3,299,225,121,222,person
22709,19,table,20,1,9769,19,258,202,368,324,110,122,dining table
22710,23,chair,24,0,9769,24,167,174,217,243,50,69,chair
22711,26,chair,27,1,9769,25,0,191,61,279,61,88,chair
22712,28,chair,29,1,9769,23,127,182,160,263,33,81,chair
22713,29,chair,30,0,9769,27,71,198,130,292,59,94,chair
22714,31,chair,32,1,9769,19,214,181,256,262,42,81,chair
22715,33,chair,34,1,9769,24,314,196,383,310,69,114,chair
22716,34,chair,35,0,9769,32,240,210,318,322,78,112,chair
22717,35,chair,36,0,9769,42,329,228,422,361,93,133,chair
22718,7,person,8,1,23590,19,378,196,427,252,49,56,person
22719,8,person,9,1,23590,20,429,189,484,264,55,75,person
22720,9,person,10,1,23590,32,175,196,226,419,51,223,person
22721,10,person,11,0,23590,42,192,214,278,456,86,242,person
22722,11,person,12,0,23590,51,426,285,527,600,101,315,person
22723,12,person,13,1,23590,38,520,298,663,599,143,301,person
22724,2,person,3,1,23591,47,1048,122,1598,1198,550,1076,person
22725,3,person,4,1,23591,53,608,202,1059,1198,451,996,person
22726,4,person,5,1,23591,38,126,335,640,1194,514,859,person
22727,5,table,6,0,9864,41,0,203,467,339,467,136,dining table
22728,13,chair,14,0,9864,21,35,201,97,339,62,138,chair
22729,14,chair,15,0,9864,20,185,201,261,338,76,137,chair
22730,15,chair,16,0,9864,24,261,214,346,344,85,130,chair
22731,16,chair,17,1,9864,18,384,227,465,343,81,116,chair
22732,15,table,16,1,9866,21,0,231,80,337,80,106,dining table
22733,19,chair,20,1,9866,20,46,208,116,319,70,111,chair
22734,6,table,7,0,9867,22,150,192,290,244,140,52,dining table
22735,8,chair,9,1,9867,15,188,185,219,255,31,70,chair
22736,13,chair,14,1,9867,16,45,209,112,292,67,83,chair
22737,15,chair,16,1,9867,16,166,268,257,348,91,80,chair
22738,17,table,18,1,9867,15,368,216,466,313,98,97,dining table
22739,6,chair,7,1,9868,15,59,218,106,282,47,64,chair
22740,8,chair,9,1,9869,23,33,126,70,261,37,135,chair
22741,9,chair,10,1,9869,18,63,146,97,299,34,153,chair
22742,10,chair,11,1,9869,15,79,157,140,299,61,142,chair
22743,17,chair,18,1,9869,17,347,121,393,170,46,49,chair
22744,26,chair,27,1,9869,25,256,137,317,181,61,44,chair
22745,7,person,8,0,9870,24,85,89,117,190,32,101,person
22746,11,chair,12,1,9870,17,2,202,72,265,70,63,chair
22747,12,table,13,0,9870,29,179,165,301,266,122,101,dining table
22748,13,chair,14,0,9870,21,181,159,239,265,58,106,chair
22749,17,person,18,1,9870,19,189,115,222,164,33,49,person
22750,18,person,19,1,9870,15,230,115,252,144,22,29,person
22751,22,chair,23,1,9870,19,335,204,399,264,64,60,chair
22752,6,table,7,0,9871,34,91,352,580,768,489,416,dining table
22753,7,table,8,0,9871,33,509,496,1279,953,770,457,dining table
22754,10,chair,11,1,9871,16,580,345,669,479,89,134,chair
22755,11,chair,12,1,9871,20,43,382,185,775,142,393,chair
22756,12,chair,13,1,9871,22,548,453,742,557,194,104,chair
22757,13,chair,14,1,9871,20,757,432,926,529,169,97,chair
22758,14,chair,15,1,9871,28,861,628,1195,956,334,328,chair
22759,16,chair,17,1,9871,21,154,318,282,371,128,53,chair
22760,26,window,27,0,9872,35,688,250,890,714,202,464,window
22761,28,window,29,1,9872,32,378,194,474,757,96,563,window
22762,38,table,39,1,9872,51,8,777,539,1034,531,257,dining table
22763,43,chair,44,1,9872,25,370,749,502,801,132,52,chair
22764,46,chair,47,1,9872,30,57,786,222,1140,165,354,chair
22765,47,chair,48,1,9872,29,188,804,368,1094,180,290,chair
22766,53,bottle,54,1,9872,20,453,884,510,990,57,106,bottle
22767,54,table,55,1,9872,177,34,1044,1033,1547,999,503,dining table
22768,61,chair,62,1,9872,33,688,738,851,943,163,205,chair
22769,62,chair,63,1,9872,45,822,731,1032,1050,210,319,chair
22770,63,table,64,1,9872,57,800,727,1142,1050,342,323,dining table
22771,65,chair,66,1,9872,21,1015,646,1128,1058,113,412,chair
22772,74,chair,75,1,9872,33,1473,653,1653,825,180,172,chair
22773,75,table,76,1,9872,81,1042,805,1732,1232,690,427,dining table
22774,79,chair,80,1,9872,53,1136,690,1367,1284,231,594,chair
22775,80,fork,81,0,9872,18,1526,863,1625,892,99,29,fork
22776,82,chair,83,1,9872,28,1647,700,1859,1044,212,344,chair
22777,83,chair,84,1,9872,31,1686,1013,2025,1134,339,121,chair
22778,89,table,90,1,9872,156,1257,1064,2197,1615,940,551,dining table
22779,90,chair,91,1,9872,66,1501,1163,1965,1649,464,486,chair
22780,91,chair,92,1,9872,27,1930,1237,2198,1647,268,410,chair
22781,92,vase,93,1,9872,17,1785,1112,1839,1187,54,75,vase
22782,97,fork,98,0,9872,18,1919,1139,1973,1172,54,33,fork
22783,100,chair,101,1,9872,23,526,1373,1086,1633,560,260,chair
22784,101,table,102,1,9872,33,1,1451,1089,1650,1088,199,dining table
22785,5,table,6,0,9873,46,349,1056,981,1527,632,471,dining table
22786,9,table,10,0,9873,16,3,990,280,1265,277,275,dining table
22787,13,chair,14,1,9873,20,252,1075,426,1535,174,460,chair
22788,14,chair,15,1,9873,26,19,1023,251,1457,232,434,chair
22789,25,chair,26,1,9873,17,311,898,422,974,111,76,chair
22790,26,chair,27,1,9873,18,234,963,318,1096,84,133,chair
22791,82,chair,83,0,9873,24,619,932,739,1010,120,78,chair
22792,24,window,25,0,9874,23,1533,242,2075,601,542,359,window
22793,35,chair,36,1,9874,16,324,628,479,767,155,139,chair
22794,36,chair,37,1,9874,31,502,659,705,1184,203,525,chair
22795,37,chair,38,1,9874,32,5,692,284,1248,279,556,chair
22796,38,table,39,1,9874,21,193,776,625,1018,432,242,dining table
22797,42,plate,43,1,9874,17,388,785,536,820,148,35,plate
22798,45,table,46,1,9874,16,2,1038,150,1347,148,309,dining table
22799,46,chair,47,1,9874,20,202,977,631,1463,429,486,chair
22800,53,chair,54,1,9874,22,684,890,997,1413,313,523,chair
22801,60,chair,61,1,9874,18,1170,814,1380,1212,210,398,chair
22802,61,chair,62,1,9874,22,971,563,1060,894,89,331,chair
22803,62,chair,63,1,9874,20,1173,596,1309,762,136,166,chair
22804,63,chair,64,1,9874,22,1253,555,1370,645,117,90,chair
22805,65,table,66,1,9874,27,1033,650,1503,810,470,160,dining table
22806,66,chair,67,1,9874,21,1329,627,1487,754,158,127,chair
22807,74,table,75,1,9874,53,1040,751,1699,1170,659,419,dining table
22808,75,chair,76,1,9874,31,1259,708,1488,1146,229,438,chair
22809,76,table,77,0,9874,34,1695,609,1973,839,278,230,dining table
22810,77,chair,78,1,9874,43,1672,538,1819,818,147,280,chair
22811,78,chair,79,1,9874,30,1886,558,2033,846,147,288,chair
22812,90,plate,91,0,9874,33,1856,1173,2166,1277,310,104,plate
22813,93,spoon,94,0,9874,15,1728,1129,1821,1198,93,69,spoon
22814,94,fork,95,0,9874,16,1880,1243,2066,1315,186,72,fork
22815,96,plate,97,1,9874,42,1083,1255,1415,1385,332,130,plate
22816,24,window,25,0,9875,22,39,443,700,854,661,411,window
22817,48,table,49,1,9875,80,1175,1079,2195,1650,1020,571,dining table
22818,49,chair,50,1,9875,88,1616,1148,2194,1649,578,501,chair
22819,50,table,51,1,9875,30,828,908,1046,986,218,78,dining table
22820,54,chair,55,1,9875,57,1085,978,1412,1218,327,240,chair
22821,55,chair,56,1,9875,17,926,940,1042,984,116,44,chair
22822,56,chair,57,1,9875,28,691,941,897,990,206,49,chair
22823,57,table,58,1,9875,105,656,972,1319,1164,663,192,dining table
22824,58,table,59,1,9875,65,47,922,578,996,531,74,dining table
22825,59,table,60,1,9875,50,382,921,560,993,178,72,dining table
22826,63,chair,64,1,9875,39,31,932,204,999,173,67,chair
22827,64,chair,65,1,9875,30,77,947,301,995,224,48,chair
22828,69,chair,70,1,9875,32,1,1065,109,1166,108,101,chair
22829,70,table,71,1,9875,118,1,993,649,1156,648,163,dining table
22830,71,chair,72,1,9875,51,34,1004,347,1167,313,163,chair
22831,72,chair,73,1,9875,58,365,1050,733,1145,368,95,chair
22832,78,chair,79,1,9875,46,860,990,1116,1189,256,199,chair
22833,79,chair,80,1,9875,38,1207,1029,1505,1124,298,95,chair
22834,80,chair,81,1,9875,28,1511,1016,1764,1102,253,86,chair
22835,83,table,84,1,9875,36,1,1164,254,1617,253,453,dining table
22836,84,table,85,1,9875,137,203,1135,1320,1649,1117,514,dining table
22837,85,chair,86,1,9875,50,467,1255,1127,1650,660,395,chair
22838,86,chair,87,1,9875,27,2,1546,602,1648,600,102,chair
22839,91,fork,92,0,9875,21,509,1204,558,1284,49,80,fork
22840,38,chair,39,1,9876,24,1733,786,1859,1077,126,291,chair
22841,41,table,42,1,9876,32,1024,792,1381,988,357,196,dining table
22842,42,chair,43,1,9876,24,980,741,1076,1066,96,325,chair
22843,43,chair,44,1,9876,16,1078,724,1193,797,115,73,chair
22844,44,chair,45,1,9876,17,1393,728,1454,866,61,138,chair
22845,45,chair,46,1,9876,42,1194,754,1330,919,136,165,chair
22846,46,chair,47,1,9876,35,1244,799,1395,919,151,120,chair
22847,47,chair,48,1,9876,50,1073,810,1234,1282,161,472,chair
22848,48,chair,49,1,9876,39,1430,853,1674,1132,244,279,chair
22849,49,chair,50,1,9876,39,1274,863,1459,1172,185,309,chair
22850,51,chair,51,1,9876,89,1147,958,1571,1670,424,712,chair
22851,52,table,52,0,9876,63,1186,1111,2032,1670,846,559,dining table
22852,53,chair,53,1,9876,59,1762,1027,2184,1670,422,643,chair
22853,56,fork,56,0,9876,19,1661,1204,1830,1249,169,45,fork
22854,58,table,58,1,9876,33,1037,903,1685,1262,648,359,dining table
22855,59,table,59,1,9876,35,80,954,793,1372,713,418,dining table
22856,60,chair,60,1,9876,30,397,836,589,959,192,123,chair
22857,61,chair,61,1,9876,38,169,846,377,974,208,128,chair
22858,62,chair,62,1,9876,28,183,914,456,1215,273,301,chair
22859,63,chair,63,1,9876,37,476,895,700,1311,224,416,chair
22860,64,chair,64,1,9876,22,126,1172,501,1337,375,165,chair
22861,69,table,69,1,9876,25,66,1289,947,1670,881,381,dining table
22862,70,chair,70,1,9876,18,129,1486,713,1671,584,185,chair
22863,73,clock,73,0,9876,15,75,124,229,277,154,153,clock
22864,31,table,32,1,9877,33,834,873,1083,1140,249,267,dining table
22865,32,chair,33,1,9877,31,783,838,934,1120,151,282,chair
22866,33,table,34,1,9877,48,926,911,1280,1227,354,316,dining table
22867,36,plate,37,0,9877,21,985,913,1099,937,114,24,plate
22868,45,chair,46,1,9877,48,922,875,1106,1218,184,343,chair
22869,47,bowl,48,0,9877,25,1206,1166,1316,1233,110,67,bowl
22870,49,table,50,1,9877,15,399,883,505,984,106,101,dining table
22871,50,chair,51,1,9877,15,310,836,440,884,130,48,chair
22872,51,chair,52,1,9877,27,261,860,414,989,153,129,chair
22873,53,table,54,1,9877,16,19,888,148,960,129,72,dining table
22874,54,chair,55,1,9877,20,128,891,293,954,165,63,chair
22875,55,table,56,1,9877,18,251,955,355,1068,104,113,dining table
22876,57,chair,58,1,9877,32,57,926,270,1070,213,144,chair
22877,58,chair,59,1,9877,23,2,969,209,1075,207,106,chair
22878,61,table,62,0,9877,62,82,1061,688,1472,606,411,dining table
22879,62,chair,63,1,9877,17,307,970,552,1065,245,95,chair
22880,67,chair,68,1,9877,56,199,1065,547,1472,348,407,chair
22881,49,table,50,0,9878,39,3,1063,428,1467,425,404,dining table
22882,50,chair,51,0,9878,31,112,1071,362,1467,250,396,chair
22883,52,table,53,1,9878,36,1865,939,2150,1055,285,116,dining table
22884,55,chair,56,1,9878,15,1734,928,1878,1027,144,99,chair
22885,56,chair,57,1,9878,19,1959,938,2119,1044,160,106,chair
22886,57,table,58,1,9878,78,1198,986,2193,1303,995,317,dining table
22887,58,chair,59,1,9878,17,1662,953,1790,1026,128,73,chair
22888,61,chair,62,1,9878,18,1249,989,1418,1145,169,156,chair
22889,62,chair,63,1,9878,17,1488,1002,1647,1181,159,179,chair
22890,63,chair,64,1,9878,21,1840,1025,2066,1138,226,113,chair
22891,64,table,65,1,9878,46,1027,1141,2198,1471,1171,330,dining table
22892,65,chair,66,1,9878,35,1328,1059,1561,1169,233,110,chair
22893,66,chair,67,1,9878,15,1791,1090,2086,1226,295,136,chair
22894,67,chair,68,1,9878,19,1119,1179,1425,1471,306,292,chair
22895,68,chair,69,1,9878,18,1663,1244,2075,1471,412,227,chair
22896,84,plate,85,0,9878,15,445,536,519,623,74,87,plate
22897,91,chair,92,1,9878,21,362,1310,773,1472,411,162,chair
22898,28,window,29,1,9879,18,905,356,977,680,72,324,window
22899,32,table,33,1,9879,15,1178,691,1210,755,32,64,dining table
22900,33,chair,34,1,9879,20,1195,663,1258,761,63,98,chair
22901,34,chair,35,1,9879,30,1080,634,1180,846,100,212,chair
22902,35,chair,36,1,9879,37,917,630,1007,852,90,222,chair
22903,36,chair,37,1,9879,31,439,667,570,768,131,101,chair
22904,37,table,38,1,9879,81,742,685,986,876,244,191,dining table
22905,44,bottle,45,1,9879,17,777,665,806,751,29,86,bottle
22906,56,table,57,1,9879,60,385,754,684,1077,299,323,dining table
22907,57,chair,58,1,9879,58,814,690,966,1034,152,344,chair
22908,58,chair,59,0,9879,54,611,750,856,1137,245,387,chair
22909,59,window,60,1,9879,26,200,241,343,772,143,531,window
22910,64,chair,65,1,9879,61,207,710,425,1042,218,332,chair
22911,66,chair,67,1,9879,17,0,725,135,862,135,137,chair
22912,74,chair,75,1,9879,51,1116,755,1282,897,166,142,chair
22913,76,table,77,1,9879,171,945,880,1572,1379,627,499,dining table
22914,77,chair,78,1,9879,39,1599,815,1832,1228,233,413,chair
22915,78,chair,79,0,9879,59,1231,956,1661,1488,430,532,chair
22916,88,fork,89,0,9879,18,1226,977,1264,1020,38,43,fork
22917,89,table,90,1,9879,51,0,859,350,1023,350,164,dining table
22918,7,door,8,0,21009,27,869,17,1084,657,215,640,door
22919,8,window,9,0,21009,21,1088,0,1410,636,322,636,window
22920,15,vase,16,0,21009,17,1437,583,1512,663,75,80,vase
22921,17,chair,18,0,21009,44,1404,621,1600,1085,196,464,chair
22922,18,chair,19,0,21009,87,1073,646,1491,1200,418,554,chair
22923,19,chair,20,1,21009,18,1070,543,1200,658,130,115,chair
22924,20,chair,21,1,21009,56,851,573,1018,1098,167,525,chair
22925,21,table,22,0,21009,101,822,627,1531,1134,709,507,dining table
22926,25,plate,26,0,21009,15,1152,709,1308,746,156,37,plate
22927,32,vase,33,0,21009,18,1253,601,1302,686,49,85,vase
22928,33,plant pot,34,0,21009,16,632,859,730,959,98,100,potted plant
22929,35,table,36,0,21009,41,2,684,403,926,401,242,dining table
22930,36,chair,37,1,21009,28,93,588,265,686,172,98,chair
22931,49,spoon,50,0,21009,17,2,1005,166,1058,164,53,spoon
22932,50,spoon,51,0,21009,15,386,1047,471,1128,85,81,spoon
22933,51,spoon,52,0,21009,18,344,1040,447,1138,103,98,spoon
22934,52,plate,53,0,21009,18,75,1036,359,1159,284,123,plate
22935,55,table,56,0,21009,45,1,923,599,1199,598,276,dining table
22936,28,clock,29,0,21010,27,1164,314,1282,438,118,124,clock
22937,43,chair,44,1,21010,20,0,1106,101,1670,101,564,chair
22938,44,chair,45,1,21010,25,237,1364,728,1670,491,306,chair
22939,47,table,48,0,21010,56,210,968,706,1369,496,401,dining table
22940,48,chair,49,1,21010,57,190,954,460,1350,270,396,chair
22941,49,chair,50,1,21010,77,434,921,668,1337,234,416,chair
22942,54,chair,55,0,21010,86,717,1007,995,1605,278,598,chair
22943,57,table,58,0,21010,64,600,1050,1242,1548,642,498,dining table
22944,58,chair,59,1,21010,40,988,911,1184,1061,196,150,chair
22945,70,chair,71,1,21010,34,1410,1062,1605,1447,195,385,chair
22946,71,table,72,0,21010,47,1360,1150,2199,1672,839,522,dining table
22947,72,chair,73,1,21010,57,1864,997,2158,1641,294,644,chair
22948,73,chair,74,1,21010,27,1436,1405,1865,1670,429,265,chair
22949,80,fork,81,0,21010,20,1589,1208,1712,1252,123,44,fork
22950,82,fork,83,0,21010,17,1911,1205,2015,1228,104,23,fork
22951,84,chair,85,1,21010,47,1810,919,1999,1163,189,244,chair
22952,85,chair,86,1,21010,25,1656,913,1772,1168,116,255,chair
22953,86,chair,87,1,21010,35,1854,849,2004,977,150,128,chair
22954,87,chair,88,1,21010,59,2037,870,2199,1233,162,363,chair
22955,90,chair,91,1,21010,31,1253,810,1360,1040,107,230,chair
22956,91,chair,92,1,21010,23,1039,838,1143,951,104,113,chair
22957,92,chair,93,1,21010,62,1149,845,1317,1175,168,330,chair
22958,93,table,94,1,21010,19,1141,892,1417,999,276,107,dining table
22959,96,table,97,0,21010,39,1768,958,2200,1139,432,181,dining table
22960,97,bowl,98,0,21010,15,1312,848,1476,904,164,56,bowl
22961,10,table,11,0,21011,27,1226,564,1493,803,267,239,dining table
22962,11,table,12,0,21011,47,699,680,1352,1096,653,416,dining table
22963,12,table,13,1,21011,51,544,546,1020,706,476,160,dining table
22964,13,table,14,0,21011,41,190,635,772,1006,582,371,dining table
22965,14,table,15,1,21011,19,3,614,236,768,233,154,dining table
22966,16,table,17,1,21011,31,201,1003,706,1098,505,95,dining table
22967,19,chair,20,1,21011,24,1302,621,1416,1083,114,462,chair
22968,20,chair,21,1,21011,26,972,699,1296,1097,324,398,chair
22969,22,chair,23,1,21011,17,3,817,172,1096,169,279,chair
22970,28,plate,29,0,21011,16,824,785,964,828,140,43,plate
22971,34,bottle,35,1,21011,17,1069,663,1103,802,34,139,bottle
22972,43,chair,44,1,21011,18,776,653,871,823,95,170,chair
22973,44,chair,45,1,21011,16,838,547,900,783,62,236,chair
22974,45,chair,46,1,21011,20,769,559,841,828,72,269,chair
22975,49,chair,50,1,21011,15,550,537,619,609,69,72,chair
22976,50,chair,51,1,21011,44,582,567,699,964,117,397,chair
22977,51,chair,52,1,21011,22,454,557,561,656,107,99,chair
22978,52,chair,53,1,21011,20,267,544,358,635,91,91,chair
22979,53,chair,54,1,21011,47,221,586,400,965,179,379,chair
22980,54,chair,55,1,21011,67,383,603,553,1017,170,414,chair
22981,55,chair,56,1,21011,27,32,573,193,791,161,218,chair
22982,56,chair,57,1,21011,17,2,665,126,856,124,191,chair
22983,65,window,66,0,21011,20,537,130,675,505,138,375,window
22984,14,table,15,1,21012,17,1180,1023,1308,1289,128,266,dining table
22985,15,person,16,1,21012,46,1215,826,1482,1344,267,518,person
22986,16,person,17,1,21012,30,1634,882,1898,1199,264,317,person
22987,17,person,18,1,21012,25,1762,890,2014,1413,252,523,person
22988,20,person,21,1,21012,44,1323,933,1655,1376,332,443,person
22989,21,person,22,1,21012,25,1430,1169,1932,1512,502,343,person
22990,29,table,30,0,21012,52,1167,1356,2014,1512,847,156,dining table
22991,34,window,34,0,21012,39,649,435,1203,728,554,293,window
22992,36,person,36,1,21012,28,768,582,885,935,117,353,person
22993,37,person,37,1,21012,43,901,569,1079,1037,178,468,person
22994,40,person,40,1,21012,39,51,967,673,1510,622,543,person
22995,41,person,41,1,21012,40,427,839,774,1454,347,615,person
22996,42,chair,42,1,21012,17,662,1129,848,1510,186,381,chair
22997,43,person,43,1,21012,39,2,694,298,1432,296,738,person
22998,44,person,44,1,21012,28,534,802,827,1241,293,439,person
22999,46,person,46,1,21012,22,659,790,859,1110,200,320,person
23000,47,person,47,0,21012,20,758,802,895,1071,137,269,person
23001,50,person,50,1,21012,28,194,784,314,1050,120,266,person
23002,51,person,51,1,21012,27,252,794,422,1031,170,237,person
23003,52,table,52,1,21012,22,242,1026,390,1432,148,406,dining table
23004,3,person,4,0,189,112,11,2,314,229,303,227,person
23005,8,person,9,1,189,91,167,0,550,366,383,366,person
23006,4,person,5,1,10021,46,16,90,162,275,146,185,person
23007,5,person,6,1,10021,47,189,90,307,300,118,210,person
23008,10,clock,11,1,10021,65,38,2,99,129,61,127,clock
23009,5,person,6,1,10024,23,239,60,299,237,60,177,person
23010,6,person,7,1,10024,28,129,46,198,131,69,85,person
23011,16,dog,17,0,10024,40,353,181,407,315,54,134,dog
23012,8,table,8,1,10028,21,221,123,316,230,95,107,dining table
23013,10,table,10,0,10028,26,104,118,205,231,101,113,dining table
23014,11,table,11,1,10028,19,11,119,90,224,79,105,dining table
23015,13,mirror,13,0,10028,24,184,77,209,122,25,45,mirror
23016,4,table,5,1,10029,15,322,247,403,317,81,70,dining table
23017,6,hat,7,0,10032,16,0,10,58,54,58,44,hat
23018,1,shoe,2,0,23649,86,86,98,580,478,494,380,shoe
23019,2,shoe,3,0,23649,89,292,38,695,354,403,316,shoe
23020,4,person,5,1,10126,18,112,95,143,130,31,35,person
23021,8,person,9,0,10126,46,5,95,46,202,41,107,person
23022,9,person,10,0,10126,37,44,101,76,206,32,105,person
23023,5,person,6,1,10127,29,282,748,628,1128,346,380,person
23024,6,person,7,1,10129,16,1861,513,1986,673,125,160,person
23025,5,window,6,1,10131,20,1864,0,2195,1388,331,1388,window
23026,30,vase,31,0,10131,15,1491,1077,1642,1220,151,143,vase
23027,35,person,36,0,10131,91,89,410,644,2100,555,1690,person
23028,11,person,12,1,10132,32,536,314,724,506,188,192,person
23029,20,table,21,1,10132,15,1237,429,1319,560,82,131,dining table
23030,3,person,4,1,10133,37,144,246,313,718,169,472,person
23031,11,person,12,1,10133,22,2,252,60,954,58,702,person
23032,12,person,13,1,10133,15,1197,483,1277,956,80,473,person
23033,15,table,16,1,10133,19,792,401,1040,561,248,160,dining table
23034,2,window,3,1,10135,17,182,3,2047,875,1865,872,window
23035,6,person,7,1,10137,21,695,532,888,723,193,191,person
23036,8,person,9,1,10137,34,386,499,591,805,205,306,person
23037,9,person,10,1,10137,16,1083,533,1155,695,72,162,person
23038,12,person,13,1,10137,21,1166,515,1295,698,129,183,person
23039,13,person,14,1,10137,23,1270,555,1428,722,158,167,person
23040,14,person,15,0,10137,84,911,513,1232,1460,321,947,person
23041,9,person,10,1,11075,31,177,67,243,130,66,63,person
23042,24,bottle,25,0,11075,17,124,93,181,110,57,17,bottle
23043,25,bottle,26,0,11075,17,20,98,77,118,57,20,bottle
23044,27,bottle,28,0,11075,45,30,23,232,46,202,23,bottle
23045,28,bottle,29,0,11075,23,15,50,75,70,60,20,bottle
23046,7,person,8,1,11076,34,106,79,179,195,73,116,person
23047,8,dog,9,1,11076,64,157,55,341,298,184,243,dog
23048,11,person,12,1,11076,39,307,50,375,298,68,248,person
23049,13,person,14,1,11077,15,280,200,314,249,34,49,person
23050,14,person,15,1,11077,20,252,209,312,251,60,42,person
23051,15,person,16,1,11077,16,269,208,301,270,32,62,person
23052,16,car,17,0,11077,45,194,242,587,431,393,189,car
23053,17,car,18,1,11077,18,0,330,255,478,255,148,car
23054,32,door,33,0,11077,19,456,257,558,389,102,132,door
23055,33,door,34,0,11077,18,520,260,587,378,67,118,door
23056,10,bottle,11,0,11081,19,126,336,373,1149,247,813,bottle
23057,11,bottle,12,0,11081,19,303,340,508,1063,205,723,bottle
23058,12,bottle,13,0,11081,15,660,428,730,697,70,269,bottle
23059,16,bottle,17,0,11081,16,867,428,936,698,69,270,bottle
23060,17,bottle,18,0,11081,15,932,426,1000,702,68,276,bottle
23061,35,bottle,36,0,11083,15,1314,82,1401,402,87,320,bottle
23062,39,bottle,40,0,11083,15,926,22,1016,380,90,358,bottle
23063,40,bottle,41,0,11083,15,840,23,929,375,89,352,bottle
23064,41,bottle,42,0,11083,16,750,5,844,370,94,365,bottle
23065,42,bottle,43,0,11083,20,643,45,750,363,107,318,bottle
23066,43,bottle,44,0,11083,16,346,1,449,349,103,348,bottle
23067,44,bottle,45,0,11083,17,220,0,342,341,122,341,bottle
23068,45,bottle,46,0,11083,16,100,1,220,340,120,339,bottle
23069,57,bottle,58,1,11083,16,1443,489,1502,806,59,317,bottle
23070,67,bottle,68,0,11083,16,1520,895,1609,1241,89,346,bottle
23071,68,bottle,69,0,11083,15,1445,892,1523,1242,78,350,bottle
23072,69,bottle,70,0,11083,17,1365,901,1454,1250,89,349,bottle
23073,71,bottle,72,0,11083,15,1195,893,1283,1265,88,372,bottle
23074,72,bottle,73,0,11083,16,677,913,778,1307,101,394,bottle
23075,73,bottle,74,0,11083,15,781,907,889,1298,108,391,bottle
23076,74,bottle,75,0,11083,16,882,903,989,1294,107,391,bottle
23077,75,bottle,76,0,11083,19,977,858,1104,1283,127,425,bottle
23078,76,bottle,77,0,11083,15,1104,898,1196,1272,92,374,bottle
23079,87,bottle,88,0,11083,15,1639,1316,1708,1643,69,327,bottle
23080,88,bottle,89,0,11083,18,1573,1296,1647,1648,74,352,bottle
23081,91,bottle,92,1,11083,16,360,1442,465,1648,105,206,bottle
23082,93,bottle,94,1,11083,17,573,1399,707,1649,134,250,bottle
23083,96,bottle,97,1,11083,15,922,1391,1017,1649,95,258,bottle
23084,97,bottle,98,1,11083,15,1006,1354,1125,1648,119,294,bottle
23085,99,bottle,100,1,11083,15,1264,1357,1360,1649,96,292,bottle
23086,110,bottle,111,0,11083,16,463,922,579,1322,116,400,bottle
23087,111,bottle,112,0,11083,15,567,900,671,1309,104,409,bottle
23088,13,person,14,1,11662,18,550,361,586,444,36,83,person
23089,27,person,28,1,11662,24,411,363,460,494,49,131,person
23090,28,person,29,1,11662,26,344,366,429,526,85,160,person
23091,30,person,31,1,11662,26,632,306,672,414,40,108,person
23092,31,person,32,1,11662,18,589,304,626,363,37,59,person
23093,33,person,34,1,11662,17,519,296,540,374,21,78,person
23094,34,person,35,1,11662,23,439,294,483,385,44,91,person
23095,35,person,36,1,11662,17,421,299,450,347,29,48,person
23096,38,person,39,1,11662,18,376,300,397,346,21,46,person
23097,39,person,40,1,11662,18,349,309,380,349,31,40,person
23098,40,person,41,1,11662,20,320,304,346,347,26,43,person
23099,42,person,43,1,11662,48,160,279,297,536,137,257,person
23100,43,person,44,1,11662,19,297,304,319,347,22,43,person
23101,44,person,45,1,11662,31,100,291,187,433,87,142,person
23102,45,person,46,1,11662,27,58,323,110,444,52,121,person
23103,46,backpack,47,0,11662,15,69,332,99,398,30,66,backpack
23104,48,person,49,1,11662,18,2,294,49,535,47,241,person
23105,49,person,50,1,11662,18,31,302,70,372,39,70,person
23106,9,person,10,1,11663,20,207,211,252,310,45,99,person
23107,15,window,16,1,11664,18,889,290,1044,511,155,221,window
23108,18,person,19,1,11664,19,513,417,587,697,74,280,person
23109,20,person,21,1,11664,17,890,432,968,546,78,114,person
23110,21,person,22,1,11664,21,893,506,991,625,98,119,person
23111,22,person,23,1,11664,23,991,413,1078,584,87,171,person
23112,23,person,24,1,11664,22,1069,392,1150,545,81,153,person
23113,24,person,25,1,11664,19,1134,435,1247,546,113,111,person
23114,25,person,26,1,11664,21,1484,519,1648,702,164,183,person
23115,26,person,27,1,11664,18,1484,394,1632,652,148,258,person
23116,30,person,31,1,11664,15,148,458,195,518,47,60,person
23117,32,person,33,1,11664,23,21,515,84,770,63,255,person
23118,33,person,34,0,11664,55,178,408,409,870,231,462,person
23119,34,person,35,0,11664,46,57,412,205,911,148,499,person
23120,51,boat,52,1,11664,15,1083,618,1399,799,316,181,boat
23121,62,table,63,1,11664,26,1196,984,1477,1328,281,344,dining table
23122,75,table,76,1,11664,33,493,1082,832,1443,339,361,dining table
23123,79,table,80,1,11664,20,547,698,1055,924,508,226,dining table
23124,81,chair,82,1,11664,29,411,698,594,991,183,293,chair
23125,82,table,83,1,11664,21,330,670,539,907,209,237,dining table
23126,3,person,4,1,11665,90,1620,211,2198,1363,578,1152,person
23127,4,window,5,0,11665,38,1682,113,1964,624,282,511,window
23128,5,window,6,1,11665,17,386,142,464,349,78,207,window
23129,8,window,9,1,11665,44,1679,117,1972,618,293,501,window
23130,17,person,18,1,11665,30,1605,369,1731,623,126,254,person
23131,18,person,19,1,11665,19,1597,440,1647,608,50,168,person
23132,19,person,20,1,11665,41,1427,335,1613,756,186,421,person
23133,20,person,21,1,11665,34,1624,365,1824,676,200,311,person
23134,32,table,33,1,11665,15,1787,736,1891,872,104,136,dining table
23135,39,person,40,1,11665,29,1391,415,1466,765,75,350,person
23136,40,person,41,1,11665,21,1262,373,1324,478,62,105,person
23137,41,person,42,1,11665,58,1299,373,1436,838,137,465,person
23138,42,person,43,1,11665,66,1031,394,1394,851,363,457,person
23139,45,person,46,1,11665,16,1107,466,1164,554,57,88,person
23140,47,person,48,1,11665,30,1048,314,1151,498,103,184,person
23141,48,person,49,1,11665,49,904,391,1064,565,160,174,person
23142,53,person,54,1,11665,151,403,33,1130,1647,727,1614,person
23143,56,table,57,1,11665,18,981,683,1183,898,202,215,dining table
23144,57,person,58,1,11665,20,351,312,410,406,59,94,person
23145,58,person,59,1,11665,24,383,283,468,419,85,136,person
23146,60,person,61,1,11665,36,197,285,354,416,157,131,person
23147,61,person,62,1,11665,23,122,302,214,387,92,85,person
23148,62,person,63,1,11665,38,122,315,219,486,97,171,person
23149,63,person,64,1,11665,18,0,235,74,336,74,101,person
23150,64,person,65,1,11665,37,43,269,136,501,93,232,person
23151,65,person,66,1,11665,27,2,277,109,507,107,230,person
23152,67,person,68,1,11665,23,113,405,218,550,105,145,person
23153,68,person,69,1,11665,29,198,413,283,579,85,166,person
23154,70,table,71,1,11665,24,2,591,496,908,494,317,dining table
23155,72,person,73,1,11665,40,237,381,539,616,302,235,person
23156,81,person,82,1,11665,23,262,680,398,812,136,132,person
23157,90,table,91,1,11665,30,2,904,325,1549,323,645,dining table
23158,91,table,92,1,11665,54,1119,1341,1959,1649,840,308,dining table
23159,39,person,40,1,11666,37,868,364,1004,519,136,155,person
23160,45,person,46,1,11666,15,1122,375,1158,473,36,98,person
23161,47,person,48,1,11666,18,810,350,872,439,62,89,person
23162,7,person,8,1,11667,15,0,94,32,192,32,98,person
23163,16,person,17,1,11667,19,0,86,24,130,24,44,person
23164,18,person,19,0,11667,58,182,69,232,225,50,156,person
23165,19,person,20,1,11667,46,241,83,279,212,38,129,person
23166,21,person,22,1,11667,39,265,80,332,248,67,168,person
23167,23,person,24,0,11667,23,154,87,177,124,23,37,person
23168,24,person,25,1,11667,21,54,83,90,126,36,43,person
23169,25,person,26,0,11667,23,100,70,111,107,11,37,person
23170,27,person,28,1,11667,16,112,89,125,113,13,24,person
23171,28,person,29,1,11667,15,123,87,133,105,10,18,person
23172,29,person,30,1,11667,19,241,75,255,108,14,33,person
23173,30,person,31,1,11667,22,51,71,73,113,22,42,person
23174,32,person,33,0,11667,17,171,73,178,94,7,21,person
23175,33,person,34,0,11667,17,165,73,172,94,7,21,person
23176,28,person,29,1,11668,22,534,407,671,596,137,189,person
23177,50,person,51,0,11668,41,1364,393,1500,820,136,427,person
23178,51,person,52,0,11668,46,1483,412,1597,801,114,389,person
23179,13,table,14,1,11669,30,362,787,655,996,293,209,dining table
23180,14,table,15,1,11669,47,19,794,289,1250,270,456,dining table
23181,15,person,16,1,11669,48,0,744,82,1626,82,882,person
23182,16,person,17,1,11669,53,1002,708,1260,1045,258,337,person
23183,17,person,18,0,11669,99,233,760,515,1548,282,788,person
23184,50,person,51,1,11670,23,553,554,703,746,150,192,person
23185,51,person,52,1,11670,28,729,531,856,756,127,225,person
23186,52,person,53,1,11670,39,1182,536,1467,918,285,382,person
23187,54,hat,55,0,11670,16,1625,553,1724,650,99,97,hat
23188,55,person,56,0,11670,68,1559,558,1989,1329,430,771,person
23189,58,person,59,1,11670,30,1967,565,2085,717,118,152,person
23190,6,person,7,1,11671,20,149,294,266,533,117,239,person
23191,7,person,8,1,11671,20,329,315,427,471,98,156,person
23192,21,person,22,1,11671,17,852,397,958,656,106,259,person
23193,22,person,23,1,11671,15,870,530,958,1122,88,592,person
23194,4,table,5,1,11767,21,65,191,151,267,86,76,dining table
23195,5,person,6,0,11767,37,23,160,115,294,92,134,person
23196,6,chair,7,0,11767,23,17,208,93,294,76,86,chair
23197,7,person,8,1,11767,21,7,152,46,239,39,87,person
23198,8,chair,9,1,11767,17,2,172,24,263,22,91,chair
23199,9,person,10,1,11767,26,67,112,117,191,50,79,person
23200,10,person,11,1,11767,25,123,155,188,204,65,49,person
23201,12,person,13,0,11767,36,137,170,193,293,56,123,person
23202,13,chair,14,0,11767,26,142,203,214,294,72,91,chair
23203,14,person,15,1,11767,15,121,117,139,159,18,42,person
23204,15,person,16,1,11767,19,124,139,150,185,26,46,person
23205,16,person,17,1,11767,17,147,118,166,159,19,41,person
23206,19,person,20,1,11767,27,198,148,229,233,31,85,person
23207,24,person,25,1,11767,20,32,118,58,157,26,39,person
23208,25,person,26,1,11767,17,59,117,76,156,17,39,person
23209,28,person,29,1,11767,52,217,100,298,295,81,195,person
23210,27,table,28,1,11768,15,313,368,557,433,244,65,dining table
23211,29,table,30,0,11768,15,363,326,503,394,140,68,dining table
23212,30,table,31,0,11768,15,231,333,348,408,117,75,dining table
23213,31,table,32,0,11768,15,192,317,267,365,75,48,dining table
23214,32,table,33,0,11768,15,295,313,381,344,86,31,dining table
23215,33,table,34,0,11768,16,384,305,486,333,102,28,dining table
23216,34,table,35,0,11768,16,486,316,638,358,152,42,dining table
23217,35,table,36,0,11768,15,248,303,312,332,64,29,dining table
23218,2,person,3,1,11769,40,920,2,1173,258,253,256,person
23219,3,table,4,1,11769,15,877,201,1020,342,143,141,dining table
23220,5,person,6,1,11769,41,475,28,712,356,237,328,person
23221,6,person,7,1,11769,49,755,71,1018,528,263,457,person
23222,8,person,9,1,11769,24,1147,101,1279,398,132,297,person
23223,9,person,10,1,11769,50,932,230,1279,837,347,607,person
23224,11,person,12,1,11769,90,468,172,946,696,478,524,person
23225,12,person,13,1,11769,71,204,124,614,518,410,394,person
23226,13,person,14,1,11769,58,116,61,374,439,258,378,person
23227,14,person,15,1,11769,29,0,20,170,335,170,315,person
23228,16,person,17,1,11769,54,0,321,334,850,334,529,person
23229,17,person,18,1,11769,15,675,687,969,850,294,163,person
23230,18,table,19,1,11769,36,46,399,1277,851,1231,452,dining table
23231,28,plate,29,1,11769,18,739,660,937,744,198,84,plate
23232,29,bowl,30,1,11769,16,927,699,1048,800,121,101,bowl
23233,4,person,5,1,11770,19,421,304,525,480,104,176,person
23234,5,person,6,1,11770,27,721,346,884,579,163,233,person
23235,7,person,8,1,11770,17,0,458,163,645,163,187,person
23236,9,person,10,1,11770,28,179,463,392,699,213,236,person
23237,10,person,11,1,11770,32,540,460,716,680,176,220,person
23238,19,person,20,1,11770,24,895,428,1016,630,121,202,person
23239,20,person,21,1,11770,36,852,445,1054,822,202,377,person
23240,21,person,22,1,11770,32,1007,443,1268,734,261,291,person
23241,22,person,23,1,11770,27,1218,454,1392,719,174,265,person
23242,26,person,27,1,11770,23,1704,499,2001,798,297,299,person
23243,27,person,28,1,11770,30,1567,484,1920,947,353,463,person
23244,28,person,29,1,11770,50,1367,422,1782,1257,415,835,person
23245,29,person,30,1,11770,34,650,521,869,878,219,357,person
23246,30,person,31,1,11770,67,237,471,831,1145,594,674,person
23247,31,person,32,1,11770,44,0,613,445,1526,445,913,person
23248,32,person,33,1,11770,70,824,534,1513,1528,689,994,person
23249,33,table,34,1,11770,48,301,803,1061,1431,760,628,dining table
23250,39,table,40,1,11770,24,93,729,260,996,167,267,dining table
23251,40,chair,41,1,11770,17,183,891,291,1192,108,301,chair
23252,41,chair,42,1,11770,34,970,1052,1618,1532,648,480,chair
23253,42,chair,43,1,11770,26,1588,884,1945,1472,357,588,chair
23254,69,chair,70,1,11770,15,272,1266,935,1534,663,268,chair
23255,4,person,5,1,11771,32,18,44,82,105,64,61,person
23256,6,person,7,1,11771,22,0,149,58,242,58,93,person
23257,7,person,8,1,11771,82,38,0,260,243,222,243,person
23258,8,person,9,1,11771,34,62,35,134,113,72,78,person
23259,9,person,10,1,11771,15,67,66,89,94,22,28,person
23260,10,person,11,1,11771,15,44,50,68,76,24,26,person
23261,14,person,15,1,11772,61,171,46,286,159,115,113,person
23262,15,table,16,1,11772,15,0,135,355,236,355,101,dining table
23263,16,person,17,1,11772,61,18,28,154,209,136,181,person
23264,18,person,19,1,11772,31,134,53,167,129,33,76,person
23265,19,chair,20,1,11772,20,141,85,172,134,31,49,chair
23266,20,person,21,1,11772,22,263,63,305,159,42,96,person
23267,22,person,23,1,11772,22,309,69,349,110,40,41,person
23268,30,person,31,1,11772,18,46,46,68,82,22,36,person
23269,31,person,32,1,11772,22,20,48,50,96,30,48,person
23270,32,person,33,1,11772,16,0,48,18,84,18,36,person
23271,37,plate,38,0,11772,15,135,140,179,161,44,21,plate
23272,0,window,1,0,12268,49,0,0,317,254,317,254,window
23273,1,person,2,0,12268,65,120,63,323,574,203,511,person
23274,6,person,7,1,12268,55,368,82,536,558,168,476,person
23275,6,window,7,0,12269,16,121,94,174,210,53,116,window
23276,0,person,1,1,13828,22,170,60,316,156,146,96,person
23277,3,person,4,1,13829,49,69,23,252,215,183,192,person
23278,9,person,10,1,14160,23,326,162,496,363,170,201,person
23279,10,person,11,0,14160,78,127,103,412,671,285,568,person
23280,5,table,6,0,15224,31,2,198,481,450,479,252,dining table
23281,6,table,7,1,15224,23,274,170,608,237,334,67,dining table
23282,11,chair,12,0,15224,28,90,287,205,462,115,175,chair
23283,12,chair,13,0,15224,24,184,270,261,425,77,155,chair
23284,13,chair,14,1,15224,16,247,261,302,399,55,138,chair
23285,14,chair,15,1,15224,18,290,245,340,368,50,123,chair
23286,15,chair,16,1,15224,17,330,236,374,347,44,111,chair
23287,16,chair,17,1,15224,16,364,229,401,330,37,101,chair
23288,17,chair,18,1,15224,17,391,219,429,309,38,90,chair
23289,18,chair,19,1,15224,18,419,215,451,297,32,82,chair
23290,19,chair,20,1,15224,18,402,327,496,478,94,151,chair
23291,20,chair,21,1,15224,15,451,304,509,421,58,117,chair
23292,3,person,4,1,15297,45,2,23,115,274,113,251,person
23293,4,person,5,1,15297,54,173,59,259,332,86,273,person
23294,5,mirror,6,1,15297,17,167,145,208,233,41,88,mirror
23295,25,pots,26,0,15301,28,759,301,960,463,201,162,potted plant
23296,5,person,6,1,15304,48,549,80,748,765,199,685,person
23297,6,person,7,1,15304,49,292,77,570,762,278,685,person
23298,7,chair,8,1,15304,15,294,563,471,764,177,201,chair
23299,8,person,9,1,15304,27,27,398,421,767,394,369,person
23300,2,person,3,1,15305,58,155,55,351,240,196,185,person
23301,14,person,14,1,22037,39,249,231,326,340,77,109,person
23302,6,chair,7,0,15311,21,44,143,119,261,75,118,chair
23303,9,sofa,10,0,15312,20,476,187,569,274,93,87,couch
23304,3,person,4,1,240,30,473,1,649,334,176,333,person
23305,8,chair,9,1,240,18,465,1,558,180,93,179,chair
23306,9,bottle,10,0,240,21,520,179,612,321,92,142,bottle
23307,11,plate,12,0,240,21,448,202,542,271,94,69,plate
23308,13,fork,14,0,240,23,533,330,617,420,84,90,fork
23309,14,plate,15,0,240,18,322,91,396,135,74,44,plate
23310,15,plate,16,0,240,16,59,148,152,207,93,59,plate
23311,16,plate,17,1,240,35,134,269,245,361,111,92,plate
23312,18,fork,19,0,240,19,373,153,438,176,65,23,fork
23313,20,fork,21,0,240,15,300,80,363,91,63,11,fork
23314,25,fork,26,0,240,20,102,227,194,270,92,43,fork
23315,29,fork,30,0,240,23,181,397,294,466,113,69,fork
23316,30,knife,31,1,240,17,188,413,314,480,126,67,knife
23317,34,person,35,1,240,40,267,0,497,153,230,153,person
23318,39,person,40,1,240,22,1,116,91,303,90,187,person
23319,40,person,41,1,240,25,0,290,161,487,161,197,person
23320,42,person,43,1,240,15,486,445,649,487,163,42,person
23321,4,person,5,1,15329,32,305,144,407,296,102,152,person
23322,9,chair,10,1,15329,17,531,353,637,476,106,123,chair
23323,5,person,6,0,24116,23,616,592,651,679,35,87,person
23324,6,person,7,0,24116,17,644,599,674,683,30,84,person
23325,1,plate,2,0,24118,31,20,2,1164,1600,1144,1598,plate
23326,3,knife,4,0,24118,15,10,145,308,907,298,762,knife
23327,10,sofa,11,0,15594,33,264,192,479,288,215,96,couch
23328,12,table,13,0,15594,36,6,209,235,354,229,145,dining table
23329,10,umbrella,11,0,15597,15,315,95,347,190,32,95,umbrella
23330,18,umbrella,19,0,15597,19,91,79,167,155,76,76,umbrella
23331,3,table,4,0,15601,15,244,81,398,195,154,114,dining table
23332,8,person,9,0,15601,29,3,50,28,119,25,69,person
23333,11,person,12,1,15601,19,148,35,171,61,23,26,person
23334,19,chair,20,1,15610,17,280,175,316,253,36,78,chair
23335,1,person,2,1,15611,60,37,536,497,1198,460,662,person
23336,3,person,4,1,15611,15,2,827,357,1200,355,373,person
23337,4,person,5,1,15611,79,590,513,953,961,363,448,person
23338,6,person,7,1,15611,60,965,616,1373,1135,408,519,person
23339,8,person,9,0,15611,54,1054,634,1599,1199,545,565,person
23340,11,table,12,1,15611,19,541,930,931,1051,390,121,dining table
23341,28,person,23,1,15612,50,77,396,245,672,168,276,person
23342,29,person,24,1,15612,49,674,407,756,609,82,202,person
23343,31,person,26,0,15612,34,910,412,1033,569,123,157,person
23344,33,person,28,0,15612,30,1064,402,1167,572,103,170,person
23345,35,person,30,1,15612,16,1,432,66,504,65,72,person
23346,36,person,31,1,15612,18,49,429,109,504,60,75,person
23347,67,television,61,1,15612,18,534,282,621,356,87,74,tv
23348,0,person,1,1,25171,79,267,161,474,575,207,414,person
23349,1,person,2,1,25171,169,38,19,451,575,413,556,person
23350,4,person,5,1,25171,15,23,261,53,377,30,116,person
23351,2,person,3,1,25172,30,9,213,606,1196,597,983,person
23352,3,person,4,1,25172,38,394,242,1002,1198,608,956,person
23353,4,person,5,1,25172,35,939,329,1555,1198,616,869,person
23354,11,person,12,1,25172,15,1344,433,1440,638,96,205,person
23355,5,person,6,1,25173,38,754,32,1023,682,269,650,person
23356,6,person,7,1,25173,92,279,41,881,681,602,640,person
23357,7,person,8,1,25173,94,98,24,600,683,502,659,person
23358,8,bottle,9,0,25173,31,428,446,501,653,73,207,bottle
23359,9,cell phone,10,1,25173,22,507,544,570,643,63,99,cell phone
23360,2,table,3,0,25174,21,149,499,752,678,603,179,dining table
23361,3,person,4,1,25174,21,1,426,169,680,168,254,person
23362,5,person,6,1,25174,28,5,350,131,460,126,110,person
23363,6,person,7,1,25174,54,130,260,343,590,213,330,person
23364,7,person,8,1,25174,68,310,218,559,509,249,291,person
23365,9,person,10,1,25174,29,762,282,1024,640,262,358,person
23366,10,person,11,1,25174,76,611,307,891,656,280,349,person
23367,11,person,12,1,25174,61,608,196,788,517,180,321,person
23368,12,person,13,1,25174,31,758,205,887,320,129,115,person
23369,13,person,14,0,25174,52,850,162,926,470,76,308,person
23370,14,person,15,1,25174,26,924,187,1024,307,100,120,person
23371,15,person,16,1,25174,25,918,169,1024,275,106,106,person
23372,16,person,17,1,25174,23,913,173,974,265,61,92,person
23373,17,plate,18,0,25174,18,186,544,310,629,124,85,plate
23374,19,plate,20,1,25174,15,332,494,467,561,135,67,plate
23375,20,plate,21,1,25174,19,476,500,611,566,135,66,plate
23376,21,plate,22,0,25174,26,571,546,727,630,156,84,plate
23377,38,fork,39,0,25174,16,600,604,689,676,89,72,fork
23378,39,fork,40,0,25174,20,183,550,278,607,95,57,fork
23379,5,window,6,0,15779,19,16,20,86,147,70,127,window
23380,6,window,7,0,15779,15,104,77,133,155,29,78,window
23381,7,window,8,0,15779,15,142,104,156,158,14,54,window
23382,8,window,9,0,15779,19,16,136,87,214,71,78,window
23383,22,chair,23,1,15779,18,4,218,48,289,44,71,chair
23384,27,chair,28,0,15779,15,195,208,232,259,37,51,chair
23385,28,chair,29,0,15779,24,84,219,133,286,49,67,chair
23386,29,chair,30,1,15779,22,44,222,82,291,38,69,chair
23387,31,chair,32,1,15779,15,0,247,64,319,64,72,chair
23388,32,table,33,1,15779,18,87,199,151,207,64,8,dining table
23389,34,table,35,1,15779,24,20,212,119,230,99,18,dining table
23390,4,table,5,1,15780,15,0,353,187,478,187,125,dining table
23391,6,chair,7,1,15780,15,30,386,124,479,94,93,chair
23392,7,chair,8,0,15780,27,121,365,230,479,109,114,chair
23393,12,table,13,1,15780,20,277,331,495,405,218,74,dining table
23394,13,chair,14,1,15780,15,249,328,287,450,38,122,chair
23395,14,chair,15,1,15780,25,294,344,380,467,86,123,chair
23396,18,table,19,1,15780,16,393,378,639,479,246,101,dining table
23397,22,person,23,1,15780,15,601,339,639,479,38,140,person
23398,30,chair,31,1,15780,16,450,324,519,377,69,53,chair
23399,5,bench,6,0,15781,34,517,728,683,941,166,213,bench
23400,15,chair,16,1,15781,15,1057,827,1190,1066,133,239,chair
23401,17,table,18,1,15781,19,1111,805,1516,1065,405,260,dining table
23402,23,bench,24,1,15781,58,0,747,349,1064,349,317,bench
23403,7,person,8,0,15782,30,42,79,100,269,58,190,person
23404,8,motorbike,9,1,15782,71,23,175,219,371,196,196,motorcycle
23405,9,person,10,1,15782,43,170,213,286,333,116,120,person
23406,10,motorbike,11,1,15782,44,93,269,325,407,232,138,motorcycle
23407,11,person,12,1,15782,38,78,301,243,407,165,106,person
23408,12,person,13,1,15782,20,0,143,42,407,42,264,person
23409,13,person,14,1,15782,36,249,88,323,244,74,156,person
23410,14,person,15,1,15782,25,321,135,379,194,58,59,person
23411,17,person,18,1,15782,25,400,84,430,158,30,74,person
23412,20,person,21,1,15782,24,458,71,530,167,72,96,person
23413,24,motorbike,25,1,15782,17,468,104,524,174,56,70,motorcycle
23414,25,person,26,1,15782,27,353,159,416,233,63,74,person
23415,26,motorbike,27,0,15782,26,279,206,436,346,157,140,motorcycle
23416,27,person,28,1,15782,52,394,210,534,403,140,193,person
23417,2,car,3,1,24258,28,266,137,640,480,374,343,car
23418,7,car,8,1,24258,57,41,209,480,386,439,177,car
23419,8,car,9,1,24258,60,103,43,476,215,373,172,car
23420,9,person,10,1,24258,24,208,184,262,254,54,70,person
23421,10,person,11,1,24258,20,128,200,183,256,55,56,person
23422,1,sofa,2,0,246,17,361,165,470,246,109,81,couch
23423,2,sofa,3,0,246,19,91,226,130,308,39,82,couch
23424,5,table,6,1,246,32,147,244,469,322,322,78,dining table
23425,11,person,12,1,246,88,106,60,283,350,177,290,person
23426,18,person,19,0,246,51,256,62,368,239,112,177,person
23427,24,person,25,0,246,114,0,64,252,352,252,288,person
23428,34,bowl,35,0,246,21,272,245,338,273,66,28,bowl
23429,35,plate,36,0,246,16,207,271,293,293,86,22,plate
23430,0,window,1,0,247,90,1,1,1384,1064,1383,1063,window
23431,2,table,3,1,247,27,523,674,1446,1067,923,393,dining table
23432,7,chair,8,1,247,17,1257,583,1600,1067,343,484,chair
23433,8,chair,9,1,247,24,1258,487,1599,1066,341,579,chair
23434,9,person,10,1,247,59,1094,230,1577,1066,483,836,person
23435,18,chair,19,1,247,43,404,472,837,1067,433,595,chair
23436,31,person,31,1,247,66,547,218,975,1065,428,847,person
23437,32,chair,32,1,247,33,236,577,793,1067,557,490,chair
23438,33,chair,33,1,247,16,1,782,368,1067,367,285,chair
23439,36,vase,36,1,247,17,1143,558,1205,668,62,110,vase
23440,47,person,47,1,247,99,78,1,480,859,402,858,person
23441,2,mirror,3,0,248,34,0,113,310,152,310,39,mirror
23442,4,table,5,1,248,15,310,171,383,204,73,33,dining table
23443,5,sofa,6,1,248,19,373,134,400,170,27,36,couch
23444,6,person,7,1,248,40,354,135,400,270,46,135,person
23445,7,chair,8,1,248,19,360,189,400,289,40,100,chair
23446,8,person,9,1,248,17,360,126,375,167,15,41,person
23447,10,person,11,0,248,70,293,78,366,299,73,221,person
23448,22,sofa,23,1,248,29,274,137,321,177,47,40,couch
23449,23,table,24,1,248,49,163,176,318,286,155,110,dining table
23450,24,chair,25,0,248,49,237,203,314,316,77,113,chair
23451,31,person,32,1,248,33,209,128,258,185,49,57,person
23452,37,person,38,1,248,71,236,131,304,285,68,154,person
23453,43,chair,44,0,248,38,167,204,226,307,59,103,chair
23454,45,sofa,46,1,248,27,127,140,226,261,99,121,couch
23455,46,sofa,47,1,248,37,0,144,129,260,129,116,couch
23456,47,table,48,1,248,40,0,188,118,278,118,90,dining table
23457,51,person,51,1,248,55,21,133,111,259,90,126,person
23458,52,person,52,1,248,55,66,130,120,273,54,143,person
23459,53,chair,53,1,248,36,25,218,102,319,77,101,chair
23460,5,bowl,6,0,249,15,400,249,436,307,36,58,bowl
23461,10,bowl,11,0,249,17,337,207,383,276,46,69,bowl
23462,15,bowl,16,0,249,16,288,185,330,252,42,67,bowl
23463,18,knife,19,0,249,15,314,338,394,408,80,70,knife
23464,19,fork,20,0,249,25,137,308,242,366,105,58,fork
23465,20,plate,21,0,249,16,98,261,256,309,158,48,plate
23466,26,plate,27,0,249,21,287,249,346,271,59,22,plate
23467,34,bowl,35,0,249,15,393,199,431,255,38,56,bowl
23468,36,person,37,1,249,41,0,13,168,480,168,467,person
23469,37,table,38,1,249,36,57,233,852,479,795,246,dining table
23470,39,person,40,1,249,54,400,18,591,327,191,309,person
23471,51,person,52,1,249,26,2,1,167,92,165,91,person
23472,52,plate,53,1,249,23,58,84,186,106,128,22,plate
23473,7,chair,8,1,15793,19,35,133,74,169,39,36,chair
23474,10,chair,11,1,15793,23,91,137,115,190,24,53,chair
23475,13,chair,14,1,15793,16,106,158,136,185,30,27,chair
23476,14,chair,15,1,15793,16,99,145,126,169,27,24,chair
23477,15,chair,16,1,15793,18,169,135,200,151,31,16,chair
23478,18,chair,19,1,15793,20,185,185,228,255,43,70,chair
23479,19,chair,20,1,15793,32,42,165,113,256,71,91,chair
23480,33,chair,34,1,15793,20,125,218,193,255,68,37,chair
23481,36,table,37,1,15794,15,143,153,172,168,29,15,dining table
23482,10,table,11,1,15795,24,89,245,317,380,228,135,dining table
23483,11,chair,12,1,15795,19,49,264,130,443,81,179,chair
23484,12,chair,13,1,15795,16,301,237,364,374,63,137,chair
23485,14,table,15,1,15795,17,98,370,498,477,400,107,dining table
23486,16,vase,17,0,15795,19,245,405,280,474,35,69,vase
23487,23,table,24,1,15795,19,420,222,639,407,219,185,dining table
23488,24,chair,25,1,15795,15,356,210,433,314,77,104,chair
23489,28,plate,29,0,15795,15,165,420,258,474,93,54,plate
23490,5,chair,6,1,15796,15,34,175,51,254,17,79,chair
23491,6,chair,7,0,15796,26,44,185,101,273,57,88,chair
23492,7,chair,8,0,15796,24,111,169,152,255,41,86,chair
23493,8,person,9,1,15796,20,12,125,49,174,37,49,person
23494,9,person,10,1,15796,16,92,122,120,164,28,42,person
23495,12,chair,13,1,15796,21,204,159,233,222,29,63,chair
23496,13,chair,14,1,15796,26,225,164,263,233,38,69,chair
23497,29,chair,30,1,15796,18,161,218,216,257,55,39,chair
23498,30,chair,31,1,15796,21,56,238,137,289,81,51,chair
23499,31,chair,32,1,15796,23,395,227,455,337,60,110,chair
23500,46,chair,47,1,15796,19,447,201,488,308,41,107,chair
23501,78,knife,79,0,15796,15,51,302,62,333,11,31,knife
23502,90,chair,91,1,15796,18,354,176,384,215,30,39,chair
23503,5,plate,6,0,15797,17,166,172,213,201,47,29,plate
23504,11,chair,12,1,15797,17,53,151,121,234,68,83,chair
23505,15,chair,16,1,15797,17,267,119,310,233,43,114,chair
23506,8,table,9,1,15798,20,253,170,323,282,70,112,dining table
23507,9,chair,10,0,15798,36,233,166,322,287,89,121,chair
23508,12,table,13,1,15798,19,215,154,261,197,46,43,dining table
23509,14,chair,15,0,15798,29,108,158,155,237,47,79,chair
23510,15,chair,16,0,15798,22,166,160,212,239,46,79,chair
23511,28,chair,29,1,15798,18,58,147,91,208,33,61,chair
23512,29,chair,30,1,15798,20,21,156,62,240,41,84,chair
23513,2,person,2,0,15799,54,320,150,500,335,180,185,person
23514,3,person,3,1,15799,31,354,158,436,259,82,101,person
23515,4,person,4,1,15799,40,326,169,390,272,64,103,person
23516,6,person,5,1,15799,34,310,172,334,240,24,68,person
23517,8,person,7,1,15799,108,0,144,218,335,218,191,person
23518,9,person,8,1,15799,83,55,164,192,284,137,120,person
23519,10,person,9,1,15799,80,133,163,231,269,98,106,person
23520,12,person,11,1,15799,40,170,161,208,256,38,95,person
23521,15,person,12,1,15799,31,244,168,296,214,52,46,person
23522,16,person,13,1,15799,42,187,178,238,219,51,41,person
23523,17,person,14,1,15799,33,195,171,251,213,56,42,person
23524,18,person,15,1,15799,47,224,150,249,205,25,55,person
23525,30,bottle,26,1,15799,19,243,229,271,314,28,85,bottle
23526,32,bottle,28,1,15799,16,261,224,280,295,19,71,bottle
23527,33,bottle,29,1,15799,19,252,211,265,238,13,27,bottle
23528,35,bottle,31,1,15799,15,261,194,275,222,14,28,bottle
23529,36,plate,32,0,15799,18,188,262,235,278,47,16,plate
23530,38,plate,34,1,15799,16,188,252,232,264,44,12,plate
23531,40,plate,36,1,15799,15,289,272,345,300,56,28,plate
23532,41,plate,37,1,15799,17,290,256,320,268,30,12,plate
23533,42,person,38,1,15799,47,300,167,353,250,53,83,person
23534,43,plate,39,0,15799,15,293,222,314,228,21,6,plate
23535,7,chair,8,1,15800,16,323,244,422,388,99,144,chair
23536,4,plate,5,0,15801,16,110,204,190,231,80,27,plate
23537,10,plate,11,0,15801,15,8,177,67,192,59,15,plate
23538,17,table,18,1,15801,25,170,139,306,225,136,86,dining table
23539,7,person,8,1,15802,45,272,124,435,317,163,193,person
23540,8,person,9,1,15802,24,108,121,207,233,99,112,person
23541,9,person,10,1,15802,28,14,142,140,292,126,150,person
23542,10,chair,11,0,15803,19,126,145,178,234,52,89,chair
23543,18,chair,19,1,15804,19,251,235,326,286,75,51,chair
23544,19,plate,20,1,15804,17,290,260,366,286,76,26,plate
23545,22,plate,23,1,15804,18,332,234,398,263,66,29,plate
23546,25,table,26,1,15804,16,70,170,189,276,119,106,dining table
23547,26,chair,27,1,15804,46,74,177,140,276,66,99,chair
23548,27,chair,28,1,15804,30,63,170,112,251,49,81,chair
23549,28,chair,29,1,15804,26,135,172,186,262,51,90,chair
23550,29,chair,30,1,15804,16,121,164,156,223,35,59,chair
23551,30,plate,31,0,15804,16,95,182,128,194,33,12,plate
23552,31,plate,32,0,15804,17,141,178,177,190,36,12,plate
23553,32,plate,33,0,15804,18,82,173,110,183,28,10,plate
23554,37,chair,37,1,15804,19,8,156,53,209,45,53,chair
23555,42,table,42,1,15804,26,311,167,380,216,69,49,dining table
23556,43,chair,43,1,15804,19,304,157,334,217,30,60,chair
23557,46,table,46,1,15804,18,195,169,312,240,117,71,dining table
23558,49,plate,49,0,15804,15,236,170,263,177,27,7,plate
23559,56,chair,56,1,15804,21,232,180,270,245,38,65,chair
23560,57,chair,57,1,15804,27,204,174,248,240,44,66,chair
23561,58,chair,58,1,15804,20,262,171,302,234,40,63,chair
23562,71,table,70,1,15804,16,171,146,208,172,37,26,dining table
23563,72,chair,71,1,15804,18,187,149,204,178,17,29,chair
23564,8,sofa,9,0,15805,18,145,182,355,283,210,101,couch
23565,9,table,10,1,15805,16,210,176,390,212,180,36,dining table
23566,10,table,11,1,15805,25,296,213,480,348,184,135,dining table
23567,4,chair,5,1,15806,23,275,340,352,474,77,134,chair
23568,11,table,12,1,15806,24,331,390,394,467,63,77,dining table
23569,12,table,13,1,15806,16,95,415,254,476,159,61,dining table
23570,13,chair,14,1,15806,26,180,324,310,524,130,200,chair
23571,20,table,21,1,15806,21,359,445,689,523,330,78,dining table
23572,7,person,8,1,15807,18,158,80,172,119,14,39,person
23573,8,person,9,1,15807,20,174,90,210,123,36,33,person
23574,9,person,10,1,15807,20,120,90,150,134,30,44,person
23575,11,person,12,1,15807,15,89,83,108,108,19,25,person
23576,13,person,14,1,15807,15,61,76,74,108,13,32,person
23577,16,chair,17,1,15808,17,148,152,196,219,48,67,chair
23578,17,table,18,1,15808,19,172,157,237,217,65,60,dining table
23579,18,chair,19,1,15808,20,218,151,258,219,40,68,chair
23580,21,table,22,1,15808,19,275,158,412,228,137,70,dining table
23581,23,chair,24,1,15808,18,264,159,337,255,73,96,chair
23582,24,chair,25,1,15808,17,408,150,425,197,17,47,chair
23583,28,plate,29,0,15808,17,271,249,385,292,114,43,plate
23584,33,table,34,1,15808,24,0,181,183,319,183,138,dining table
23585,34,chair,35,1,15808,17,37,192,169,343,132,151,chair
23586,7,table,8,1,15809,20,0,152,85,225,85,73,dining table
23587,11,table,12,1,15809,33,91,128,178,192,87,64,dining table
23588,12,chair,13,0,15809,26,128,128,170,201,42,73,chair
23589,13,chair,14,1,15809,16,179,120,198,183,19,63,chair
23590,14,table,15,0,15809,28,197,123,251,167,54,44,dining table
23591,16,chair,17,0,15809,18,271,105,292,140,21,35,chair
23592,19,table,19,0,15810,23,113,261,177,329,64,68,dining table
23593,21,table,20,0,15810,23,101,198,162,272,61,74,dining table
23594,22,table,21,0,15810,16,97,164,145,206,48,42,dining table
23595,23,table,22,0,15810,15,288,279,372,336,84,57,dining table
23596,26,table,23,1,15810,17,240,199,295,255,55,56,dining table
23597,28,table,25,1,15810,17,350,192,413,248,63,56,dining table
23598,29,chair,26,0,15810,17,82,273,120,327,38,54,chair
23599,31,chair,28,0,15810,25,74,226,110,274,36,48,chair
23600,32,chair,29,1,15810,18,68,204,102,230,34,26,chair
23601,33,chair,30,0,15810,15,76,173,102,206,26,33,chair
23602,39,chair,36,0,15810,19,259,276,294,327,35,51,chair
23603,40,chair,37,0,15810,20,281,253,321,295,40,42,chair
23604,42,chair,39,0,15810,17,361,288,400,335,39,47,chair
23605,44,chair,41,0,15810,21,238,228,270,271,32,43,chair
23606,45,chair,42,0,15810,22,277,218,317,255,40,37,chair
23607,46,person,43,1,15810,25,284,198,308,242,24,44,person
23608,48,person,45,1,15810,18,249,175,277,208,28,33,person
23609,51,person,47,1,15810,23,358,199,398,243,40,44,person
23610,52,chair,48,1,15810,15,406,202,437,240,31,38,chair
23611,53,person,49,1,15810,22,401,183,432,237,31,54,person
23612,54,person,50,1,15810,17,369,169,398,198,29,29,person
23613,56,chair,52,1,15810,18,327,186,351,232,24,46,chair
23614,57,person,53,1,15810,29,334,178,371,230,37,52,person
23615,58,chair,54,0,15810,23,281,152,309,187,28,35,chair
23616,3,table,4,1,15811,18,5,172,146,255,141,83,dining table
23617,5,chair,6,1,15811,19,2,173,46,264,44,91,chair
23618,12,chair,13,1,15812,16,320,123,355,184,35,61,chair
23619,13,chair,14,0,15812,23,346,136,394,203,48,67,chair
23620,21,chair,22,0,15812,19,271,99,292,129,21,30,chair
23621,34,chair,35,1,15812,25,30,124,64,177,34,53,chair
23622,16,table,17,0,15814,19,120,178,156,224,36,46,dining table
23623,18,chair,19,1,15814,17,188,194,237,292,49,98,chair
23624,19,chair,20,1,15814,21,214,199,273,307,59,108,chair
23625,20,table,21,1,15814,17,335,235,548,276,213,41,dining table
23626,21,chair,22,0,15814,38,287,211,400,408,113,197,chair
23627,22,chair,23,1,15814,34,380,231,499,411,119,180,chair
23628,23,chair,24,1,15814,15,0,255,61,410,61,155,chair
23629,4,person,5,1,22051,19,0,371,80,552,80,181,person
23630,6,person,6,1,22051,37,54,340,212,626,158,286,person
23631,7,person,7,1,22051,16,0,529,90,635,90,106,person
23632,11,person,11,1,22051,44,365,323,581,699,216,376,person
23633,12,person,12,1,22051,45,109,385,394,618,285,233,person
23634,14,person,14,1,22051,84,429,375,906,914,477,539,person
23635,15,person,15,1,22051,102,1018,491,1645,1242,627,751,person
23636,17,person,17,1,22051,78,0,386,611,1242,611,856,person
23637,18,table,18,0,22051,49,4,731,1407,1242,1403,511,dining table
23638,21,plate,21,0,22051,19,736,793,906,880,170,87,plate
23639,24,plate,24,0,22051,22,1026,873,1255,979,229,106,plate
23640,25,plate,25,0,22051,19,549,1042,857,1212,308,170,plate
23641,36,plate,36,1,22051,19,892,760,1071,835,179,75,plate
23642,39,plate,39,1,22051,26,320,915,551,1043,231,128,plate
23643,45,bowl,45,0,22051,15,1303,685,1362,815,59,130,bowl
23644,3,person,4,1,22052,64,348,120,499,375,151,255,person
23645,4,chair,5,1,22052,19,294,293,459,375,165,82,chair
23646,5,person,6,1,22052,58,213,89,335,231,122,142,person
23647,6,person,7,1,22052,124,60,116,224,344,164,228,person
23648,7,person,8,1,22052,101,0,119,196,375,196,256,person
23649,9,table,10,1,22052,103,79,194,429,375,350,181,dining table
23650,5,chair,6,1,22053,18,512,156,550,307,38,151,chair
23651,6,person,7,0,22053,28,467,18,504,144,37,126,person
23652,7,person,8,0,22053,50,449,20,484,134,35,114,person
23653,8,person,9,1,22053,21,334,11,348,76,14,65,person
23654,9,person,10,1,22053,30,386,14,408,157,22,143,person
23655,10,person,11,1,22053,49,404,8,457,162,53,154,person
23656,11,person,12,1,22053,40,347,12,404,183,57,171,person
23657,13,refrigerator,14,0,22053,45,129,0,284,212,155,212,refrigerator
23658,15,chair,16,1,22053,17,379,176,399,243,20,67,chair
23659,16,person,17,1,22053,47,275,88,385,240,110,152,person
23660,17,person,18,1,22053,55,142,91,232,228,90,137,person
23661,18,person,19,1,22053,79,52,122,222,398,170,276,person
23662,19,person,20,1,22053,105,274,151,487,413,213,262,person
23663,20,chair,21,1,22053,31,285,270,479,413,194,143,chair
23664,21,table,22,0,22053,77,131,201,401,413,270,212,dining table
23665,22,chair,23,0,22053,29,18,256,200,413,182,157,chair
23666,23,chair,24,1,22053,16,75,377,253,413,178,36,chair
23667,28,plate,29,0,22053,15,328,236,378,254,50,18,plate
23668,2,door,3,0,22054,38,366,149,440,269,74,120,door
23669,7,window,8,0,22054,39,521,32,598,300,77,268,window
23670,10,window,11,0,22054,23,457,94,496,288,39,194,window
23671,13,clock,14,0,22054,29,583,65,653,202,70,137,clock
23672,14,window,15,0,22054,70,248,121,337,284,89,163,window
23673,20,table,21,0,22054,19,150,271,249,358,99,87,dining table
23674,21,chair,22,1,22054,33,146,253,194,346,48,93,chair
23675,22,chair,23,0,22054,28,135,256,193,361,58,105,chair
23676,23,chair,24,1,22054,19,214,273,257,348,43,75,chair
23677,24,person,25,1,22054,79,255,173,306,361,51,188,person
23678,27,person,28,1,22054,38,421,221,474,278,53,57,person
23679,28,person,29,1,22054,50,359,225,408,318,49,93,person
23680,29,person,30,1,22054,60,481,205,555,312,74,107,person
23681,30,chair,31,1,22054,20,508,266,558,275,50,9,chair
23682,31,chair,32,1,22054,22,502,270,573,302,71,32,chair
23683,32,chair,33,1,22054,31,405,273,483,452,78,179,chair
23684,33,chair,34,0,22054,42,367,266,451,405,84,139,chair
23685,34,table,35,0,22054,29,404,307,659,381,255,74,dining table
23686,35,chair,36,1,22054,22,500,293,621,382,121,89,chair
23687,36,chair,37,1,22054,15,650,289,700,385,50,96,chair
23688,37,chair,38,1,22054,19,405,369,700,453,295,84,chair
23689,38,chair,39,0,22054,32,255,266,350,416,95,150,chair
23690,39,chair,40,1,22054,27,274,264,345,385,71,121,chair
23691,40,person,41,1,22054,82,276,220,371,383,95,163,person
23692,0,table,1,0,24273,20,61,476,939,665,878,189,dining table
23693,6,chair,7,1,24273,21,205,430,381,532,176,102,chair
23694,7,chair,8,1,24273,20,535,435,709,495,174,60,chair
23695,8,chair,9,1,24273,17,876,505,1000,665,124,160,chair
23696,9,table,10,1,24273,21,781,435,1000,591,219,156,dining table
23697,9,person,10,1,24274,62,1,313,378,684,377,371,person
23698,10,person,11,1,24274,73,186,313,382,608,196,295,person
23699,11,person,12,1,24274,83,294,288,505,467,211,179,person
23700,12,person,13,1,24274,47,369,299,502,413,133,114,person
23701,13,person,14,1,24274,20,402,351,444,410,42,59,person
23702,14,person,15,1,24274,24,439,287,516,403,77,116,person
23703,15,person,16,1,24274,54,504,205,613,402,109,197,person
23704,16,person,17,1,24274,94,514,299,937,683,423,384,person
23705,17,person,18,1,24274,64,562,276,704,513,142,237,person
23706,18,person,19,1,24274,15,690,274,751,305,61,31,person
23707,19,person,20,1,24274,30,561,269,646,406,85,137,person
23708,22,chair,23,0,24274,26,925,357,1017,505,92,148,chair
23709,23,person,24,1,24274,36,870,280,946,461,76,181,person
23710,24,person,25,1,24274,17,945,281,1022,381,77,100,person
23711,25,chair,26,1,24274,21,853,335,926,459,73,124,chair
23712,26,person,27,1,24274,34,871,213,967,309,96,96,person
23713,28,table,29,1,24274,55,93,382,673,684,580,302,dining table
23714,32,plate,33,0,24274,26,241,546,373,608,132,62,plate
23715,3,chair,4,1,24275,31,590,133,832,306,242,173,chair
23716,4,table,5,0,24275,31,1,263,921,681,920,418,dining table
23717,5,bowl,6,0,24275,26,584,411,743,507,159,96,bowl
23718,6,bowl,7,0,24275,20,338,320,516,426,178,106,bowl
23719,7,plate,8,0,24275,22,338,380,523,439,185,59,plate
23720,10,glasses,11,0,24275,16,264,325,311,365,47,40,eye glasses
23721,13,fork,14,0,24275,18,187,359,343,433,156,74,fork
23722,4,window,5,0,24276,41,414,51,987,364,573,313,window
23723,12,sofa,13,0,24276,25,717,423,808,581,91,158,couch
23724,19,person,20,1,24276,104,775,116,974,671,199,555,person
23725,20,person,21,1,24276,70,792,131,955,630,163,499,person
23726,21,person,22,1,24276,29,938,1,1023,665,85,664,person
23727,14,table,15,1,24277,28,16,395,89,475,73,80,dining table
23728,15,chair,16,1,24277,43,36,361,120,478,84,117,chair
23729,16,chair,17,1,24277,25,2,373,58,537,56,164,chair
23730,0,window,1,0,24278,70,1,0,753,458,752,458,window
23731,3,table,4,1,24278,17,912,312,1024,449,112,137,dining table
23732,9,table,10,1,24278,33,295,428,508,584,213,156,dining table
23733,10,chair,11,1,24278,17,305,478,378,537,73,59,chair
23734,14,person,15,1,24278,79,0,7,418,713,418,706,person
23735,15,person,16,1,24278,96,476,116,933,660,457,544,person
23736,17,plate,18,1,24278,15,683,595,779,668,96,73,plate
23737,13,chair,14,0,24279,18,652,437,729,553,77,116,chair
23738,14,chair,15,1,24279,18,739,429,817,460,78,31,chair
23739,15,chair,16,0,24279,18,845,444,938,563,93,119,chair
23740,16,chair,17,0,24279,25,759,467,857,593,98,126,chair
23741,20,chair,21,0,24279,16,205,510,340,586,135,76,chair
23742,24,plate,25,0,24279,26,218,643,314,686,96,43,plate
23743,25,plate,26,0,24279,15,230,641,299,678,69,37,plate
23744,42,table,43,1,24279,26,727,455,864,559,137,104,dining table
23745,18,table,19,0,24280,29,895,345,1024,400,129,55,dining table
23746,19,chair,20,1,24280,15,888,344,921,375,33,31,chair
23747,20,chair,21,0,24280,40,855,350,919,428,64,78,chair
23748,21,chair,22,0,24280,38,903,365,988,454,85,89,chair
23749,22,chair,23,1,24280,16,988,394,1024,457,36,63,chair
23750,23,chair,24,1,24280,36,959,405,1024,515,65,110,chair
23751,25,chair,26,1,24280,32,812,377,852,462,40,85,chair
23752,26,table,27,0,24280,28,657,332,778,376,121,44,dining table
23753,28,table,29,0,24280,23,584,339,663,399,79,60,dining table
23754,29,table,30,1,24280,32,612,350,672,410,60,60,dining table
23755,30,table,31,0,24280,38,658,361,826,460,168,99,dining table
23756,31,chair,32,1,24280,23,635,379,677,434,42,55,chair
23757,32,chair,33,1,24280,20,546,394,614,437,68,43,chair
23758,33,table,34,0,24280,20,502,342,585,377,83,35,dining table
23759,34,chair,35,1,24280,23,535,355,588,420,53,65,chair
23760,37,chair,38,1,24280,22,377,385,419,500,42,115,chair
23761,38,table,39,0,24280,36,230,351,386,442,156,91,dining table
23762,39,table,40,0,24280,50,384,381,574,512,190,131,dining table
23763,40,chair,41,1,24280,43,413,419,516,542,103,123,chair
23764,41,chair,42,1,24280,20,541,429,610,479,69,50,chair
23765,42,chair,43,1,24280,26,658,424,741,447,83,23,chair
23766,43,chair,44,1,24280,27,699,394,783,451,84,57,chair
23767,44,chair,45,1,24280,22,855,452,964,503,109,51,chair
23768,45,chair,46,1,24280,40,441,471,529,637,88,166,chair
23769,46,chair,47,1,24280,20,429,605,580,678,151,73,chair
23770,47,chair,48,1,24280,65,85,458,237,601,152,143,chair
23771,48,chair,49,1,24280,33,1,514,210,678,209,164,chair
23772,49,table,50,0,24280,25,0,456,155,640,155,184,dining table
23773,66,plate,67,0,24280,17,746,585,868,655,122,70,plate
23774,67,plate,68,0,24280,16,872,606,963,656,91,50,plate
23775,76,table,77,0,24280,27,508,445,1024,678,516,233,dining table
23776,79,person,80,1,24280,21,57,270,86,414,29,144,person
23777,87,fork,88,0,24280,15,729,584,751,647,22,63,fork
23778,103,chair,104,1,24280,35,314,373,382,454,68,81,chair
23779,104,chair,105,0,24280,37,238,378,313,464,75,86,chair
23780,1,person,2,1,15815,68,614,0,1199,1419,585,1419,person
23781,12,plate,13,0,15815,17,534,996,834,1098,300,102,plate
23782,6,person,7,1,15817,45,237,39,362,479,125,440,person
23783,8,plate,9,0,15817,15,199,401,343,456,144,55,plate
23784,9,plate,10,0,15817,18,35,410,187,467,152,57,plate
23785,10,plate,11,0,15817,15,49,367,177,410,128,43,plate
23786,11,plate,12,0,15817,17,184,360,309,403,125,43,plate
23787,4,person,5,1,24281,129,2,149,500,799,498,650,person
23788,4,person,5,1,24282,49,1521,73,2089,1102,568,1029,person
23789,5,person,6,1,24282,62,674,193,1337,1063,663,870,person
23790,8,bowl,9,0,24282,25,1624,994,2064,1221,440,227,bowl
23791,14,bowl,15,0,24282,20,343,1113,600,1261,257,148,bowl
23792,15,bowl,16,0,24282,20,191,1251,506,1429,315,178,bowl
23793,16,plate,17,0,24282,20,428,1302,899,1562,471,260,plate
23794,17,bowl,18,0,24282,21,1017,1198,1290,1362,273,164,bowl
23795,18,bowl,19,0,24282,19,1260,1332,1589,1534,329,202,bowl
23796,19,bowl,20,0,24282,20,1364,1208,1642,1373,278,165,bowl
23797,20,plate,21,0,24282,21,1176,1083,1518,1237,342,154,plate
23798,24,bowl,25,0,24282,16,952,1070,1037,1146,85,76,bowl
23799,26,bowl,27,0,24282,17,594,1410,718,1527,124,117,bowl
23800,3,door,4,0,24283,17,9,117,231,360,222,243,door
23801,6,door,7,0,24283,55,299,108,566,604,267,496,door
23802,7,person,8,1,24283,23,169,453,312,684,143,231,person
23803,8,person,9,1,24283,26,39,245,172,713,133,468,person
23804,9,person,10,1,24283,104,1,58,647,877,646,819,person
23805,10,person,11,1,24283,49,572,27,766,730,194,703,person
23806,11,table,12,0,24283,20,2,580,767,1023,765,443,dining table
23807,13,shoe,14,0,259,21,550,183,581,232,31,49,shoe
23808,14,shoe,15,0,259,20,471,313,529,344,58,31,shoe
23809,15,shoe,16,1,259,22,487,308,544,334,57,26,shoe
23810,16,shoe,17,0,259,18,561,331,619,360,58,29,shoe
23811,17,shoe,18,1,259,17,560,320,620,350,60,30,shoe
23812,31,person,32,0,259,117,135,58,285,414,150,356,person
23813,42,person,43,0,259,83,267,28,406,414,139,386,person
23814,38,person,39,1,16205,42,280,98,392,332,112,234,person
23815,39,person,40,1,16205,57,177,64,290,332,113,268,person
23816,2,person,3,0,16207,60,72,154,189,315,117,161,person
23817,8,shoe,9,0,16208,15,239,111,278,130,39,19,shoe
23818,14,person,15,1,16209,16,18,320,42,367,24,47,person
23819,16,person,17,1,16209,15,2,293,26,342,24,49,person
23820,17,person,18,0,16209,39,66,298,131,468,65,170,person
23821,19,person,20,1,16209,18,56,291,72,359,16,68,person
23822,8,person,9,1,16211,122,161,39,349,582,188,543,person
23823,10,shoe,11,1,16211,30,5,112,193,199,188,87,shoe
23824,11,shoe,12,1,16211,31,0,119,187,213,187,94,shoe
23825,12,shoe,13,1,16211,30,0,150,170,240,170,90,shoe
23826,13,shoe,14,1,16211,18,0,196,112,251,112,55,shoe
23827,14,shoe,15,1,16211,15,0,231,121,304,121,73,shoe
23828,15,shoe,16,1,16211,18,155,321,220,354,65,33,shoe
23829,16,shoe,17,1,16211,18,145,334,212,370,67,36,shoe
23830,17,shoe,18,1,16211,18,129,350,211,393,82,43,shoe
23831,18,shoe,19,1,16211,18,110,375,203,428,93,53,shoe
23832,19,shoe,20,1,16211,18,92,406,194,463,102,57,shoe
23833,20,shoe,21,1,16211,20,62,438,182,505,120,67,shoe
23834,21,shoe,22,1,16211,20,30,486,167,566,137,80,shoe
23835,24,mirror,25,1,16211,28,63,1,168,146,105,145,mirror
23836,27,shoe,27,0,16212,16,145,65,180,93,35,28,shoe
23837,36,shoe,36,1,16212,17,73,163,112,195,39,32,shoe
23838,38,shoe,38,0,16212,17,109,147,146,174,37,27,shoe
23839,40,shoe,40,0,16212,19,151,159,185,197,34,38,shoe
23840,41,shoe,41,0,16212,21,195,129,230,161,35,32,shoe
23841,42,shoe,42,0,16212,17,192,168,226,205,34,37,shoe
23842,43,shoe,43,0,16212,16,120,229,159,266,39,37,shoe
23843,49,shoe,49,0,16212,15,239,49,257,73,18,24,shoe
23844,50,shoe,50,0,16212,21,244,79,263,112,19,33,shoe
23845,53,shoe,53,0,16212,18,247,149,270,175,23,26,shoe
23846,54,shoe,54,0,16212,21,262,54,290,89,28,35,shoe
23847,56,shoe,56,0,16212,22,312,93,339,126,27,33,shoe
23848,57,shoe,57,0,16212,22,276,102,304,135,28,33,shoe
23849,58,shoe,58,0,16212,15,269,148,297,176,28,28,shoe
23850,59,shoe,59,0,16212,17,255,242,274,275,19,33,shoe
23851,60,shoe,60,0,16212,16,292,234,322,260,30,26,shoe
23852,61,shoe,61,0,16212,21,312,162,341,187,29,25,shoe
23853,62,shoe,62,0,16212,18,342,57,375,82,33,25,shoe
23854,63,shoe,63,0,16212,19,349,96,379,118,30,22,shoe
23855,64,shoe,64,0,16212,15,347,127,378,148,31,21,shoe
23856,65,shoe,65,0,16212,16,344,154,378,178,34,24,shoe
23857,8,person,9,1,16213,25,0,152,57,374,57,222,person
23858,9,person,10,1,16213,26,41,155,99,225,58,70,person
23859,10,person,11,1,16213,33,85,156,122,253,37,97,person
23860,12,person,13,0,16213,36,153,191,222,283,69,92,person
23861,13,person,14,0,16213,54,240,150,295,297,55,147,person
23862,14,person,15,1,16213,34,300,141,332,292,32,151,person
23863,15,person,16,0,16213,41,326,148,383,311,57,163,person
23864,16,person,17,1,16213,22,448,126,500,374,52,248,person
23865,17,person,18,1,16213,33,222,148,254,262,32,114,person
23866,21,person,22,1,16213,22,139,155,171,212,32,57,person
23867,24,person,25,1,16213,17,169,153,194,188,25,35,person
23868,3,person,4,1,16214,50,212,167,313,333,101,166,person
23869,7,shoe,8,1,16214,20,276,319,324,351,48,32,shoe
23870,8,shoe,9,0,16214,18,260,322,308,357,48,35,shoe
23871,29,shoe,30,0,16215,16,128,232,162,254,34,22,shoe
23872,7,dog,8,0,16216,33,173,213,229,278,56,65,dog
23873,19,shoe,20,1,16216,15,59,18,95,40,36,22,shoe
23874,10,shoe,11,0,16217,15,65,226,108,253,43,27,shoe
23875,11,shoe,12,0,16217,16,63,278,110,307,47,29,shoe
23876,12,shoe,13,0,16217,16,11,282,56,309,45,27,shoe
23877,13,suitcase,14,0,16217,15,125,22,197,52,72,30,suitcase
23878,13,table,14,0,16218,17,95,184,150,233,55,49,dining table
23879,24,shoe,25,0,16219,21,454,790,610,862,156,72,shoe
23880,25,shoe,26,1,16219,16,498,792,645,847,147,55,shoe
23881,26,shoe,27,1,16219,20,250,814,400,889,150,75,shoe
23882,27,shoe,28,1,16219,22,194,825,352,901,158,76,shoe
23883,28,shoe,29,0,16219,20,140,827,314,908,174,81,shoe
23884,35,person,36,1,16219,93,562,192,1029,1055,467,863,person
23885,2,shoe,3,0,16221,15,340,38,425,64,85,26,shoe
23886,3,shoe,4,0,16221,22,342,11,404,57,62,46,shoe
23887,11,shoe,12,0,16221,23,175,133,211,176,36,43,shoe
23888,12,shoe,13,0,16221,17,102,138,134,176,32,38,shoe
23889,16,shoe,17,0,16221,29,2,181,71,212,69,31,shoe
23890,7,person,8,1,16224,50,153,15,320,280,167,265,person
23891,26,shoe,27,0,16224,16,5,220,79,284,74,64,shoe
23892,5,shoe,6,0,16225,15,231,309,271,382,40,73,shoe
23893,0,shoe,1,0,16226,16,145,210,187,326,42,116,shoe
23894,3,shoe,4,0,16226,18,45,201,86,339,41,138,shoe
23895,4,shoe,5,0,16226,15,263,204,300,323,37,119,shoe
23896,5,shoe,6,0,16226,19,320,204,361,323,41,119,shoe
23897,7,shoe,8,0,16226,16,277,339,311,451,34,112,shoe
23898,8,shoe,9,0,16226,16,236,359,271,463,35,104,shoe
23899,9,shoe,10,0,16226,21,194,351,229,469,35,118,shoe
23900,10,shoe,11,0,16226,17,141,355,178,473,37,118,shoe
23901,11,shoe,12,0,16226,18,79,361,116,490,37,129,shoe
23902,12,shoe,13,0,16226,18,19,371,56,498,37,127,shoe
23903,8,shoe,9,0,16227,15,206,177,228,193,22,16,shoe
23904,9,shoe,10,0,16227,15,193,174,213,191,20,17,shoe
23905,10,shoe,11,0,16227,15,180,170,204,187,24,17,shoe
23906,3,table,4,0,16228,18,2,220,278,337,276,117,dining table
23907,50,mirror,51,1,16228,15,276,233,359,284,83,51,mirror
23908,26,flowerpot,27,0,16229,15,143,197,177,250,34,53,potted plant
23909,0,person,1,0,16230,77,345,27,439,327,94,300,person
23910,27,person,28,1,16230,18,219,2,267,64,48,62,person
23911,28,person,29,1,16230,29,320,17,357,128,37,111,person
23912,9,shoe,10,0,16232,15,134,225,165,242,31,17,shoe
23913,4,shoe,5,0,16235,22,422,106,484,143,62,37,shoe
23914,7,shoe,8,0,16235,25,21,114,91,165,70,51,shoe
23915,8,person,9,0,16235,45,210,120,252,237,42,117,person
23916,26,shoe,27,0,16236,17,415,86,447,148,32,62,shoe
23917,1,person,2,0,16237,29,139,0,373,406,234,406,person
23918,12,shoe,13,0,16237,18,321,25,372,76,51,51,shoe
23919,23,shoe,24,0,16237,16,136,354,194,455,58,101,shoe
23920,24,shoe,25,0,16237,17,10,275,117,306,107,31,shoe
23921,1,person,2,1,16238,46,203,37,338,222,135,185,person
23922,2,person,3,1,16238,66,0,62,227,300,227,238,person
23923,3,person,4,1,16238,52,156,126,270,300,114,174,person
23924,4,person,5,1,16238,44,294,56,400,300,106,244,person
23925,7,shoe,8,0,16238,18,143,54,175,101,32,47,shoe
23926,8,shoe,9,0,16238,19,170,51,207,95,37,44,shoe
23927,9,shoe,10,0,16238,15,198,46,234,88,36,42,shoe
23928,10,shoe,11,1,16238,15,216,42,247,82,31,40,shoe
23929,11,shoe,12,0,16238,16,292,34,324,68,32,34,shoe
23930,12,shoe,13,0,16238,15,308,30,342,65,34,35,shoe
23931,13,shoe,14,0,16238,15,327,29,357,62,30,33,shoe
23932,16,shoe,17,1,16238,15,119,60,148,109,29,49,shoe
23933,24,shoe,25,0,16238,15,4,1,36,57,32,56,shoe
23934,9,sofa,10,1,16239,28,81,116,189,200,108,84,couch
23935,10,sofa,11,1,16239,28,0,160,147,225,147,65,couch
23936,3,shoe,4,0,16240,18,1133,168,1532,306,399,138,shoe
23937,4,shoe,5,0,16240,20,412,567,864,746,452,179,shoe
23938,6,shoe,7,0,16240,19,431,1099,790,1263,359,164,shoe
23939,7,shoe,8,0,16240,18,1120,975,1480,1173,360,198,shoe
23940,8,shoe,9,0,16240,16,1766,268,1973,355,207,87,shoe
23941,9,shoe,10,0,16240,21,1792,652,2038,724,246,72,shoe
23942,10,shoe,11,0,16240,19,1852,748,2007,1078,155,330,shoe
23943,11,bench,12,0,16241,25,713,699,1279,958,566,259,bench
23944,13,shoe,14,1,16241,15,382,319,528,403,146,84,shoe
23945,14,shoe,15,1,16241,15,457,315,618,394,161,79,shoe
23946,27,mirror,28,1,16241,19,1011,269,1149,410,138,141,mirror
23947,28,shoe,29,0,16241,21,795,304,931,369,136,65,shoe
23948,31,shoe,32,0,16241,15,973,203,1115,253,142,50,shoe
23949,37,shoe,38,0,16241,17,772,48,905,113,133,65,shoe
23950,17,shoe,18,1,16242,19,926,363,1108,484,182,121,shoe
23951,7,sofa,8,1,16243,76,623,537,1531,988,908,451,couch
23952,8,person,9,0,16243,70,675,433,1024,1056,349,623,person
23953,9,person,10,1,16243,26,1192,668,1598,1074,406,406,person
23954,22,table,23,1,16244,51,0,648,635,1513,635,865,dining table
23955,24,suitcase,25,0,16244,20,296,557,576,711,280,154,suitcase
23956,29,suitcase,30,1,16244,33,1647,240,2047,894,400,654,suitcase
23957,30,shoe,31,1,16244,44,922,696,1542,877,620,181,shoe
23958,31,shoe,32,1,16244,37,944,677,1505,803,561,126,shoe
23959,32,shoe,33,1,16244,45,965,755,1699,934,734,179,shoe
23960,33,shoe,34,1,16244,49,958,776,1771,1050,813,274,shoe
23961,34,shoe,35,1,16244,49,981,910,2046,1205,1065,295,shoe
23962,35,shoe,36,1,16244,47,940,952,2044,1436,1104,484,shoe
23963,6,person,7,1,16245,99,349,207,1263,970,914,763,person
23964,15,shoe,16,0,16246,17,176,899,255,1012,79,113,shoe
23965,16,shoe,17,0,16246,17,261,901,333,1013,72,112,shoe
23966,17,shoe,18,0,16246,15,416,896,489,1016,73,120,shoe
23967,18,shoe,19,0,16246,17,492,901,568,1018,76,117,shoe
23968,19,shoe,20,1,16246,22,591,910,757,971,166,61,shoe
23969,20,shoe,21,1,16246,19,606,934,757,1005,151,71,shoe
23970,15,plant pots,16,0,16260,18,445,273,483,297,38,24,potted plant
23971,19,person,20,1,16260,21,327,283,349,330,22,47,person
23972,20,person,21,1,16260,24,326,264,354,319,28,55,person
23973,10,person,11,0,16261,20,142,149,159,186,17,37,person
23974,11,person,12,0,16261,17,114,170,130,204,16,34,person
23975,21,person,22,1,16261,15,223,208,252,237,29,29,person
23976,22,person,23,1,16261,15,268,212,299,236,31,24,person
23977,24,person,25,0,16261,19,226,168,240,204,14,36,person
23978,29,person,30,1,16261,16,108,326,139,357,31,31,person
23979,14,person,15,0,16262,22,125,100,137,135,12,35,person
23980,15,person,16,0,16262,17,136,107,148,134,12,27,person
23981,16,person,17,0,16262,20,157,102,167,129,10,27,person
23982,17,person,18,1,16262,15,152,101,160,129,8,28,person
23983,24,bench,25,0,16262,31,2,150,76,222,74,72,bench
23984,25,clock,26,0,16262,28,152,12,179,36,27,24,clock
23985,27,person,28,0,16262,34,51,117,89,173,38,56,person
23986,8,person,9,0,16263,15,60,220,69,248,9,28,person
23987,4,person,5,0,16264,21,145,470,179,577,34,107,person
23988,5,person,6,0,16264,19,74,478,123,581,49,103,person
23989,8,person,9,0,16264,16,1199,466,1246,573,47,107,person
23990,12,person,13,1,16264,15,120,615,176,694,56,79,person
23991,32,person,33,0,16264,24,999,1121,1099,1253,100,132,person
23992,34,person,35,0,16264,20,409,714,446,802,37,88,person
23993,36,person,37,0,16264,17,910,706,931,795,21,89,person
23994,38,person,39,0,16264,16,746,695,771,785,25,90,person
23995,49,person,50,0,16264,21,9,473,57,597,48,124,person
23996,50,person,51,0,16264,17,382,711,413,787,31,76,person
23997,51,person,52,0,16264,16,937,709,963,787,26,78,person
23998,52,person,53,0,16264,25,1056,463,1101,555,45,92,person
23999,13,person,14,0,16265,17,871,721,914,905,43,184,person
24000,26,person,27,1,16265,17,178,1484,252,1649,74,165,person
24001,27,person,28,1,16265,16,114,1477,177,1648,63,171,person
24002,30,person,31,0,16265,16,1028,1204,1080,1362,52,158,person
24003,57,person,58,1,16265,16,768,715,817,782,49,67,person
24004,11,person,12,1,16268,16,845,1373,925,1588,80,215,person
24005,12,person,13,1,16268,15,755,1376,827,1591,72,215,person
24006,13,person,14,0,16268,17,182,1379,248,1534,66,155,person
24007,14,person,15,0,16268,17,934,1382,994,1540,60,158,person
24008,15,person,16,1,16268,15,519,1385,633,1588,114,203,person
24009,5,person,6,0,16269,27,92,175,123,287,31,112,person
24010,6,person,7,0,16269,28,121,168,150,295,29,127,person
24011,13,chair,14,0,16269,18,406,213,444,283,38,70,chair
24012,8,person,9,0,16271,18,214,232,226,265,12,33,person
24013,22,person,23,1,16272,19,14,99,49,166,35,67,person
24014,23,person,24,1,16272,26,17,112,58,239,41,127,person
24015,24,person,25,0,16272,20,4,93,15,138,11,45,person
24016,7,car,8,0,16273,15,194,65,255,89,61,24,car
24017,24,person,25,1,16274,29,252,194,290,230,38,36,person
24018,25,person,26,1,16274,18,216,181,251,238,35,57,person
24019,29,person,30,0,16274,16,170,171,178,194,8,23,person
24020,31,person,32,0,16274,20,189,162,199,188,10,26,person
24021,1,car,2,0,16275,19,155,121,201,161,46,40,car
24022,2,car,3,0,16275,27,53,139,152,176,99,37,car
24023,12,person,13,0,16275,19,135,10,149,50,14,40,person
24024,13,person,14,0,16275,17,149,8,162,50,13,42,person
24025,15,person,16,0,16275,18,192,7,206,46,14,39,person
24026,12,person,13,0,16277,19,288,410,318,480,30,70,person
24027,13,person,14,0,16277,16,354,344,373,392,19,48,person
24028,14,person,15,0,16277,22,253,475,273,555,20,80,person
24029,5,person,6,0,16278,19,207,149,220,190,13,41,person
24030,6,person,7,0,16278,18,220,145,230,184,10,39,person
24031,7,person,8,0,16278,19,28,122,40,154,12,32,person
24032,11,person,12,1,16278,15,48,183,64,207,16,24,person
24033,47,person,47,0,22109,24,22,470,41,520,19,50,person
24034,49,person,49,1,22109,23,121,465,133,508,12,43,person
24035,55,person,55,1,22109,17,311,513,327,534,16,21,person
24036,57,person,57,1,22109,15,402,534,417,555,15,21,person
24037,26,baseball glove,27,0,16726,17,43,851,158,993,115,142,baseball glove
24038,28,baseball glove,29,0,16726,16,59,1270,185,1368,126,98,baseball glove
24039,5,person,6,1,289,95,70,1,391,386,321,385,person
24040,11,person,12,1,959,58,58,528,196,712,138,184,person
24041,14,person,15,0,959,72,432,516,482,648,50,132,person
24042,16,person,17,1,959,67,458,501,498,619,40,118,person
24043,17,person,18,1,959,21,494,502,517,533,23,31,person
24044,0,person,1,0,18977,46,15,78,60,227,45,149,person
24045,14,person,15,1,18978,22,187,113,207,136,20,23,person
24046,19,person,20,0,18978,30,12,115,33,161,21,46,person
24047,20,person,21,0,18978,22,50,111,65,156,15,45,person
24048,21,person,22,1,18978,17,63,113,74,149,11,36,person
24049,23,person,24,0,18978,20,2,108,8,144,6,36,person
24050,24,person,25,1,18978,19,145,112,157,136,12,24,person
24051,5,person,6,0,18980,24,265,185,287,238,22,53,person
24052,7,person,8,1,18983,68,49,3,326,313,277,310,person
24053,7,person,8,1,18985,37,120,74,191,279,71,205,person
24054,22,person,23,1,18985,45,231,109,377,266,146,157,person
24055,25,person,26,1,18985,26,2,50,85,299,83,249,person
24056,0,person,1,0,18988,52,218,391,368,599,150,208,person
24057,49,table,26,1,18988,16,466,439,556,484,90,45,dining table
24058,7,person,8,1,18990,26,231,57,291,182,60,125,person
24059,9,person,10,1,18990,23,100,85,151,163,51,78,person
24060,2,person,3,0,18991,25,72,144,89,193,17,49,person
24061,9,person,10,0,18991,21,88,147,97,170,9,23,person
24062,10,person,11,1,18994,40,293,14,429,196,136,182,person
24063,11,person,12,1,18994,57,160,34,228,244,68,210,person
24064,5,person,6,1,18995,50,219,13,595,398,376,385,person
24065,12,person,13,0,18999,52,266,159,344,408,78,249,person
24066,7,person,8,0,19002,41,683,573,777,949,94,376,person
24067,9,person,10,0,19002,47,1337,622,1578,1196,241,574,person
24068,11,person,12,1,19002,24,793,549,904,804,111,255,person
24069,16,person,17,0,19002,28,387,553,457,790,70,237,person
24070,17,person,18,0,19002,22,533,542,609,746,76,204,person
24071,27,person,28,0,19002,23,618,542,681,725,63,183,person
24072,7,bottle,8,0,24503,31,48,179,136,399,88,220,bottle
24073,8,bottle,9,0,24503,23,126,227,170,390,44,163,bottle
24074,9,bottle,10,0,24503,18,23,448,92,663,69,215,bottle
24075,10,bottle,11,0,24503,21,91,431,160,604,69,173,bottle
24076,30,bottle,31,0,24503,22,288,334,323,460,35,126,bottle
24077,31,bottle,32,0,24503,22,274,332,298,464,24,132,bottle
24078,32,bottle,33,0,24503,23,310,335,338,446,28,111,bottle
24079,14,person,15,1,24504,20,16,301,96,393,80,92,person
24080,4,person,5,1,24506,21,287,140,406,229,119,89,person
24081,5,person,6,1,24506,27,366,172,526,308,160,136,person
24082,6,person,7,1,24506,15,102,145,177,223,75,78,person
24083,7,person,8,1,24506,24,136,178,264,344,128,166,person
24084,8,person,9,1,24506,42,96,274,360,489,264,215,person
24085,9,person,10,1,24506,60,140,407,570,1024,430,617,person
24086,8,person,9,0,19004,36,1165,711,1399,1066,234,355,person
24087,11,person,12,1,19004,29,607,622,911,959,304,337,person
24088,16,chair,17,1,19004,19,688,1250,1053,1472,365,222,chair
24089,17,chair,18,1,19004,16,1142,1227,1415,1372,273,145,chair
24090,18,chair,19,1,19004,15,1511,1206,1707,1333,196,127,chair
24091,19,chair,20,1,19004,17,1821,1216,2199,1471,378,255,chair
24092,8,chair,9,1,19005,17,198,322,329,532,131,210,chair
24093,17,bottle,18,0,19005,15,27,320,66,400,39,80,bottle
24094,12,person,10,1,19006,24,441,165,530,299,89,134,person
24095,13,person,11,1,19006,23,517,158,574,295,57,137,person
24096,14,person,12,1,19006,17,572,171,632,247,60,76,person
24097,16,person,14,1,19006,21,319,115,384,188,65,73,person
24098,17,person,15,1,19006,17,164,132,217,195,53,63,person
24099,4,table,5,0,19080,27,161,365,316,477,155,112,dining table
24100,5,chair,6,1,19080,28,143,336,210,477,67,141,chair
24101,6,chair,7,1,19080,19,251,370,373,477,122,107,chair
24102,10,chair,11,0,19080,27,533,326,611,445,78,119,chair
24103,6,bottle,7,0,19081,24,1803,938,1983,1190,180,252,bottle
24104,7,chair,8,1,19081,36,1574,791,1784,1296,210,505,chair
24105,8,chair,9,1,19081,41,1234,839,1545,1332,311,493,chair
24106,9,table,10,1,19081,64,1371,889,1700,1321,329,432,dining table
24107,16,table,17,1,19081,42,823,851,1139,1068,316,217,dining table
24108,19,chair,20,0,19081,32,549,228,655,372,106,144,chair
24109,20,clock,21,0,19081,15,790,246,875,341,85,95,clock
24110,21,chair,22,1,19081,15,205,699,337,805,132,106,chair
24111,23,chair,24,1,19081,22,641,803,833,1032,192,229,chair
24112,24,table,25,1,19081,40,0,782,501,1120,501,338,dining table
24113,25,chair,26,1,19081,24,0,884,209,1312,209,428,chair
24114,32,table,33,1,19081,82,0,1004,1142,1534,1142,530,dining table
24115,7,chair,8,1,19082,17,555,405,644,518,89,113,chair
24116,8,chair,9,1,19082,18,487,455,621,532,134,77,chair
24117,11,chair,12,1,19082,55,305,521,618,865,313,344,chair
24118,12,chair,13,1,19082,35,777,379,914,537,137,158,chair
24119,14,chair,15,1,19082,17,913,454,1037,548,124,94,chair
24120,16,chair,17,1,19082,19,1044,376,1197,596,153,220,chair
24121,17,chair,18,1,19082,24,1090,432,1166,663,76,231,chair
24122,18,chair,19,1,19082,34,1121,466,1279,749,158,283,chair
24123,22,chair,23,1,19082,57,711,529,1026,937,315,408,chair
24124,23,table,24,1,19082,73,442,511,942,803,500,292,dining table
24125,33,table,34,1,19082,40,20,787,563,958,543,171,dining table
24126,38,plate,39,0,19082,16,296,879,479,957,183,78,plate
24127,39,chair,40,1,19082,18,604,772,676,958,72,186,chair
24128,0,window,1,0,19083,18,335,0,599,126,264,126,window
24129,1,sofa,2,0,19083,17,336,91,453,136,117,45,couch
24130,2,chair,3,1,19083,19,547,97,599,174,52,77,chair
24131,8,table,9,0,19083,47,64,201,461,451,397,250,dining table
24132,1,door,2,1,19084,15,186,207,281,422,95,215,door
24133,7,chair,8,1,19084,31,434,416,539,590,105,174,chair
24134,8,chair,9,1,19084,24,524,445,651,618,127,173,chair
24135,13,table,14,1,19084,41,433,440,580,566,147,126,dining table
24136,20,chair,21,1,19084,28,539,543,650,747,111,204,chair
24137,21,chair,22,1,19084,32,626,576,813,747,187,171,chair
24138,22,table,23,1,19084,54,530,543,993,747,463,204,dining table
24139,33,table,34,1,19084,54,30,416,261,501,231,85,dining table
24140,39,chair,40,1,19084,37,2,510,163,747,161,237,chair
24141,40,chair,41,1,19084,49,181,492,377,747,196,255,chair
24142,41,table,42,1,19084,60,24,485,394,713,370,228,dining table
24143,4,chair,5,1,19085,15,212,157,284,234,72,77,chair
24144,8,table,9,1,19085,27,391,166,527,287,136,121,dining table
24145,16,chair,17,1,19085,20,346,207,463,375,117,168,chair
24146,17,table,18,0,19085,20,201,219,435,355,234,136,dining table
24147,25,chair,26,1,19085,20,76,195,213,301,137,106,chair
24148,26,chair,27,1,19085,22,2,238,109,377,107,139,chair
24149,29,chair,30,0,19085,15,489,189,599,309,110,120,chair
24150,30,table,31,1,19085,17,2,203,175,255,173,52,dining table
24151,10,bowl,11,0,19086,16,190,112,231,138,41,26,bowl
24152,7,chair,8,1,19087,17,102,154,134,188,32,34,chair
24153,8,chair,9,1,19087,32,250,166,297,251,47,85,chair
24154,11,chair,12,1,19087,20,224,194,279,337,55,143,chair
24155,12,table,13,0,19087,43,143,178,243,265,100,87,dining table
24156,15,table,16,1,19087,30,0,189,150,337,150,148,dining table
24157,6,table,7,0,19088,48,88,143,398,271,310,128,dining table
24158,7,person,8,0,19090,20,39,105,63,174,24,69,person
24159,22,person,23,1,19091,44,460,184,630,458,170,274,person
24160,23,person,24,1,19091,20,559,343,780,516,221,173,person
24161,40,person,41,1,19185,28,489,274,547,354,58,80,person
24162,53,person,54,1,19185,22,243,314,322,472,79,158,person
24163,15,person,16,1,19186,16,313,77,343,109,30,32,person
24164,17,person,18,0,19186,35,224,91,255,194,31,103,person
24165,10,person,11,1,19188,35,157,56,259,236,102,180,person
24166,11,person,12,0,19188,49,61,56,174,326,113,270,person
24167,5,person,6,1,19189,70,223,58,434,325,211,267,person
24168,6,person,7,1,19189,66,2,53,233,337,231,284,person
24169,30,scissors,31,1,19189,19,327,303,357,324,30,21,scissors
24170,12,person,13,1,19190,20,19,121,45,193,26,72,person
24171,3,person,4,1,19208,19,240,183,312,277,72,94,person
24172,4,person,5,0,19208,60,291,183,469,561,178,378,person
24173,5,person,6,0,19208,52,115,205,269,636,154,431,person
24174,6,backpack,7,0,19208,24,127,272,236,406,109,134,backpack
24175,4,person,5,0,19209,34,89,151,119,253,30,102,person
24176,4,person,5,1,19210,19,55,142,123,219,68,77,person
24177,4,person,5,1,19211,27,140,209,299,403,159,194,person
24178,5,person,6,0,19211,39,0,243,178,681,178,438,person
24179,5,person,6,0,293,29,417,451,487,669,70,218,person
24180,6,person,7,0,293,21,356,445,409,644,53,199,person
24181,7,person,8,0,293,29,242,442,313,642,71,200,person
24182,8,person,9,0,293,34,127,424,195,617,68,193,person
24183,9,person,10,0,293,41,702,445,825,704,123,259,person
24184,0,table,1,0,19281,46,243,211,363,360,120,149,dining table
24185,1,umbrella,2,0,19281,47,159,22,453,233,294,211,umbrella
24186,2,chair,3,0,19281,25,153,212,270,375,117,163,chair
24187,3,person,4,0,19281,65,175,182,266,375,91,193,person
24188,4,chair,5,0,19281,47,340,203,456,367,116,164,chair
24189,9,umbrella,10,1,19281,19,418,56,499,171,81,115,umbrella
24190,12,chair,13,1,19281,17,447,186,498,294,51,108,chair
24191,15,person,16,0,19284,24,399,170,415,230,16,60,person
24192,6,table,6,1,19285,22,152,284,400,374,248,90,dining table
24193,2,person,3,1,19288,31,248,157,344,353,96,196,person
24194,11,table,12,1,19289,31,85,133,144,193,59,60,dining table
24195,1,person,2,1,19292,39,282,220,361,375,79,155,person
24196,2,person,3,1,19292,50,214,176,292,374,78,198,person
24197,3,person,4,1,19292,18,0,204,124,374,124,170,person
24198,13,person,14,1,19292,23,163,160,206,200,43,40,person
24199,14,person,15,1,19292,19,155,176,195,236,40,60,person
24200,18,person,19,1,19292,26,260,141,296,226,36,85,person
24201,20,person,21,0,19292,24,292,132,325,219,33,87,person
24202,21,person,22,1,19292,28,193,167,239,283,46,116,person
24203,22,chair,23,0,19292,20,176,222,232,283,56,61,chair
24204,39,person,40,1,19292,20,457,216,500,308,43,92,person
24205,4,person,5,1,19293,64,2,141,279,375,277,234,person
24206,5,pot,6,1,19294,21,120,315,295,456,175,141,potted plant
24207,12,bowl,12,0,19294,16,923,216,1023,246,100,30,bowl
24208,45,person,45,1,19294,17,628,32,698,126,70,94,person
24209,46,person,46,1,19294,15,460,32,513,87,53,55,person
24210,5,person,6,0,19296,103,83,5,168,332,85,327,person
24211,1,person,2,1,19297,42,249,88,343,364,94,276,person
24212,2,person,3,1,19297,49,343,98,467,389,124,291,person
24213,4,sofa,5,0,19300,17,40,132,149,183,109,51,couch
24214,6,person,7,1,19300,19,18,75,37,137,19,62,person
24215,7,person,8,0,19300,21,8,114,38,162,30,48,person
24216,8,person,9,0,19300,44,139,70,176,161,37,91,person
24217,9,person,10,0,19300,61,186,60,254,222,68,162,person
24218,6,person,6,1,24577,111,389,91,613,474,224,383,person
24219,7,person,7,1,24577,54,149,205,257,462,108,257,person
24220,10,person,11,0,19532,45,248,129,299,269,51,140,person
24221,12,person,13,0,19532,46,321,133,370,328,49,195,person
24222,13,person,14,1,19532,26,433,134,499,341,66,207,person
24223,5,backpack,6,0,19533,18,320,44,420,308,100,264,backpack
24224,9,person,10,1,19533,68,0,19,264,374,264,355,person
24225,10,person,11,1,19533,44,248,11,450,374,202,363,person
24226,4,person,5,0,19536,70,237,3,295,214,58,211,person
24227,5,person,6,0,19536,86,145,66,200,216,55,150,person
24228,5,television,6,0,19539,25,160,100,192,140,32,40,tv
24229,6,person,7,0,19539,38,143,131,175,234,32,103,person
24230,2,person,3,1,19540,46,334,118,458,280,124,162,person
24231,17,person,18,1,19540,43,116,166,257,374,141,208,person
24232,7,person,8,0,19543,37,225,144,259,272,34,128,person
24233,7,person,8,0,19544,67,193,136,402,478,209,342,person
24234,11,bottle,12,0,19544,16,514,288,553,398,39,110,bottle
24235,10,table,11,0,19547,16,49,140,346,292,297,152,dining table
24236,1,person,2,1,19548,15,226,177,236,253,10,76,person
24237,6,person,7,1,19548,17,0,0,96,373,96,373,person
24238,5,table,6,0,20043,22,174,280,377,390,203,110,dining table
24239,1,window,2,1,20046,18,44,75,123,118,79,43,window
24240,0,door,1,0,20049,17,270,58,370,416,100,358,door
24241,2,table,3,0,20049,42,150,168,270,224,120,56,dining table
24242,12,person,13,0,20053,54,356,80,466,295,110,215,person
24243,6,person,7,0,20054,17,96,339,118,390,22,51,person
24244,7,person,8,0,20054,15,120,338,138,394,18,56,person
24245,4,bottle,5,0,20055,15,261,65,289,182,28,117,bottle
24246,12,person,13,0,20055,23,53,138,71,190,18,52,person
24247,26,person,27,0,20057,82,620,487,878,1258,258,771,person
24248,0,pot,1,1,20059,30,881,778,1512,1199,631,421,potted plant
24249,1,pot,2,0,20059,32,65,583,378,924,313,341,potted plant
24250,14,table,15,1,20060,21,0,896,436,1198,436,302,dining table
24251,18,bottle,19,1,20061,21,1506,921,1632,1130,126,209,bottle
24252,3,bottle,4,0,969,17,288,107,309,128,21,21,bottle
24253,4,bottle,5,0,969,15,278,116,299,139,21,23,bottle
24254,5,bottle,6,0,969,15,259,115,278,138,19,23,bottle
24255,6,bottle,7,1,969,20,274,126,288,149,14,23,bottle
24256,7,bottle,8,0,969,17,232,105,248,127,16,22,bottle
24257,8,bottle,9,1,969,18,244,115,258,138,14,23,bottle
24258,9,bottle,10,1,969,20,251,125,267,148,16,23,bottle
24259,10,bottle,11,1,969,20,261,136,276,158,15,22,bottle
24260,13,bottle,14,1,969,17,303,143,321,162,18,19,bottle
24261,18,bottle,19,1,969,15,169,102,184,120,15,18,bottle
24262,19,bottle,20,1,969,15,171,121,185,143,14,22,bottle
24263,20,bottle,21,1,969,16,157,134,172,155,15,21,bottle
24264,21,bottle,22,0,969,15,148,126,161,143,13,17,bottle
24265,22,bottle,23,1,969,18,160,114,172,131,12,17,bottle
24266,24,bottle,25,0,969,16,158,95,172,111,14,16,bottle
24267,25,bottle,26,1,969,16,147,104,162,122,15,18,bottle
24268,26,bottle,27,1,969,16,135,113,154,130,19,17,bottle
24269,27,bottle,28,0,969,18,123,103,146,121,23,18,bottle
24270,39,bottle,40,1,969,16,212,80,227,100,15,20,bottle
24271,44,bottle,45,1,969,16,244,54,259,67,15,13,bottle
24272,45,bottle,46,0,969,15,227,55,240,68,13,13,bottle
24273,47,bottle,48,1,969,18,223,73,236,86,13,13,bottle
24274,50,bottle,51,0,969,18,308,39,331,54,23,15,bottle
24275,51,bottle,52,1,969,15,300,52,319,64,19,12,bottle
24276,53,bottle,54,0,969,18,309,60,328,77,19,17,bottle
24277,55,bottle,56,1,969,15,308,82,327,97,19,15,bottle
24278,58,bottle,59,1,969,15,113,130,127,146,14,16,bottle
24279,59,bottle,60,1,969,20,113,139,126,161,13,22,bottle
24280,62,bottle,63,0,969,15,120,184,140,227,20,43,bottle
24281,83,bottle,84,1,969,17,91,218,101,267,10,49,bottle
24282,85,bottle,86,1,969,15,81,119,98,142,17,23,bottle
24283,90,bottle,91,0,969,15,343,37,360,97,17,60,bottle
24284,91,bottle,92,1,969,20,5,19,39,37,34,18,bottle
24285,92,bottle,93,1,969,18,11,50,43,67,32,17,bottle
24286,93,bottle,94,0,969,17,0,56,27,77,27,21,bottle
24287,94,bottle,95,1,969,15,12,117,49,142,37,25,bottle
24288,95,bottle,96,1,969,19,1,126,34,154,33,28,bottle
24289,97,bottle,98,1,969,16,8,167,37,194,29,27,bottle
24290,99,bottle,100,1,969,17,386,127,414,152,28,25,bottle
24291,100,bottle,101,1,969,18,400,138,426,164,26,26,bottle
24292,101,bottle,102,1,969,16,414,149,435,173,21,24,bottle
24293,111,bottle,112,1,969,16,404,224,433,254,29,30,bottle
24294,114,bottle,115,1,969,15,109,75,131,89,22,14,bottle
24295,116,bottle,117,1,969,15,389,32,426,46,37,14,bottle
24296,142,bottle,143,1,969,20,384,243,411,270,27,27,bottle
24297,143,bottle,144,1,969,16,401,255,426,284,25,29,bottle
24298,148,bottle,149,0,969,16,409,110,436,128,27,18,bottle
24299,150,bottle,151,1,969,15,395,4,420,18,25,14,bottle
24300,153,bottle,154,1,969,16,191,137,206,164,15,27,bottle
24301,155,bottle,156,1,969,15,206,142,219,165,13,23,bottle
24302,156,bottle,157,0,969,16,214,127,226,152,12,25,bottle
24303,157,bottle,158,1,969,15,222,139,234,164,12,25,bottle
24304,159,bottle,160,1,969,15,233,132,246,159,13,27,bottle
24305,163,bottle,164,1,969,15,278,20,294,34,16,14,bottle
24306,164,bottle,165,1,969,18,287,11,304,27,17,16,bottle
24307,167,bottle,168,1,969,15,255,1,275,15,20,14,bottle
24308,174,bottle,175,1,969,16,0,257,23,282,23,25,bottle
24309,175,bottle,176,1,969,15,295,1,316,16,21,15,bottle
24310,8,door,9,0,20070,24,204,122,275,302,71,180,door
24311,5,person,6,0,1332,36,365,218,473,473,108,255,person
24312,6,person,7,0,1332,27,318,279,372,461,54,182,person
24313,7,person,8,0,1332,26,260,212,373,464,113,252,person
24314,8,person,9,0,1332,32,223,223,278,453,55,230,person
24315,9,person,10,1,1332,21,68,237,130,351,62,114,person
24316,10,person,11,1,1332,25,44,196,102,424,58,228,person
24317,7,person,8,1,1334,61,194,44,404,305,210,261,person
24318,6,person,7,1,1335,25,76,205,148,289,72,84,person
24319,7,person,8,1,1335,33,27,205,138,374,111,169,person
24320,9,person,10,1,1335,22,99,153,139,233,40,80,person
24321,12,person,13,1,1335,25,353,200,407,279,54,79,person
24322,13,person,14,1,1335,34,354,195,452,342,98,147,person
24323,17,person,18,1,1335,22,445,170,479,296,34,126,person
24324,18,person,19,1,1335,20,407,153,442,259,35,106,person
24325,19,person,20,1,1335,21,362,160,407,252,45,92,person
24326,8,person,9,1,1337,18,113,100,141,142,28,42,person
24327,9,person,10,0,1337,24,17,107,46,165,29,58,person
24328,5,table,6,0,1338,22,1610,841,2025,1410,415,569,dining table
24329,9,person,10,1,1338,15,1111,733,1200,880,89,147,person
24330,10,person,11,0,1338,26,1176,690,1275,1031,99,341,person
24331,11,person,12,1,1338,16,1238,729,1314,841,76,112,person
24332,19,person,20,0,1338,25,301,740,367,960,66,220,person
24333,4,person,5,0,1342,41,64,104,137,220,73,116,person
24334,4,person,5,1,1344,61,0,34,236,249,236,215,person
24335,6,person,7,1,1344,16,110,96,164,144,54,48,person
24336,13,person,14,0,1346,72,283,102,439,371,156,269,person
24337,5,person,6,0,1347,28,1019,606,1157,982,138,376,person
24338,6,person,7,0,1347,19,954,674,1019,923,65,249,person
24339,9,person,10,1,1347,23,1466,696,1690,988,224,292,person
24340,11,person,12,1,1347,23,1890,764,2068,1019,178,255,person
24341,14,person,15,0,1347,27,646,588,751,976,105,388,person
24342,16,person,17,1,1347,17,541,680,680,963,139,283,person
24343,20,person,21,0,1347,45,243,797,579,1555,336,758,person
24344,21,person,22,0,1347,34,732,779,883,1232,151,453,person
24345,28,person,29,1,1347,15,1985,1053,2198,1647,213,594,person
24346,12,person,13,1,1348,15,409,37,451,165,42,128,person
24347,13,person,14,1,1348,48,313,38,442,331,129,293,person
24348,1,person,2,1,1351,63,483,238,740,766,257,528,person
24349,2,person,3,1,1351,47,641,267,846,766,205,499,person
24350,3,person,4,0,1351,78,831,239,1023,765,192,526,person
24351,4,person,5,1,1351,33,945,288,1024,650,79,362,person
24352,10,balls,11,1,1351,21,465,496,577,590,112,94,sports ball
24353,2,person,3,0,22627,79,453,202,715,881,262,679,person
24354,3,person,4,0,22627,80,55,144,358,915,303,771,person
24355,4,train,4,0,6,45,275,764,2053,1147,1778,383,train
24356,6,person,6,1,6,23,791,799,867,921,76,122,person
24357,9,person,9,1,6,33,943,850,1021,994,78,144,person
24358,15,person,15,1,6,33,994,894,1057,1020,63,126,person
24359,22,person,22,1,6,34,1049,843,1161,931,112,88,person
24360,31,person,31,1,6,19,1092,861,1156,904,64,43,person
24361,32,person,32,1,6,20,1154,867,1205,931,51,64,person
24362,33,person,33,1,6,23,1204,853,1244,923,40,70,person
24363,38,person,38,1,6,30,1247,862,1294,1008,47,146,person
24364,45,person,45,1,6,22,1279,861,1315,915,36,54,person
24365,52,person,52,1,6,22,1337,874,1378,925,41,51,person
24366,53,person,53,1,6,26,1381,846,1438,924,57,78,person
24367,54,person,54,1,6,21,1411,855,1446,913,35,58,person
24368,55,person,55,0,6,43,1461,844,1513,1000,52,156,person
24369,62,person,62,1,6,34,1499,844,1572,919,73,75,person
24370,68,person,68,1,6,23,1572,878,1616,922,44,44,person
24371,69,person,69,1,6,38,1556,844,1625,921,69,77,person
24372,70,person,70,1,6,24,1628,857,1676,923,48,66,person
24373,77,person,77,1,6,30,1687,867,1739,994,52,127,person
24374,79,person,79,1,6,17,1762,859,1797,911,35,52,person
24375,81,person,81,1,6,22,1813,846,1874,921,61,75,person
24376,82,person,82,1,6,19,1889,885,1932,921,43,36,person
24377,2,boat,3,0,1354,25,39,561,334,767,295,206,boat
24378,4,boat,4,0,1354,21,426,662,686,767,260,105,boat
24379,21,person,20,0,1354,18,167,656,222,727,55,71,person
24380,22,person,21,0,1354,20,87,621,157,715,70,94,person
24381,23,person,22,0,1354,28,685,351,723,478,38,127,person
24382,24,person,23,0,1354,25,653,300,689,424,36,124,person
24383,25,person,24,1,1354,29,500,356,550,479,50,123,person
24384,26,person,25,0,1354,30,564,312,597,427,33,115,person
24385,27,person,26,1,1354,22,560,485,615,570,55,85,person
24386,28,person,27,1,1354,28,699,495,772,619,73,124,person
24387,29,person,28,1,1354,21,755,544,821,658,66,114,person
24388,30,person,29,1,1354,15,732,585,779,645,47,60,person
24389,31,person,30,1,1354,18,798,607,872,695,74,88,person
24390,32,person,31,1,1354,21,633,515,699,602,66,87,person
24391,33,person,32,1,1354,16,639,508,672,571,33,63,person
24392,34,person,33,1,1354,22,904,639,994,763,90,124,person
24393,35,person,34,1,1354,23,899,590,967,694,68,104,person
24394,36,person,35,1,1354,27,785,429,826,566,41,137,person
24395,37,person,36,0,1354,24,824,415,867,552,43,137,person
24396,38,person,37,0,1354,33,872,468,949,614,77,146,person
24397,39,person,38,1,1354,22,747,423,786,546,39,123,person
24398,40,person,39,1,1354,25,478,442,523,544,45,102,person
24399,41,person,40,0,1354,21,496,455,535,522,39,67,person
24400,44,person,43,1,1354,24,367,442,415,522,48,80,person
24401,45,person,44,0,1354,19,360,453,389,515,29,62,person
24402,46,person,45,0,1354,27,415,297,459,430,44,133,person
24403,47,person,46,0,1354,23,538,295,571,411,33,116,person
24404,48,person,47,1,1354,17,370,378,403,456,33,78,person
24405,49,person,48,1,1354,26,298,415,361,519,63,104,person
24406,50,person,49,1,1354,16,297,465,334,516,37,51,person
24407,51,person,50,1,1354,22,253,440,300,516,47,76,person
24408,54,person,53,1,1354,17,199,456,236,516,37,60,person
24409,55,person,54,1,1354,15,159,446,199,515,40,69,person
24410,56,person,55,1,1354,22,228,405,259,513,31,108,person
24411,57,person,56,1,1354,16,240,429,273,484,33,55,person
24412,58,person,57,1,1354,23,226,367,266,454,40,87,person
24413,59,person,58,0,1354,36,967,515,1022,678,55,163,person
24414,60,person,59,1,1354,27,920,499,987,632,67,133,person
24415,61,person,60,0,1354,30,593,326,650,432,57,106,person
24416,62,person,61,1,1354,21,662,257,700,358,38,101,person
24417,66,person,65,1,1354,18,841,215,861,253,20,38,person
24418,67,person,66,1,1354,21,732,322,761,454,29,132,person
24419,69,person,68,1,1354,27,701,238,732,349,31,111,person
24420,70,person,69,1,1354,17,63,343,91,401,28,58,person
24421,71,person,70,1,1354,16,383,344,425,446,42,102,person
24422,22,person,22,0,1355,24,242,745,264,791,22,46,person
24423,23,person,23,0,1355,18,307,749,321,794,14,45,person
24424,24,person,24,0,1355,23,340,742,355,788,15,46,person
24425,0,person,1,0,1356,54,333,398,523,947,190,549,person
24426,2,person,3,0,1356,51,231,419,384,936,153,517,person
24427,0,person,1,0,1357,52,466,156,1177,783,711,627,person
24428,7,person,8,0,1359,28,130,566,316,682,186,116,person
24429,8,person,9,1,1359,20,412,551,535,646,123,95,person
24430,9,person,10,0,1359,24,4,772,163,881,159,109,person
24431,10,person,11,1,1359,18,105,873,235,947,130,74,person
24432,11,person,12,1,1359,18,1723,375,1811,445,88,70,person
24433,12,person,13,1,1359,26,1763,644,1892,718,129,74,person
24434,13,person,14,1,1359,27,1836,735,1999,805,163,70,person
24435,14,person,15,0,1359,18,2041,718,2151,765,110,47,person
24436,15,person,16,0,1359,20,1816,458,1939,533,123,75,person
24437,10,person,9,0,1362,98,777,1728,1001,2135,224,407,person
24438,11,person,10,0,1362,56,786,1822,857,2135,71,313,person
24439,12,person,11,0,1362,42,748,1896,847,2136,99,240,person
24440,13,person,12,0,1362,20,509,1770,531,1853,22,83,person
24441,14,person,13,0,1362,16,482,1779,499,1853,17,74,person
24442,12,person,13,0,1363,18,362,157,379,197,17,40,person
24443,13,person,14,1,1363,15,384,146,398,201,14,55,person
24444,15,person,16,0,1363,17,225,148,237,181,12,33,person
24445,17,person,18,1,1363,15,125,148,137,173,12,25,person
24446,18,person,19,0,1363,15,211,148,220,176,9,28,person
24447,5,person,6,0,1364,20,946,650,1112,1196,166,546,person
24448,6,person,7,0,1364,26,1164,613,1332,1198,168,585,person
24449,7,person,8,0,1364,44,327,577,795,1196,468,619,person
24450,0,person,1,0,1371,54,643,238,988,749,345,511,person
24451,1,person,2,0,1371,20,1060,395,1279,682,219,287,person
24452,2,person,3,0,1371,42,491,326,680,657,189,331,person
24453,3,person,4,0,1371,70,114,123,604,749,490,626,person
24454,4,person,5,0,1371,18,0,333,199,535,199,202,person
24455,7,person,8,0,1372,19,118,195,127,233,9,38,person
24456,8,person,9,0,1372,21,103,194,113,235,10,41,person
24457,18,person,13,0,1374,21,1044,1458,1074,1533,30,75,person
24458,19,person,14,0,1374,25,1228,1462,1264,1521,36,59,person
24459,20,person,15,0,1374,24,1340,1446,1371,1521,31,75,person
24460,21,person,16,0,1374,34,1490,1484,1523,1558,33,74,person
24461,22,person,17,0,1374,27,1615,1431,1639,1502,24,71,person
24462,23,person,18,0,1374,23,1712,1471,1746,1548,34,77,person
24463,24,person,19,0,1374,17,866,1461,935,1476,69,15,person
24464,25,person,20,0,1374,24,1179,1450,1206,1522,27,72,person
24465,26,person,21,0,1374,24,1673,1406,1696,1469,23,63,person
24466,27,person,22,0,1374,26,1905,1494,1939,1553,34,59,person
24467,28,person,23,0,1374,26,1996,1457,2015,1527,19,70,person
24468,29,person,24,0,1374,30,2082,1470,2110,1551,28,81,person
24469,30,person,25,0,1374,28,2123,1466,2156,1533,33,67,person
24470,34,person,29,1,1374,22,2026,1445,2055,1505,29,60,person
24471,35,person,30,1,1374,16,2143,1442,2160,1481,17,39,person
24472,36,person,31,1,1374,18,2103,1418,2125,1471,22,53,person
24473,2,person,3,1,1375,19,0,210,27,358,27,148,person
24474,6,person,7,0,1375,43,77,220,117,354,40,134,person
24475,13,person,14,0,1375,33,234,213,281,342,47,129,person
24476,14,person,15,0,1375,35,295,214,344,339,49,125,person
24477,15,person,16,0,1375,41,361,182,403,330,42,148,person
24478,16,person,17,0,1375,29,402,186,453,343,51,157,person
24479,17,person,18,0,1375,28,437,186,467,311,30,125,person
24480,2,person,3,1,1376,23,63,54,100,101,37,47,person
24481,3,person,4,1,1376,24,60,100,109,161,49,61,person
24482,4,person,5,1,1376,23,77,141,115,192,38,51,person
24483,5,person,6,1,1376,21,90,176,120,226,30,50,person
24484,6,person,7,1,1376,25,326,67,374,124,48,57,person
24485,7,person,8,1,1376,27,310,114,354,162,44,48,person
24486,8,person,9,1,1376,26,300,148,340,207,40,59,person
24487,15,person,13,0,1383,43,1315,1160,1425,1468,110,308,person
24488,16,person,14,0,1383,36,1235,1203,1324,1475,89,272,person
24489,17,person,15,0,1383,29,1703,1141,1778,1432,75,291,person
24490,18,person,16,1,1383,19,771,1125,824,1282,53,157,person
24491,19,person,17,1,1383,20,651,1188,717,1345,66,157,person
24492,20,person,18,1,1383,18,540,1214,611,1407,71,193,person
24493,21,person,19,1,1383,25,853,1168,924,1404,71,236,person
24494,22,person,20,1,1383,16,729,1122,766,1201,37,79,person
24495,23,person,21,1,1383,21,432,1206,487,1378,55,172,person
24496,12,person,13,0,1388,75,1117,642,1308,1062,191,420,person
24497,20,person,21,0,1388,60,1030,645,1134,1063,104,418,person
24498,28,person,29,0,1388,88,1923,654,2050,931,127,277,person
24499,39,person,40,1,1388,25,2024,728,2088,807,64,79,person
24500,41,person,42,0,1388,38,1007,644,1063,873,56,229,person
24501,42,person,43,0,1388,49,957,606,1021,890,64,284,person
24502,51,bench,52,0,1388,21,1243,663,1290,700,47,37,bench
24503,52,bench,53,0,1388,19,1276,667,1330,713,54,46,bench
24504,53,bench,54,0,1388,23,1318,673,1365,723,47,50,bench
24505,54,person,55,0,1388,80,809,672,919,923,110,251,person
24506,66,person,67,0,1388,68,122,598,264,1020,142,422,person
24507,67,backpack,68,0,1388,24,933,650,997,742,64,92,backpack
24508,79,person,80,0,1388,73,303,613,419,944,116,331,person
24509,95,person,96,0,1388,45,460,644,516,788,56,144,person
24510,96,person,97,1,1388,31,677,632,739,721,62,89,person
24511,100,person,101,1,1388,20,115,633,156,731,41,98,person
24512,101,person,102,1,1388,50,247,628,307,798,60,170,person
24513,0,person,1,0,1389,55,770,490,1182,1320,412,830,person
24514,0,person,1,0,1391,64,193,510,577,1485,384,975,person
24515,17,bench,17,0,1392,21,1114,1286,1227,1339,113,53,bench
24516,19,bench,19,0,1392,18,1226,1293,1300,1342,74,49,bench
24517,7,person,8,0,1393,63,855,539,1360,1531,505,992,person
24518,8,person,9,0,1393,48,423,489,1389,1533,966,1044,person
24519,9,person,10,0,1393,39,0,560,476,1533,476,973,person
24520,0,person,1,0,1394,16,970,738,1147,1051,177,313,person
24521,1,person,2,0,1394,19,1418,823,1702,1082,284,259,person
24522,2,person,3,0,1394,18,1694,702,2046,1533,352,831,person
24523,11,person,12,1,22628,22,500,430,542,478,42,48,person
24524,13,person,14,1,22628,23,411,420,453,479,42,59,person
24525,14,person,15,1,22628,16,307,442,337,479,30,37,person
24526,15,person,16,1,22628,19,220,434,257,479,37,45,person
24527,16,person,17,1,22628,15,181,444,214,479,33,35,person
24528,5,person,6,1,22629,96,0,128,583,680,583,552,person
24529,6,person,7,1,22629,43,278,455,589,677,311,222,person
24530,2,person,3,1,22630,16,11,447,55,491,44,44,person
24531,10,person,11,0,1496,30,1081,544,1222,851,141,307,person
24532,11,person,12,0,1496,24,725,627,874,912,149,285,person
24533,12,person,13,0,1496,33,528,776,687,1090,159,314,person
24534,23,person,24,0,1497,28,387,220,399,255,12,35,person
24535,24,person,25,0,1497,43,455,207,471,254,16,47,person
24536,8,person,9,1,1498,23,993,1190,1675,1637,682,447,person
24537,9,person,10,1,1498,23,1752,1091,2196,1647,444,556,person
24538,12,person,13,0,1498,64,501,244,759,731,258,487,person
24539,16,person,17,1,1498,27,470,204,567,540,97,336,person
24540,20,person,21,0,1498,21,1703,229,1765,355,62,126,person
24541,21,person,22,1,1498,27,1691,170,1760,327,69,157,person
24542,22,person,23,1,1498,22,1715,127,1765,203,50,76,person
24543,23,person,24,1,1498,22,1747,87,1795,190,48,103,person
24544,24,person,25,1,1498,18,1795,102,1838,160,43,58,person
24545,25,person,26,1,1498,20,1786,134,1839,223,53,89,person
24546,26,person,27,1,1498,18,1759,185,1801,308,42,123,person
24547,27,person,28,1,1498,17,1849,97,1913,173,64,76,person
24548,28,person,29,1,1498,23,1851,139,1927,237,76,98,person
24549,29,person,30,1,1498,25,1793,185,1865,300,72,115,person
24550,30,person,31,0,1498,17,1791,232,1854,360,63,128,person
24551,31,person,32,0,1498,19,1783,265,1849,353,66,88,person
24552,32,person,33,1,1498,20,1927,187,1988,282,61,95,person
24553,33,person,34,1,1498,15,1913,205,1956,267,43,62,person
24554,34,person,35,1,1498,25,1978,192,2054,342,76,150,person
24555,35,person,36,1,1498,26,2056,144,2122,238,66,94,person
24556,37,person,38,1,1498,18,2099,170,2158,229,59,59,person
24557,38,person,39,1,1498,23,2093,196,2162,297,69,101,person
24558,39,person,40,1,1498,20,2069,252,2149,385,80,133,person
24559,40,person,41,0,1498,25,1996,242,2087,380,91,138,person
24560,41,person,42,0,1498,19,1920,267,1981,360,61,93,person
24561,42,person,43,1,1498,23,1848,246,1940,359,92,113,person
24562,43,person,44,1,1498,24,1824,13,1900,143,76,130,person
24563,10,person,11,0,1499,22,18,329,36,385,18,56,person
24564,12,person,13,0,1499,17,241,319,260,358,19,39,person
24565,13,person,14,0,1499,27,476,488,548,580,72,92,person
24566,14,person,15,0,1499,22,541,476,603,560,62,84,person
24567,15,person,16,0,1499,20,576,465,636,542,60,77,person
24568,16,person,17,0,1499,32,702,434,797,565,95,131,person
24569,17,person,18,1,1499,19,609,449,641,514,32,65,person
24570,18,person,19,1,1499,20,640,443,668,505,28,62,person
24571,19,person,20,1,1499,18,397,525,476,598,79,73,person
24572,20,person,21,1,1499,28,672,422,747,512,75,90,person
24573,21,person,22,1,1499,16,331,546,396,598,65,52,person
24574,22,person,23,1,1499,15,669,418,694,480,25,62,person
24575,24,person,25,0,1499,23,623,357,655,410,32,53,person
24576,26,person,27,1,1499,15,691,406,713,449,22,43,person
24577,27,person,28,1,1499,15,744,388,766,432,22,44,person
24578,28,person,29,1,1499,19,302,541,342,596,40,55,person
24579,29,person,30,0,1499,20,490,273,517,308,27,35,person
24580,8,person,9,0,1500,25,589,292,679,502,90,210,person
24581,14,person,15,1,1500,16,940,465,996,558,56,93,person
24582,15,person,16,1,1500,18,899,465,938,561,39,96,person
24583,16,person,17,1,1500,17,287,482,356,579,69,97,person
24584,17,person,18,1,1500,16,827,482,871,564,44,82,person
24585,19,person,20,1,1500,15,1340,448,1392,539,52,91,person
24586,20,person,21,1,1500,17,1302,458,1344,542,42,84,person
24587,21,person,22,1,1500,16,1208,468,1252,545,44,77,person
24588,22,person,23,1,1500,16,1115,461,1155,550,40,89,person
24589,24,person,25,0,1500,19,1608,392,1653,497,45,105,person
24590,26,person,27,1,1500,15,1158,455,1202,542,44,87,person
24591,35,person,36,1,1500,21,1042,479,1078,552,36,73,person
24592,36,person,37,1,1500,19,861,481,895,558,34,77,person
24593,11,person,12,0,1501,20,129,228,143,290,14,62,person
24594,12,person,13,0,1501,22,87,225,100,299,13,74,person
24595,7,person,8,0,1502,70,24,159,103,372,79,213,person
24596,10,person,11,1,1502,15,106,121,124,147,18,26,person
24597,13,person,14,1,1502,15,13,106,35,138,22,32,person
24598,14,person,15,1,1502,18,141,114,157,141,16,27,person
24599,16,person,17,1,1502,16,210,95,228,126,18,31,person
24600,21,person,22,0,1503,23,98,132,115,172,17,40,person
24601,22,person,23,0,1503,23,67,144,82,195,15,51,person
24602,9,person,10,0,1504,16,237,23,250,51,13,28,person
24603,10,person,11,0,1504,25,218,31,236,65,18,34,person
24604,11,person,12,0,1504,17,198,15,209,46,11,31,person
24605,12,person,13,0,1504,15,181,29,193,54,12,25,person
24606,13,person,14,0,1504,23,171,26,182,57,11,31,person
24607,14,person,15,0,1504,17,162,26,172,56,10,30,person
24608,15,person,16,0,1504,21,151,28,163,57,12,29,person
24609,16,person,17,0,1504,21,138,28,152,57,14,29,person
24610,17,person,18,0,1504,17,283,12,298,39,15,27,person
24611,18,person,19,0,1504,23,335,28,353,57,18,29,person
24612,19,person,20,0,1504,20,343,0,358,29,15,29,person
24613,20,person,21,0,1504,18,365,0,378,27,13,27,person
24614,21,person,22,0,1504,15,393,25,404,59,11,34,person
24615,22,person,23,0,1504,22,440,4,452,36,12,32,person
24616,23,person,24,0,1504,20,325,0,339,29,14,29,person
24617,24,person,25,0,1504,20,317,44,332,76,15,32,person
24618,11,chair,12,1,1573,16,1390,943,1511,1198,121,255,chair
24619,13,chair,14,1,1573,15,1353,966,1432,1195,79,229,chair
24620,17,person,18,1,1573,15,389,645,414,705,25,60,person
24621,18,person,19,1,1573,16,545,648,574,703,29,55,person
24622,20,person,21,1,1573,15,4,636,35,694,31,58,person
24623,23,person,24,0,1573,21,1152,652,1175,714,23,62,person
24624,34,person,35,0,1573,30,1178,671,1206,721,28,50,person
24625,35,person,36,1,1573,19,724,672,759,697,35,25,person
24626,6,person,7,1,1574,15,51,160,87,199,36,39,person
24627,7,person,8,1,1574,17,102,155,126,186,24,31,person
24628,8,person,9,1,1574,16,218,159,248,197,30,38,person
24629,9,person,10,1,1574,16,250,169,278,199,28,30,person
24630,10,person,11,0,1574,17,186,133,194,161,8,28,person
24631,11,person,12,1,1574,16,137,168,157,199,20,31,person
24632,12,person,13,1,1574,15,157,163,175,191,18,28,person
24633,6,person,7,0,1577,15,1051,364,1072,415,21,51,person
24634,7,person,8,0,1577,17,960,384,976,438,16,54,person
24635,11,person,12,0,1577,17,914,344,937,396,23,52,person
24636,5,person,6,0,1579,29,1262,687,1364,839,102,152,person
24637,6,person,7,0,1579,29,1519,705,1616,871,97,166,person
24638,7,person,8,0,1579,27,328,558,389,692,61,134,person
24639,8,person,9,0,1579,23,707,525,761,646,54,121,person
24640,9,person,10,0,1579,24,782,503,825,622,43,119,person
24641,10,person,11,0,1579,22,411,544,486,635,75,91,person
24642,11,person,12,0,1579,21,544,514,609,597,65,83,person
24643,12,person,13,0,1579,21,106,395,141,488,35,93,person
24644,13,person,14,1,1579,17,646,1197,761,1349,115,152,person
24645,14,person,15,1,1579,17,571,1171,653,1295,82,124,person
24646,15,person,16,1,1579,16,718,1175,806,1316,88,141,person
24647,16,person,17,1,1579,19,495,1147,581,1258,86,111,person
24648,17,person,18,1,1579,19,350,1180,463,1314,113,134,person
24649,18,person,19,1,1579,22,333,1000,415,1122,82,122,person
24650,19,person,20,1,1579,17,268,992,342,1080,74,88,person
24651,20,person,21,1,1579,20,181,947,268,1046,87,99,person
24652,21,person,22,1,1579,22,251,1037,331,1128,80,91,person
24653,22,person,23,1,1579,24,97,1026,195,1148,98,122,person
24654,23,person,24,1,1579,19,67,1322,238,1508,171,186,person
24655,14,person,15,0,1581,16,653,1008,664,1040,11,32,person
24656,8,person,9,0,1583,19,2,162,26,190,24,28,person
24657,8,person,9,0,1584,18,255,221,265,242,10,21,person
24658,9,person,10,0,1584,16,296,200,304,222,8,22,person
24659,10,person,11,0,1584,16,405,223,417,244,12,21,person
24660,12,person,13,0,1584,19,310,246,326,279,16,33,person
24661,13,person,14,0,1584,18,77,207,91,225,14,18,person
24662,18,person,19,0,1584,15,75,183,83,201,8,18,person
24663,3,person,4,1,24801,22,86,1,244,120,158,119,person
24664,4,person,5,1,24801,35,237,1,389,120,152,119,person
24665,5,person,6,1,24801,25,378,1,541,119,163,118,person
24666,7,person,8,0,24801,92,17,11,385,480,368,469,person
24667,8,person,9,0,24801,69,360,85,580,458,220,373,person
24668,1,person,2,0,24802,37,1,79,98,268,97,189,person
24669,2,person,3,0,24802,54,219,30,365,244,146,214,person
24670,3,person,4,0,24802,79,524,129,697,420,173,291,person
24671,4,person,5,0,24802,67,475,189,648,501,173,312,person
24672,5,person,6,0,24802,68,730,391,932,685,202,294,person
24673,6,person,7,0,24802,68,822,297,1024,549,202,252,person
24674,7,person,8,0,24802,59,334,96,470,404,136,308,person
24675,5,person,6,1,24803,111,47,154,524,800,477,646,person
24676,7,person,8,1,24804,23,392,39,440,113,48,74,person
24677,8,person,9,1,24804,25,358,48,394,123,36,75,person
24678,10,person,11,1,24804,27,41,93,97,178,56,85,person
24679,11,person,12,1,24804,18,224,38,261,106,37,68,person
24680,12,person,13,1,24804,25,194,100,246,179,52,79,person
24681,13,person,14,1,24804,18,467,7,500,66,33,59,person
24682,14,person,15,1,24804,17,341,9,377,75,36,66,person
24683,15,person,16,1,24804,61,460,203,563,434,103,231,person
24684,16,person,17,1,24804,53,421,318,549,513,128,195,person
24685,17,person,18,1,24804,67,341,293,400,576,59,283,person
24686,18,person,19,0,24804,66,374,359,479,637,105,278,person
24687,19,person,20,1,24804,36,165,291,227,451,62,160,person
24688,20,person,21,1,24804,96,172,381,311,723,139,342,person
24689,21,person,22,1,24804,75,76,484,246,838,170,354,person
24690,22,person,23,1,24804,89,0,518,126,941,126,423,person
24691,3,person,4,1,24805,36,771,88,890,249,119,161,person
24692,4,person,5,0,24805,108,729,144,947,506,218,362,person
24693,5,person,6,1,24805,47,199,131,304,427,105,296,person
24694,6,person,7,1,24805,106,151,154,419,504,268,350,person
24695,7,person,8,0,24805,114,70,131,303,622,233,491,person
24696,2,person,3,0,24806,90,653,208,882,693,229,485,person
24697,3,person,4,0,24806,65,404,131,603,562,199,431,person
24698,4,person,5,1,24806,46,463,101,635,331,172,230,person
24699,5,person,6,1,24806,50,598,85,756,365,158,280,person
24700,6,person,7,1,24806,40,432,4,630,144,198,140,person
24701,11,person,12,0,1588,48,800,604,981,939,181,335,person
24702,12,horse,13,0,1588,27,568,460,708,562,140,102,horse
24703,13,person,14,0,1588,21,610,460,660,579,50,119,person
24704,17,person,18,1,1588,22,1058,681,1204,835,146,154,person
24705,18,person,19,1,1588,15,1033,781,1277,958,244,177,person
24706,21,person,22,1,1588,19,637,762,735,895,98,133,person
24707,22,person,23,1,1588,34,427,702,633,906,206,204,person
24708,23,person,24,1,1588,18,281,706,437,879,156,173,person
24709,24,person,25,1,1588,23,0,768,350,956,350,188,person
24710,25,person,26,1,1588,21,173,679,296,818,123,139,person
24711,27,person,28,1,1588,21,73,654,171,787,98,133,person
24712,28,person,29,1,1588,25,10,637,173,845,163,208,person
24713,2,person,3,1,24807,60,699,186,812,464,113,278,person
24714,3,person,4,1,24807,98,723,132,994,768,271,636,person
24715,4,person,5,1,24807,53,237,216,445,766,208,550,person
24716,5,person,6,1,24807,59,419,219,531,768,112,549,person
24717,6,person,7,1,24807,52,282,226,458,766,176,540,person
24718,7,person,8,1,24807,65,23,170,269,767,246,597,person
24719,3,horse,4,0,24808,80,624,453,1230,1272,606,819,horse
24720,4,person,5,0,24808,55,57,96,796,579,739,483,person
24721,12,person,13,0,24808,43,543,759,627,941,84,182,person
24722,13,person,14,0,24808,33,606,752,665,949,59,197,person
24723,14,person,15,1,24808,22,511,662,577,741,66,79,person
24724,15,person,16,1,24808,22,463,658,513,738,50,80,person
24725,16,person,17,1,24808,20,413,646,464,737,51,91,person
24726,17,person,18,1,24808,20,561,660,602,729,41,69,person
24727,18,person,19,1,24808,25,358,659,425,736,67,77,person
24728,19,person,20,1,24808,20,349,646,396,694,47,48,person
24729,20,person,21,0,24808,33,257,635,328,762,71,127,person
24730,21,person,22,1,24808,23,203,642,270,728,67,86,person
24731,22,person,23,1,24808,15,310,645,338,706,28,61,person
24732,23,person,24,1,24808,21,253,639,284,725,31,86,person
24733,24,person,25,1,24808,25,172,654,228,724,56,70,person
24734,25,person,26,1,24808,25,135,629,197,723,62,94,person
24735,26,person,27,1,24808,17,125,624,157,679,32,55,person
24736,27,person,28,1,24808,24,85,625,135,691,50,66,person
24737,28,person,29,1,24808,28,2,609,85,716,83,107,person
24738,29,person,30,1,24808,20,326,649,353,728,27,79,person
24739,30,person,31,0,24808,36,1,725,64,936,63,211,person
24740,4,horse,5,0,24809,133,254,400,526,753,272,353,horse
24741,5,person,6,0,24809,42,337,296,444,589,107,293,person
24742,3,person,4,0,24810,34,3,83,126,344,123,261,person
24743,4,horse,5,1,24810,40,21,179,221,344,200,165,horse
24744,5,person,6,1,24810,38,219,76,365,311,146,235,person
24745,6,person,7,0,24810,65,131,199,558,529,427,330,person
24746,7,horse,8,0,24810,143,130,309,826,841,696,532,horse
24747,8,person,9,1,24810,36,807,188,917,353,110,165,person
24748,9,person,10,1,24810,51,829,325,996,503,167,178,person
24749,10,person,11,0,24810,98,776,380,1013,789,237,409,person
24750,13,person,12,1,24810,36,47,320,138,734,91,414,person
24751,14,person,13,1,24810,42,14,303,94,666,80,363,person
24752,5,horse,6,0,24811,81,587,224,693,527,106,303,horse
24753,6,horse,7,0,24811,33,1,360,453,683,452,323,horse
24754,7,person,8,0,24811,90,544,98,718,407,174,309,person
24755,8,person,9,1,24811,56,0,4,194,421,194,417,person
24756,4,horse,5,0,24812,133,604,734,1629,1709,1025,975,horse
24757,5,person,6,0,24812,52,772,323,1181,1180,409,857,person
24758,8,horse,9,1,24813,104,938,767,1539,1364,601,597,horse
24759,9,horse,10,1,24813,149,580,720,1294,1414,714,694,horse
24760,10,horse,11,0,24813,152,316,698,1077,1470,761,772,horse
24761,11,person,12,1,24813,50,1004,482,1225,777,221,295,person
24762,12,person,13,1,24813,50,765,477,955,825,190,348,person
24763,13,person,14,0,24813,62,524,519,706,1204,182,685,person
24764,14,horse,15,1,24813,50,1144,577,1335,719,191,142,horse
24765,15,person,16,1,24813,24,1193,522,1244,654,51,132,person
24766,16,horse,17,1,24813,37,2052,548,2198,703,146,155,horse
24767,17,person,18,0,24813,24,2134,505,2193,638,59,133,person
24768,18,horse,19,0,24813,66,174,586,463,765,289,179,horse
24769,19,person,20,0,24813,26,266,537,336,682,70,145,person
24770,20,horse,21,1,24813,34,641,620,770,795,129,175,horse
24771,21,person,22,1,24813,24,680,542,743,709,63,167,person
24772,22,person,23,0,24813,21,258,395,298,476,40,81,person
24773,23,person,24,0,24813,22,218,402,264,474,46,72,person
24774,24,person,25,0,24813,24,507,394,544,469,37,75,person
24775,25,person,26,0,24813,21,539,399,570,469,31,70,person
24776,26,person,27,0,24813,17,240,466,279,524,39,58,person
24777,27,person,28,0,24813,18,206,473,243,535,37,62,person
24778,28,person,29,0,24813,16,119,523,157,582,38,59,person
24779,29,person,30,0,24813,20,160,534,206,601,46,67,person
24780,30,person,31,0,24813,23,76,399,126,468,50,69,person
24781,31,person,32,0,24813,24,124,408,167,464,43,56,person
24782,32,person,33,0,24813,24,199,536,247,602,48,66,person
24783,33,person,34,0,24813,20,238,526,264,591,26,65,person
24784,34,person,35,1,24813,16,257,518,293,575,36,57,person
24785,35,person,36,0,24813,16,403,522,436,581,33,59,person
24786,36,person,37,1,24813,15,436,519,465,565,29,46,person
24787,37,person,38,1,24813,16,432,553,457,595,25,42,person
24788,38,person,39,0,24813,20,456,523,497,597,41,74,person
24789,39,person,40,0,24813,21,490,503,529,597,39,94,person
24790,40,person,41,0,24813,32,527,483,580,582,53,99,person
24791,41,person,42,0,24813,24,691,391,731,466,40,75,person
24792,42,person,43,0,24813,18,750,390,786,451,36,61,person
24793,43,person,44,0,24813,25,784,385,839,459,55,74,person
24794,44,person,45,0,24813,24,868,382,924,446,56,64,person
24795,45,person,46,0,24813,18,922,385,951,442,29,57,person
24796,46,person,47,0,24813,19,997,377,1032,455,35,78,person
24797,47,person,48,0,24813,20,1023,380,1056,451,33,71,person
24798,48,person,49,1,24813,23,1051,378,1077,451,26,73,person
24799,49,person,50,0,24813,27,1069,374,1111,449,42,75,person
24800,50,person,51,0,24813,24,1138,374,1172,449,34,75,person
24801,51,person,52,0,24813,24,1173,376,1206,449,33,73,person
24802,52,person,53,0,24813,21,1216,393,1244,460,28,67,person
24803,53,person,54,1,24813,22,1245,368,1282,436,37,68,person
24804,54,person,55,0,24813,27,1265,396,1298,458,33,62,person
24805,55,person,56,0,24813,30,1782,430,1812,518,30,88,person
24806,56,person,57,0,24813,38,2005,338,2052,424,47,86,person
24807,57,person,58,0,24813,23,2034,482,2066,551,32,69,person
24808,58,person,59,0,24813,30,2073,476,2112,559,39,83,person
24809,59,person,60,0,24813,31,2135,334,2182,406,47,72,person
24810,60,person,61,0,24813,40,1487,464,1530,548,43,84,person
24811,61,person,62,0,24813,27,1538,361,1584,424,46,63,person
24812,62,person,63,0,24813,27,1580,359,1618,426,38,67,person
24813,63,person,64,0,24813,31,1618,365,1655,437,37,72,person
24814,64,person,65,0,24813,29,1475,370,1510,440,35,70,person
24815,65,person,66,0,24813,22,1448,369,1483,430,35,61,person
24816,66,person,67,0,24813,17,1430,377,1453,436,23,59,person
24817,67,person,68,0,24813,31,1396,362,1436,444,40,82,person
24818,68,person,69,0,24813,38,1351,475,1395,563,44,88,person
24819,69,person,70,0,24813,29,1319,490,1356,563,37,73,person
24820,70,person,71,0,24813,22,1547,519,1584,587,37,68,person
24821,71,person,72,0,24813,28,1592,512,1639,607,47,95,person
24822,72,person,73,0,24813,31,1646,515,1680,585,34,70,person
24823,73,person,74,0,24813,25,5,399,43,468,38,69,person
24824,74,person,75,0,24813,22,1516,419,1561,477,45,58,person
24825,75,person,76,0,24813,24,1549,430,1586,477,37,47,person
24826,76,person,77,0,24813,23,1576,426,1618,480,42,54,person
24827,77,person,78,0,24813,23,1675,523,1710,583,35,60,person
24828,78,person,79,1,24813,18,1098,447,1134,503,36,56,person
24829,79,person,80,1,24813,17,1070,451,1098,495,28,44,person
24830,80,person,81,1,24813,17,1044,452,1068,505,24,53,person
24831,81,person,82,1,24813,17,1007,457,1049,512,42,55,person
24832,82,person,83,1,24813,21,977,464,1008,537,31,73,person
24833,83,person,84,1,24813,16,693,506,730,552,37,46,person
24834,4,person,5,0,1589,23,1597,580,1736,780,139,200,person
24835,4,person,5,0,1590,19,743,1033,775,1123,32,90,person
24836,44,person,45,1,1590,20,679,1032,716,1075,37,43,person
24837,45,person,46,1,1590,27,767,1052,806,1113,39,61,person
24838,47,person,48,1,1590,30,907,1054,937,1145,30,91,person
24839,48,person,49,0,1590,22,920,1080,953,1177,33,97,person
24840,51,person,52,0,1590,16,1737,740,1748,769,11,29,person
24841,52,person,53,0,1590,16,1754,738,1766,770,12,32,person
24842,53,car,54,1,1590,21,2032,801,2107,849,75,48,car
24843,8,person,9,0,1849,18,34,191,47,235,13,44,person
24844,10,person,11,0,1849,15,149,176,155,206,6,30,person
24845,11,person,12,0,1849,15,212,172,219,197,7,25,person
24846,13,person,14,0,1849,16,300,176,312,208,12,32,person
24847,14,person,15,0,1849,23,293,201,312,256,19,55,person
24848,15,person,16,0,1849,20,441,186,453,228,12,42,person
24849,18,person,19,0,1849,19,199,191,215,227,16,36,person
24850,19,person,20,0,1849,24,170,203,190,252,20,49,person
24851,20,person,21,0,1849,15,56,181,66,215,10,34,person
24852,21,person,22,0,1849,22,9,191,29,235,20,44,person
24853,29,person,30,1,1852,45,234,129,407,401,173,272,person
24854,5,person,6,0,1854,48,34,90,111,198,77,108,person
24855,6,person,7,0,1854,23,122,88,145,122,23,34,person
24856,7,person,8,0,1854,15,107,66,123,92,16,26,person
24857,8,person,9,0,1854,29,151,72,178,117,27,45,person
24858,9,person,10,0,1854,42,175,69,231,147,56,78,person
24859,10,person,11,1,1854,18,209,64,227,97,18,33,person
24860,11,person,12,0,1854,37,234,69,261,125,27,56,person
24861,12,person,13,0,1854,34,25,56,45,112,20,56,person
24862,13,person,14,1,1854,21,2,51,14,120,12,69,person
24863,3,person,4,0,1855,43,0,86,62,179,62,93,person
24864,4,person,5,1,1855,29,51,68,79,134,28,66,person
24865,5,person,6,0,1855,31,76,60,99,143,23,83,person
24866,6,person,7,0,1855,34,150,56,176,128,26,72,person
24867,7,person,8,0,1855,33,188,82,228,140,40,58,person
24868,8,person,9,0,1855,46,232,63,263,155,31,92,person
24869,2,person,3,0,24814,91,645,95,1051,738,406,643,person
24870,8,person,9,0,24815,117,747,129,959,604,212,475,person
24871,9,person,10,0,24815,166,253,78,697,680,444,602,person
24872,10,person,11,0,24816,15,481,165,493,207,12,42,person
24873,11,person,12,1,24816,82,0,107,628,1023,628,916,person
24874,0,person,1,1,24817,25,713,0,799,544,86,544,person
24875,1,person,2,1,24817,98,496,0,738,544,242,544,person
24876,2,person,3,1,24817,27,707,135,763,335,56,200,person
24877,3,person,4,0,24817,145,172,36,412,498,240,462,person
24878,4,person,5,1,24817,89,173,45,283,451,110,406,person
24879,5,person,6,0,24817,129,39,75,176,461,137,386,person
24880,10,car,11,0,24818,29,109,123,206,200,97,77,car
24881,11,car,12,0,24818,29,202,123,273,193,71,70,car
24882,12,car,13,1,24818,20,295,132,360,190,65,58,car
24883,13,person,14,1,24818,81,335,79,419,455,84,376,person
24884,14,person,15,0,24818,126,242,140,531,623,289,483,person
24885,15,person,16,0,24818,218,504,189,870,606,366,417,person
24886,16,person,17,0,24818,156,850,100,1017,602,167,502,person
24887,17,ball,18,0,24818,37,452,319,502,374,50,55,sports ball
24888,2,person,3,0,24819,99,668,155,844,542,176,387,person
24889,3,person,4,1,24819,23,631,286,662,544,31,258,person
24890,4,person,5,0,24819,121,448,91,733,652,285,561,person
24891,5,person,6,1,24819,29,485,278,539,435,54,157,person
24892,6,person,7,0,24819,82,393,168,512,548,119,380,person
24893,7,person,8,1,24819,54,381,160,470,532,89,372,person
24894,8,person,9,1,24819,48,307,193,411,543,104,350,person
24895,9,person,10,0,24819,77,273,150,406,558,133,408,person
24896,10,person,11,1,24819,17,145,222,193,321,48,99,person
24897,11,person,12,0,24819,67,169,163,282,551,113,388,person
24898,12,person,13,0,24819,47,218,155,287,520,69,365,person
24899,13,person,14,0,24819,19,2,245,40,370,38,125,person
24900,16,person,17,0,24819,23,161,268,190,430,29,162,person
24901,6,person,7,0,24820,33,59,66,100,163,41,97,person
24902,7,person,8,0,24820,47,133,69,246,231,113,162,person
24903,8,person,9,0,24820,49,200,64,285,242,85,178,person
24904,9,person,10,0,24820,78,193,254,553,465,360,211,person
24905,10,person,11,0,24820,91,362,78,563,458,201,380,person
24906,20,car,21,0,2038,24,43,250,168,292,125,42,car
24907,23,car,24,1,2038,17,16,223,105,253,89,30,car
24908,24,car,25,1,2038,16,54,217,131,243,77,26,car
24909,25,car,26,1,2038,17,75,210,158,238,83,28,car
24910,33,person,34,0,2038,21,163,244,182,295,19,51,person
24911,34,person,35,0,2038,17,179,239,189,291,10,52,person
24912,38,person,39,0,2038,24,214,253,230,310,16,57,person
24913,39,person,40,0,2038,19,229,254,244,309,15,55,person
24914,40,person,41,0,2038,20,258,223,276,266,18,43,person
24915,41,person,42,0,2038,19,284,215,298,262,14,47,person
24916,42,person,43,0,2038,22,310,220,324,271,14,51,person
24917,43,person,44,0,2038,19,324,224,338,269,14,45,person
24918,1,car,2,0,2039,56,31,157,965,611,934,454,car
24919,3,person,4,0,2039,17,586,48,657,162,71,114,person
24920,4,person,5,0,2039,16,514,73,567,166,53,93,person
24921,5,person,6,0,2039,18,463,51,526,172,63,121,person
24922,8,door,9,0,2039,22,548,190,787,476,239,286,door
24923,0,car,1,1,2040,28,219,499,803,1102,584,603,car
24924,8,car,9,0,2040,24,666,89,859,293,193,204,car
24925,10,person,11,1,2040,34,610,83,721,276,111,193,person
24926,12,person,13,0,2040,43,134,147,242,405,108,258,person
24927,9,person,10,1,2041,31,52,355,284,697,232,342,person
24928,10,car,11,0,2041,53,59,515,997,1052,938,537,car
24929,13,car,14,0,2041,56,984,645,2062,1163,1078,518,car
24930,24,window,25,0,2041,17,436,600,899,706,463,106,window
24931,27,door,28,0,2041,19,170,598,394,959,224,361,door
24932,31,door,32,0,2041,20,1122,681,1356,1064,234,383,door
24933,13,chair,14,0,2098,16,478,275,526,334,48,59,chair
24934,15,person,16,0,2098,27,65,228,119,306,54,78,person
24935,16,person,17,0,2098,18,394,210,421,312,27,102,person
24936,18,chair,19,0,2098,16,295,234,312,255,17,21,chair
24937,19,person,20,0,2098,19,332,223,344,261,12,38,person
24938,20,person,21,0,2098,17,447,222,456,256,9,34,person
24939,21,person,22,0,2098,15,478,227,486,263,8,36,person
24940,6,person,7,0,2099,19,36,109,49,159,13,50,person
24941,7,person,8,1,2099,18,255,110,273,159,18,49,person
24942,8,person,9,0,2099,15,66,114,76,147,10,33,person
24943,11,person,12,0,2101,33,106,119,134,185,28,66,person
24944,12,person,13,0,2101,42,218,106,245,182,27,76,person
24945,13,person,14,0,2101,71,297,121,381,276,84,155,person
24946,14,person,15,0,2101,17,70,119,81,152,11,33,person
24947,10,person,11,0,2102,37,118,278,196,453,78,175,person
24948,11,person,12,1,2102,28,167,282,209,428,42,146,person
24949,12,person,13,0,2102,16,379,284,407,351,28,67,person
24950,13,person,14,0,2102,28,532,293,582,390,50,97,person
24951,14,person,15,0,2102,34,606,292,640,375,34,83,person
24952,15,person,16,0,2102,17,511,293,526,336,15,43,person
24953,17,person,18,0,2102,30,745,291,780,365,35,74,person
24954,18,person,19,0,2102,19,316,295,348,331,32,36,person
24955,19,person,20,0,2102,19,588,288,605,340,17,52,person
24956,7,person,8,0,2103,25,265,72,288,154,23,82,person
24957,8,person,9,0,2103,19,192,71,204,134,12,63,person
24958,9,person,10,0,2103,15,331,73,343,119,12,46,person
24959,10,person,11,1,2104,15,186,81,207,112,21,31,person
24960,13,person,14,0,2104,52,194,118,277,205,83,87,person
24961,14,person,15,0,2104,37,254,100,311,181,57,81,person
24962,15,person,16,1,2104,39,263,164,318,265,55,101,person
24963,16,person,17,0,2104,52,269,175,379,303,110,128,person
24964,17,person,18,1,2104,16,153,48,170,82,17,34,person
24965,19,person,20,0,2104,21,327,44,345,110,18,66,person
24966,20,person,21,0,2104,21,294,53,313,114,19,61,person
24967,11,person,12,0,2105,16,527,321,544,398,17,77,person
24968,7,person,8,0,2106,21,103,42,116,73,13,31,person
24969,8,person,9,0,2106,23,278,52,293,84,15,32,person
24970,9,person,10,0,2106,22,257,124,266,166,9,42,person
24971,10,person,11,0,2106,24,52,90,70,127,18,37,person
24972,11,person,12,0,2106,22,75,145,90,188,15,43,person
24973,13,person,14,0,2106,19,219,21,230,46,11,25,person
24974,6,person,7,0,2107,38,463,207,518,336,55,129,person
24975,7,person,8,0,2107,27,417,206,461,330,44,124,person
24976,8,person,9,0,2107,37,271,177,318,348,47,171,person
24977,9,person,10,0,2107,27,157,185,227,328,70,143,person
24978,3,person,4,0,2108,40,101,102,134,172,33,70,person
24979,4,person,5,0,2108,41,76,124,107,216,31,92,person
24980,5,person,6,0,2108,46,229,108,260,190,31,82,person
24981,11,person,12,0,2110,29,181,90,199,146,18,56,person
24982,12,person,13,0,2110,25,239,93,252,154,13,61,person
24983,13,person,14,0,2110,54,124,89,174,217,50,128,person
24984,14,person,15,0,2110,39,36,97,77,179,41,82,person
24985,3,person,4,0,2114,34,67,69,91,134,24,65,person
24986,4,person,5,0,2114,22,19,69,37,127,18,58,person
24987,5,person,6,0,2114,25,155,76,175,136,20,60,person
24988,6,person,7,0,2114,27,218,70,238,149,20,79,person
24989,7,person,8,0,2114,30,302,66,332,116,30,50,person
24990,8,person,9,1,2114,18,237,62,248,110,11,48,person
24991,9,person,10,0,2114,18,201,59,218,112,17,53,person
24992,13,person,14,0,2114,21,46,53,60,101,14,48,person
24993,14,person,15,0,2115,28,340,476,443,773,103,297,person
24994,15,person,16,0,2115,62,599,168,860,1024,261,856,person
24995,3,person,4,0,2116,34,182,121,253,253,71,132,person
24996,4,person,5,1,2116,41,61,87,121,225,60,138,person
24997,5,person,6,0,2116,47,58,163,172,347,114,184,person
24998,6,person,7,1,2116,47,87,234,195,365,108,131,person
24999,1,person,2,1,22,81,360,282,1850,974,1490,692,person
25000,5,ball,6,0,22,16,1041,769,1257,982,216,213,sports ball
25001,6,ball,7,0,22,16,878,760,1056,982,178,222,sports ball
25002,7,ball,8,0,22,17,697,863,889,1087,192,224,sports ball
25003,8,ball,9,0,22,15,765,951,981,1099,216,148,sports ball
25004,9,ball,10,0,22,18,782,1028,1024,1253,242,225,sports ball
25005,11,ball,12,0,22,18,979,965,1166,1202,187,237,sports ball
25006,12,ball,13,1,22,15,1304,833,1489,944,185,111,sports ball
25007,13,ball,14,0,22,16,1478,795,1663,939,185,144,sports ball
25008,14,ball,15,0,22,16,1527,906,1775,1139,248,233,sports ball
25009,16,ball,17,0,22,16,1335,925,1528,1148,193,223,sports ball
25010,17,ball,18,0,22,17,1366,1045,1647,1332,281,287,sports ball
25011,19,ball,20,0,22,17,1128,1144,1394,1402,266,258,sports ball
25012,20,ball,21,1,22,15,1009,648,1196,779,187,131,sports ball
25013,23,ball,24,0,22,15,111,850,339,1043,228,193,sports ball
25014,1,person,2,1,23,79,379,490,1373,1092,994,602,person
25015,2,ball,3,0,23,17,937,828,1097,981,160,153,sports ball
25016,4,ball,5,0,23,15,1473,749,1624,895,151,146,sports ball
25017,5,ball,6,0,23,15,1682,1076,1861,1251,179,175,sports ball
25018,7,ball,8,0,23,16,1813,649,1966,792,153,143,sports ball
25019,8,ball,9,0,23,15,1243,362,1380,504,137,142,sports ball
25020,10,ball,11,0,23,15,739,267,859,381,120,114,sports ball
25021,19,ball,20,0,23,15,1077,1014,1250,1192,173,178,sports ball
25022,21,ball,22,0,23,16,1357,1173,1531,1338,174,165,sports ball
25023,22,ball,23,0,23,16,1181,1150,1340,1309,159,159,sports ball
25024,23,ball,24,1,23,16,1287,1292,1406,1464,119,172,sports ball
25025,24,ball,25,0,23,15,908,985,1081,1157,173,172,sports ball
25026,25,ball,26,0,23,16,929,1178,1104,1361,175,183,sports ball
25027,3,person,4,1,24,77,66,534,598,1186,532,652,person
25028,10,person,11,1,24,152,643,327,974,989,331,662,person
25029,19,balls,20,0,24,225,1,685,1192,1599,1191,914,sports ball
25030,7,person,8,0,5,89,342,128,1595,1322,1253,1194,person
25031,4,person,5,1,2249,62,356,155,467,356,111,201,person
25032,5,person,6,1,2249,23,194,179,253,245,59,66,person
25033,6,person,7,1,2249,40,122,182,293,354,171,172,person
25034,7,person,8,1,2249,19,271,355,405,450,134,95,person
25035,13,balls,14,0,2250,53,2,84,330,219,328,135,sports ball
25036,1,person,2,0,2251,37,100,66,197,200,97,134,person
25037,15,ball,16,0,2251,16,199,179,220,199,21,20,sports ball
25038,3,balls,4,0,2252,64,39,43,290,110,251,67,sports ball
25039,3,ball,4,0,2253,17,414,210,639,457,225,247,sports ball
25040,4,ball,5,0,2253,18,432,138,604,252,172,114,sports ball
25041,6,balls,7,0,2253,104,3,128,571,476,568,348,sports ball
25042,7,person,8,1,2253,34,270,138,393,285,123,147,person
25043,0,person,1,0,2254,42,492,243,937,954,445,711,person
25044,1,person,2,0,2254,45,1103,136,1277,624,174,488,person
25045,7,person,8,1,2254,34,1048,3,1215,380,167,377,person
25046,1,balls,2,0,2255,136,0,52,400,340,400,288,sports ball
25047,4,ball,5,0,2255,16,176,206,226,245,50,39,sports ball
25048,6,ball,7,0,2255,15,64,126,104,164,40,38,sports ball
25049,8,ball,9,1,2255,19,178,260,237,306,59,46,sports ball
25050,9,ball,10,0,2255,15,352,128,389,165,37,37,sports ball
25051,13,ball,14,0,2255,15,322,74,351,102,29,28,sports ball
25052,14,ball,15,0,2255,15,289,74,317,101,28,27,sports ball
25053,17,ball,18,0,2255,17,343,275,400,335,57,60,sports ball
25054,18,ball,19,0,2255,16,92,172,133,204,41,32,sports ball
25055,19,person,20,1,2255,71,47,6,367,329,320,323,person
25056,20,ball,21,0,2255,15,236,251,294,302,58,51,sports ball
25057,23,ball,24,1,2255,16,284,275,343,329,59,54,sports ball
25058,0,person,1,1,2256,76,1426,1,2049,1374,623,1373,person
25059,1,person,2,0,2256,41,71,369,264,677,193,308,person
25060,2,person,3,0,2256,46,845,193,1066,552,221,359,person
25061,3,person,4,1,2256,35,763,1190,1054,1483,291,293,person
25062,4,person,5,1,2256,24,1051,762,1240,919,189,157,person
25063,5,person,6,1,2256,41,2,299,238,656,236,357,person
25064,10,window,11,1,2256,15,1185,0,1563,253,378,253,window
25065,11,person,12,1,2256,20,1514,1172,2045,1527,531,355,person
25066,15,balls,16,0,2256,95,5,762,1416,1527,1411,765,sports ball
25067,16,person,17,1,2256,36,471,974,664,1266,193,292,person
25068,17,person,18,1,2256,34,0,899,193,1088,193,189,person
25069,0,balls,1,0,2257,37,1,0,499,374,498,374,sports ball
25070,1,person,2,1,2257,26,269,13,358,145,89,132,person
25071,13,ball,14,0,2257,15,25,239,78,285,53,46,sports ball
25072,2,person,3,0,2258,74,130,497,997,1632,867,1135,person
25073,3,balls,4,0,2258,81,627,741,1532,2040,905,1299,sports ball
25074,16,balls,17,0,2259,52,148,187,460,294,312,107,sports ball
25075,0,balls,1,0,2260,31,0,0,1599,1198,1599,1198,sports ball
25076,3,person,4,1,2260,59,604,7,1025,746,421,739,person
25077,4,person,5,1,2260,77,63,573,739,1110,676,537,person
25078,12,ball,13,0,2260,15,815,676,904,777,89,101,sports ball
25079,19,ball,20,0,2260,15,837,815,938,913,101,98,sports ball
25080,29,ball,30,0,2260,15,1471,1014,1574,1115,103,101,sports ball
25081,0,balls,1,0,2261,97,0,0,1599,1198,1599,1198,sports ball
25082,1,person,2,1,2261,34,329,2,687,672,358,670,person
25083,2,person,3,1,2261,38,488,468,1005,1171,517,703,person
25084,3,person,4,1,2261,19,1088,0,1419,195,331,195,person
25085,3,person,4,0,2262,42,384,166,710,397,326,231,person
25086,4,person,5,0,2262,56,702,138,927,454,225,316,person
25087,5,person,6,0,2262,39,909,203,1123,490,214,287,person
25088,14,balls,15,0,2262,175,263,246,1254,556,991,310,sports ball
25089,0,balls,1,0,2263,55,0,0,1599,1198,1599,1198,sports ball
25090,1,person,2,1,2263,52,3,2,1230,1197,1227,1195,person
25091,2,ball,3,1,2263,40,299,596,765,1109,466,513,sports ball
25092,4,ball,5,0,2263,16,1089,416,1305,623,216,207,sports ball
25093,5,ball,6,0,2263,16,1246,256,1483,480,237,224,sports ball
25094,6,ball,7,0,2263,16,796,324,1017,545,221,221,sports ball
25095,7,ball,8,1,2263,16,804,3,1256,342,452,339,sports ball
25096,8,ball,9,0,2263,18,1235,52,1462,264,227,212,sports ball
25097,9,ball,10,1,2263,19,154,186,372,408,218,222,sports ball
25098,11,ball,12,0,2263,17,1395,477,1599,679,204,202,sports ball
25099,12,ball,13,0,2263,16,1375,877,1597,1078,222,201,sports ball
25100,0,balls,1,0,2264,83,2,0,500,374,498,374,sports ball
25101,1,person,2,0,2264,103,28,17,384,374,356,357,person
25102,2,ball,3,0,2264,16,13,3,85,74,72,71,sports ball
25103,3,ball,4,0,2264,15,319,111,394,186,75,75,sports ball
25104,4,ball,5,0,2264,16,399,89,482,166,83,77,sports ball
25105,5,ball,6,0,2264,15,308,32,382,106,74,74,sports ball
25106,7,ball,8,1,2264,21,369,13,437,83,68,70,sports ball
25107,8,ball,9,0,2264,17,378,167,458,247,80,80,sports ball
25108,9,ball,10,0,2264,18,377,279,460,363,83,84,sports ball
25109,10,ball,11,1,2264,19,417,248,492,319,75,71,sports ball
25110,11,ball,12,1,2264,15,286,286,341,358,55,72,sports ball
25111,12,ball,13,1,2264,17,81,112,142,186,61,74,sports ball
25112,13,ball,14,1,2264,20,116,63,173,125,57,62,sports ball
25113,14,ball,15,1,2264,20,52,56,120,123,68,67,sports ball
25114,15,ball,16,1,2264,18,24,114,84,177,60,63,sports ball
25115,18,ball,19,0,2264,15,99,246,157,306,58,60,sports ball
25116,20,ball,21,0,2264,15,33,314,102,374,69,60,sports ball
25117,21,ball,22,1,2264,17,81,3,149,64,68,61,sports ball
25118,4,ball,5,0,2265,67,0,261,2198,1647,2198,1386,sports ball
25119,5,ball,6,0,2265,27,1093,345,1650,899,557,554,sports ball
25120,6,ball,7,0,2265,25,548,259,1003,705,455,446,sports ball
25121,7,ball,8,0,2265,31,13,293,575,794,562,501,sports ball
25122,1,person,2,1,2266,25,194,43,284,139,90,96,person
25123,13,ball,14,1,2266,15,159,66,195,99,36,33,sports ball
25124,21,ball,22,1,2266,15,398,66,433,100,35,34,sports ball
25125,24,ball,25,1,2266,15,363,166,405,207,42,41,sports ball
25126,26,ball,27,1,2266,15,372,114,413,149,41,35,sports ball
25127,27,ball,28,1,2266,17,440,125,482,162,42,37,sports ball
25128,28,ball,29,1,2266,22,241,218,299,273,58,55,sports ball
25129,31,ball,32,1,2266,15,292,223,326,256,34,33,sports ball
25130,33,ball,34,1,2266,16,322,213,371,252,49,39,sports ball
25131,35,ball,36,1,2266,17,271,190,313,222,42,32,sports ball
25132,40,ball,41,1,2266,17,327,146,367,186,40,40,sports ball
25133,41,ball,42,0,2266,17,93,201,146,254,53,53,sports ball
25134,43,ball,44,0,2266,15,98,158,141,201,43,43,sports ball
25135,1,balls,2,0,2267,62,0,98,529,499,529,401,sports ball
25136,3,person,4,1,2267,36,472,48,666,499,194,451,person
25137,7,ball,8,0,2267,16,160,373,247,460,87,87,sports ball
25138,1,person,2,0,22757,84,240,379,1140,1307,900,928,person
25139,4,ball,5,0,22757,15,1018,1277,1169,1430,151,153,sports ball
25140,6,ball,7,0,22757,15,828,1352,978,1514,150,162,sports ball
25141,8,ball,9,0,22757,16,717,1342,835,1493,118,151,sports ball
25142,9,ball,10,0,22757,17,759,1277,880,1393,121,116,sports ball
25143,11,ball,12,0,22757,16,564,1307,725,1477,161,170,sports ball
25144,15,ball,16,0,22757,15,943,1454,1114,1584,171,130,sports ball
25145,20,balls,21,0,22757,54,606,791,1198,1224,592,433,sports ball
25146,15,person,16,0,25,74,938,279,1004,444,66,165,person
25147,25,person,26,0,25,57,881,290,927,431,46,141,person
25148,34,person,35,0,25,67,818,277,873,427,55,150,person
25149,44,person,45,0,25,64,768,286,816,420,48,134,person
25150,52,person,53,0,25,47,712,298,752,413,40,115,person
25151,60,person,61,1,25,31,687,313,711,394,24,81,person
25152,61,person,62,0,25,30,677,312,701,394,24,82,person
25153,62,person,63,0,25,55,651,296,683,410,32,114,person
25154,69,person,70,0,25,57,590,291,624,405,34,114,person
25155,77,person,78,0,25,78,346,230,431,450,85,220,person
25156,85,person,86,0,25,170,30,10,233,644,203,634,person
25157,125,person,126,1,25,41,34,261,70,414,36,153,person
25158,126,person,127,1,25,71,7,251,49,428,42,177,person
25159,127,person,128,1,25,47,1,222,50,451,49,229,person
25160,2,person,3,1,26,49,553,72,632,423,79,351,person
25161,3,person,4,0,26,85,466,61,577,423,111,362,person
25162,4,person,5,1,26,74,101,81,170,422,69,341,person
25163,5,person,6,0,26,72,23,71,134,423,111,352,person
25164,6,person,7,0,26,114,188,9,483,423,295,414,person
25165,16,person,17,0,26,130,147,14,421,423,274,409,person
25166,3,window,4,0,2269,25,198,53,314,199,116,146,window
25167,20,chair,21,0,2269,15,183,186,207,225,24,39,chair
25168,21,chair,22,0,2269,21,266,187,302,237,36,50,chair
25169,22,table,23,0,2269,21,219,190,273,227,54,37,dining table
25170,23,chair,24,0,2269,22,123,218,182,319,59,101,chair
25171,5,person,6,0,2272,52,430,68,504,355,74,287,person
25172,6,person,7,1,2272,36,418,79,456,342,38,263,person
25173,7,person,8,0,2272,35,203,93,249,240,46,147,person
25174,8,person,9,1,2272,28,236,89,260,237,24,148,person
25175,9,person,10,0,2272,55,35,56,136,287,101,231,person
25176,10,person,11,0,2272,43,539,85,595,243,56,158,person
25177,11,person,12,0,2272,33,513,96,553,238,40,142,person
25178,12,person,13,0,2272,36,610,88,688,275,78,187,person
25179,13,person,14,1,2272,59,242,25,391,434,149,409,person
25180,14,person,15,1,2272,61,246,60,434,433,188,373,person
25181,77,person,78,1,2272,58,653,76,700,280,47,204,person
25182,12,person,13,0,2274,19,121,122,144,151,23,29,person
25183,13,person,14,0,2274,35,391,103,412,173,21,70,person
25184,14,chair,15,0,2274,17,338,129,354,152,16,23,chair
25185,15,chair,16,0,2274,15,355,130,369,153,14,23,chair
25186,2,door,3,1,2278,33,1183,528,1288,842,105,314,door
25187,5,person,6,0,2278,170,428,238,800,1602,372,1364,person
25188,6,person,7,0,2278,94,1057,351,1216,1268,159,917,person
25189,7,person,8,0,2278,55,1253,456,1373,952,120,496,person
25190,8,person,9,0,2278,55,1689,474,1764,900,75,426,person
25191,27,person,28,0,2278,61,792,444,909,1001,117,557,person
25192,8,sofa,9,1,2281,15,221,135,253,151,32,16,couch
25193,11,sofa,12,0,2281,17,128,135,173,161,45,26,couch
25194,7,chair,8,0,2282,16,246,229,280,281,34,52,chair
25195,8,chair,9,0,2282,18,307,232,347,288,40,56,chair
25196,9,chair,10,0,2282,17,381,228,413,275,32,47,chair
25197,16,chair,17,0,2283,26,32,592,256,842,224,250,chair
25198,17,chair,18,0,2283,19,1056,589,1147,700,91,111,chair
25199,19,chair,20,0,2283,15,1207,587,1279,702,72,115,chair
25200,13,table,14,0,2286,22,80,215,185,275,105,60,dining table
25201,14,chair,15,0,2286,19,52,212,97,281,45,69,chair
25202,15,chair,16,0,2286,23,108,219,148,282,40,63,chair
25203,16,table,17,1,2286,26,324,218,429,285,105,67,dining table
25204,17,chair,18,0,2286,23,424,230,470,293,46,63,chair
25205,18,chair,19,0,2286,27,370,228,408,294,38,66,chair
25206,19,table,20,0,2286,25,514,230,634,289,120,59,dining table
25207,20,chair,21,0,2286,17,593,236,639,298,46,62,chair
25208,21,chair,22,0,2286,28,533,230,573,294,40,64,chair
25209,22,chair,23,0,2286,21,490,226,528,282,38,56,chair
25210,6,table,7,0,2288,20,1779,680,1902,816,123,136,dining table
25211,7,table,8,1,2288,24,1826,738,1965,955,139,217,dining table
25212,8,chair,9,0,2288,26,1845,735,2063,988,218,253,chair
25213,9,chair,10,0,2288,21,2037,697,2190,961,153,264,chair
25214,12,person,13,0,2290,95,184,401,433,1055,249,654,person
25215,13,person,14,0,2290,103,369,423,623,1026,254,603,person
25216,14,person,15,0,2290,101,480,370,677,1025,197,655,person
25217,15,person,16,0,2290,78,883,440,1168,966,285,526,person
25218,16,person,17,0,2290,85,1000,363,1201,959,201,596,person
25219,5,mirror,6,0,2292,16,107,83,159,118,52,35,mirror
25220,12,person,13,0,2292,49,121,92,179,187,58,95,person
25221,13,person,14,0,2292,37,178,106,225,189,47,83,person
25222,3,window,4,0,2293,27,74,18,179,79,105,61,window
25223,4,window,5,0,2293,19,205,18,272,81,67,63,window
25224,5,person,6,0,22758,145,96,80,663,936,567,856,person
25225,6,person,7,1,22758,66,1,45,184,1019,183,974,person
25226,7,person,8,1,22758,26,243,204,352,351,109,147,person
25227,8,person,9,1,22758,22,109,188,232,331,123,143,person
25228,10,person,11,1,22758,22,527,221,624,374,97,153,person
25229,11,person,12,1,22758,18,624,188,681,570,57,382,person
25230,13,person,14,1,22758,28,551,85,658,267,107,182,person
25231,14,person,15,1,22758,16,558,201,629,337,71,136,person
25232,15,person,16,1,22758,34,140,85,264,315,124,230,person
25233,16,person,17,1,22758,21,287,103,382,211,95,108,person
25234,19,person,20,1,22758,17,449,122,498,209,49,87,person
25235,20,person,21,1,22758,21,228,83,293,206,65,123,person
25236,22,person,23,1,22758,16,135,77,198,189,63,112,person
25237,23,person,24,1,22758,19,111,73,167,266,56,193,person
25238,26,person,27,1,22758,15,61,13,119,129,58,116,person
25239,2,chair,3,0,22759,41,277,63,528,636,251,573,chair
25240,4,person,5,0,22759,84,135,534,476,879,341,345,person
25241,62,chair,63,0,22760,56,450,722,661,1014,211,292,chair
25242,63,chair,64,1,22760,43,536,698,705,948,169,250,chair
25243,64,table,65,0,22760,67,135,711,565,1012,430,301,dining table
25244,65,chair,66,1,22760,27,499,659,584,803,85,144,chair
25245,66,chair,67,0,22760,43,874,795,1051,1137,177,342,chair
25246,67,chair,68,0,22760,50,1049,803,1233,1139,184,336,chair
25247,68,table,69,0,22760,73,838,727,1247,976,409,249,dining table
25248,69,chair,70,1,22760,33,948,676,1029,744,81,68,chair
25249,70,chair,71,0,22760,29,1044,677,1124,736,80,59,chair
25250,71,plate,72,0,22760,22,1098,769,1159,790,61,21,plate
25251,72,plate,73,0,22760,23,957,770,1019,789,62,19,plate
25252,82,table,83,1,22760,48,900,643,1103,753,203,110,dining table
25253,83,chair,84,1,22760,24,935,645,1009,748,74,103,chair
25254,84,chair,85,1,22760,27,1015,647,1081,728,66,81,chair
25255,91,chair,92,1,22760,27,69,682,173,836,104,154,chair
25256,92,chair,93,1,22760,24,0,705,83,1002,83,297,chair
25257,93,chair,94,0,22760,73,1,789,328,1137,327,348,chair
25258,94,plate,95,0,22760,21,386,754,458,773,72,19,plate
25259,96,plate,97,0,22760,22,216,765,297,786,81,21,plate
25260,98,plate,99,1,22760,19,162,749,220,764,58,15,plate
25261,100,plate,101,0,22760,15,492,722,541,737,49,15,plate
25262,108,chair,109,1,22760,37,209,624,327,734,118,110,chair
25263,109,chair,110,1,22760,27,318,619,381,716,63,97,chair
25264,111,chair,112,1,22760,31,372,613,423,714,51,101,chair
25265,112,table,113,0,22760,17,1,678,83,787,82,109,dining table
25266,113,table,114,1,22760,53,1,620,337,749,336,129,dining table
25267,115,plate,116,0,22760,15,109,643,153,650,44,7,plate
25268,128,chair,129,0,22760,21,31,600,78,632,47,32,chair
25269,130,table,131,0,22760,43,392,603,519,699,127,96,dining table
25270,132,table,133,0,22760,29,483,587,593,646,110,59,dining table
25271,133,chair,134,0,22760,19,321,597,363,640,42,43,chair
25272,134,chair,135,1,22760,18,528,613,563,661,35,48,chair
25273,135,chair,136,1,22760,19,491,618,540,685,49,67,chair
25274,136,chair,137,1,22760,42,558,636,657,781,99,145,chair
25275,137,chair,138,0,22760,34,720,627,815,764,95,137,chair
25276,138,chair,139,1,22760,25,744,621,823,739,79,118,chair
25277,139,table,140,1,22760,42,595,632,752,759,157,127,dining table
25278,140,chair,141,1,22760,22,574,584,629,636,55,52,chair
25279,143,chair,144,1,22760,25,699,602,754,674,55,72,chair
25280,145,table,146,0,22760,28,725,603,812,676,87,73,dining table
25281,146,chair,147,1,22760,21,820,596,857,680,37,84,chair
25282,147,chair,148,1,22760,32,784,599,849,693,65,94,chair
25283,148,table,149,1,22760,23,598,580,674,633,76,53,dining table
25284,149,table,150,0,22760,23,792,590,848,635,56,45,dining table
25285,150,chair,151,1,22760,35,1705,873,1936,1186,231,313,chair
25286,151,table,152,0,22760,54,1482,743,1936,1024,454,281,dining table
25287,152,table,153,1,22760,17,1861,721,1936,827,75,106,dining table
25288,153,chair,154,1,22760,22,1835,671,1906,764,71,93,chair
25289,154,plate,155,0,22760,19,1831,791,1909,808,78,17,plate
25290,156,plate,157,0,22760,17,1678,786,1752,805,74,19,plate
25291,163,chair,164,1,22760,30,1465,689,1567,909,102,220,chair
25292,164,chair,165,1,22760,22,1577,691,1661,767,84,76,chair
25293,165,chair,166,1,22760,46,1654,654,1778,756,124,102,chair
25294,166,table,167,1,22760,32,1514,650,1727,767,213,117,dining table
25295,169,chair,170,0,22760,29,1400,654,1480,800,80,146,chair
25296,170,chair,171,0,22760,37,1302,652,1410,798,108,146,chair
25297,171,table,172,0,22760,40,1230,647,1435,763,205,116,dining table
25298,172,table,173,1,22760,30,1155,613,1272,694,117,81,dining table
25299,173,chair,174,1,22760,15,1251,621,1294,678,43,57,chair
25300,174,chair,175,1,22760,18,1310,622,1359,650,49,28,chair
25301,180,chair,181,0,22760,26,1194,615,1258,711,64,96,chair
25302,181,table,182,1,22760,19,1099,596,1155,656,56,60,dining table
25303,183,chair,184,1,22760,27,1133,595,1176,666,43,71,chair
25304,184,chair,185,0,22760,24,845,587,890,657,45,70,chair
25305,186,chair,187,0,22760,17,909,576,946,629,37,53,chair
25306,187,chair,188,1,22760,20,1071,580,1099,639,28,59,chair
25307,188,chair,189,1,22760,19,1044,580,1071,638,27,58,chair
25308,189,table,190,0,22760,37,931,612,1068,650,137,38,dining table
25309,190,chair,191,1,22760,27,1014,617,1063,648,49,31,chair
25310,191,table,192,1,22760,19,881,579,919,628,38,49,dining table
25311,193,table,194,1,22760,19,1297,602,1374,633,77,31,dining table
25312,194,table,195,1,22760,23,641,574,708,622,67,48,dining table
25313,1,person,2,0,22761,74,853,242,1023,681,170,439,person
25314,2,person,3,0,22761,86,632,272,1022,579,390,307,person
25315,3,person,4,0,22761,103,356,200,571,671,215,471,person
25316,4,person,5,0,22761,95,275,0,550,539,275,539,person
25317,5,person,6,0,22761,59,2,213,217,680,215,467,person
25318,6,person,7,0,22761,32,1,327,241,656,240,329,person
25319,2,person,3,1,22762,148,156,56,694,900,538,844,person
25320,3,person,4,0,22762,126,121,178,520,901,399,723,person
25321,2,person,3,0,22763,109,51,183,680,1022,629,839,person
25322,3,person,4,1,22763,101,152,146,682,1024,530,878,person
25323,4,person,5,1,22763,35,0,349,129,861,129,512,person
25324,5,person,6,1,22763,47,384,69,680,301,296,232,person
25325,6,person,7,1,22763,26,508,0,680,138,172,138,person
25326,7,person,8,1,22763,74,108,17,443,402,335,385,person
25327,8,person,9,1,22763,29,167,1,305,299,138,298,person
25328,13,chair,14,0,22764,33,132,534,253,709,121,175,chair
25329,14,chair,15,0,22764,33,2,535,125,707,123,172,chair
25330,2,person,3,0,30,163,103,86,495,925,392,839,person
25331,1,person,2,0,31,114,1,50,185,404,184,354,person
25332,15,person,16,0,31,137,261,73,452,399,191,326,person
25333,30,person,31,0,31,106,403,36,641,428,238,392,person
25334,39,person,40,0,31,102,516,0,660,381,144,381,person
25335,50,ball,51,1,31,24,263,240,301,282,38,42,sports ball
25336,4,person,5,0,32,78,100,134,264,413,164,279,person
25337,14,person,15,0,32,72,230,211,403,406,173,195,person
25338,21,person,22,0,32,117,405,86,610,433,205,347,person
25339,1,person,2,1,33,107,127,38,599,365,472,327,person
25340,5,person,6,0,34,156,1215,3,1909,1052,694,1049,person
25341,20,ball,21,0,34,19,1613,3,1691,85,78,82,sports ball
25342,21,person,22,1,34,64,1752,2,1885,347,133,345,person
25343,1,person,2,0,35,74,240,106,353,332,113,226,person
25344,11,person,12,0,35,71,154,105,253,325,99,220,person
25345,21,person,22,0,35,45,12,34,84,272,72,238,person
25346,25,person,26,0,35,89,31,181,131,420,100,239,person
25347,3,person,4,0,36,81,350,66,467,377,117,311,person
25348,14,person,15,0,2465,20,658,199,674,254,16,55,person
25349,20,person,21,0,2465,15,145,181,157,209,12,28,person
25350,11,person,12,0,2472,69,79,122,199,414,120,292,person
25351,4,person,5,0,2473,20,293,340,323,406,30,66,person
25352,5,person,6,0,2473,19,399,346,421,420,22,74,person
25353,6,person,7,0,2473,25,416,344,440,420,24,76,person
25354,7,person,8,1,2473,23,428,347,447,421,19,74,person
25355,8,person,9,1,2473,17,441,350,454,418,13,68,person
25356,1,person,2,0,20288,60,526,46,649,500,123,454,person
25357,1,person,2,0,20289,15,120,175,138,252,18,77,person
25358,5,person,6,0,22801,103,374,372,716,891,342,519,person
25359,7,person,8,1,22801,16,586,56,671,139,85,83,person
25360,8,person,9,1,22801,18,673,66,735,141,62,75,person
25361,9,person,10,1,22801,19,735,63,819,141,84,78,person
25362,10,person,11,1,22801,19,841,49,932,141,91,92,person
25363,11,person,12,1,22801,16,933,63,1006,140,73,77,person
25364,12,person,13,1,22801,21,487,9,584,138,97,129,person
25365,13,person,14,1,22801,20,385,45,498,140,113,95,person
25366,14,person,15,0,22801,20,293,49,386,139,93,90,person
25367,15,person,16,1,22801,19,195,46,296,140,101,94,person
25368,16,person,17,1,22801,25,46,27,162,138,116,111,person
25369,2,person,3,0,22802,120,220,18,566,766,346,748,person
25370,3,person,4,1,22803,49,70,177,182,494,112,317,person
25371,4,person,5,0,22803,87,104,112,344,649,240,537,person
25372,1,person,2,0,22804,175,227,64,890,764,663,700,person
25373,2,ball,3,1,22804,15,640,95,672,131,32,36,sports ball
25374,5,person,6,0,22805,81,1001,694,1452,1737,451,1043,person
25375,6,person,7,0,22805,71,75,339,508,1398,433,1059,person
25376,7,ball,8,0,22805,15,1045,1686,1196,1830,151,144,sports ball
25377,3,person,4,0,22807,115,324,240,594,635,270,395,person
25378,4,person,5,1,22807,43,664,459,860,766,196,307,person
25379,5,person,6,1,22807,41,374,588,656,767,282,179,person
25380,2,person,3,1,22808,20,940,191,1000,258,60,67,person
25381,3,person,4,1,22808,21,866,191,937,258,71,67,person
25382,4,person,5,1,22808,24,788,191,866,258,78,67,person
25383,5,person,6,1,22808,19,728,191,789,259,61,68,person
25384,6,person,7,1,22808,19,655,191,700,238,45,47,person
25385,7,person,8,1,22808,37,689,116,782,225,93,109,person
25386,8,person,9,1,22808,38,781,87,875,193,94,106,person
25387,9,person,10,1,22808,30,868,91,941,198,73,107,person
25388,10,person,11,1,22808,24,937,95,999,191,62,96,person
25389,11,person,12,1,22808,27,912,18,986,114,74,96,person
25390,12,person,13,1,22808,19,848,18,905,97,57,79,person
25391,13,person,14,1,22808,37,772,29,877,116,105,87,person
25392,14,person,15,1,22808,22,736,96,785,184,49,88,person
25393,15,person,16,1,22808,33,761,55,810,152,49,97,person
25394,16,person,17,1,22808,29,649,92,709,189,60,97,person
25395,17,person,18,1,22808,34,648,27,717,120,69,93,person
25396,18,person,19,1,22808,26,882,1,936,95,54,94,person
25397,19,person,20,1,22808,24,806,1,860,79,54,78,person
25398,20,person,21,1,22808,32,530,157,591,255,61,98,person
25399,21,person,22,1,22808,27,740,1,789,95,49,94,person
25400,22,person,23,1,22808,26,698,9,754,114,56,105,person
25401,23,person,24,1,22808,23,485,192,560,260,75,68,person
25402,24,person,25,1,22808,22,409,194,484,262,75,68,person
25403,25,person,26,1,22808,34,453,149,507,251,54,102,person
25404,26,person,27,1,22808,31,373,159,430,262,57,103,person
25405,27,person,28,1,22808,32,574,23,654,116,80,93,person
25406,28,person,29,1,22808,30,506,28,576,117,70,89,person
25407,29,person,30,1,22808,24,299,164,381,262,82,98,person
25408,30,person,31,1,22808,43,446,87,524,189,78,102,person
25409,31,person,32,1,22808,29,605,0,669,80,64,80,person
25410,32,person,33,1,22808,29,532,0,599,70,67,70,person
25411,33,person,34,1,22808,23,467,0,530,78,63,78,person
25412,34,person,35,1,22808,27,387,0,443,70,56,70,person
25413,35,person,36,1,22808,35,364,87,431,188,67,101,person
25414,36,person,37,1,22808,37,420,15,493,119,73,104,person
25415,37,person,38,1,22808,22,314,0,383,84,69,84,person
25416,38,person,39,1,22808,28,370,41,435,109,65,68,person
25417,39,person,40,1,22808,28,307,92,372,183,65,91,person
25418,40,person,41,1,22808,27,284,23,347,109,63,86,person
25419,41,person,42,1,22808,20,235,1,297,59,62,58,person
25420,42,person,43,1,22808,26,170,0,237,72,67,72,person
25421,43,person,44,1,22808,20,226,27,270,100,44,73,person
25422,44,person,45,1,22808,30,235,155,304,262,69,107,person
25423,45,person,46,1,22808,29,247,58,313,154,66,96,person
25424,46,person,47,1,22808,35,215,108,284,190,69,82,person
25425,47,person,48,1,22808,29,142,164,218,258,76,94,person
25426,48,person,49,1,22808,32,183,50,247,155,64,105,person
25427,49,person,50,1,22808,29,147,100,218,185,71,85,person
25428,50,person,51,1,22808,25,24,182,116,262,92,80,person
25429,51,person,52,1,22808,30,73,162,156,262,83,100,person
25430,52,person,53,1,22808,42,45,80,146,201,101,121,person
25431,53,person,54,1,22808,21,92,144,139,213,47,69,person
25432,54,person,55,1,22808,32,103,48,169,161,66,113,person
25433,55,person,56,1,22808,25,143,14,202,107,59,93,person
25434,56,person,57,1,22808,32,45,12,118,114,73,102,person
25435,57,person,58,1,22808,24,20,0,78,83,58,83,person
25436,59,person,60,1,22808,15,2,119,33,224,31,105,person
25437,60,person,61,0,22808,74,127,188,285,500,158,312,person
25438,61,person,62,0,22808,69,257,296,525,500,268,204,person
25439,62,person,63,0,22808,103,486,162,748,503,262,341,person
25440,1,person,2,1,22809,49,503,0,592,177,89,177,person
25441,2,person,3,0,22809,49,145,207,277,524,132,317,person
25442,1,person,2,1,22810,20,489,226,536,463,47,237,person
25443,2,person,3,1,22810,40,164,255,227,428,63,173,person
25444,3,person,4,1,22810,72,187,67,368,367,181,300,person
25445,4,person,5,0,22810,77,169,217,409,723,240,506,person
25446,5,person,6,1,22810,22,1,182,52,450,51,268,person
25447,7,bat,8,0,22810,29,305,377,528,432,223,55,baseball bat
25448,1,person,2,1,22811,95,2,76,688,880,686,804,person
25449,4,person,5,0,22812,126,271,126,850,963,579,837,person
25450,1,person,2,0,22813,100,800,132,951,439,151,307,person
25451,2,person,3,0,22813,68,687,153,818,467,131,314,person
25452,3,person,4,1,22813,84,650,121,834,414,184,293,person
25453,4,person,5,1,22813,15,649,1,700,50,51,49,person
25454,5,person,6,1,22813,54,596,129,719,462,123,333,person
25455,6,person,7,0,22813,45,561,166,654,476,93,310,person
25456,7,person,8,1,22813,30,533,192,609,479,76,287,person
25457,8,person,9,1,22813,40,538,144,607,442,69,298,person
25458,9,person,10,1,22813,19,518,134,566,188,48,54,person
25459,10,person,11,0,22813,80,417,186,583,501,166,315,person
25460,11,person,12,1,22813,58,417,166,519,483,102,317,person
25461,12,person,13,1,22813,52,398,156,476,486,78,330,person
25462,13,person,14,1,22813,59,327,161,447,491,120,330,person
25463,14,person,15,1,22813,68,290,134,433,480,143,346,person
25464,6,person,7,0,22814,69,163,322,489,747,326,425,person
25465,7,person,8,0,22814,48,563,445,834,741,271,296,person
25466,8,person,9,0,22814,60,805,424,1006,750,201,326,person
25467,9,person,10,1,22814,18,14,91,86,164,72,73,person
25468,10,person,11,1,22814,22,74,104,170,175,96,71,person
25469,11,person,12,1,22814,15,184,101,263,177,79,76,person
25470,12,person,13,1,22814,30,102,84,187,173,85,89,person
25471,13,person,14,1,22814,27,68,45,133,163,65,118,person
25472,14,person,15,1,22814,36,156,47,250,157,94,110,person
25473,15,person,16,1,22814,27,129,5,207,89,78,84,person
25474,16,person,17,1,22814,23,273,114,343,180,70,66,person
25475,17,person,18,1,22814,24,332,114,397,183,65,69,person
25476,19,person,20,1,22814,21,499,123,553,194,54,71,person
25477,20,person,21,1,22814,29,533,89,598,204,65,115,person
25478,21,person,22,1,22814,26,606,82,703,178,97,96,person
25479,22,person,23,1,22814,21,725,111,814,207,89,96,person
25480,23,person,24,1,22814,31,792,76,878,204,86,128,person
25481,24,person,25,1,22814,25,698,82,763,175,65,93,person
25482,25,person,26,1,22814,17,682,73,723,131,41,58,person
25483,26,person,27,1,22814,24,867,97,955,202,88,105,person
25484,27,person,28,1,22814,21,956,81,1023,201,67,120,person
25485,28,person,29,1,22814,16,934,98,981,164,47,66,person
25486,29,person,30,1,22814,34,917,3,1023,127,106,124,person
25487,30,person,31,1,22814,23,595,57,645,138,50,81,person
25488,31,person,32,1,22814,26,408,76,476,164,68,88,person
25489,32,person,33,1,22814,26,382,60,435,157,53,97,person
25490,33,person,34,1,22814,33,246,57,318,174,72,117,person
25491,34,person,35,1,22814,19,331,72,386,127,55,55,person
25492,35,person,36,1,22814,30,301,30,354,127,53,97,person
25493,36,person,37,1,22814,32,334,1,413,84,79,83,person
25494,37,person,38,0,22814,27,461,54,505,143,44,89,person
25495,38,person,39,1,22814,29,420,32,476,95,56,63,person
25496,39,person,40,1,22814,22,499,70,552,134,53,64,person
25497,40,person,41,1,22814,33,499,22,569,113,70,91,person
25498,41,person,42,1,22814,25,574,22,632,108,58,86,person
25499,43,person,44,1,22814,20,568,1,661,49,93,48,person
25500,44,person,45,1,22814,19,700,0,777,63,77,63,person
25501,45,person,46,1,22814,21,795,1,861,55,66,54,person
25502,46,person,47,1,22814,23,863,1,928,72,65,71,person
25503,1,person,2,0,22815,97,206,123,536,563,330,440,person
25504,7,bench,8,0,2515,16,251,130,317,143,66,13,bench
25505,3,person,4,0,2518,48,763,835,967,1386,204,551,person
25506,4,person,5,1,2518,30,1700,997,2063,1458,363,461,person
25507,5,person,6,0,2518,46,639,146,792,495,153,349,person
25508,6,person,7,0,2518,61,385,461,561,953,176,492,person
25509,7,person,8,0,2518,70,178,428,357,843,179,415,person
25510,8,person,9,1,2518,45,100,296,234,714,134,418,person
25511,9,person,10,0,2518,42,0,256,149,630,149,374,person
25512,10,ball,11,0,2518,16,998,382,1113,507,115,125,sports ball
25513,4,person,5,0,2519,62,345,552,634,1198,289,646,person
25514,5,person,6,0,2519,58,529,608,740,1191,211,583,person
25515,6,person,7,1,2519,37,754,569,951,1199,197,630,person
25516,7,person,8,1,2519,48,707,599,989,1200,282,601,person
25517,0,person,1,0,2520,46,1672,570,1922,1175,250,605,person
25518,2,person,3,0,2520,28,240,573,398,898,158,325,person
25519,4,person,5,0,2520,29,755,514,896,1151,141,637,person
25520,12,person,13,0,2520,17,132,484,175,598,43,114,person
25521,13,person,14,0,2520,40,38,619,193,890,155,271,person
25522,14,person,15,0,2520,19,585,669,619,778,34,109,person
25523,15,person,16,0,2520,22,434,656,507,813,73,157,person
25524,20,person,21,0,2520,38,931,590,1041,953,110,363,person
25525,21,person,22,0,2520,64,994,578,1155,1128,161,550,person
25526,22,person,23,1,2520,35,1516,606,1590,944,74,338,person
25527,23,person,24,0,2520,49,1504,627,1650,965,146,338,person
25528,56,person,57,0,2520,51,1479,686,1512,786,33,100,person
25529,57,person,58,0,2520,28,1328,735,1366,777,38,42,person
25530,1,person,2,0,24846,34,2,243,339,833,337,590,person
25531,2,person,3,1,24846,32,334,243,632,831,298,588,person
25532,3,person,4,1,24846,72,337,0,813,451,476,451,person
25533,5,person,6,1,24846,135,502,56,1243,1495,741,1439,person
25534,6,person,7,1,24846,93,27,733,691,1498,664,765,person
25535,7,ball,8,0,24846,35,184,676,415,924,231,248,sports ball
25536,5,person,6,1,24847,19,254,0,354,49,100,49,person
25537,7,person,8,1,24847,24,478,0,577,209,99,209,person
25538,9,person,10,0,24847,117,355,106,591,646,236,540,person
25539,10,person,11,0,24847,134,0,35,357,632,357,597,person
25540,11,ball,12,0,24847,16,1,183,73,272,72,89,sports ball
25541,2,person,3,0,24848,173,10,9,372,768,362,759,person
25542,3,person,4,0,24848,110,306,51,591,768,285,717,person
25543,11,ball,12,0,24848,24,64,247,167,349,103,102,sports ball
25544,1,person,2,0,24849,114,85,81,295,493,210,412,person
25545,2,person,3,0,24849,92,267,112,412,595,145,483,person
25546,3,person,4,1,24849,74,467,53,612,252,145,199,person
25547,4,person,5,0,24849,111,460,167,615,616,155,449,person
25548,5,person,6,0,24849,102,656,116,780,535,124,419,person
25549,2,person,3,0,24850,112,24,105,409,734,385,629,person
25550,3,person,4,0,24850,174,254,39,676,759,422,720,person
25551,4,ball,5,0,24850,20,33,555,156,676,123,121,sports ball
25552,5,person,6,0,24850,29,99,201,194,392,95,191,person
25553,6,person,7,1,24850,36,20,150,130,392,110,242,person
25554,7,person,8,1,24850,27,145,146,227,281,82,135,person
25555,8,person,9,0,24850,34,3,130,77,377,74,247,person
25556,9,person,10,1,24850,16,1,124,39,258,38,134,person
25557,10,person,11,1,24850,17,2,58,47,168,45,110,person
25558,11,person,12,1,24850,18,99,129,143,245,44,116,person
25559,12,person,13,1,24850,23,50,62,122,156,72,94,person
25560,13,person,14,1,24850,27,45,19,112,107,67,88,person
25561,14,person,15,1,24850,19,221,54,287,150,66,96,person
25562,15,person,16,1,24850,31,553,148,638,408,85,260,person
25563,16,person,17,1,24850,22,608,109,672,200,64,91,person
25564,17,person,18,1,24850,18,496,114,566,193,70,79,person
25565,18,person,19,1,24850,20,519,71,575,152,56,81,person
25566,19,person,20,1,24850,26,600,84,660,162,60,78,person
25567,20,person,21,1,24850,24,570,22,636,154,66,132,person
25568,21,person,22,1,24850,16,618,2,670,87,52,85,person
25569,22,person,23,1,24850,18,273,28,339,115,66,87,person
25570,23,person,24,1,24850,17,314,3,378,84,64,81,person
25571,24,person,25,1,24850,26,220,2,288,106,68,104,person
25572,0,person,1,0,2525,27,210,117,229,178,19,61,person
25573,5,person,6,0,2525,19,140,132,154,179,14,47,person
25574,8,person,9,0,2527,19,499,160,511,214,12,54,person
25575,9,person,10,0,2527,22,532,157,563,224,31,67,person
25576,10,person,11,0,2529,37,97,201,167,312,70,111,person
25577,11,person,12,0,2529,26,314,195,341,288,27,93,person
25578,12,person,13,0,2529,24,174,191,203,281,29,90,person
25579,13,person,14,0,2529,26,95,199,129,291,34,92,person
25580,14,person,15,0,2529,23,385,197,410,270,25,73,person
25581,15,person,16,0,2529,25,51,185,75,235,24,50,person
25582,2,person,3,0,3021,104,6,6,183,268,177,262,person
25583,2,person,3,0,3022,37,92,37,167,263,75,226,person
25584,5,person,6,0,3022,50,25,108,112,236,87,128,person
25585,1,person,2,0,3023,65,625,148,890,688,265,540,person
25586,2,person,3,0,3023,50,126,337,397,698,271,361,person
25587,4,person,5,1,3023,25,0,184,116,677,116,493,person
25588,6,car,7,0,3023,22,808,103,1012,272,204,169,car
25589,8,car,9,1,3023,41,495,84,801,369,306,285,car
25590,9,person,10,1,3023,28,145,174,321,434,176,260,person
25591,2,person,3,0,3024,79,193,64,318,228,125,164,person
25592,3,person,4,0,3024,45,112,130,193,255,81,125,person
25593,4,person,5,0,3024,61,28,109,116,263,88,154,person
25594,2,bench,3,0,3025,16,409,214,787,338,378,124,bench
25595,3,person,4,0,3025,30,409,180,523,331,114,151,person
25596,4,person,5,0,3025,35,491,179,596,332,105,153,person
25597,5,person,6,1,3025,27,601,187,708,315,107,128,person
25598,6,person,7,0,3025,28,688,179,785,330,97,151,person
25599,9,person,10,0,3025,57,312,121,421,533,109,412,person
25600,10,person,11,0,3025,46,585,271,748,519,163,248,person
25601,11,person,12,0,3025,28,203,196,265,331,62,135,person
25602,3,person,4,1,3026,33,353,46,474,198,121,152,person
25603,6,person,7,0,3026,33,345,122,450,404,105,282,person
25604,8,person,9,0,3026,44,79,262,253,575,174,313,person
25605,9,person,10,0,3026,62,466,169,695,562,229,393,person
25606,11,person,12,0,3026,44,14,61,111,336,97,275,person
25607,2,person,3,0,3027,15,129,228,150,314,21,86,person
25608,3,person,4,0,3027,24,652,360,705,538,53,178,person
25609,4,person,5,0,3027,18,558,429,627,523,69,94,person
25610,5,person,6,0,3027,35,435,366,500,540,65,174,person
25611,8,person,9,1,3027,41,714,264,742,353,28,89,person
25612,9,person,10,1,3027,39,742,263,775,357,33,94,person
25613,10,person,11,1,3027,51,771,261,800,358,29,97,person
25614,11,person,12,1,3027,39,880,283,910,374,30,91,person
25615,12,person,13,1,3027,45,414,231,446,317,32,86,person
25616,13,person,14,1,3027,31,445,244,468,319,23,75,person
25617,14,person,15,1,3027,38,463,238,493,323,30,85,person
25618,6,person,7,0,3030,46,197,108,263,246,66,138,person
25619,10,chair,11,0,3031,25,186,185,236,256,50,71,chair
25620,11,person,12,0,3031,24,141,125,155,156,14,31,person
25621,14,person,15,1,3031,27,262,121,303,186,41,65,person
25622,4,person,5,0,3033,52,0,72,139,203,139,131,person
25623,5,person,6,0,3034,44,51,81,80,164,29,83,person
25624,6,person,7,0,3035,56,50,92,99,215,49,123,person
25625,7,person,8,0,3035,51,198,103,233,200,35,97,person
25626,8,person,9,0,3035,28,22,103,37,147,15,44,person
25627,9,person,10,0,3035,20,146,102,158,134,12,32,person
25628,10,person,11,1,3035,25,289,113,319,172,30,59,person
25629,2,car,3,1,4231,20,288,83,331,115,43,32,car
25630,4,person,5,1,4231,24,4,77,23,149,19,72,person
25631,5,person,6,1,4231,21,244,75,259,119,15,44,person
25632,13,person,14,1,4231,31,15,65,53,161,38,96,person
25633,14,person,15,1,4231,16,76,75,93,103,17,28,person
25634,15,person,16,1,4231,26,146,84,164,174,18,90,person
25635,16,person,17,1,4231,29,113,87,148,160,35,73,person
25636,18,person,19,1,4231,24,214,78,233,151,19,73,person
25637,19,person,20,1,4231,27,191,82,229,147,38,65,person
25638,20,person,21,1,4231,21,255,75,275,118,20,43,person
25639,21,person,22,1,4231,54,31,67,91,239,60,172,person
25640,22,person,23,1,4231,36,82,76,116,194,34,118,person
25641,23,person,24,1,4231,27,155,77,193,155,38,78,person
25642,24,person,25,1,4231,19,0,147,67,245,67,98,person
25643,25,person,26,0,4231,53,95,140,160,245,65,105,person
25644,26,person,27,1,4231,34,151,124,199,224,48,100,person
25645,27,person,28,1,4231,16,239,121,273,166,34,45,person
25646,28,person,29,1,4231,28,276,120,310,191,34,71,person
25647,29,person,30,1,4231,16,325,79,338,111,13,32,person
25648,30,person,31,1,4231,18,335,76,348,112,13,36,person
25649,32,person,33,1,4231,20,356,73,376,115,20,42,person
25650,33,person,34,1,4231,15,374,79,385,106,11,27,person
25651,35,person,36,1,4231,17,392,97,422,124,30,27,person
25652,36,person,37,1,4231,17,368,100,391,129,23,29,person
25653,37,person,38,1,4231,28,345,104,389,161,44,57,person
25654,38,person,39,1,4231,17,381,123,412,162,31,39,person
25655,39,person,40,1,4231,37,393,130,448,245,55,115,person
25656,40,person,41,1,4231,33,356,161,440,245,84,84,person
25657,41,person,42,1,4231,17,343,122,375,176,32,54,person
25658,42,person,43,1,4231,17,337,134,365,192,28,58,person
25659,44,person,45,1,4231,18,307,107,326,147,19,40,person
25660,45,person,46,1,4231,39,292,125,373,245,81,120,person
25661,46,person,47,1,4231,31,235,135,310,244,75,109,person
25662,47,person,48,1,4231,31,188,142,259,245,71,103,person
25663,51,person,52,1,4231,16,431,81,449,117,18,36,person
25664,8,person,9,1,4232,15,50,157,83,209,33,52,person
25665,10,person,11,1,4232,17,57,158,129,231,72,73,person
25666,13,person,14,0,4232,23,159,122,209,246,50,124,person
25667,16,person,17,1,4232,15,5,155,39,204,34,49,person
25668,17,person,18,1,4232,22,191,164,275,265,84,101,person
25669,20,person,21,1,4232,21,318,122,364,206,46,84,person
25670,22,person,23,1,4232,16,394,178,430,226,36,48,person
25671,23,person,24,1,4232,15,299,170,348,222,49,52,person
25672,26,person,27,1,4232,27,339,170,406,280,67,110,person
25673,32,person,33,1,4232,17,606,179,663,257,57,78,person
25674,38,person,39,1,4232,24,434,186,515,303,81,117,person
25675,40,person,41,1,4232,28,501,174,589,245,88,71,person
25676,41,person,42,1,4232,19,523,194,590,320,67,126,person
25677,45,person,46,1,4232,31,516,205,666,429,150,224,person
25678,46,table,47,0,4232,20,188,262,648,414,460,152,dining table
25679,47,bench,48,0,4232,27,111,333,514,546,403,213,bench
25680,48,person,49,0,4232,61,343,222,546,547,203,325,person
25681,5,umbrella,6,0,4233,18,48,98,145,184,97,86,umbrella
25682,10,person,11,0,4233,20,219,126,236,175,17,49,person
25683,15,chair,16,0,4233,16,248,183,283,216,35,33,chair
25684,16,person,17,1,4233,16,242,152,289,193,47,41,person
25685,17,chair,18,0,4233,17,288,179,330,222,42,43,chair
25686,18,person,19,1,4233,16,289,148,329,203,40,55,person
25687,19,chair,20,0,4233,17,95,186,143,237,48,51,chair
25688,20,person,21,1,4233,15,98,156,137,199,39,43,person
25689,22,person,23,1,4233,17,139,151,169,193,30,42,person
25690,24,chair,25,0,4233,16,23,198,77,272,54,74,chair
25691,25,person,26,1,4233,25,5,156,56,254,51,98,person
25692,26,person,27,1,4233,17,11,135,50,172,39,37,person
25693,29,person,30,0,4233,23,345,142,387,217,42,75,person
25694,30,umbrella,31,0,4233,26,329,54,584,171,255,117,umbrella
25695,32,person,33,1,4233,15,610,121,636,181,26,60,person
25696,33,person,34,1,4233,18,581,150,620,233,39,83,person
25697,34,person,35,1,4233,16,533,155,581,212,48,57,person
25698,35,person,36,1,4233,27,488,170,570,274,82,104,person
25699,36,chair,37,1,4233,23,540,219,596,311,56,92,chair
25700,37,chair,38,0,4233,27,302,220,394,334,92,114,chair
25701,38,person,39,1,4233,21,398,148,440,216,42,68,person
25702,39,person,40,1,4233,25,401,173,474,263,73,90,person
25703,41,person,42,1,4233,46,252,219,517,431,265,212,person
25704,42,person,43,1,4233,27,389,308,599,432,210,124,person
25705,43,person,44,0,4233,18,175,144,205,189,30,45,person
25706,44,person,45,1,4233,16,448,159,492,218,44,59,person
25707,10,bicycle,11,1,4234,28,220,1316,422,1527,202,211,bicycle
25708,11,umbrella,12,0,4234,31,250,517,1928,1527,1678,1010,umbrella
25709,14,table,15,0,4234,17,1236,1337,1649,1527,413,190,dining table
25710,19,chair,20,0,4234,19,1667,1251,1857,1485,190,234,chair
25711,20,person,21,1,4234,23,870,1251,1084,1527,214,276,person
25712,21,person,22,0,4234,33,73,1090,223,1491,150,401,person
25713,22,person,23,1,4234,26,331,1058,452,1413,121,355,person
25714,23,person,24,0,4234,34,612,1067,716,1471,104,404,person
25715,24,person,25,0,4234,40,764,1026,924,1435,160,409,person
25716,25,person,26,1,4234,26,1612,1094,1791,1340,179,246,person
25717,26,person,27,1,4234,23,1906,1094,2043,1262,137,168,person
25718,31,door,32,1,4234,15,826,984,980,1250,154,266,door
25719,33,chair,34,1,4234,15,1888,1327,2046,1528,158,201,chair
25720,58,window,59,1,4234,36,1675,781,2047,1182,372,401,window
25721,68,window,69,1,4234,15,815,800,986,940,171,140,window
25722,70,window,71,1,4234,21,151,286,356,560,205,274,window
25723,22,table,23,0,4235,16,127,176,215,221,88,45,dining table
25724,24,table,25,0,4235,19,11,188,121,254,110,66,dining table
25725,3,umbrella,4,1,4236,18,10,19,79,51,69,32,umbrella
25726,4,umbrella,5,0,4236,37,55,5,222,205,167,200,umbrella
25727,5,person,6,1,4236,17,77,68,99,101,22,33,person
25728,6,person,7,1,4236,22,38,62,71,99,33,37,person
25729,7,person,8,1,4236,32,0,68,38,124,38,56,person
25730,8,person,9,1,4236,27,92,80,149,132,57,52,person
25731,9,person,10,1,4236,73,25,83,107,221,82,138,person
25732,10,person,11,1,4236,37,171,83,224,189,53,106,person
25733,17,table,18,0,4236,23,57,120,190,224,133,104,dining table
25734,3,umbrella,4,1,4237,17,752,3,2044,918,1292,915,umbrella
25735,4,person,5,1,4237,40,1539,490,2044,1524,505,1034,person
25736,5,person,6,1,4237,27,1542,680,1794,1052,252,372,person
25737,6,person,7,1,4237,33,1138,484,1390,829,252,345,person
25738,7,person,8,1,4237,41,211,541,517,1075,306,534,person
25739,10,person,11,1,4237,20,9,1105,553,1530,544,425,person
25740,11,person,12,1,4237,31,0,487,241,1527,241,1040,person
25741,13,chair,14,1,4237,19,1450,1013,1800,1292,350,279,chair
25742,14,person,15,1,4237,43,1096,695,1447,1242,351,547,person
25743,15,chair,16,1,4237,16,1322,986,1560,1272,238,286,chair
25744,16,person,17,1,4237,57,639,208,1108,1301,469,1093,person
25745,17,table,18,0,4237,15,618,1242,1610,1533,992,291,dining table
25746,24,chair,25,1,4237,15,449,1010,654,1289,205,279,chair
25747,25,umbrella,26,1,4237,19,359,1150,452,1328,93,178,umbrella
25748,49,window,50,1,4237,27,1690,327,2038,664,348,337,window
25749,16,person,17,1,4238,19,1218,488,1264,562,46,74,person
25750,19,person,20,1,4238,19,960,519,1011,584,51,65,person
25751,20,person,21,1,4238,16,926,515,970,575,44,60,person
25752,28,table,29,1,4238,16,527,588,586,663,59,75,dining table
25753,30,person,31,1,4238,19,541,527,593,623,52,96,person
25754,31,person,32,1,4238,33,705,531,754,642,49,111,person
25755,34,person,35,1,4238,21,823,522,886,578,63,56,person
25756,36,chair,37,0,4238,38,751,588,846,724,95,136,chair
25757,37,chair,38,0,4238,48,871,584,960,731,89,147,chair
25758,38,chair,39,1,4238,37,983,589,1074,765,91,176,chair
25759,39,chair,40,0,4238,46,1216,580,1335,761,119,181,chair
25760,40,chair,41,1,4238,17,1175,588,1255,730,80,142,chair
25761,41,chair,42,0,4238,44,1432,627,1599,904,167,277,chair
25762,44,chair,45,0,4238,31,1349,568,1421,688,72,120,chair
25763,45,person,46,1,4238,16,1518,510,1548,559,30,49,person
25764,47,person,48,1,4238,25,1343,507,1409,574,66,67,person
25765,48,table,49,0,4238,16,799,593,991,717,192,124,dining table
25766,49,table,50,0,4238,23,137,785,1118,1004,981,219,dining table
25767,50,chair,51,1,4238,30,400,881,831,1066,431,185,chair
25768,51,chair,52,1,4238,42,850,834,1210,1066,360,232,chair
25769,52,chair,53,1,4238,37,2,680,196,1023,194,343,chair
25770,53,person,54,1,4238,67,6,534,212,845,206,311,person
25771,54,person,55,1,4238,28,213,522,341,706,128,184,person
25772,55,person,56,1,4238,39,228,476,484,742,256,266,person
25773,56,chair,57,1,4238,21,265,700,461,831,196,131,chair
25774,57,chair,58,1,4238,23,190,730,427,849,237,119,chair
25775,58,table,59,1,4238,23,156,706,231,815,75,109,dining table
25776,59,chair,60,1,4238,15,680,645,748,806,68,161,chair
25777,60,table,61,1,4238,23,448,672,661,785,213,113,dining table
25778,62,chair,63,1,4238,28,486,699,696,824,210,125,chair
25779,72,chair,73,1,4238,23,1055,710,1234,838,179,128,chair
25780,3,umbrella,4,0,4239,32,367,0,785,1213,418,1213,umbrella
25781,4,umbrella,5,0,4239,24,1463,299,1640,1048,177,749,umbrella
25782,7,umbrella,8,0,4239,22,839,394,980,893,141,499,umbrella
25783,13,umbrella,14,0,4239,24,1221,705,1299,926,78,221,umbrella
25784,14,person,15,1,4239,18,1249,877,1309,955,60,78,person
25785,15,person,16,1,4239,18,1318,892,1374,955,56,63,person
25786,17,person,18,1,4239,16,1567,888,1597,967,30,79,person
25787,19,person,20,1,4239,22,1735,821,1812,980,77,159,person
25788,20,person,21,1,4239,48,1516,849,1832,1397,316,548,person
25789,21,person,22,1,4239,19,892,847,967,959,75,112,person
25790,23,person,24,1,4239,18,836,871,897,976,61,105,person
25791,24,person,25,1,4239,20,774,862,847,976,73,114,person
25792,25,person,26,1,4239,18,712,860,783,954,71,94,person
25793,30,table,31,1,4239,15,1174,993,1561,1135,387,142,dining table
25794,32,table,33,0,4239,18,1382,1075,2030,1374,648,299,dining table
25795,36,table,37,0,4239,16,524,1030,1182,1191,658,161,dining table
25796,37,bench,38,0,4239,17,411,1114,1043,1228,632,114,bench
25797,41,table,42,0,4239,26,166,1146,1621,1543,1455,397,dining table
25798,42,bench,43,1,4239,16,226,1296,1283,1543,1057,247,bench
25799,50,table,51,1,4239,29,836,983,1232,1051,396,68,dining table
25800,1,person,2,1,22893,15,768,173,800,533,32,360,person
25801,2,person,3,1,22893,30,733,100,800,322,67,222,person
25802,3,person,4,1,22893,45,634,32,740,277,106,245,person
25803,4,person,5,1,22893,19,546,98,580,192,34,94,person
25804,6,person,7,1,22893,32,476,34,576,235,100,201,person
25805,7,person,8,1,22893,20,295,97,363,184,68,87,person
25806,8,person,9,1,22893,22,269,73,329,164,60,91,person
25807,10,person,11,1,22893,42,0,37,111,509,111,472,person
25808,11,person,12,1,22893,97,97,21,316,472,219,451,person
25809,12,person,13,1,22893,58,5,72,327,532,322,460,person
25810,13,person,14,1,22893,72,311,17,453,358,142,341,person
25811,14,person,15,1,22893,55,408,81,574,378,166,297,person
25812,15,person,16,1,22893,51,538,127,798,533,260,406,person
25813,17,table,18,0,22893,25,226,355,610,532,384,177,dining table
25814,20,bottle,21,1,22893,15,344,257,368,378,24,121,bottle
25815,21,bottle,22,1,22893,15,351,264,380,389,29,125,bottle
25816,22,bottle,23,0,22893,17,358,270,398,405,40,135,bottle
25817,25,bottle,26,1,22893,18,405,292,426,403,21,111,bottle
25818,4,person,5,1,4309,24,235,34,276,86,41,52,person
25819,5,person,6,1,4309,23,265,51,308,117,43,66,person
25820,6,person,7,1,4309,25,210,54,245,117,35,63,person
25821,7,person,8,1,4309,39,172,79,284,215,112,136,person
25822,8,person,9,1,4309,29,167,82,229,200,62,118,person
25823,9,person,10,1,4309,46,108,69,193,208,85,139,person
25824,10,person,11,0,4309,62,98,130,197,259,99,129,person
25825,11,person,12,1,4309,65,266,55,381,192,115,137,person
25826,12,person,13,0,4309,66,181,135,304,281,123,146,person
25827,9,person,10,0,4311,82,300,178,443,691,143,513,person
25828,10,person,11,0,4311,77,776,273,947,674,171,401,person
25829,4,person,5,0,4312,25,33,43,54,101,21,58,person
25830,4,person,5,0,4314,74,256,15,310,169,54,154,person
25831,2,person,3,1,4317,20,2,1,68,101,66,100,person
25832,3,person,4,0,4317,69,0,65,170,308,170,243,person
25833,4,person,5,1,4317,62,144,78,211,302,67,224,person
25834,5,person,6,1,4317,56,188,81,267,301,79,220,person
25835,6,person,7,1,4317,41,272,93,345,261,73,168,person
25836,7,person,8,1,4317,42,319,107,397,291,78,184,person
25837,8,person,9,1,4317,46,358,114,478,287,120,173,person
25838,9,person,10,1,4317,47,220,120,353,325,133,205,person
25839,4,person,5,0,4318,20,369,359,418,447,49,88,person
25840,5,person,6,0,4318,18,175,353,228,426,53,73,person
25841,6,person,7,0,4318,17,6,347,64,434,58,87,person
25842,7,person,8,0,4318,23,1126,363,1191,422,65,59,person
25843,13,car,14,1,4320,16,439,192,498,235,59,43,car
25844,14,car,15,0,4320,15,376,184,422,222,46,38,car
25845,2,person,3,1,4324,26,360,128,449,301,89,173,person
25846,4,person,5,1,4324,21,406,92,476,164,70,72,person
25847,5,person,6,1,4324,17,339,137,378,216,39,79,person
25848,6,person,7,1,4324,15,269,162,310,217,41,55,person
25849,7,person,8,1,4324,15,288,145,315,188,27,43,person
25850,8,person,9,1,4324,20,180,187,230,274,50,87,person
25851,10,person,11,1,4324,23,109,229,186,308,77,79,person
25852,11,person,12,1,4324,27,15,255,127,330,112,75,person
25853,12,person,13,1,4324,35,207,168,295,313,88,145,person
25854,13,person,14,1,4324,33,236,157,403,330,167,173,person
25855,6,person,7,0,4329,41,323,126,409,228,86,102,person
25856,0,person,1,0,4481,28,739,501,892,881,153,380,person
25857,1,person,2,0,4481,32,472,456,546,708,74,252,person
25858,2,person,3,0,4481,39,78,474,177,821,99,347,person
25859,3,person,4,0,4481,30,909,471,993,734,84,263,person
25860,4,person,5,0,4481,36,361,458,443,708,82,250,person
25861,5,person,6,1,4481,48,1077,460,1155,718,78,258,person
25862,6,person,7,1,4481,45,1191,442,1324,630,133,188,person
25863,7,person,8,0,4481,58,1305,463,1402,745,97,282,person
25864,10,person,11,0,4481,82,1379,427,1500,758,121,331,person
25865,12,person,13,1,4481,41,619,453,690,598,71,145,person
25866,13,person,14,1,4481,49,664,495,745,602,81,107,person
25867,14,person,15,0,4481,58,1470,436,1526,744,56,308,person
25868,15,person,16,0,4481,41,548,461,600,622,52,161,person
25869,18,person,19,1,4481,21,1491,570,1599,1199,108,629,person
25870,38,chair,39,1,4481,18,978,584,1025,703,47,119,chair
25871,39,chair,40,1,4481,19,1012,569,1057,684,45,115,chair
25872,40,chair,41,1,4481,20,1050,576,1095,707,45,131,chair
25873,41,person,42,0,4481,39,860,460,923,702,63,242,person
25874,42,person,43,1,4481,26,212,470,267,582,55,112,person
25875,43,person,44,1,4481,24,261,467,313,577,52,110,person
25876,53,ball,54,0,4481,17,1414,470,1454,509,40,39,sports ball
25877,54,person,55,1,4481,19,850,446,903,537,53,91,person
25878,55,person,56,1,4481,22,430,461,465,551,35,90,person
25879,56,person,57,1,4481,27,529,442,568,569,39,127,person
25880,57,person,58,1,4481,28,587,473,638,602,51,129,person
25881,58,person,59,1,4481,28,972,461,1027,589,55,128,person
25882,59,person,60,1,4481,37,1389,438,1429,664,40,226,person
25883,60,person,61,1,4481,40,196,459,244,665,48,206,person
25884,61,person,62,1,4481,32,31,464,102,591,71,127,person
25885,62,person,63,1,4481,24,180,456,217,587,37,131,person
25886,63,person,64,1,4481,20,324,524,368,595,44,71,person
25887,64,person,65,1,4481,16,454,466,494,519,40,53,person
25888,65,person,66,1,4481,41,410,511,477,665,67,154,person
25889,66,chair,67,1,4481,18,428,569,480,639,52,70,chair
25890,67,chair,68,1,4481,17,307,551,356,610,49,59,chair
25891,68,person,69,1,4481,22,1302,450,1338,552,36,102,person
25892,69,person,70,1,4481,22,1009,454,1035,583,26,129,person
25893,12,chair,13,1,4482,16,368,117,399,175,31,58,chair
25894,0,person,1,0,4484,48,1406,651,1627,1379,221,728,person
25895,1,person,2,1,4484,51,1697,1119,2200,1650,503,531,person
25896,3,person,3,0,4484,42,1571,572,1741,1205,170,633,person
25897,5,person,5,0,4484,52,1042,712,1242,1137,200,425,person
25898,6,person,6,0,4484,55,573,595,764,974,191,379,person
25899,7,person,7,1,4484,70,985,571,1128,1056,143,485,person
25900,8,person,8,0,4484,61,1182,604,1334,1001,152,397,person
25901,9,person,9,1,4484,45,899,604,1015,978,116,374,person
25902,10,person,10,0,4484,52,698,557,850,970,152,413,person
25903,11,person,11,1,4484,22,1078,599,1167,761,89,162,person
25904,12,person,12,1,4484,47,1318,632,1405,973,87,341,person
25905,13,person,13,1,4484,49,1367,583,1484,1013,117,430,person
25906,14,person,14,1,4484,25,2047,704,2126,812,79,108,person
25907,15,person,15,1,4484,46,499,674,614,932,115,258,person
25908,29,table,29,1,4484,15,4,814,187,978,183,164,dining table
25909,38,glasses,38,0,4484,15,110,1248,183,1302,73,54,eye glasses
25910,40,person,40,1,4484,22,988,1406,1388,1644,400,238,person
25911,44,table,43,0,4484,29,1713,910,1875,1127,162,217,dining table
25912,46,door,45,1,4484,16,1154,536,1288,670,134,134,door
25913,49,person,48,1,4484,21,1144,612,1210,788,66,176,person
25914,50,person,49,1,4484,21,1517,615,1595,792,78,177,person
25915,51,person,50,1,4484,16,1561,614,1597,708,36,94,person
25916,53,person,52,1,4484,34,1727,582,1815,918,88,336,person
25917,54,person,53,1,4484,31,1777,628,1873,909,96,281,person
25918,55,person,54,1,4484,39,1831,620,1931,1055,100,435,person
25919,56,person,55,1,4484,26,1950,620,2058,843,108,223,person
25920,57,person,56,1,4484,22,1948,598,2012,758,64,160,person
25921,58,person,57,1,4484,47,1998,756,2199,1129,201,373,person
25922,60,person,59,1,4484,25,1835,1041,2104,1183,269,142,person
25923,61,person,60,1,4484,15,2125,908,2199,1162,74,254,person
25924,9,ball,10,0,4486,21,140,58,189,108,49,50,sports ball
25925,1,person,2,1,4487,36,58,180,274,423,216,243,person
25926,7,chair,8,1,4487,17,20,254,63,392,43,138,chair
25927,8,chair,9,1,4487,16,7,302,79,425,72,123,chair
25928,10,person,11,1,4487,71,40,154,258,399,218,245,person
25929,12,person,13,1,4487,43,344,209,514,420,170,211,person
25930,13,person,14,1,4487,47,497,212,612,361,115,149,person
25931,15,cup,16,1,4487,15,381,253,404,287,23,34,cup
25932,16,person,17,1,4487,23,542,231,639,424,97,193,person
25933,14,table,15,0,4488,22,2,432,313,632,311,200,dining table
25934,15,table,16,1,4488,16,1,561,141,749,140,188,dining table
25935,26,chair,27,0,4488,25,597,382,722,637,125,255,chair
25936,27,chair,28,0,4488,24,703,426,872,712,169,286,chair
25937,28,chair,29,0,4488,21,860,405,1000,685,140,280,chair
25938,9,balls,10,0,4489,23,161,116,203,136,42,20,sports ball
25939,5,person,6,1,4490,55,0,64,186,418,186,354,person
25940,7,ball,8,1,4491,15,115,180,187,239,72,59,sports ball
25941,8,ball,9,1,4491,19,132,213,214,287,82,74,sports ball
25942,9,ball,10,1,4491,18,191,173,257,237,66,64,sports ball
25943,10,ball,11,1,4491,19,215,202,296,271,81,69,sports ball
25944,11,ball,12,1,4491,18,249,240,342,315,93,75,sports ball
25945,12,ball,13,1,4491,15,151,254,248,313,97,59,sports ball
25946,18,person,19,0,4492,50,75,65,178,355,103,290,person
25947,11,person,12,0,4493,61,51,86,155,453,104,367,person
25948,2,person,3,0,4495,32,246,0,378,428,132,428,person
25949,20,person,21,0,4496,64,13,89,200,246,187,157,person
25950,0,person,1,0,4498,65,352,266,572,652,220,386,person
25951,1,ball,2,0,4498,22,526,476,589,540,63,64,sports ball
25952,0,ball,1,0,4499,29,366,232,457,319,91,87,sports ball
25953,1,person,2,0,4499,45,75,69,452,540,377,471,person
25954,17,chair,18,0,4501,19,119,106,144,136,25,30,chair
25955,18,chair,19,0,4501,19,147,103,170,135,23,32,chair
25956,19,chair,20,0,4501,17,171,100,190,124,19,24,chair
25957,20,table,21,1,4501,15,117,99,179,114,62,15,dining table
25958,21,chair,22,1,4501,16,95,106,118,134,23,28,chair
25959,2,person,3,0,22952,81,17,186,241,545,224,359,person
25960,3,person,4,0,22952,76,224,209,411,523,187,314,person
25961,4,person,5,1,22952,56,297,97,458,428,161,331,person
25962,5,person,6,0,22952,59,430,96,595,514,165,418,person
25963,6,ball,7,0,22952,18,441,272,519,339,78,67,sports ball
25964,7,ball,8,0,22952,17,352,172,411,234,59,62,sports ball
25965,8,person,9,1,22952,51,165,60,302,359,137,299,person
25966,9,ball,10,0,22952,15,182,97,245,157,63,60,sports ball
25967,10,ball,11,0,22952,18,58,416,130,490,72,74,sports ball
25968,11,ball,12,0,22952,26,338,424,398,502,60,78,sports ball
25969,1,ball,2,0,22953,16,739,481,820,562,81,81,sports ball
25970,2,person,3,0,22953,148,16,13,648,645,632,632,person
25971,4,person,5,0,22953,27,202,3,233,133,31,130,person
25972,7,person,8,1,4503,17,436,145,464,216,28,71,person
25973,9,person,10,1,4503,17,470,179,496,224,26,45,person
25974,10,person,11,1,4503,19,479,196,512,253,33,57,person
25975,18,person,19,1,4503,43,337,149,500,299,163,150,person
25976,19,person,20,1,4503,66,258,151,519,402,261,251,person
25977,22,person,23,0,4503,55,150,124,458,476,308,352,person
25978,30,person,31,1,4503,21,276,63,326,157,50,94,person
25979,31,person,32,1,4503,19,209,24,278,155,69,131,person
25980,4,person,5,1,4505,18,0,85,48,304,48,219,person
25981,5,person,6,1,4505,16,0,17,49,145,49,128,person
25982,6,person,7,1,4505,26,500,61,544,187,44,126,person
25983,7,person,8,1,4505,27,433,65,502,183,69,118,person
25984,8,person,9,1,4505,26,406,77,450,153,44,76,person
25985,9,person,10,1,4505,17,403,61,433,111,30,50,person
25986,10,person,11,1,4505,29,342,80,385,171,43,91,person
25987,11,person,12,1,4505,28,308,59,362,139,54,80,person
25988,12,person,13,1,4505,15,236,64,262,97,26,33,person
25989,13,person,14,0,4505,20,268,64,306,113,38,49,person
25990,14,person,15,1,4505,15,196,67,224,94,28,27,person
25991,15,person,16,1,4505,16,43,36,68,94,25,58,person
25992,18,person,19,1,4505,48,318,116,434,237,116,121,person
25993,20,person,21,1,4505,24,282,113,336,202,54,89,person
25994,21,person,22,1,4505,31,303,162,434,283,131,121,person
25995,22,person,23,1,4505,15,210,131,259,174,49,43,person
25996,23,person,24,1,4505,17,181,111,213,163,32,52,person
25997,24,person,25,1,4505,19,135,112,181,170,46,58,person
25998,25,person,26,1,4505,27,49,110,112,181,63,71,person
25999,26,person,27,1,4505,34,242,146,320,285,78,139,person
26000,27,person,28,1,4505,36,88,132,194,290,106,158,person
26001,28,person,29,1,4505,30,153,156,281,287,128,131,person
26002,29,hat,30,0,4505,26,168,157,259,220,91,63,hat
26003,30,hat,31,0,4505,27,333,163,422,220,89,57,hat
26004,31,hat,32,0,4505,19,251,144,317,194,66,50,hat
26005,33,person,34,1,4505,42,404,151,558,281,154,130,person
26006,2,person,3,1,4506,16,186,69,202,99,16,30,person
26007,2,person,3,1,54,87,76,87,223,409,147,322,person
26008,8,person,9,0,54,118,295,23,496,408,201,385,person
26009,4,person,5,0,55,74,248,80,558,400,310,320,person
26010,15,person,16,1,55,71,0,0,417,400,417,400,person
26011,7,person,8,1,4507,31,642,918,964,1449,322,531,person
26012,8,person,9,1,4507,24,214,1088,642,1445,428,357,person
26013,9,person,10,0,4507,35,149,349,372,1009,223,660,person
26014,10,person,11,1,4507,34,383,304,547,989,164,685,person
26015,11,person,12,0,4507,40,451,256,671,1009,220,753,person
26016,18,person,19,1,4507,15,358,845,449,935,91,90,person
26017,20,person,21,1,4507,15,436,840,480,927,44,87,person
26018,22,person,23,1,4507,15,763,853,819,955,56,102,person
26019,4,person,5,1,4511,31,254,872,668,1287,414,415,person
26020,5,person,6,0,4511,64,358,284,783,1313,425,1029,person
26021,6,person,7,0,4511,86,973,35,1614,1440,641,1405,person
26022,7,person,8,1,4511,24,1762,999,2088,1357,326,358,person
26023,8,person,9,1,4511,22,1493,840,1724,1328,231,488,person
26024,9,person,10,1,4511,27,840,863,1109,1277,269,414,person
26025,10,person,11,1,4511,19,18,923,263,1230,245,307,person
26026,11,person,12,1,4511,17,1280,1135,1467,1322,187,187,person
26027,12,person,13,1,4511,27,796,872,955,1227,159,355,person
26028,13,person,14,1,4511,16,701,907,802,1212,101,305,person
26029,14,person,15,1,4511,18,1744,1138,1902,1331,158,193,person
26030,15,person,16,1,4511,16,1792,952,1914,1109,122,157,person
26031,3,person,4,0,4513,39,298,112,328,200,30,88,person
26032,4,person,5,0,4513,30,162,125,193,214,31,89,person
26033,5,person,6,0,4513,32,240,105,292,210,52,105,person
26034,7,person,8,0,4513,30,252,218,297,339,45,121,person
26035,9,person,10,0,4513,27,142,250,202,333,60,83,person
26036,10,chair,11,0,4513,15,136,295,181,346,45,51,chair
26037,11,person,12,0,4513,30,93,219,145,324,52,105,person
26038,12,person,13,0,4513,23,69,210,107,320,38,110,person
26039,13,person,14,0,4513,28,40,206,75,316,35,110,person
26040,14,person,15,0,4513,32,412,221,457,359,45,138,person
26041,15,person,16,0,4513,26,437,203,493,309,56,106,person
26042,17,person,18,0,4513,26,538,200,582,282,44,82,person
26043,5,person,6,1,4514,143,453,64,1156,1438,703,1374,person
26044,6,person,7,0,4514,141,665,53,1581,1443,916,1390,person
26045,5,person,6,1,4516,63,234,325,736,1233,502,908,person
26046,6,person,7,1,4516,76,745,142,1759,1224,1014,1082,person
26047,7,person,8,1,4516,30,805,470,955,1216,150,746,person
26048,7,person,8,0,4821,50,391,1238,573,1487,182,249,person
26049,8,person,9,0,4821,21,1054,142,1111,251,57,109,person
26050,9,person,10,0,4821,22,981,88,1054,213,73,125,person
26051,12,person,13,1,4822,15,23,0,44,20,21,20,person
26052,13,person,13,1,4823,16,418,45,448,84,30,39,person
26053,14,person,14,1,4823,15,407,43,429,83,22,40,person
26054,18,chair,18,0,4823,20,124,175,140,194,16,19,chair
26055,20,chair,20,0,4823,22,358,201,376,225,18,24,chair
26056,3,person,4,0,4824,51,248,229,494,537,246,308,person
26057,4,person,5,0,4824,37,752,322,917,678,165,356,person
26058,5,person,6,0,4824,65,256,652,676,1017,420,365,person
26059,8,person,9,0,4825,32,637,254,703,456,66,202,person
26060,9,person,10,1,4825,18,638,249,663,385,25,136,person
26061,12,person,13,0,4825,38,298,300,372,400,74,100,person
26062,13,person,14,0,4825,24,417,297,456,378,39,81,person
26063,3,person,4,0,4826,35,169,65,210,202,41,137,person
26064,4,person,5,0,4826,42,266,145,347,292,81,147,person
26065,5,person,6,0,4826,47,390,86,448,214,58,128,person
26066,7,person,8,0,4827,26,156,10,169,62,13,52,person
26067,8,person,9,0,4827,28,98,11,127,68,29,57,person
26068,9,person,10,0,4827,25,74,11,93,66,19,55,person
26069,7,person,8,1,4828,18,439,106,470,164,31,58,person
26070,8,person,9,1,4828,18,458,84,497,157,39,73,person
26071,16,person,17,0,4829,25,73,193,94,252,21,59,person
26072,18,person,19,0,4829,17,201,202,236,272,35,70,person
26073,1,person,2,1,4830,36,732,1,1023,767,291,766,person
26074,6,person,7,0,4830,79,500,196,658,646,158,450,person
26075,7,person,8,1,4830,26,56,258,165,450,109,192,person
26076,10,person,11,1,4830,21,0,493,107,698,107,205,person
26077,11,person,12,1,4830,35,0,284,226,765,226,481,person
26078,12,person,13,1,4830,18,201,609,404,767,203,158,person
26079,13,person,14,1,4830,27,112,0,228,246,116,246,person
26080,14,person,15,1,4830,32,390,53,532,312,142,259,person
26081,15,person,16,1,4830,23,186,155,344,275,158,120,person
26082,16,person,17,1,4830,21,29,122,119,239,90,117,person
26083,3,person,4,0,59,83,361,235,831,429,470,194,person
26084,10,person,11,0,60,31,956,407,1047,570,91,163,person
26085,12,person,13,1,60,16,564,281,627,340,63,59,person
26086,13,person,14,1,60,15,648,274,721,331,73,57,person
26087,14,person,15,1,60,16,721,268,772,327,51,59,person
26088,16,person,17,1,60,17,859,263,914,320,55,57,person
26089,17,person,18,1,60,15,909,260,960,321,51,61,person
26090,18,person,19,0,60,15,959,262,1009,316,50,54,person
26091,19,person,20,1,60,18,1062,258,1121,350,59,92,person
26092,21,person,22,1,60,15,1227,257,1287,308,60,51,person
26093,23,person,24,1,60,15,1418,237,1475,302,57,65,person
26094,24,person,25,1,60,16,1482,251,1542,302,60,51,person
26095,1,person,2,1,61,21,450,291,560,363,110,72,person
26096,2,person,3,1,61,16,334,282,407,362,73,80,person
26097,4,person,5,1,61,31,0,245,107,363,107,118,person
26098,6,person,7,1,61,76,232,31,388,334,156,303,person
26099,7,person,8,1,61,51,307,118,470,363,163,245,person
26100,4,person,5,1,62,55,90,5,162,138,72,133,person
26101,11,person,12,0,62,87,162,86,260,276,98,190,person
26102,12,person,13,0,62,83,85,112,221,295,136,183,person
26103,23,person,24,0,62,59,306,140,390,269,84,129,person
26104,24,person,25,1,62,64,420,118,494,295,74,177,person
26105,25,person,26,1,62,49,408,155,500,314,92,159,person
26106,3,person,4,0,63,70,82,285,534,1211,452,926,person
26107,4,person,5,0,64,96,465,141,573,444,108,303,person
26108,3,person,4,0,65,70,373,81,566,429,193,348,person
26109,1,person,2,0,557,127,152,20,278,204,126,184,person
26110,6,horse,7,0,4831,15,607,337,635,362,28,25,horse
26111,9,person,10,0,4831,16,517,400,530,432,13,32,person
26112,14,person,15,1,4831,16,517,475,546,524,29,49,person
26113,15,person,16,1,4831,20,481,482,517,536,36,54,person
26114,16,person,17,1,4831,21,431,475,462,528,31,53,person
26115,17,person,18,1,4831,18,330,480,365,537,35,57,person
26116,19,person,20,1,4831,15,574,465,599,517,25,52,person
26117,20,person,21,1,4831,15,599,468,623,507,24,39,person
26118,2,person,3,0,4832,18,107,85,113,108,6,23,person
26119,1,person,2,0,4833,37,124,155,185,263,61,108,person
26120,2,person,3,1,4834,16,848,390,897,488,49,98,person
26121,3,person,4,0,4834,22,912,399,962,604,50,205,person
26122,8,person,9,0,4834,19,1098,248,1152,444,54,196,person
26123,11,person,12,0,4834,24,933,124,986,268,53,144,person
26124,12,person,13,1,4834,17,811,81,856,175,45,94,person
26125,14,person,15,1,4834,17,647,44,699,104,52,60,person
26126,15,person,16,1,4834,17,1106,576,1174,647,68,71,person
26127,17,person,18,1,4834,20,1063,632,1118,735,55,103,person
26128,18,person,19,1,4834,31,969,616,1098,723,129,107,person
26129,19,person,20,1,4834,19,1114,650,1185,782,71,132,person
26130,20,person,21,1,4834,18,1076,684,1144,800,68,116,person
26131,21,person,22,1,4834,21,1027,709,1114,850,87,141,person
26132,22,person,23,1,4834,18,969,13,1023,78,54,65,person
26133,6,person,7,1,4835,18,89,80,103,104,14,24,person
26134,7,person,8,1,4835,17,72,94,88,115,16,21,person
26135,10,person,11,1,4835,18,237,87,258,111,21,24,person
26136,11,person,12,1,4835,20,257,87,274,110,17,23,person
26137,12,person,13,1,4835,19,279,66,297,96,18,30,person
26138,13,person,14,1,4835,20,313,63,328,89,15,26,person
26139,0,person,1,0,4836,77,243,52,267,143,24,91,person
26140,5,person,6,1,4836,18,80,8,108,35,28,27,person
26141,6,person,7,1,4836,21,107,8,131,35,24,27,person
26142,8,person,9,1,4836,17,246,14,270,36,24,22,person
26143,11,person,12,1,4836,19,290,11,315,37,25,26,person
26144,15,person,16,0,4836,47,94,85,131,191,37,106,person
26145,18,person,19,0,4836,45,56,39,85,119,29,80,person
26146,19,person,20,1,4836,35,199,44,234,112,35,68,person
26147,3,person,4,0,4839,88,329,46,495,285,166,239,person
26148,2,person,3,1,22983,31,542,21,618,230,76,209,person
26149,4,person,5,1,22983,24,260,538,378,612,118,74,person
26150,2,person,3,0,22984,89,580,21,847,678,267,657,person
26151,9,chair,10,0,4927,21,116,154,163,230,47,76,chair
26152,10,chair,11,0,4927,24,164,152,208,230,44,78,chair
26153,25,person,26,0,72,64,68,178,172,350,104,172,person
26154,33,person,34,0,72,50,222,164,301,339,79,175,person
26155,47,person,48,0,72,56,462,71,567,413,105,342,person
26156,8,person,9,0,4967,46,139,124,198,222,59,98,person
26157,0,person,1,0,4968,57,160,382,1279,1341,1119,959,person
26158,1,person,2,1,4968,18,717,470,1058,843,341,373,person
26159,3,person,4,0,4968,58,1593,201,2097,1023,504,822,person
26160,4,chair,5,1,4968,36,1807,423,2200,1439,393,1016,chair
26161,7,chair,8,0,4968,50,215,618,1028,1528,813,910,chair
26162,12,person,13,1,4968,46,1432,266,1834,945,402,679,person
26163,3,car,3,0,4969,31,224,407,635,561,411,154,car
26164,11,table,11,0,4969,20,854,484,1204,623,350,139,dining table
26165,13,bicycle,13,1,4969,30,458,341,571,406,113,65,bicycle
26166,38,chair,38,0,4969,34,633,474,730,600,97,126,chair
26167,2,chair,3,0,4971,18,157,119,180,154,23,35,chair
26168,3,chair,4,0,4971,21,176,137,221,204,45,67,chair
26169,3,person,4,0,4974,42,1193,177,1400,692,207,515,person
26170,4,bicycle,5,1,4974,36,869,525,1225,656,356,131,bicycle
26171,4,person,5,0,4980,33,154,250,242,404,88,154,person
26172,0,chair,1,0,4982,16,459,229,548,331,89,102,chair
26173,3,table,4,0,4982,18,41,205,234,359,193,154,dining table
26174,4,table,5,0,23000,32,797,436,1023,639,226,203,dining table
26175,5,bench,6,0,23000,30,715,505,864,635,149,130,bench
26176,6,person,7,0,23000,62,368,305,463,584,95,279,person
26177,13,bench,14,0,23001,15,0,315,143,350,143,35,bench
26178,16,bench,17,0,23001,15,298,324,439,368,141,44,bench
26179,1,person,2,0,23002,56,398,510,522,1010,124,500,person
26180,8,car,9,0,23003,39,215,556,421,634,206,78,car
26181,17,table,18,0,23003,21,759,590,853,638,94,48,dining table
26182,2,car,3,1,23004,17,1219,631,1286,704,67,73,car
26183,7,person,8,0,23004,16,913,609,951,669,38,60,person
26184,14,dog,15,0,23006,29,215,526,360,617,145,91,dog
26185,16,bench,17,0,23006,23,160,377,219,436,59,59,bench
26186,18,person,19,1,23006,35,117,276,156,411,39,135,person
26187,21,chair,22,0,23006,60,821,388,928,490,107,102,chair
26188,12,person,13,1,23007,34,539,374,630,560,91,186,person
26189,13,table,14,0,23007,19,242,429,405,504,163,75,dining table
26190,14,bench,15,0,23007,24,303,456,433,520,130,64,bench
26191,7,table,8,1,5093,17,31,102,116,143,85,41,dining table
26192,8,table,9,1,5093,20,105,114,207,182,102,68,dining table
26193,9,person,10,1,5093,32,158,76,196,121,38,45,person
26194,10,person,11,1,5093,25,102,71,140,120,38,49,person
26195,11,person,12,1,5093,21,30,72,58,109,28,37,person
26196,12,chair,13,0,5093,29,203,122,253,191,50,69,chair
26197,13,person,14,0,5093,53,162,75,255,181,93,106,person
26198,15,sofa,16,1,5093,22,0,136,225,229,225,93,couch
26199,25,chair,26,1,5094,15,140,230,232,298,92,68,chair
26200,27,chair,28,1,5094,17,287,172,368,264,81,92,chair
26201,5,chair,6,0,5095,18,168,207,271,299,103,92,chair
26202,6,person,7,1,5095,38,187,147,289,276,102,129,person
26203,12,person,13,1,5095,26,256,120,307,196,51,76,person
26204,13,person,14,1,5095,26,288,198,399,297,111,99,person
26205,16,person,17,1,5095,23,161,110,205,180,44,70,person
26206,18,person,19,1,5095,15,226,120,259,155,33,35,person
26207,19,person,20,1,5095,21,182,90,219,141,37,51,person
26208,20,person,21,1,5095,20,61,144,119,198,58,54,person
26209,21,chair,22,0,5095,16,68,189,138,271,70,82,chair
26210,23,person,24,1,5095,22,2,144,58,231,56,87,person
26211,24,person,25,1,5095,17,36,126,68,172,32,46,person
26212,25,person,26,1,5095,17,92,125,132,172,40,47,person
26213,26,chair,27,1,5095,15,115,153,148,219,33,66,chair
26214,27,person,28,1,5095,24,346,138,398,210,52,72,person
26215,28,person,29,1,5095,15,120,111,140,139,20,28,person
26216,19,chair,20,0,5096,26,190,149,236,233,46,84,chair
26217,21,chair,22,1,5096,18,235,107,260,152,25,45,chair
26218,32,chair,32,1,5096,24,0,150,57,249,57,99,chair
26219,37,bench,37,1,5096,52,282,107,350,164,68,57,bench
26220,6,sofa,7,0,5097,18,255,105,355,136,100,31,couch
26221,10,chair,11,0,5097,18,230,116,266,164,36,48,chair
26222,11,table,12,0,5097,31,96,165,219,272,123,107,dining table
26223,12,chair,13,0,5097,23,63,163,143,269,80,106,chair
26224,13,chair,14,1,5097,15,191,142,230,223,39,81,chair
26225,14,chair,15,0,5097,25,171,185,270,299,99,114,chair
26226,20,chair,21,0,5097,21,295,160,368,273,73,113,chair
26227,8,person,9,1,5098,30,152,90,243,246,91,156,person
26228,9,person,10,1,5098,34,294,70,378,220,84,150,person
26229,10,person,11,1,5098,33,372,60,471,294,99,234,person
26230,11,person,12,1,5098,47,478,65,587,421,109,356,person
26231,12,person,13,1,5098,29,105,141,209,273,104,132,person
26232,13,person,14,1,5098,28,199,172,317,293,118,121,person
26233,14,person,15,1,5098,27,338,157,436,344,98,187,person
26234,15,person,16,1,5098,48,229,198,450,478,221,280,person
26235,16,person,17,1,5098,15,2,168,34,304,32,136,person
26236,17,person,18,1,5098,21,4,347,70,476,66,129,person
26237,18,person,19,1,5098,34,63,273,313,476,250,203,person
26238,27,chair,28,1,5098,24,335,340,530,477,195,137,chair
26239,29,chair,30,1,5098,15,435,270,512,381,77,111,chair
26240,30,chair,31,1,5098,15,589,200,639,320,50,120,chair
26241,5,window,6,1,5099,16,175,21,266,152,91,131,window
26242,7,person,8,1,5099,28,209,95,292,160,83,65,person
26243,9,person,10,1,5099,26,156,123,220,213,64,90,person
26244,11,person,12,1,5099,16,234,117,299,165,65,48,person
26245,13,chair,14,1,5099,15,201,162,300,201,99,39,chair
26246,16,window,17,1,5099,22,424,20,556,205,132,185,window
26247,18,chair,19,1,5099,18,434,125,478,233,44,108,chair
26248,19,person,20,1,5099,20,478,96,530,155,52,59,person
26249,20,chair,21,1,5099,24,468,138,528,267,60,129,chair
26250,22,chair,23,1,5099,43,508,156,631,340,123,184,chair
26251,23,person,24,1,5099,38,547,124,638,330,91,206,person
26252,25,person,26,1,5099,24,289,118,363,233,74,115,person
26253,26,chair,27,1,5099,27,328,158,454,312,126,154,chair
26254,27,chair,28,1,5099,25,149,197,267,296,118,99,chair
26255,28,person,29,1,5099,39,197,180,363,324,166,144,person
26256,29,person,30,1,5099,30,93,135,172,302,79,167,person
26257,30,person,31,1,5099,29,6,153,145,336,139,183,person
26258,31,person,32,1,5099,50,208,209,461,478,253,269,person
26259,33,person,34,1,5099,30,23,363,183,478,160,115,person
26260,15,chair,16,1,5100,29,240,128,282,185,42,57,chair
26261,17,chair,18,1,5100,23,135,132,190,197,55,65,chair
26262,18,chair,19,0,5100,40,191,144,250,209,59,65,chair
26263,19,chair,20,1,5100,43,89,149,163,241,74,92,chair
26264,20,chair,21,1,5100,26,3,183,95,248,92,65,chair
26265,14,sofa,15,0,5101,23,19,105,108,156,89,51,couch
26266,19,sofa,20,1,5101,16,227,137,316,172,89,35,couch
26267,20,sofa,21,1,5101,16,240,139,320,207,80,68,couch
26268,22,chair,23,0,5101,16,162,111,185,132,23,21,chair
26269,23,chair,24,0,5101,29,161,125,194,167,33,42,chair
26270,24,chair,25,1,5101,17,140,115,162,134,22,19,chair
26271,27,chair,28,1,5101,19,75,128,112,152,37,24,chair
26272,28,chair,29,1,5101,28,110,136,146,181,36,45,chair
26273,30,chair,31,1,5101,20,127,177,206,239,79,62,chair
26274,12,chair,13,1,5102,18,193,80,234,129,41,49,chair
26275,15,chair,16,0,5102,16,112,73,144,117,32,44,chair
26276,4,person,5,0,5144,21,694,781,799,941,105,160,person
26277,5,person,6,1,5144,15,628,993,691,1110,63,117,person
26278,6,person,7,1,5144,26,271,1053,355,1383,84,330,person
26279,7,person,8,1,5144,38,304,1062,431,1440,127,378,person
26280,9,person,10,0,5144,43,20,1068,197,1492,177,424,person
26281,12,person,13,1,5144,26,401,1057,479,1378,78,321,person
26282,13,person,14,0,5144,34,467,1033,584,1357,117,324,person
26283,14,person,15,0,5144,25,589,1083,687,1361,98,278,person
26284,17,person,18,1,5144,21,685,1042,755,1249,70,207,person
26285,18,person,19,0,5144,28,718,1075,823,1365,105,290,person
26286,19,person,20,1,5144,16,825,1055,871,1208,46,153,person
26287,20,person,21,1,5144,25,838,1049,919,1385,81,336,person
26288,21,person,22,0,5144,29,908,1073,998,1392,90,319,person
26289,22,person,23,0,5144,31,998,1026,1099,1376,101,350,person
26290,23,person,24,0,5144,27,1099,1064,1175,1356,76,292,person
26291,24,person,25,0,5144,25,1230,1061,1341,1402,111,341,person
26292,25,person,26,1,5144,24,1190,1095,1267,1389,77,294,person
26293,27,person,28,0,5144,33,1341,1007,1466,1501,125,494,person
26294,29,person,30,1,5144,19,1166,1084,1223,1324,57,240,person
26295,3,person,3,0,5146,19,58,321,108,467,50,146,person
26296,0,person,1,0,5147,16,135,49,196,240,61,191,person
26297,4,horse,5,0,5147,27,4,73,95,217,91,144,horse
26298,5,person,6,0,5148,37,77,176,164,337,87,161,person
26299,10,person,11,1,5151,21,0,331,101,487,101,156,person
26300,0,bench,1,0,5153,19,22,320,174,387,152,67,bench
26301,10,person,11,1,5153,15,131,282,169,348,38,66,person
26302,12,person,13,1,5153,21,585,288,628,371,43,83,person
26303,5,person,6,1,5154,32,425,366,1215,1640,790,1274,person
26304,6,person,7,1,5154,45,515,794,1286,1640,771,846,person
26305,5,chair,6,0,5156,22,0,193,57,261,57,68,chair
26306,7,person,8,1,5156,29,2,159,57,258,55,99,person
26307,8,person,9,1,5156,34,125,165,157,260,32,95,person
26308,9,person,10,1,5156,30,150,126,197,261,47,135,person
26309,10,person,11,1,5156,23,191,163,217,260,26,97,person
26310,11,person,12,1,5156,47,261,77,348,261,87,184,person
26311,13,person,14,1,5156,19,239,119,251,154,12,35,person
26312,1,person,2,0,5157,115,241,50,333,231,92,181,person
26313,7,window,8,0,5158,15,54,82,121,134,67,52,window
26314,2,person,3,1,5159,15,0,90,18,121,18,31,person
26315,3,person,4,0,5159,59,240,88,307,241,67,153,person
26316,4,person,5,1,5159,21,293,87,311,141,18,54,person
26317,5,person,6,0,5159,26,308,97,325,150,17,53,person
26318,8,chair,9,0,5159,25,68,141,110,211,42,70,chair
26319,9,chair,10,0,5159,24,141,159,181,237,40,78,chair
26320,10,chair,11,1,5159,16,229,167,252,210,23,43,chair
26321,13,chair,13,1,5159,17,0,160,29,244,29,84,chair
26322,14,chair,14,1,5159,28,0,199,65,300,65,101,chair
26323,17,chair,17,1,5159,18,284,202,325,267,41,65,chair
26324,9,person,10,1,5160,37,345,194,465,327,120,133,person
26325,10,person,11,1,5160,31,213,170,300,327,87,157,person
26326,11,person,12,1,5160,43,14,214,124,328,110,114,person
26327,8,person,9,1,5162,47,6,76,114,214,108,138,person
26328,11,person,12,1,5162,24,157,107,184,176,27,69,person
26329,12,person,13,1,5162,29,199,107,241,164,42,57,person
26330,13,person,14,1,5162,24,237,108,256,153,19,45,person
26331,14,person,15,1,5162,22,256,115,291,154,35,39,person
26332,15,person,16,1,5162,28,290,103,322,146,32,43,person
26333,10,person,11,0,5164,19,356,138,368,192,12,54,person
26334,16,chair,17,1,5165,19,230,187,267,264,37,77,chair
26335,19,person,20,1,5165,15,76,142,93,176,17,34,person
26336,20,person,21,1,5165,17,59,143,77,177,18,34,person
26337,2,chair,3,1,5166,18,117,498,326,640,209,142,chair
26338,4,person,5,1,5166,49,64,296,275,622,211,326,person
26339,5,chair,6,1,5166,30,41,427,238,640,197,213,chair
26340,1,person,2,1,5167,30,222,67,289,160,67,93,person
26341,2,person,3,1,5167,66,133,76,224,249,91,173,person
26342,3,person,4,1,5167,51,270,87,328,281,58,194,person
26343,4,person,5,1,5167,38,212,120,299,250,87,130,person
26344,5,person,6,1,5167,24,91,114,135,174,44,60,person
26345,6,person,7,1,5167,36,290,120,399,283,109,163,person
26346,7,person,8,1,5167,15,363,60,399,163,36,103,person
26347,8,person,9,1,5167,24,325,267,399,300,74,33,person
26348,9,person,10,1,5167,24,88,129,135,231,47,102,person
26349,10,person,11,1,5167,26,2,112,139,300,137,188,person
26350,12,car,11,0,5168,26,26,99,107,162,81,63,car
26351,17,person,16,1,5168,16,2,181,22,204,20,23,person
26352,21,person,20,0,5168,18,94,164,119,224,25,60,person
26353,22,chair,21,0,5168,15,117,185,145,224,28,39,chair
26354,32,person,31,1,5168,18,533,216,549,242,16,26,person
26355,34,person,33,0,5168,29,477,177,501,242,24,65,person
26356,35,person,34,1,5168,27,469,159,491,220,22,61,person
26357,48,person,47,0,5168,18,476,130,495,166,19,36,person
26358,60,person,59,1,5168,20,431,133,447,168,16,35,person
26359,64,person,63,1,5168,21,448,115,470,143,22,28,person
26360,72,person,71,1,5168,18,309,114,325,145,16,31,person
26361,73,person,72,1,5168,23,315,110,336,136,21,26,person
26362,89,person,88,1,5168,22,380,95,392,122,12,27,person
26363,0,person,1,0,5169,50,76,86,256,300,180,214,person
26364,2,chair,3,0,5170,26,45,184,86,247,41,63,chair
26365,4,chair,5,0,5170,20,83,207,135,301,52,94,chair
26366,5,chair,6,0,5170,24,317,216,367,301,50,85,chair
26367,7,person,8,1,5170,21,66,150,93,204,27,54,person
26368,1,person,1,0,5171,17,323,85,353,179,30,94,person
26369,2,person,2,1,5171,15,364,80,400,239,36,159,person
26370,2,chair,3,0,5172,19,135,47,207,137,72,90,chair
26371,3,chair,4,0,5172,15,211,45,273,140,62,95,chair
26372,7,person,8,1,5172,48,246,1,387,134,141,133,person
26373,8,person,9,1,5172,84,123,13,391,299,268,286,person
26374,9,chair,10,1,5172,24,287,139,393,299,106,160,chair
26375,10,person,11,1,5172,19,144,0,191,40,47,40,person
26376,11,person,12,1,5172,49,134,0,252,137,118,137,person
26377,1,chair,2,0,5173,22,43,152,75,210,32,58,chair
26378,3,chair,4,0,5173,19,139,146,162,187,23,41,chair
26379,4,chair,5,0,5173,30,195,155,233,224,38,69,chair
26380,9,chair,10,0,5173,35,239,160,275,227,36,67,chair
26381,10,chair,11,0,5173,28,277,155,320,229,43,74,chair
26382,11,chair,12,0,5173,30,330,160,374,232,44,72,chair
26383,16,chair,17,1,5173,19,115,151,132,199,17,48,chair
26384,3,person,4,1,5174,19,360,58,399,163,39,105,person
26385,4,person,5,1,5174,34,336,149,399,190,63,41,person
26386,5,person,6,1,5174,21,239,93,264,136,25,43,person
26387,6,person,7,1,5174,37,252,90,307,187,55,97,person
26388,7,person,8,1,5174,32,287,62,347,188,60,126,person
26389,8,person,9,1,5174,46,146,64,237,181,91,117,person
26390,9,person,10,1,5174,23,108,76,169,163,61,87,person
26391,10,person,11,1,5174,29,80,73,126,163,46,90,person
26392,11,person,12,1,5174,36,56,72,102,165,46,93,person
26393,12,person,13,1,5174,17,43,97,56,138,13,41,person
26394,13,person,14,1,5174,49,0,38,91,300,91,262,person
26395,3,chair,4,1,5175,16,70,143,105,175,35,32,chair
26396,5,person,6,0,5175,22,139,105,154,164,15,59,person
26397,6,person,7,0,5175,17,193,111,203,145,10,34,person
26398,7,person,8,0,5175,19,180,111,188,144,8,33,person
26399,14,chair,15,1,5175,24,342,142,379,199,37,57,chair
26400,15,chair,16,0,5175,27,303,143,336,200,33,57,chair
26401,19,chair,20,1,5175,18,250,134,273,168,23,34,chair
26402,4,chair,5,0,5176,24,120,193,182,298,62,105,chair
26403,5,person,6,0,5176,32,102,164,159,265,57,101,person
26404,6,person,7,1,5176,15,180,239,286,299,106,60,person
26405,7,person,8,1,5176,32,17,178,104,299,87,121,person
26406,8,person,9,1,5176,20,82,158,116,214,34,56,person
26407,9,person,10,1,5176,19,20,160,57,211,37,51,person
26408,14,person,15,1,5176,21,349,110,388,167,39,57,person
26409,15,person,16,1,5176,21,208,132,237,170,29,38,person
26410,16,person,17,1,5176,20,236,139,269,181,33,42,person
26411,17,person,18,1,5176,15,236,135,258,167,22,32,person
26412,18,person,19,1,5176,17,156,136,182,172,26,36,person
26413,19,person,20,1,5176,28,164,138,216,238,52,100,person
26414,20,person,21,1,5176,19,57,145,83,185,26,40,person
26415,21,person,22,1,5176,17,37,140,59,167,22,27,person
26416,24,chair,25,1,5176,17,215,178,246,237,31,59,chair
26417,27,person,28,1,5176,20,313,165,355,195,42,30,person
26418,28,person,29,1,5176,15,304,175,326,230,22,55,person
26419,29,person,30,1,5176,37,237,137,350,275,113,138,person
26420,30,person,31,1,5176,32,325,165,393,248,68,83,person
26421,31,chair,32,1,5176,16,334,224,388,300,54,76,chair
26422,35,person,36,1,5176,15,100,132,134,178,34,46,person
26423,5,person,6,1,5178,82,159,25,496,420,337,395,person
26424,7,chair,8,0,5178,43,164,76,271,250,107,174,chair
26425,8,chair,9,0,5178,28,407,83,513,252,106,169,chair
26426,10,chair,11,1,5178,15,255,94,304,173,49,79,chair
26427,11,chair,12,1,5178,30,496,68,575,247,79,179,chair
26428,12,person,13,1,5178,50,447,1,640,249,193,248,person
26429,13,person,14,1,5178,30,260,0,449,160,189,160,person
26430,17,chair,18,1,5178,20,226,56,263,152,37,96,chair
26431,9,person,10,0,5179,19,162,150,175,182,13,32,person
26432,10,person,11,0,5179,35,175,144,200,207,25,63,person
26433,12,person,13,0,5179,25,238,151,260,222,22,71,person
26434,15,person,16,1,5179,37,287,174,355,242,68,68,person
26435,0,person,1,1,5181,35,330,141,390,268,60,127,person
26436,2,person,3,0,5182,66,90,155,223,290,133,135,person
26437,3,person,4,0,5182,42,208,161,280,282,72,121,person
26438,4,person,5,1,5182,52,123,42,175,240,52,198,person
26439,5,person,6,1,5182,33,158,74,207,192,49,118,person
26440,6,person,7,1,5182,41,200,68,244,194,44,126,person
26441,7,person,8,1,5182,54,240,58,300,259,60,201,person
26442,1,person,2,1,5183,15,92,136,110,150,18,14,person
26443,3,person,4,1,5183,29,111,126,149,251,38,125,person
26444,4,person,5,1,5183,29,77,150,123,297,46,147,person
26445,9,person,10,1,5183,25,334,49,372,91,38,42,person
26446,10,person,11,1,5183,18,348,151,374,185,26,34,person
26447,15,person,16,1,5183,41,299,128,357,300,58,172,person
26448,16,person,17,1,5183,28,2,105,94,300,92,195,person
26449,21,chair,22,0,5183,25,222,190,274,266,52,76,chair
26450,22,chair,23,0,5183,25,186,185,225,257,39,72,chair
26451,23,chair,24,0,5183,21,153,179,189,244,36,65,chair
26452,24,person,25,1,5183,29,185,148,235,207,50,59,person
26453,2,chair,3,1,5184,20,347,166,374,221,27,55,chair
26454,4,chair,5,0,5184,25,257,169,286,220,29,51,chair
26455,5,person,6,1,5184,28,271,141,291,208,20,67,person
26456,9,chair,10,0,5184,24,196,160,217,195,21,35,chair
26457,11,chair,12,0,5184,22,170,153,189,181,19,28,chair
26458,13,chair,14,0,5184,24,2,171,34,230,32,59,chair
26459,14,chair,15,0,5184,25,39,170,70,227,31,57,chair
26460,15,chair,16,0,5184,28,83,171,115,226,32,55,chair
26461,16,person,17,1,5184,28,83,142,117,211,34,69,person
26462,0,person,1,1,5185,31,179,150,225,225,46,75,person
26463,1,person,2,1,5185,39,296,61,400,299,104,238,person
26464,2,person,3,1,5185,40,200,104,296,299,96,195,person
26465,3,person,4,1,5185,31,34,169,133,293,99,124,person
26466,4,person,5,0,5186,18,228,199,247,233,19,34,person
26467,8,person,9,0,5186,24,95,182,116,239,21,57,person
26468,9,person,10,0,5186,21,115,183,134,223,19,40,person
26469,11,person,12,0,5186,15,34,176,49,209,15,33,person
26470,3,person,4,0,5187,41,124,89,187,283,63,194,person
26471,4,person,5,0,5187,34,229,14,267,190,38,176,person
26472,5,person,6,1,5187,38,234,55,286,218,52,163,person
26473,6,person,7,1,5187,37,362,40,446,190,84,150,person
26474,7,person,8,0,5187,28,217,189,294,287,77,98,person
26475,8,table,9,0,5187,24,85,4,194,113,109,109,dining table
26476,0,person,1,1,5188,51,20,11,74,244,54,233,person
26477,1,person,2,1,5188,62,38,36,199,300,161,264,person
26478,2,chair,3,1,5188,16,134,215,167,264,33,49,chair
26479,7,chair,8,1,5188,15,2,108,21,161,19,53,chair
26480,3,person,4,0,5189,48,108,86,162,224,54,138,person
26481,4,person,5,0,5189,36,255,72,292,173,37,101,person
26482,5,person,6,1,5189,22,183,100,200,160,17,60,person
26483,6,person,7,0,5189,26,197,103,217,174,20,71,person
26484,7,person,8,0,5189,49,208,112,254,231,46,119,person
26485,8,person,9,1,5189,20,2,43,63,91,61,48,person
26486,10,person,11,1,5189,33,1,105,47,226,46,121,person
26487,11,person,12,1,5189,32,7,97,51,217,44,120,person
26488,12,person,13,1,5189,21,47,109,70,174,23,65,person
26489,13,person,14,0,5189,30,74,96,119,198,45,102,person
26490,17,person,18,1,5189,33,360,86,399,300,39,214,person
26491,18,person,19,1,5189,19,369,101,386,162,17,61,person
26492,1,person,2,0,5190,29,209,119,246,239,37,120,person
26493,2,person,3,1,5190,24,123,123,152,181,29,58,person
26494,6,person,7,1,5190,15,184,140,207,161,23,21,person
26495,10,person,11,1,5190,20,82,123,111,154,29,31,person
26496,6,person,7,0,5191,48,181,100,222,215,41,115,person
26497,5,person,6,0,5192,32,83,361,147,491,64,130,person
26498,7,person,8,1,5192,29,169,357,242,455,73,98,person
26499,9,person,10,0,5192,34,307,364,408,500,101,136,person
26500,10,person,11,0,5192,30,2,310,51,490,49,180,person
26501,12,person,13,1,5192,17,124,347,149,387,25,40,person
26502,1,person,2,1,5193,15,0,0,43,84,43,84,person
26503,2,person,3,1,5193,33,15,0,111,72,96,72,person
26504,3,person,4,1,5193,40,75,0,213,65,138,65,person
26505,4,person,5,1,5193,28,192,0,304,33,112,33,person
26506,5,person,6,1,5193,26,301,0,399,54,98,54,person
26507,6,person,7,1,5193,58,175,28,399,300,224,272,person
26508,22,person,23,0,5194,27,278,211,313,297,35,86,person
26509,64,person,65,1,5194,15,113,252,141,286,28,34,person
26510,0,person,1,1,5195,15,106,119,127,151,21,32,person
26511,1,person,2,0,5195,55,0,110,44,279,44,169,person
26512,2,person,3,0,5195,32,150,149,196,228,46,79,person
26513,3,table,4,0,5195,25,150,179,246,247,96,68,dining table
26514,4,person,5,0,5195,33,108,148,150,226,42,78,person
26515,5,table,6,0,5195,41,73,174,152,233,79,59,dining table
26516,6,person,7,0,5195,17,50,143,78,173,28,30,person
26517,7,person,8,1,5195,19,204,135,239,162,35,27,person
26518,8,table,9,0,5195,42,257,173,351,246,94,73,dining table
26519,9,chair,10,0,5195,15,230,167,266,224,36,57,chair
26520,10,person,11,1,5195,24,235,137,272,195,37,58,person
26521,11,person,12,1,5195,31,271,136,318,224,47,88,person
26522,12,chair,13,0,5195,16,256,170,289,239,33,69,chair
26523,13,person,14,0,5195,28,360,128,399,211,39,83,person
26524,21,chair,22,0,5195,16,170,170,208,231,38,61,chair
26525,4,table,5,0,5196,18,0,179,54,226,54,47,dining table
26526,5,person,5,0,5197,20,5,373,25,432,20,59,person
26527,6,person,6,0,5197,18,32,368,54,419,22,51,person
26528,2,person,3,1,5198,16,2,217,98,300,96,83,person
26529,3,person,4,1,5198,23,145,213,284,300,139,87,person
26530,4,person,5,1,5198,47,294,154,397,300,103,146,person
26531,6,person,7,1,5198,26,342,121,399,205,57,84,person
26532,7,person,8,1,5198,31,250,97,311,267,61,170,person
26533,9,person,10,1,5198,19,296,133,322,214,26,81,person
26534,11,person,12,1,5198,15,201,123,229,162,28,39,person
26535,13,person,14,1,5198,31,197,142,255,220,58,78,person
26536,15,chair,16,1,5198,16,186,119,216,161,30,42,chair
26537,16,person,17,1,5198,21,162,106,193,156,31,50,person
26538,17,person,18,1,5198,25,150,126,190,161,40,35,person
26539,19,person,20,1,5198,19,121,121,153,168,32,47,person
26540,20,person,21,1,5198,30,74,139,135,239,61,100,person
26541,21,person,22,1,5198,27,134,145,199,242,65,97,person
26542,22,chair,23,1,5198,15,136,195,188,277,52,82,chair
26543,26,chair,27,1,5198,20,54,165,107,269,53,104,chair
26544,27,person,28,1,5198,19,11,112,48,151,37,39,person
26545,28,person,29,1,5198,17,87,114,123,155,36,41,person
26546,29,chair,30,0,5198,21,18,157,54,228,36,71,chair
26547,6,chair,7,1,5199,22,155,190,186,274,31,84,chair
26548,7,chair,8,1,5199,22,119,197,159,296,40,99,chair
26549,8,chair,9,1,5199,23,85,197,122,299,37,102,chair
26550,9,chair,10,1,5199,18,41,203,89,299,48,96,chair
26551,12,chair,13,0,5199,23,256,178,291,248,35,70,chair
26552,14,chair,15,1,5199,17,298,175,322,238,24,63,chair
26553,15,person,16,0,5199,35,362,122,399,253,37,131,person
26554,22,person,23,1,5199,21,270,128,309,166,39,38,person
26555,23,person,24,1,5199,19,55,124,82,160,27,36,person
26556,24,person,25,1,5199,16,44,119,66,161,22,42,person
26557,31,person,32,1,5199,15,303,129,330,169,27,40,person
26558,33,person,34,1,5199,16,152,125,170,157,18,32,person
26559,4,person,5,1,5200,29,321,49,375,105,54,56,person
26560,6,person,7,1,5200,25,343,19,374,83,31,64,person
26561,10,chair,11,1,5200,20,206,85,229,143,23,58,chair
26562,12,chair,13,1,5200,18,239,101,266,141,27,40,chair
26563,13,chair,14,1,5200,20,269,111,314,153,45,42,chair
26564,15,chair,16,1,5200,17,330,111,366,135,36,24,chair
26565,16,chair,17,1,5200,17,368,104,400,155,32,51,chair
26566,18,chair,19,1,5200,17,359,153,379,216,20,63,chair
26567,19,chair,20,1,5200,22,363,163,400,239,37,76,chair
26568,28,chair,29,1,5200,22,181,52,223,96,42,44,chair
26569,29,chair,30,1,5200,16,219,50,250,88,31,38,chair
26570,30,person,31,1,5200,29,186,1,239,47,53,46,person
26571,33,person,34,1,5200,19,340,0,368,49,28,49,person
26572,9,person,10,0,5201,39,191,172,255,259,64,87,person
26573,10,chair,11,0,5201,19,179,201,223,265,44,64,chair
26574,11,person,12,1,5201,22,228,169,257,215,29,46,person
26575,12,chair,13,0,5201,17,237,200,267,265,30,65,chair
26576,14,chair,15,1,5201,18,135,191,176,239,41,48,chair
26577,15,chair,16,0,5201,25,115,195,163,259,48,64,chair
26578,16,chair,17,1,5201,23,96,188,123,241,27,53,chair
26579,18,person,19,0,5201,26,369,134,384,179,15,45,person
26580,19,chair,20,0,5201,20,291,174,316,211,25,37,chair
26581,20,chair,21,0,5201,23,35,177,66,219,31,42,chair
26582,21,table,22,0,5201,15,18,173,82,213,64,40,dining table
26583,0,person,1,1,5202,46,128,68,242,192,114,124,person
26584,1,person,2,1,5202,51,32,70,211,300,179,230,person
26585,13,person,14,0,5202,28,12,54,60,185,48,131,person
26586,14,person,15,1,5202,16,36,52,62,97,26,45,person
26587,15,person,16,1,5202,15,187,50,207,77,20,27,person
26588,16,person,17,1,5202,22,359,19,399,148,40,129,person
26589,18,chair,19,1,5202,23,0,199,47,300,47,101,chair
26590,5,person,6,1,5203,16,9,259,21,278,12,19,person
26591,6,person,7,1,5203,15,31,258,45,276,14,18,person
26592,7,person,8,1,5203,16,9,274,35,300,26,26,person
26593,8,person,9,1,5203,16,29,275,54,300,25,25,person
26594,9,person,10,1,5203,15,54,277,78,299,24,22,person
26595,10,person,11,1,5203,19,241,252,265,300,24,48,person
26596,11,person,12,1,5203,17,274,262,314,300,40,38,person
26597,12,person,13,1,5203,19,198,260,218,300,20,40,person
26598,13,person,14,1,5203,17,171,259,190,298,19,39,person
26599,14,person,15,1,5203,24,306,251,344,299,38,48,person
26600,3,person,4,1,5204,61,145,125,471,640,326,515,person
26601,4,person,5,1,5204,19,303,63,370,140,67,77,person
26602,5,person,6,1,5204,16,246,122,285,171,39,49,person
26603,6,person,7,1,5204,19,257,135,309,232,52,97,person
26604,8,person,9,1,5204,18,258,94,304,142,46,48,person
26605,9,person,10,1,5204,15,390,104,420,190,30,86,person
26606,10,person,11,1,5204,20,413,75,454,180,41,105,person
26607,1,person,2,1,5205,32,234,187,304,260,70,73,person
26608,2,chair,3,1,5205,20,230,227,261,297,31,70,chair
26609,3,chair,4,1,5205,24,241,230,301,300,60,70,chair
26610,4,chair,5,1,5205,22,277,248,350,299,73,51,chair
26611,6,person,7,1,5205,20,54,191,86,247,32,56,person
26612,7,chair,8,1,5205,18,55,227,104,273,49,46,chair
26613,8,chair,9,1,5205,16,61,242,138,300,77,58,chair
26614,9,chair,10,1,5205,16,114,260,181,288,67,28,chair
26615,13,person,14,1,5205,18,279,172,303,207,24,35,person
26616,14,person,15,1,5205,20,135,173,158,204,23,31,person
26617,16,person,17,1,5205,21,174,177,203,215,29,38,person
26618,19,chair,20,1,5205,17,157,210,194,261,37,51,chair
26619,4,person,5,0,5581,49,62,43,225,235,163,192,person
26620,5,person,6,0,5581,43,260,76,380,197,120,121,person
26621,6,person,7,0,5581,32,324,207,376,367,52,160,person
26622,7,person,8,0,5581,37,166,244,225,403,59,159,person
26623,8,person,9,0,5581,35,452,53,505,220,53,167,person
26624,12,person,13,0,5581,20,40,225,71,321,31,96,person
26625,13,person,14,0,5581,19,382,212,411,280,29,68,person
26626,14,person,15,0,5581,22,590,208,622,283,32,75,person
26627,17,person,18,1,5581,16,196,149,216,183,20,34,person
26628,18,person,19,1,5581,15,234,157,252,183,18,26,person
26629,19,person,20,1,5581,15,283,225,309,258,26,33,person
26630,20,person,21,0,5581,24,505,223,533,280,28,57,person
26631,21,person,22,0,5581,19,458,219,484,278,26,59,person
26632,22,person,23,0,5581,20,543,213,573,278,30,65,person
26633,24,person,25,1,5581,15,589,181,613,213,24,32,person
26634,25,person,26,1,5581,16,522,158,552,194,30,36,person
26635,27,person,28,1,5581,15,561,183,586,216,25,33,person
26636,28,person,29,0,5581,27,569,214,596,281,27,67,person
26637,29,person,30,1,5581,15,383,164,409,199,26,35,person
26638,31,person,32,1,5581,15,516,136,542,171,26,35,person
26639,4,person,5,0,5582,67,93,35,192,265,99,230,person
26640,2,person,3,1,5583,21,0,215,196,478,196,263,person
26641,3,person,4,1,5583,16,554,342,638,478,84,136,person
26642,5,person,6,1,5583,35,399,291,475,432,76,141,person
26643,9,person,10,1,5583,19,487,217,511,276,24,59,person
26644,10,person,11,1,5583,17,538,236,558,280,20,44,person
26645,11,person,12,1,5583,18,557,225,575,279,18,54,person
26646,12,person,13,1,5583,16,573,229,594,280,21,51,person
26647,13,person,14,1,5583,27,530,214,557,279,27,65,person
26648,15,person,16,1,5583,18,498,187,521,231,23,44,person
26649,6,bicycle,7,0,5584,27,997,973,1059,1028,62,55,bicycle
26650,37,person,38,0,5584,17,818,952,850,1011,32,59,person
26651,6,person,7,0,5585,21,84,186,104,229,20,43,person
26652,7,person,8,0,5585,24,181,185,208,228,27,43,person
26653,8,person,9,0,5585,17,225,180,238,213,13,33,person
26654,9,person,10,0,5585,20,214,178,223,211,9,33,person
26655,10,person,11,0,5585,20,161,188,172,224,11,36,person
26656,11,person,12,0,5585,19,145,191,160,227,15,36,person
26657,12,person,13,0,5585,17,238,179,251,213,13,34,person
26658,13,person,14,0,5585,17,251,180,264,211,13,31,person
26659,14,person,15,0,5585,25,315,172,343,226,28,54,person
26660,16,person,17,0,5585,19,296,176,306,207,10,31,person
26661,17,person,18,0,5585,18,350,175,360,213,10,38,person
26662,18,person,19,0,5585,26,358,172,375,213,17,41,person
26663,19,person,20,1,5585,15,376,165,389,191,13,26,person
26664,20,person,21,0,5585,43,375,172,421,286,46,114,person
26665,21,person,22,1,5585,17,405,164,423,196,18,32,person
26666,22,person,23,1,5585,49,427,172,491,318,64,146,person
26667,23,person,24,0,5585,29,468,177,500,314,32,137,person
26668,25,person,26,0,5585,23,11,191,32,256,21,65,person
26669,26,person,27,1,5585,21,0,191,21,318,21,127,person
26670,9,horse,10,0,5586,21,332,703,413,756,81,53,horse
26671,10,person,11,1,5586,21,199,736,335,891,136,155,person
26672,11,person,12,1,5586,25,337,756,433,890,96,134,person
26673,12,person,13,0,5586,36,551,706,631,890,80,184,person
26674,13,person,14,0,5586,45,620,685,708,891,88,206,person
26675,14,person,15,0,5586,34,767,610,847,890,80,280,person
26676,15,person,16,1,5586,33,830,616,921,889,91,273,person
26677,16,person,17,1,5586,30,964,631,1033,891,69,260,person
26678,17,person,18,1,5586,23,823,731,917,891,94,160,person
26679,18,person,19,1,5586,30,915,697,1000,891,85,194,person
26680,19,person,20,1,5586,21,1317,689,1352,839,35,150,person
26681,20,person,21,0,5586,31,1253,685,1329,856,76,171,person
26682,21,person,22,1,5586,26,1134,701,1189,891,55,190,person
26683,22,person,23,0,5586,25,1069,711,1147,891,78,180,person
26684,24,person,25,1,5586,24,1665,686,1746,817,81,131,person
26685,25,person,26,1,5586,19,1753,679,1840,803,87,124,person
26686,26,person,27,1,5586,21,1634,756,1855,891,221,135,person
26687,27,person,28,1,5586,19,1695,817,1788,890,93,73,person
26688,28,chair,29,0,5586,18,1829,743,1928,845,99,102,chair
26689,3,truck,4,0,5587,17,299,145,382,183,83,38,truck
26690,9,person,10,0,5589,32,980,557,1022,661,42,104,person
26691,7,person,8,0,5590,21,28,203,41,236,13,33,person
26692,8,person,9,0,5590,21,12,208,23,240,11,32,person
26693,8,car,9,1,7258,15,70,488,798,598,728,110,car
26694,5,car,6,1,7259,23,0,186,85,236,85,50,car
26695,6,car,7,0,7259,27,179,179,269,219,90,40,car
26696,7,person,8,0,7259,32,269,148,297,245,28,97,person
26697,7,motorbike,8,0,7261,21,207,205,248,256,41,51,motorcycle
26698,8,person,9,1,7261,24,210,193,244,257,34,64,person
26699,9,car,10,0,7262,34,171,168,678,323,507,155,car
26700,12,car,13,1,7263,24,102,972,468,1140,366,168,car
26701,13,car,14,0,7263,27,420,1016,788,1209,368,193,car
26702,14,car,15,0,7263,29,963,941,1278,1110,315,169,car
26703,15,car,16,0,7263,27,1183,810,1405,945,222,135,car
26704,16,car,17,1,7263,15,1498,740,1624,854,126,114,car
26705,6,person,7,1,7265,20,1441,220,1536,353,95,133,person
26706,7,motorbike,8,0,7265,15,526,96,589,194,63,98,motorcycle
26707,8,person,9,1,7265,20,514,44,584,142,70,98,person
26708,9,motorbike,10,0,7265,50,468,441,847,898,379,457,motorcycle
26709,10,person,11,1,7265,51,476,295,791,763,315,468,person
26710,8,person,9,1,7476,27,306,80,340,177,34,97,person
26711,9,person,10,0,7476,20,179,142,200,196,21,54,person
26712,10,person,11,1,7476,26,0,135,40,280,40,145,person
26713,13,person,14,1,7476,21,107,137,126,195,19,58,person
26714,4,person,5,0,7477,45,82,54,130,182,48,128,person
26715,13,table,14,0,7478,25,1010,774,1323,1198,313,424,dining table
26716,18,person,19,1,7478,21,976,604,1130,916,154,312,person
26717,19,person,20,1,7478,32,1104,524,1265,1065,161,541,person
26718,20,person,21,0,7478,35,1436,553,1594,1097,158,544,person
26719,21,person,22,1,7478,30,262,498,380,986,118,488,person
26720,22,person,23,0,7478,33,120,474,253,984,133,510,person
26721,23,person,24,1,7478,17,7,505,115,762,108,257,person
26722,4,person,5,1,7479,74,608,354,1276,2129,668,1775,person
26723,5,person,6,1,7479,82,114,105,1014,2168,900,2063,person
26724,9,person,10,1,7481,17,81,132,98,165,17,33,person
26725,10,person,11,1,7481,19,38,121,60,191,22,70,person
26726,3,person,4,0,7482,18,32,162,42,194,10,32,person
26727,5,person,6,0,7482,21,78,166,91,196,13,30,person
26728,6,person,7,0,7482,25,124,164,139,197,15,33,person
26729,7,person,8,0,7482,25,163,158,176,201,13,43,person
26730,8,person,9,0,7482,30,187,158,201,204,14,46,person
26731,9,person,10,0,7482,23,262,151,278,208,16,57,person
26732,13,person,14,1,7483,16,341,226,374,259,33,33,person
26733,15,person,16,1,7483,28,106,242,186,382,80,140,person
26734,5,person,6,0,7484,71,102,38,175,180,73,142,person
26735,6,person,7,1,7484,35,164,63,186,150,22,87,person
26736,3,person,4,0,7485,58,138,38,209,204,71,166,person
26737,4,person,5,1,7485,48,2,24,123,213,121,189,person
26738,12,person,13,0,7486,58,874,466,1153,1306,279,840,person
26739,11,car,12,1,7487,15,870,615,998,683,128,68,car
26740,25,person,26,0,7487,101,170,243,584,1263,414,1020,person
26741,6,person,7,0,7489,90,97,185,375,934,278,749,person
26742,7,person,8,0,7489,89,816,65,1102,826,286,761,person
26743,3,person,4,1,7501,25,172,181,207,233,35,52,person
26744,4,person,5,1,7501,23,197,190,236,236,39,46,person
26745,5,person,6,1,7501,19,291,196,317,245,26,49,person
26746,6,person,7,1,7501,25,326,197,394,248,68,51,person
26747,7,person,8,1,7501,16,124,193,163,229,39,36,person
26748,8,person,9,1,7501,22,100,179,134,226,34,47,person
26749,9,person,10,1,7501,16,186,84,213,116,27,32,person
26750,12,person,13,1,7501,15,300,98,332,126,32,28,person
26751,14,person,15,1,7501,15,385,106,412,135,27,29,person
26752,15,person,16,1,7501,24,458,91,497,140,39,49,person
26753,16,person,17,1,7501,16,412,108,441,135,29,27,person
26754,17,person,18,1,7501,17,241,77,265,111,24,34,person
26755,18,person,19,1,7501,17,288,79,314,119,26,40,person
26756,20,person,21,1,7501,18,337,79,364,119,27,40,person
26757,21,person,22,1,7501,18,439,96,459,136,20,40,person
26758,22,person,23,1,7501,19,195,39,226,94,31,55,person
26759,23,person,24,1,7501,22,239,61,269,100,30,39,person
26760,24,person,25,1,7501,16,216,62,242,111,26,49,person
26761,25,person,26,1,7501,22,108,60,148,111,40,51,person
26762,26,person,27,1,7501,18,53,61,90,106,37,45,person
26763,27,person,28,1,7501,21,89,49,112,106,23,57,person
26764,28,person,29,1,7501,19,255,46,276,87,21,41,person
26765,30,person,31,1,7501,17,370,91,387,125,17,34,person
26766,32,person,33,1,7501,18,404,92,430,131,26,39,person
26767,33,person,34,1,7501,15,426,77,442,111,16,34,person
26768,34,person,35,1,7501,15,322,85,338,114,16,29,person
26769,36,person,37,1,7501,18,263,83,284,119,21,36,person
26770,37,person,38,1,7501,17,323,21,351,60,28,39,person
26771,38,person,39,1,7501,17,348,24,375,64,27,40,person
26772,39,person,40,1,7501,21,296,17,328,58,32,41,person
26773,41,person,42,1,7501,15,312,74,333,98,21,24,person
26774,42,person,43,1,7501,26,224,28,255,74,31,46,person
26775,43,person,44,1,7501,18,268,32,292,68,24,36,person
26776,44,person,45,1,7501,20,36,62,56,102,20,40,person
26777,12,person,13,1,7502,23,108,233,156,266,48,33,person
26778,13,person,14,1,7502,21,4,238,38,273,34,35,person
26779,14,person,15,0,7502,42,349,213,385,315,36,102,person
26780,16,person,17,0,7502,17,561,218,572,247,11,29,person
26781,3,person,4,0,7504,58,371,116,446,276,75,160,person
26782,4,person,5,0,7504,68,271,61,347,293,76,232,person
26783,5,person,6,1,7504,64,224,70,289,275,65,205,person
26784,6,person,7,0,7504,45,152,157,241,287,89,130,person
26785,7,person,8,0,7504,70,81,67,175,215,94,148,person
26786,8,person,9,0,7504,67,6,103,116,277,110,174,person
26787,2,person,3,0,7505,59,51,44,152,238,101,194,person
26788,3,person,4,0,7505,46,133,51,199,228,66,177,person
26789,4,person,5,0,7505,77,180,35,255,226,75,191,person
26790,5,person,6,0,7505,67,264,41,374,236,110,195,person
26791,6,person,7,1,7505,16,380,70,399,230,19,160,person
26792,5,person,6,0,7506,76,469,312,879,1020,410,708,person
26793,4,person,5,0,7507,40,0,317,295,1246,295,929,person
26794,5,person,6,0,7507,62,1215,634,1585,1644,370,1010,person
26795,6,person,7,0,7507,58,1625,603,1990,1514,365,911,person
26796,13,bottle,14,0,7507,24,1922,763,1994,868,72,105,bottle
26797,29,glasses,30,0,7507,21,1414,735,1525,767,111,32,eye glasses
26798,3,bench,4,0,7508,32,192,298,935,635,743,337,bench
26799,5,bench,6,0,7509,42,1035,477,2043,1530,1008,1053,bench
26800,13,bench,14,0,7509,24,403,379,564,653,161,274,bench
26801,6,person,7,0,7510,24,37,60,112,315,75,255,person
26802,11,person,12,1,7510,65,324,278,872,958,548,680,person
26803,1,person,2,0,141,86,42,231,327,496,285,265,person
26804,8,person,9,1,141,114,280,185,551,497,271,312,person
26805,4,person,5,0,142,116,577,58,708,391,131,333,person
26806,19,person,20,0,142,116,366,59,500,389,134,330,person
26807,1,person,2,1,7682,16,363,296,394,404,31,108,person
26808,3,person,4,0,7682,44,303,238,379,420,76,182,person
26809,4,person,5,0,7682,48,391,224,462,417,71,193,person
26810,5,person,6,0,7682,55,599,235,677,417,78,182,person
26811,8,ball,9,0,7684,23,154,194,248,288,94,94,sports ball
26812,2,person,3,0,7685,66,13,125,156,419,143,294,person
26813,3,person,4,0,7685,73,352,130,517,429,165,299,person
26814,4,person,5,0,7685,93,532,79,717,421,185,342,person
26815,8,person,9,1,7688,30,707,504,812,661,105,157,person
26816,3,person,4,0,7689,66,454,283,767,991,313,708,person
26817,13,person,14,1,7690,22,1435,637,1523,793,88,156,person
26818,7,person,8,0,7694,35,1447,695,1571,927,124,232,person
26819,8,person,9,1,7694,37,668,679,752,962,84,283,person
26820,9,person,10,0,7694,68,702,679,840,1125,138,446,person
26821,13,person,14,0,7694,63,171,688,313,1049,142,361,person
26822,3,person,4,0,7695,28,855,667,994,879,139,212,person
26823,11,person,12,0,7695,41,305,583,449,1053,144,470,person
26824,12,person,13,0,7695,72,1542,648,1689,927,147,279,person
26825,15,person,16,0,7697,18,545,483,569,537,24,54,person
26826,2,person,3,0,7699,78,305,121,521,754,216,633,person
26827,3,person,4,0,7699,69,1470,68,1770,965,300,897,person
26828,2,person,3,1,20734,36,733,422,1125,1039,392,617,person
26829,7,table,8,0,7883,22,2,236,146,336,144,100,dining table
26830,9,person,10,1,7883,46,361,70,444,279,83,209,person
26831,10,person,11,0,7883,62,305,62,389,324,84,262,person
26832,11,person,12,1,7883,52,222,60,309,335,87,275,person
26833,12,person,13,0,7883,61,82,37,235,336,153,299,person
26834,6,person,7,1,7885,45,297,85,597,448,300,363,person
26835,4,person,5,0,7886,54,267,59,350,250,83,191,person
26836,5,person,6,0,7886,48,216,58,276,223,60,165,person
26837,6,person,7,0,7886,45,160,60,213,205,53,145,person
26838,7,person,8,0,7886,36,115,73,161,192,46,119,person
26839,8,person,9,0,7886,28,93,78,119,178,26,100,person
26840,9,person,10,1,7886,25,75,84,96,170,21,86,person
26841,5,person,6,0,7887,27,123,101,160,175,37,74,person
26842,10,person,11,1,7887,63,69,54,464,450,395,396,person
26843,4,person,5,1,7888,70,121,38,358,299,237,261,person
26844,1,person,2,1,7889,66,598,211,785,515,187,304,person
26845,10,person,11,1,7890,36,1082,0,1597,1198,515,1198,person
26846,4,person,5,0,7891,38,124,66,215,179,91,113,person
26847,5,person,6,0,7891,44,156,75,215,198,59,123,person
26848,7,chair,8,0,7891,18,137,134,196,200,59,66,chair
26849,9,person,10,0,7891,42,92,63,147,153,55,90,person
26850,10,chair,11,0,7891,16,85,108,121,166,36,58,chair
26851,12,person,13,0,7891,31,23,40,70,144,47,104,person
26852,13,person,14,1,7891,21,56,66,77,118,21,52,person
26853,0,person,1,0,7892,107,215,245,1117,1533,902,1288,person
26854,6,bench,7,1,7892,21,0,503,353,1100,353,597,bench
26855,3,table,4,0,7893,23,72,205,201,353,129,148,dining table
26856,4,person,5,0,7893,54,40,153,139,340,99,187,person
26857,5,person,6,0,7894,18,193,229,217,281,24,52,person
26858,3,person,4,0,7895,28,429,586,727,1464,298,878,person
26859,4,person,5,1,7895,28,1002,615,1210,1088,208,473,person
26860,5,person,6,0,7895,36,638,588,886,1184,248,596,person
26861,6,person,7,1,7895,22,1346,592,1455,972,109,380,person
26862,11,table,12,0,7895,18,830,1048,1769,1614,939,566,dining table
26863,12,table,13,0,7895,16,238,1160,1008,1584,770,424,dining table
26864,13,person,14,1,7895,22,1435,675,1636,979,201,304,person
26865,14,person,15,1,7895,39,271,579,476,1237,205,658,person
26866,9,person,10,1,7896,56,988,536,1733,1640,745,1104,person
26867,2,person,3,1,7897,28,366,223,469,571,103,348,person
26868,3,person,4,0,7897,55,399,223,596,637,197,414,person
26869,5,person,6,1,7898,33,0,388,230,1022,230,634,person
26870,6,person,7,1,7898,74,213,123,1108,1020,895,897,person
26871,4,person,5,1,7899,51,0,0,279,288,279,288,person
26872,5,person,6,1,7900,30,3,171,600,1643,597,1472,person
26873,7,person,8,1,7900,56,924,478,1620,1633,696,1155,person
26874,7,person,8,0,8042,17,319,339,333,378,14,39,person
26875,8,person,9,0,8042,16,342,339,357,383,15,44,person
26876,13,person,14,0,8045,15,582,559,594,589,12,30,person
26877,15,person,16,0,8045,17,810,559,823,595,13,36,person
26878,17,person,18,0,8045,15,942,562,955,601,13,39,person
26879,4,person,5,0,23394,66,306,228,377,498,71,270,person
26880,5,person,6,0,23394,45,372,258,419,490,47,232,person
26881,6,person,7,0,23394,46,498,328,573,483,75,155,person
26882,7,person,8,1,23394,55,451,379,639,482,188,103,person
26883,5,person,6,0,23395,77,1510,858,2111,1156,601,298,person
26884,6,person,7,0,23395,76,1141,1058,2054,1460,913,402,person
26885,7,person,8,0,23395,63,979,404,1219,1065,240,661,person
26886,8,person,9,0,23395,86,730,434,1059,1199,329,765,person
26887,9,person,10,0,23395,90,392,386,675,1146,283,760,person
26888,10,person,11,1,23395,61,4,362,234,1463,230,1101,person
26889,2,person,3,0,23396,69,768,347,977,707,209,360,person
26890,3,person,4,0,23396,93,605,325,784,703,179,378,person
26891,4,person,5,0,23396,66,461,383,635,697,174,314,person
26892,5,person,6,1,23396,93,272,250,756,696,484,446,person
26893,6,person,7,0,23396,63,264,400,446,714,182,314,person
26894,7,person,8,0,23396,71,45,403,228,713,183,310,person
26895,17,person,18,1,8552,29,1039,621,1126,788,87,167,person
26896,21,chair,22,0,8553,22,1502,867,1664,1068,162,201,chair
26897,22,chair,23,1,8553,19,1380,861,1505,1053,125,192,chair
26898,38,chair,39,1,8556,22,1257,917,1408,1076,151,159,chair
26899,39,chair,40,1,8556,30,1302,909,1491,1104,189,195,chair
26900,18,table,19,0,8561,47,433,897,724,1146,291,249,dining table
26901,19,chair,20,0,8561,26,376,889,514,1121,138,232,chair
26902,20,chair,21,1,8561,23,653,895,841,1119,188,224,chair
26903,0,chair,1,0,8564,20,209,182,289,288,80,106,chair
26904,3,table,4,0,8564,18,133,183,247,217,114,34,dining table
26905,13,chair,14,0,8564,17,90,186,173,286,83,100,chair
26906,1,person,2,0,8569,35,771,892,903,1200,132,308,person
26907,2,person,3,0,8569,39,837,917,975,1235,138,318,person
26908,1,vase,2,0,8571,16,464,789,528,881,64,92,vase
26909,3,bench,4,0,8571,26,339,686,467,789,128,103,bench
26910,20,vase,21,0,8571,15,855,811,939,904,84,93,vase
26911,3,car,4,0,8572,19,380,826,572,875,192,49,car
26912,24,chair,25,0,8572,15,988,917,1173,1160,185,243,chair
26913,0,person,1,0,8576,51,66,533,219,1024,153,491,person
26914,1,person,2,0,8576,59,244,549,387,1024,143,475,person
26915,2,person,3,0,8576,51,936,584,1045,952,109,368,person
26916,3,person,4,0,8576,40,368,601,479,972,111,371,person
26917,4,person,5,0,8576,29,656,481,723,698,67,217,person
26918,7,person,8,0,8576,31,717,469,801,696,84,227,person
26919,8,person,9,0,8576,30,806,476,859,697,53,221,person
26920,9,person,10,0,8576,35,850,491,904,718,54,227,person
26921,10,person,11,1,8576,28,899,531,963,686,64,155,person
26922,11,person,12,1,8576,54,859,652,958,897,99,245,person
26923,13,person,14,1,8576,24,1113,647,1168,709,55,62,person
26924,14,person,15,1,8576,22,1037,667,1081,746,44,79,person
26925,15,person,16,1,8576,85,1044,656,1169,894,125,238,person
26926,16,chair,17,1,8576,37,1044,745,1161,938,117,193,chair
26927,17,person,18,1,8576,26,1144,646,1204,749,60,103,person
26928,18,person,19,1,8576,28,1240,637,1312,735,72,98,person
26929,19,person,20,1,8576,71,1158,650,1273,881,115,231,person
26930,20,chair,21,1,8576,49,1163,739,1280,902,117,163,chair
26931,22,person,23,1,8576,17,1347,666,1389,721,42,55,person
26932,23,person,24,1,8576,24,1376,645,1421,710,45,65,person
26933,24,person,25,1,8576,18,1373,671,1415,732,42,61,person
26934,26,person,27,1,8576,15,1479,632,1512,686,33,54,person
26935,27,person,28,1,8576,17,1456,640,1496,708,40,68,person
26936,28,person,29,1,8576,15,1470,643,1500,692,30,49,person
26937,29,person,30,1,8576,83,1334,642,1493,885,159,243,person
26938,30,chair,31,0,8576,50,1278,738,1387,894,109,156,chair
26939,31,person,32,1,8576,44,1268,633,1375,838,107,205,person
26940,32,chair,33,0,8576,47,1385,734,1502,887,117,153,chair
26941,33,person,34,1,8576,41,587,512,643,699,56,187,person
26942,34,person,35,1,8576,27,586,588,633,722,47,134,person
26943,35,person,36,1,8576,29,565,613,622,756,57,143,person
26944,36,person,37,1,8576,34,528,546,571,675,43,129,person
26945,38,person,39,1,8576,33,1472,549,1535,665,63,116,person
26946,40,person,41,1,8576,32,1477,666,1536,857,59,191,person
26947,41,chair,42,1,8576,27,1494,736,1536,879,42,143,chair
26948,42,person,43,1,8576,31,526,661,609,804,83,143,person
26949,43,chair,44,1,8576,22,557,756,617,889,60,133,chair
26950,45,person,46,1,8576,69,470,674,571,900,101,226,person
26951,46,chair,47,1,8576,44,453,771,572,959,119,188,chair
26952,47,person,48,1,8576,24,192,656,249,762,57,106,person
26953,48,person,49,1,8576,23,197,684,269,787,72,103,person
26954,49,person,50,1,8576,16,60,678,95,762,35,84,person
26955,50,person,51,1,8576,37,9,686,81,865,72,179,person
26956,51,chair,52,1,8576,38,2,788,81,938,79,150,chair
26957,52,person,53,1,8576,19,1,651,30,912,29,261,person
26958,53,table,54,1,8576,24,197,784,263,933,66,149,dining table
26959,55,table,56,1,8576,15,368,784,390,962,22,178,dining table
26960,8,table,9,0,8577,18,654,423,748,505,94,82,dining table
26961,2,person,3,0,25028,18,815,655,920,775,105,120,person
26962,3,person,4,1,25028,26,688,597,817,819,129,222,person
26963,11,person,12,0,25029,52,668,412,754,622,86,210,person
26964,12,person,13,0,25029,48,468,415,532,605,64,190,person
26965,13,person,14,1,25029,22,540,371,586,449,46,78,person
26966,14,person,15,0,25029,38,209,401,272,550,63,149,person
26967,3,person,4,0,8579,67,7,83,76,233,69,150,person
26968,4,person,5,0,8579,44,107,98,152,231,45,133,person
26969,5,person,6,1,8579,40,178,54,228,246,50,192,person
26970,10,person,11,0,8579,62,314,99,373,240,59,141,person
26971,11,person,12,1,8579,22,223,144,253,195,30,51,person
26972,1,chair,2,0,8580,27,52,143,108,225,56,82,chair
26973,2,chair,3,0,8580,25,202,142,241,224,39,82,chair
26974,3,table,4,0,8580,21,105,161,200,225,95,64,dining table
26975,1,person,2,0,8581,35,195,794,433,1423,238,629,person
26976,4,person,5,1,8581,64,702,250,1343,1643,641,1393,person
26977,5,person,6,1,8581,51,1115,583,1518,1416,403,833,person
26978,6,person,7,1,8581,32,1378,733,1560,1339,182,606,person
26979,2,bird,3,0,8582,31,734,115,1304,647,570,532,bird
26980,7,person,8,1,8582,45,522,615,869,1605,347,990,person
26981,9,person,10,1,8582,33,1263,423,1634,1574,371,1151,person
26982,4,person,5,0,166,145,108,74,422,910,314,836,person
26983,15,person,16,1,167,28,367,282,434,419,67,137,person
26984,16,person,17,1,167,27,487,274,560,394,73,120,person
26985,17,person,18,1,167,44,585,272,709,500,124,228,person
26986,18,person,19,0,167,63,705,297,797,553,92,256,person
26987,19,car,20,0,167,136,3,309,321,584,318,275,car
26988,27,car,28,0,167,129,253,314,632,604,379,290,car
26989,35,person,36,1,167,31,635,382,670,487,35,105,person
26990,16,person,17,0,168,42,105,342,142,447,37,105,person
26991,24,person,25,0,168,36,248,340,279,407,31,67,person
26992,32,person,33,0,168,39,404,340,445,445,41,105,person
26993,39,person,40,0,168,28,589,333,613,434,24,101,person
26994,19,person,20,0,583,21,1524,627,1537,661,13,34,person
26995,0,person,1,0,8662,65,741,502,1079,1537,338,1035,person
26996,0,person,1,0,8668,52,386,368,588,870,202,502,person
26997,11,person,12,0,8668,105,1025,332,1140,683,115,351,person
26998,0,person,1,0,8669,39,959,564,1181,1005,222,441,person
26999,7,person,8,0,8673,79,351,50,766,791,415,741,person
27000,6,person,7,0,8681,53,77,45,472,804,395,759,person
27001,0,person,1,0,8682,41,1122,735,1362,1393,240,658,person
27002,12,person,12,0,8683,19,645,728,654,755,9,27,person
27003,13,person,13,0,8683,24,658,725,668,752,10,27,person
27004,14,person,14,0,8683,21,723,726,733,754,10,28,person
27005,15,person,15,0,8683,23,760,731,772,751,12,20,person
27006,2,person,3,0,23474,111,128,302,380,998,252,696,person
27007,3,person,4,0,23477,49,828,269,911,463,83,194,person
27008,17,chair,18,0,23481,23,358,369,383,394,25,25,chair
27009,2,person,3,0,23482,114,373,34,552,416,179,382,person
27010,1,person,2,0,23483,115,685,87,880,578,195,491,person
27011,2,person,3,0,23483,135,116,94,319,518,203,424,person
27012,8,person,9,0,23484,46,516,495,632,734,116,239,person
27013,11,person,12,0,23486,62,597,295,673,501,76,206,person
27014,12,person,13,0,23486,67,490,277,575,507,85,230,person
27015,13,person,14,0,23486,45,333,277,390,483,57,206,person
27016,14,person,15,0,23486,49,375,311,428,458,53,147,person
27017,8,bench,9,0,584,20,37,136,103,163,66,27,bench
27018,12,bench,13,0,584,16,171,174,228,224,57,50,bench
27019,16,person,17,0,8798,37,174,91,200,139,26,48,person
27020,1,bench,2,1,8801,16,150,196,256,256,106,60,bench
27021,6,bench,7,0,8803,27,143,157,216,227,73,70,bench
27022,1,ball,2,0,8806,15,420,181,495,257,75,76,sports ball
27023,3,chair,4,0,8806,20,365,155,441,291,76,136,chair
27024,8,bench,9,0,8806,45,138,203,268,353,130,150,bench
27025,1,bench,2,0,8807,41,140,279,339,375,199,96,bench
27026,1,bench,2,0,8810,47,0,183,146,244,146,61,bench
27027,4,person,5,0,8810,17,120,100,131,129,11,29,person
27028,5,person,6,0,8810,17,135,100,148,125,13,25,person
27029,6,person,7,0,8810,27,4,114,84,156,80,42,person
27030,19,bench,20,0,8810,16,41,137,92,161,51,24,bench
27031,16,person,17,0,8816,16,87,90,108,125,21,35,person
27032,5,bench,6,0,8819,36,505,454,863,689,358,235,bench
27033,16,mirror,17,0,25047,34,121,93,395,341,274,248,mirror
27034,17,mirror,18,1,25047,30,424,138,580,304,156,166,mirror
27035,9,person,10,0,8953,29,198,82,220,144,22,62,person
27036,10,person,11,1,8953,15,214,90,224,137,10,47,person
27037,8,person,9,0,8956,59,157,174,266,466,109,292,person
27038,6,bench,7,0,8957,22,429,302,585,412,156,110,bench
27039,7,bench,8,0,8957,23,2,306,165,420,163,114,bench
27040,9,person,10,0,8957,51,275,196,333,356,58,160,person
27041,10,person,11,0,8957,31,237,246,280,355,43,109,person
27042,4,person,5,0,8958,28,225,151,252,225,27,74,person
27043,3,person,4,1,8960,16,199,92,232,125,33,33,person
27044,4,person,5,0,8961,34,110,152,154,259,44,107,person
27045,5,person,6,0,8961,29,156,183,191,278,35,95,person
27046,11,person,12,0,8964,18,266,258,278,289,12,31,person
27047,12,person,13,0,8964,19,256,261,266,290,10,29,person
27048,7,dog,8,0,8965,29,422,732,661,889,239,157,dog
27049,3,person,4,1,8967,53,39,9,134,210,95,201,person
27050,7,person,8,1,9491,31,607,414,949,618,342,204,person
27051,14,bicycle,15,0,9493,45,198,227,427,288,229,61,bicycle
27052,15,person,16,0,9493,25,312,192,378,281,66,89,person
27053,11,person,12,0,9494,27,283,223,360,287,77,64,person
27054,3,person,4,1,9496,25,25,45,72,115,47,70,person
27055,4,person,5,1,9496,28,86,17,148,77,62,60,person
27056,5,person,6,1,9496,31,177,4,242,55,65,51,person
27057,6,person,7,1,9496,32,279,26,335,97,56,71,person
27058,31,person,32,1,9497,26,493,261,642,501,149,240,person
27059,32,person,33,1,9497,39,631,220,842,391,211,171,person
27060,33,person,34,1,9497,32,834,278,941,499,107,221,person
27061,14,person,15,1,9499,23,572,562,773,782,201,220,person
27062,15,person,16,1,9499,26,894,521,1281,776,387,255,person
27063,16,person,17,1,9499,41,1533,495,2021,792,488,297,person
27064,2,person,3,1,20915,51,7,98,136,154,129,56,person
27065,4,person,5,0,9789,23,156,154,175,199,19,45,person
27066,5,person,6,0,9789,22,221,159,237,223,16,64,person
27067,6,person,7,0,9789,27,258,167,299,242,41,75,person
27068,7,person,8,0,9789,22,198,205,221,264,23,59,person
27069,8,person,9,1,9789,16,308,223,359,298,51,75,person
27070,9,person,10,1,9789,15,386,234,423,298,37,64,person
27071,10,person,11,0,9789,18,321,158,338,181,17,23,person
27072,5,person,6,0,9790,36,411,292,513,497,102,205,person
27073,6,person,7,0,9790,27,294,292,357,441,63,149,person
27074,7,person,8,0,9790,28,487,265,550,431,63,166,person
27075,8,person,9,0,9790,33,706,252,778,418,72,166,person
27076,9,person,10,1,9790,16,335,281,373,437,38,156,person
27077,5,person,6,0,9791,27,133,243,164,314,31,71,person
27078,6,person,7,0,9791,26,251,241,288,328,37,87,person
27079,7,person,8,0,9791,22,339,250,379,324,40,74,person
27080,8,person,9,0,9791,17,176,214,195,253,19,39,person
27081,9,person,10,0,9791,18,37,220,58,266,21,46,person
27082,10,person,11,0,9791,18,454,240,497,317,43,77,person
27083,9,person,10,0,9793,27,600,193,637,331,37,138,person
27084,22,person,23,0,9793,21,45,206,61,252,16,46,person
27085,7,person,8,0,9794,21,517,149,539,209,22,60,person
27086,8,person,9,0,9794,16,485,152,497,185,12,33,person
27087,10,person,11,0,9796,15,195,159,202,191,7,32,person
27088,11,person,12,0,9796,17,245,146,256,180,11,34,person
27089,12,person,13,0,9796,19,287,144,301,179,14,35,person
27090,15,person,16,0,9796,18,360,139,371,165,11,26,person
27091,16,person,17,0,9796,19,427,156,442,186,15,30,person
27092,18,person,19,1,9796,23,404,286,469,372,65,86,person
27093,19,person,20,1,9796,17,375,317,424,373,49,56,person
27094,20,person,21,1,9796,18,184,292,229,371,45,79,person
27095,21,person,22,1,9796,15,230,285,264,331,34,46,person
27096,22,person,23,1,9796,19,161,307,189,364,28,57,person
27097,23,person,24,1,9796,20,315,264,346,313,31,49,person
27098,17,person,18,0,9797,23,192,140,207,168,15,28,person
27099,18,person,19,0,9797,22,223,141,235,169,12,28,person
27100,19,person,20,0,9797,23,300,135,315,159,15,24,person
27101,21,person,22,0,9797,20,319,135,328,159,9,24,person
27102,22,person,23,0,9797,17,359,135,368,163,9,28,person
27103,23,person,24,0,9797,18,370,133,381,164,11,31,person
27104,6,person,7,0,9798,35,116,234,163,303,47,69,person
27105,7,person,8,0,9798,32,222,233,256,321,34,88,person
27106,8,person,9,0,9798,36,256,242,316,329,60,87,person
27107,9,person,10,0,9798,35,439,238,479,298,40,60,person
27108,14,person,15,0,9798,21,21,207,41,239,20,32,person
27109,12,person,13,0,9800,25,276,253,317,335,41,82,person
27110,13,person,14,0,9800,26,377,235,411,304,34,69,person
27111,14,person,15,0,9800,24,214,237,259,318,45,81,person
27112,15,person,16,0,9800,18,253,274,275,341,22,67,person
27113,16,person,17,0,9800,24,154,243,191,320,37,77,person
27114,17,person,18,0,9800,23,591,251,629,338,38,87,person
27115,18,person,19,0,9800,15,522,258,541,312,19,54,person
27116,19,person,20,0,9800,27,654,308,686,433,32,125,person
27117,20,person,21,0,9800,18,551,213,578,282,27,69,person
27118,21,person,22,0,9800,16,586,216,603,267,17,51,person
27119,22,person,23,0,9800,17,469,212,483,265,14,53,person
27120,23,person,24,0,9800,18,402,208,424,266,22,58,person
27121,24,person,25,0,9800,15,340,224,358,269,18,45,person
27122,25,person,26,0,9800,16,696,209,714,259,18,50,person
27123,26,person,27,0,9800,16,618,205,634,255,16,50,person
27124,27,person,28,0,9800,17,357,195,377,237,20,42,person
27125,28,person,29,1,9800,21,84,442,187,519,103,77,person
27126,29,person,30,1,9800,15,668,456,715,518,47,62,person
27127,30,person,31,0,9800,18,773,220,795,292,22,72,person
27128,31,person,32,0,9800,18,678,217,697,263,19,46,person
27129,37,person,38,0,9800,21,10,314,33,388,23,74,person
27130,43,person,44,0,9800,17,674,325,713,395,39,70,person
27131,46,person,47,0,9800,17,352,164,365,200,13,36,person
27132,52,person,53,1,9800,22,227,191,246,239,19,48,person
27133,53,person,54,1,9800,22,218,225,247,257,29,32,person
27134,54,person,55,1,9800,25,385,177,403,218,18,41,person
27135,55,person,56,1,9800,18,378,191,390,223,12,32,person
27136,56,person,57,0,9800,25,529,175,544,201,15,26,person
27137,57,person,58,1,9800,22,588,192,604,235,16,43,person
27138,58,person,59,1,9800,20,586,162,595,194,9,32,person
27139,59,person,60,0,9800,19,471,171,482,207,11,36,person
27140,60,person,61,1,9800,21,767,205,784,252,17,47,person
27141,61,person,62,0,9800,21,607,169,617,194,10,25,person
27142,62,person,63,1,9800,18,611,192,631,212,20,20,person
27143,63,person,64,1,9800,22,664,214,683,261,19,47,person
27144,64,person,65,0,9800,16,341,161,351,193,10,32,person
27145,65,person,66,1,9800,20,306,175,319,206,13,31,person
27146,66,person,67,1,9800,29,147,228,169,303,22,75,person
27147,67,person,68,0,9800,25,170,199,190,256,20,57,person
27148,68,person,69,1,9800,19,185,225,202,264,17,39,person
27149,76,person,77,0,9800,20,699,162,709,195,10,33,person
27150,77,person,78,1,9800,20,368,167,384,201,16,34,person
27151,8,person,9,0,9801,28,60,156,89,210,29,54,person
27152,10,person,11,0,9801,17,234,138,249,159,15,21,person
27153,11,person,12,0,9801,24,247,149,282,178,35,29,person
27154,12,person,13,0,9801,22,346,149,360,188,14,39,person
27155,13,person,14,0,9801,24,392,151,410,186,18,35,person
27156,25,person,26,0,9801,20,52,128,70,166,18,38,person
27157,4,person,5,0,9802,50,5,139,132,335,127,196,person
27158,5,person,6,0,9802,44,113,137,206,302,93,165,person
27159,6,person,7,0,9802,71,178,135,321,329,143,194,person
27160,7,person,8,0,9802,32,268,217,406,301,138,84,person
27161,0,person,1,1,25080,123,244,22,778,681,534,659,person
27162,12,person,13,0,9805,37,537,508,586,657,49,149,person
27163,13,person,14,0,9805,33,578,555,639,661,61,106,person
27164,12,person,13,0,9807,20,159,306,176,363,17,57,person
27165,13,person,14,0,9807,23,196,302,212,341,16,39,person
27166,14,person,15,0,9807,24,224,289,240,331,16,42,person
27167,15,person,16,0,9807,26,125,302,144,349,19,47,person
27168,16,person,17,0,9807,20,258,296,274,341,16,45,person
27169,17,person,18,0,9807,19,87,303,98,343,11,40,person
27170,18,person,19,0,9807,24,14,303,34,353,20,50,person
27171,19,person,20,0,9807,18,52,297,70,340,18,43,person
27172,37,person,38,0,9807,37,244,293,261,332,17,39,person
27173,38,person,39,0,9807,33,177,303,193,332,16,29,person
27174,4,person,5,0,9808,29,138,0,161,61,23,61,person
27175,5,person,6,0,9808,26,74,0,95,76,21,76,person
27176,6,person,7,0,9808,34,55,16,80,68,25,52,person
27177,7,person,8,0,9808,94,65,38,153,201,88,163,person
27178,24,person,25,0,9810,22,696,347,727,408,31,61,person
27179,25,person,26,0,9810,17,510,302,530,344,20,42,person
27180,28,person,29,0,9810,16,424,325,440,376,16,51,person
27181,34,person,35,0,9810,16,161,278,169,302,8,24,person
27182,37,person,38,0,9810,15,520,268,531,292,11,24,person
27183,38,person,39,0,9810,18,541,288,550,324,9,36,person
27184,40,person,41,1,9810,17,371,319,393,361,22,42,person
27185,42,person,43,0,9810,15,623,268,637,295,14,27,person
27186,43,person,44,0,9810,19,727,279,739,316,12,37,person
27187,44,person,45,0,9810,19,389,290,401,326,12,36,person
27188,7,truck,8,1,9811,19,327,306,449,359,122,53,truck
27189,3,person,4,0,9812,30,317,77,369,194,52,117,person
27190,4,person,5,0,9812,30,110,96,145,187,35,91,person
27191,5,person,6,0,9812,34,32,93,64,177,32,84,person
27192,6,person,7,0,9812,19,157,113,189,155,32,42,person
27193,7,person,8,0,9812,32,213,86,239,149,26,63,person
27194,8,person,9,0,9812,25,306,86,333,150,27,64,person
27195,9,person,10,0,9812,27,439,90,469,143,30,53,person
27196,10,person,11,0,9812,22,468,86,485,138,17,52,person
27197,11,person,12,0,9812,41,509,71,582,152,73,81,person
27198,12,person,13,0,9812,23,377,82,400,145,23,63,person
27199,13,car,14,0,9813,21,139,359,271,417,132,58,car
27200,17,person,18,0,9813,20,650,365,670,421,20,56,person
27201,18,person,19,0,9813,28,962,368,1006,457,44,89,person
27202,1,person,2,0,25081,144,253,107,631,596,378,489,person
27203,2,person,3,0,25081,102,0,1,186,542,186,541,person
27204,3,person,4,0,25082,76,567,186,644,315,77,129,person
27205,4,person,5,0,25082,73,537,228,596,333,59,105,person
27206,5,person,6,0,25082,102,385,136,463,358,78,222,person
27207,6,person,7,1,25082,52,365,178,400,320,35,142,person
27208,7,person,8,0,25082,76,259,208,318,321,59,113,person
27209,8,person,9,0,25082,67,188,216,246,310,58,94,person
27210,9,person,10,0,25082,63,89,202,135,315,46,113,person
27211,19,chair,20,0,9925,22,707,281,813,408,106,127,chair
27212,20,chair,21,0,9925,18,866,286,972,425,106,139,chair
27213,5,chair,6,0,9929,18,33,98,67,146,34,48,chair
27214,7,chair,8,0,9929,16,165,96,197,143,32,47,chair
27215,9,chair,10,0,9929,16,236,96,270,143,34,47,chair
27216,11,person,12,0,9930,58,852,0,943,211,91,211,person
27217,6,person,7,1,9932,18,101,147,127,168,26,21,person
27218,7,person,8,1,9932,20,33,184,67,218,34,34,person
27219,7,vase,8,1,9937,21,118,473,218,665,100,192,vase
27220,8,vase,9,0,9937,16,1035,454,1108,600,73,146,vase
27221,8,person,9,0,9938,35,61,100,110,165,49,65,person
27222,13,person,14,1,9938,29,20,151,66,202,46,51,person
27223,10,chair,11,1,9939,23,1937,611,2196,1024,259,413,chair
27224,19,person,20,0,9940,57,336,161,464,372,128,211,person
27225,10,chair,11,0,9942,18,234,126,260,156,26,30,chair
27226,11,chair,12,0,9942,20,253,127,281,159,28,32,chair
27227,12,chair,13,0,9942,17,282,134,304,164,22,30,chair
27228,13,chair,14,0,9942,24,307,136,331,167,24,31,chair
27229,9,chair,10,0,9945,17,0,186,157,332,157,146,chair
27230,10,chair,11,0,9945,26,392,159,499,317,107,158,chair
27231,2,person,3,0,9946,55,229,115,399,319,170,204,person
27232,4,person,5,1,9948,19,218,188,249,228,31,40,person
27233,5,person,6,1,9948,15,329,175,361,198,32,23,person
27234,15,chair,16,0,9949,22,22,103,75,161,53,58,chair
27235,16,chair,17,0,9949,21,58,103,105,155,47,52,chair
27236,8,chair,9,0,9950,19,186,62,239,142,53,80,chair
27237,9,chair,10,0,9950,24,274,63,334,146,60,83,chair
27238,14,table,15,1,9953,17,0,350,209,477,209,127,dining table
27239,11,bench,12,0,9954,21,112,167,181,274,69,107,bench
27240,9,chair,10,0,9956,28,83,200,173,313,90,113,chair
27241,5,chair,6,0,9958,26,122,78,171,131,49,53,chair
27242,6,chair,7,0,9958,25,208,80,248,127,40,47,chair
27243,7,chair,8,1,9958,26,294,90,345,174,51,84,chair
27244,9,chair,10,1,9958,15,0,106,35,141,35,35,chair
27245,10,chair,11,1,9958,15,0,114,20,169,20,55,chair
27246,13,table,14,0,9958,39,166,92,223,131,57,39,dining table
27247,6,bench,7,0,25096,19,730,190,936,346,206,156,bench
27248,9,chair,10,1,25096,33,1,210,197,517,196,307,chair
27249,10,chair,11,1,25096,25,3,160,132,282,129,122,chair
27250,14,chair,15,0,25096,37,284,111,372,253,88,142,chair
27251,6,eyeglasses,7,0,9961,18,141,142,177,165,36,23,eye glasses
27252,11,person,12,1,9961,45,203,77,286,178,83,101,person
27253,12,person,13,1,9961,25,286,113,375,196,89,83,person
27254,6,person,7,1,9962,22,323,37,375,105,52,68,person
27255,7,person,8,1,9962,20,260,28,313,96,53,68,person
27256,23,chair,24,0,9963,22,19,646,275,975,256,329,chair
27257,10,chair,11,1,9964,15,1361,466,1598,1198,237,732,chair
27258,6,person,7,1,9966,25,941,517,1216,772,275,255,person
27259,9,chair,10,1,9966,18,958,3,1275,244,317,241,chair
27260,10,chair,11,1,9966,18,752,3,970,183,218,180,chair
27261,11,chair,12,1,9966,16,1263,3,1486,195,223,192,chair
27262,9,person,10,0,10770,28,13,100,28,136,15,36,person
27263,11,person,12,0,10770,30,99,99,115,141,16,42,person
27264,12,person,13,0,10770,19,119,101,130,133,11,32,person
27265,13,person,14,0,10770,26,139,97,151,132,12,35,person
27266,14,person,15,0,10770,26,156,99,169,133,13,34,person
27267,15,person,16,0,10770,25,174,98,185,134,11,36,person
27268,16,person,17,0,10770,23,209,100,223,142,14,42,person
27269,17,person,18,0,10770,32,225,95,247,154,22,59,person
27270,18,person,19,0,10770,25,283,90,304,158,21,68,person
27271,15,person,16,0,10771,30,214,44,237,107,23,63,person
27272,7,person,8,1,10772,39,123,67,152,187,29,120,person
27273,8,person,9,0,10772,35,137,80,162,202,25,122,person
27274,9,person,10,0,10774,45,652,310,848,1007,196,697,person
27275,10,person,11,0,10774,28,1368,373,1501,655,133,282,person
27276,11,chair,12,0,10774,20,920,501,998,617,78,116,chair
27277,12,chair,13,0,10774,17,1017,496,1094,614,77,118,chair
27278,13,chair,14,0,10774,19,1094,494,1168,610,74,116,chair
27279,14,chair,15,0,10774,20,1179,494,1256,606,77,112,chair
27280,15,chair,16,0,10774,17,1257,493,1340,606,83,113,chair
27281,9,chair,10,0,10775,15,793,489,994,692,201,203,chair
27282,6,person,7,0,10776,76,333,30,616,831,283,801,person
27283,10,table,11,0,10776,28,838,296,1089,436,251,140,dining table
27284,11,chair,12,0,10776,19,796,309,906,432,110,123,chair
27285,12,chair,13,0,10776,23,946,319,1054,465,108,146,chair
27286,13,chair,14,0,10776,22,1060,322,1155,449,95,127,chair
27287,15,chair,16,0,10776,16,1165,317,1244,426,79,109,chair
27288,16,chair,17,1,10776,16,1219,338,1278,482,59,144,chair
27289,17,chair,18,1,10776,17,780,292,833,410,53,118,chair
27290,1,person,2,0,10778,70,44,18,96,132,52,114,person
27291,4,person,5,0,10778,92,100,2,184,187,84,185,person
27292,17,car,18,0,203,26,1155,373,1256,412,101,39,car
27293,18,car,19,0,203,16,1286,374,1324,399,38,25,car
27294,25,person,26,0,203,28,2138,293,2174,360,36,67,person
27295,26,person,27,0,203,23,1767,323,1788,379,21,56,person
27296,27,car,28,0,203,33,1421,333,1553,407,132,74,car
27297,47,bench,48,0,203,20,1283,418,1347,448,64,30,bench
27298,48,bench,49,0,203,19,1348,409,1413,442,65,33,bench
27299,67,person,68,1,203,227,922,845,1502,1538,580,693,person
27300,72,person,73,0,203,187,977,894,1477,1650,500,756,person
27301,83,person,84,0,203,20,1894,317,1911,360,17,43,person
27302,84,person,85,0,203,20,1865,316,1877,363,12,47,person
27303,1,person,2,1,204,40,0,137,268,315,268,178,person
27304,0,person,1,0,10919,25,212,153,233,182,21,29,person
27305,13,person,14,0,10919,33,302,141,329,207,27,66,person
27306,14,person,15,1,10919,37,145,109,209,254,64,145,person
27307,15,person,16,0,10919,30,191,136,212,188,21,52,person
27308,16,person,17,0,10919,18,251,146,262,176,11,30,person
27309,29,person,30,0,10919,16,268,148,275,176,7,28,person
27310,30,person,31,0,10919,15,274,150,284,177,10,27,person
27311,31,person,32,0,10919,15,2,145,16,168,14,23,person
27312,6,person,7,0,10920,30,28,12,93,202,65,190,person
27313,9,bench,10,0,10924,16,404,403,447,423,43,20,bench
27314,5,plant pot,6,0,23726,39,219,418,332,501,113,83,potted plant
27315,6,plant pot,7,0,23726,21,351,487,395,549,44,62,potted plant
27316,7,plant pot,8,0,23726,26,446,433,520,507,74,74,potted plant
27317,8,plant pot,9,1,23726,23,526,485,599,537,73,52,potted plant
27318,9,plant pot,10,1,23726,32,532,540,625,599,93,59,potted plant
27319,4,person,5,0,23727,53,586,187,852,721,266,534,person
27320,6,ball,7,0,23727,18,280,655,433,802,153,147,sports ball
27321,7,bicycle,8,0,23727,45,476,186,633,304,157,118,bicycle
27322,3,person,4,0,23728,55,207,371,680,702,473,331,person
27323,8,car,9,0,23729,26,742,524,792,555,50,31,car
27324,10,bench,11,0,23729,18,689,545,716,564,27,19,bench
27325,14,car,15,0,23729,18,624,528,650,546,26,18,car
27326,4,person,5,0,23730,41,48,291,97,433,49,142,person
27327,5,person,6,0,23730,40,267,316,342,421,75,105,person
27328,6,person,7,0,23730,75,462,279,609,521,147,242,person
27329,7,person,8,0,23730,59,654,299,747,475,93,176,person
27330,8,person,9,0,23730,24,589,334,621,418,32,84,person
27331,17,racket,18,0,23730,23,624,358,678,388,54,30,tennis racket
27332,2,horse,3,0,23731,104,89,463,390,664,301,201,horse
27333,5,person,6,0,23732,36,529,300,567,439,38,139,person
27334,3,person,4,1,23733,88,93,148,454,685,361,537,person
27335,1,chair,2,0,23734,102,416,0,1116,956,700,956,chair
27336,2,chair,3,0,23734,50,0,1,328,550,328,549,chair
27337,2,bench,3,0,23735,20,612,153,665,184,53,31,bench
27338,1,bird,2,0,23738,96,667,94,1423,996,756,902,bird
27339,2,person,3,1,23739,112,0,93,721,768,721,675,person
27340,3,bird,4,0,23739,48,578,258,735,503,157,245,bird
27341,18,person,19,1,10999,26,240,381,326,448,86,67,person
27342,12,chair,13,1,11000,21,90,218,133,292,43,74,chair
27343,13,chair,14,0,11000,22,59,235,119,317,60,82,chair
27344,14,chair,15,0,11000,21,186,224,232,305,46,81,chair
27345,15,person,16,0,11001,15,234,163,244,187,10,24,person
27346,16,person,17,0,11001,15,295,166,304,190,9,24,person
27347,10,person,11,0,11002,33,165,196,192,232,27,36,person
27348,24,person,25,0,11002,18,280,134,313,148,33,14,person
27349,65,person,66,0,11002,20,0,126,21,151,21,25,person
27350,66,person,67,0,11002,16,66,88,72,113,6,25,person
27351,69,person,70,0,11002,16,13,117,41,127,28,10,person
27352,2,person,3,1,207,47,0,253,84,638,84,385,person
27353,3,person,4,0,207,137,13,207,218,852,205,645,person
27354,14,person,15,1,207,18,174,435,232,508,58,73,person
27355,16,person,17,1,207,151,172,140,349,852,177,712,person
27356,25,person,26,0,207,107,233,148,479,852,246,704,person
27357,33,ball,34,0,207,20,191,374,270,436,79,62,sports ball
27358,6,door,7,0,208,15,109,142,128,177,19,35,door
27359,8,person,9,1,208,27,0,187,48,371,48,184,person
27360,9,person,10,1,208,18,0,265,48,406,48,141,person
27361,10,person,11,1,208,18,38,233,63,372,25,139,person
27362,19,person,20,1,208,120,0,67,144,413,144,346,person
27363,29,person,30,1,208,33,113,171,151,345,38,174,person
27364,30,person,31,0,208,61,139,163,211,367,72,204,person
27365,40,person,41,1,208,50,173,173,213,310,40,137,person
27366,41,person,42,1,208,93,188,162,262,386,74,224,person
27367,54,person,55,0,208,141,231,121,396,413,165,292,person
27368,67,person,68,1,208,63,338,149,405,359,67,210,person
27369,68,person,69,1,208,106,403,118,499,411,96,293,person
27370,73,person,74,1,208,60,393,145,620,412,227,267,person
27371,74,person,75,1,208,23,552,111,620,178,68,67,person
27372,75,person,76,1,208,19,480,158,620,228,140,70,person
27373,76,person,77,1,208,24,525,152,620,180,95,28,person
27374,78,suitcase,79,1,208,25,374,300,426,385,52,85,suitcase
27375,79,ball,80,0,208,22,9,44,66,90,57,46,sports ball
27376,1,person,2,1,209,49,157,1,466,313,309,312,person
27377,8,bench,9,0,930,18,107,196,194,270,87,74,bench
27378,11,person,11,1,11588,27,166,43,221,141,55,98,person
27379,7,bench,8,0,11589,23,96,215,299,390,203,175,bench
27380,8,bench,9,0,11589,19,33,163,104,236,71,73,bench
27381,6,bench,7,0,11591,25,445,272,558,407,113,135,bench
27382,12,bench,13,0,11591,22,34,259,443,298,409,39,bench
27383,5,bench,6,0,11594,19,129,119,238,240,109,121,bench
27384,3,bench,4,0,11596,28,0,130,170,204,170,74,bench
27385,19,chair,20,0,11598,15,249,266,296,347,47,81,chair
27386,1,bench,2,0,23815,19,3,870,1190,1159,1187,289,bench
27387,2,bench,3,0,23815,23,1146,771,2196,1045,1050,274,bench
27388,2,person,3,0,210,131,52,184,301,453,249,269,person
27389,17,person,18,1,11712,23,250,168,294,250,44,82,person
27390,18,person,19,1,11712,18,239,179,282,256,43,77,person
27391,19,person,20,1,11712,24,218,173,272,261,54,88,person
27392,20,person,21,1,11712,25,197,172,249,263,52,91,person
27393,21,person,22,1,11712,29,174,161,235,271,61,110,person
27394,22,person,23,1,11712,30,130,146,217,279,87,133,person
27395,23,person,24,0,11712,34,86,159,188,301,102,142,person
27396,24,person,25,0,11712,44,23,153,145,331,122,178,person
27397,25,person,26,0,11712,16,590,206,625,239,35,33,person
27398,3,person,4,0,11713,61,0,2,79,214,79,212,person
27399,4,person,5,0,11713,73,39,37,161,239,122,202,person
27400,5,person,6,1,11713,22,150,39,170,138,20,99,person
27401,6,person,7,0,11713,48,155,33,198,148,43,115,person
27402,7,person,8,1,11713,19,187,92,218,130,31,38,person
27403,8,person,9,1,11713,34,190,60,252,163,62,103,person
27404,9,person,10,0,11713,45,203,41,291,158,88,117,person
27405,10,person,11,1,11714,37,103,132,229,193,126,61,person
27406,11,person,12,0,11714,39,120,83,200,228,80,145,person
27407,4,person,5,0,11715,50,154,137,242,265,88,128,person
27408,5,person,6,0,11715,50,231,115,305,230,74,115,person
27409,6,person,7,0,11715,56,16,117,106,255,90,138,person
27410,9,person,10,0,11715,30,291,101,341,190,50,89,person
27411,10,person,11,0,11715,41,87,112,156,221,69,109,person
27412,11,person,12,1,11715,26,115,97,161,170,46,73,person
27413,12,person,13,1,11715,26,164,104,206,153,42,49,person
27414,13,person,14,1,11715,27,208,95,254,161,46,66,person
27415,14,person,15,1,11715,16,252,88,278,123,26,35,person
27416,15,person,16,1,11715,42,327,92,366,168,39,76,person
27417,16,person,17,1,11715,34,358,94,390,152,32,58,person
27418,17,person,18,1,11715,24,280,86,316,141,36,55,person
27419,18,person,19,1,11715,22,270,76,293,124,23,48,person
27420,19,person,20,1,11715,28,129,81,164,140,35,59,person
27421,20,person,21,1,11715,24,76,92,106,150,30,58,person
27422,21,person,22,1,11715,20,98,79,122,112,24,33,person
27423,22,person,23,1,11715,22,27,99,73,143,46,44,person
27424,23,person,24,1,11715,18,11,93,40,141,29,48,person
27425,24,person,25,1,11715,22,56,88,81,133,25,45,person
27426,25,person,26,1,11715,19,165,93,190,130,25,37,person
27427,26,person,27,1,11715,19,190,71,210,106,20,35,person
27428,27,person,28,1,11715,19,226,70,248,101,22,31,person
27429,28,person,29,1,11715,22,346,76,368,124,22,48,person
27430,29,person,30,1,11715,28,373,84,399,141,26,57,person
27431,0,person,1,0,11716,19,154,67,211,239,57,172,person
27432,4,person,4,0,11716,22,22,36,86,239,64,203,person
27433,20,person,20,0,11716,38,233,108,306,200,73,92,person
27434,21,person,21,1,11716,28,261,69,304,137,43,68,person
27435,22,person,22,1,11716,26,252,71,273,141,21,70,person
27436,23,person,23,0,11716,36,203,72,242,147,39,75,person
27437,26,person,26,1,11716,22,160,69,179,118,19,49,person
27438,27,person,27,1,11716,26,132,66,156,133,24,67,person
27439,28,person,28,0,11716,77,68,42,145,211,77,169,person
27440,29,person,29,1,11716,34,8,58,35,151,27,93,person
27441,30,person,30,1,11716,25,0,59,20,163,20,104,person
27442,2,door,3,1,11717,18,237,3,571,302,334,299,door
27443,3,person,4,1,11717,70,65,85,730,644,665,559,person
27444,4,person,5,1,11717,66,41,309,922,876,881,567,person
27445,16,person,17,0,11718,67,93,31,470,482,377,451,person
27446,5,person,6,0,11719,74,782,442,1480,1541,698,1099,person
27447,7,person,8,0,11720,87,36,49,187,310,151,261,person
27448,26,person,27,0,11721,99,655,393,876,860,221,467,person
27449,4,window,5,1,11722,19,190,22,218,100,28,78,window
27450,7,mirror,8,1,11722,30,25,82,100,135,75,53,mirror
27451,8,person,9,0,11722,40,45,81,76,167,31,86,person
27452,9,person,10,0,11722,39,187,81,226,180,39,99,person
27453,10,person,11,0,11722,62,95,78,181,205,86,127,person
27454,5,person,6,1,11723,85,102,330,351,617,249,287,person
27455,6,person,7,0,11723,176,229,149,806,996,577,847,person
27456,7,person,8,1,11723,79,636,237,823,680,187,443,person
27457,8,person,9,0,11723,106,791,217,1168,714,377,497,person
27458,10,person,11,1,11723,17,1280,246,1405,308,125,62,person
27459,3,person,4,0,21509,143,49,19,544,1153,495,1134,person
27460,2,person,3,1,23856,125,612,372,1600,966,988,594,person
27461,3,person,4,1,23856,191,2,440,1567,1231,1565,791,person
27462,1,person,2,0,23857,63,616,190,797,436,181,246,person
27463,2,person,3,0,23857,77,489,153,582,529,93,376,person
27464,3,person,4,0,23857,61,402,179,504,377,102,198,person
27465,4,person,5,0,23857,72,2,141,120,451,118,310,person
27466,5,person,6,0,23857,82,119,144,381,529,262,385,person
27467,10,window,11,0,23857,21,0,2,376,162,376,160,window
27468,18,person,19,1,23858,28,81,252,195,328,114,76,person
27469,19,person,20,0,23858,43,255,245,359,337,104,92,person
27470,20,person,21,0,23858,34,419,228,500,293,81,65,person
27471,21,person,22,0,23858,41,453,252,601,345,148,93,person
27472,22,person,23,1,23858,21,721,248,799,311,78,63,person
27473,23,person,24,1,23858,17,726,303,799,350,73,47,person
27474,24,person,25,0,23858,42,582,126,659,255,77,129,person
27475,2,door,3,0,23859,15,0,292,180,750,180,458,door
27476,3,person,4,1,23859,18,839,750,907,1009,68,259,person
27477,4,person,5,1,23859,51,586,732,907,1111,321,379,person
27478,5,person,6,1,23859,19,656,585,730,755,74,170,person
27479,6,person,7,0,23859,31,398,847,591,1107,193,260,person
27480,7,person,8,1,23859,28,250,611,363,815,113,204,person
27481,8,person,9,1,23859,42,66,654,310,947,244,293,person
27482,9,person,10,1,23859,31,0,629,116,954,116,325,person
27483,10,person,11,1,23859,18,0,742,39,1067,39,325,person
27484,11,person,12,0,23859,47,25,713,301,1082,276,369,person
27485,12,person,13,0,23859,147,156,84,790,1309,634,1225,person
27486,1,person,2,1,23860,85,407,1,680,1024,273,1023,person
27487,2,person,3,1,23860,74,94,8,510,1024,416,1016,person
27488,4,horse,5,0,11814,81,311,100,552,281,241,181,horse
27489,12,person,13,0,11815,36,75,134,112,219,37,85,person
27490,8,horse,9,1,11816,17,540,179,587,221,47,42,horse
27491,29,person,30,0,11817,48,259,24,349,229,90,205,person
27492,19,person,20,0,11819,45,1854,565,2027,1159,173,594,person
27493,20,person,21,1,11819,40,1998,596,2121,968,123,372,person
27494,21,person,22,1,11819,19,1793,663,1860,829,67,166,person
27495,22,person,23,1,11819,24,1669,632,1786,932,117,300,person
27496,23,person,24,1,11819,24,1614,650,1675,933,61,283,person
27497,25,person,26,0,11819,32,1550,724,1626,936,76,212,person
27498,26,person,27,0,11819,31,1385,755,1451,937,66,182,person
27499,27,person,28,0,11819,31,1445,715,1509,937,64,222,person
27500,28,person,29,1,11819,24,1536,628,1632,777,96,149,person
27501,29,person,30,1,11819,36,1447,627,1547,910,100,283,person
27502,30,person,31,1,11819,19,1409,666,1460,774,51,108,person
27503,31,person,32,1,11819,21,1376,716,1414,884,38,168,person
27504,32,person,33,1,11819,37,1352,634,1424,882,72,248,person
27505,33,person,34,1,11819,28,1281,654,1352,840,71,186,person
27506,34,person,35,1,11819,21,1252,651,1289,826,37,175,person
27507,35,person,36,0,11819,40,1189,615,1275,882,86,267,person
27508,36,person,37,1,11819,18,1145,607,1206,703,61,96,person
27509,37,person,38,0,11819,21,1155,695,1191,866,36,171,person
27510,38,person,39,0,11819,31,1086,611,1160,872,74,261,person
27511,39,person,40,1,11819,27,916,589,1008,829,92,240,person
27512,40,person,41,0,11819,39,1011,582,1099,872,88,290,person
27513,41,person,42,1,11819,34,726,573,803,907,77,334,person
27514,42,person,43,1,11819,34,761,590,827,916,66,326,person
27515,43,person,44,0,11819,40,588,617,699,888,111,271,person
27516,44,person,45,0,11819,39,383,596,474,903,91,307,person
27517,46,person,47,0,11819,34,253,588,348,906,95,318,person
27518,47,person,48,0,11819,39,199,662,290,921,91,259,person
27519,4,person,5,1,11820,58,67,116,229,798,162,682,person
27520,5,person,6,0,11820,77,158,65,473,926,315,861,person
27521,9,person,10,1,11820,17,194,43,291,196,97,153,person
27522,15,person,16,0,11820,54,435,20,557,401,122,381,person
27523,17,person,18,0,11820,73,500,0,729,524,229,524,person
27524,27,vase,28,0,11820,16,869,117,911,187,42,70,vase
27525,30,person,31,0,11820,54,680,10,835,421,155,411,person
27526,36,person,37,0,11820,48,900,72,1009,546,109,474,person
27527,37,person,38,0,11820,72,961,0,1206,584,245,584,person
27528,38,person,39,1,11820,49,1119,19,1279,564,160,545,person
27529,5,car,6,0,11821,15,403,90,427,101,24,11,car
27530,38,person,39,1,11821,21,76,63,91,113,15,50,person
27531,40,person,41,0,11821,15,30,87,39,112,9,25,person
27532,5,bench,6,0,11823,21,230,250,305,299,75,49,bench
27533,6,person,7,0,11823,34,236,212,267,301,31,89,person
27534,14,person,15,0,11823,56,150,193,202,324,52,131,person
27535,15,person,16,0,11823,40,328,219,360,342,32,123,person
27536,30,person,31,0,11824,39,119,66,167,163,48,97,person
27537,31,person,32,0,11824,32,88,70,127,161,39,91,person
27538,32,person,33,0,11824,40,46,64,87,167,41,103,person
27539,47,person,48,1,11824,15,237,87,244,104,7,17,person
27540,7,table,8,0,11881,18,0,128,41,173,41,45,dining table
27541,8,person,9,1,11882,47,801,625,1122,1191,321,566,person
27542,9,person,10,1,11882,21,464,658,614,841,150,183,person
27543,5,door,6,0,11887,27,103,860,301,1361,198,501,door
27544,6,person,7,1,11887,23,21,964,108,1369,87,405,person
27545,10,car,11,1,11887,16,0,815,169,933,169,118,car
27546,2,person,3,1,11888,16,157,31,175,83,18,52,person
27547,3,person,4,0,11888,52,118,28,174,193,56,165,person
27548,10,car,11,1,11889,19,1493,502,1587,623,94,121,car
27549,11,car,12,1,11889,20,1603,524,1777,630,174,106,car
27550,13,car,14,1,11889,15,1657,545,1799,723,142,178,car
27551,16,person,17,1,11889,21,1639,829,1798,991,159,162,person
27552,17,person,18,0,11889,31,657,553,743,922,86,369,person
27553,18,person,19,0,11889,50,385,526,524,888,139,362,person
27554,2,person,3,1,13841,87,64,3,343,299,279,296,person
27555,3,person,4,1,13841,41,45,87,144,299,99,212,person
27556,4,person,5,1,13841,46,286,125,400,299,114,174,person
27557,8,person,9,1,13841,15,0,178,35,299,35,121,person
27558,4,sofa,5,0,13842,17,93,147,250,227,157,80,couch
27559,5,sofa,6,0,13842,20,244,174,516,344,272,170,couch
27560,6,sofa,7,0,13842,21,491,164,699,374,208,210,couch
27561,24,sofa,25,0,13843,16,470,258,668,365,198,107,couch
27562,6,person,7,0,13844,30,204,442,324,820,120,378,person
27563,7,person,8,1,13844,25,291,467,409,950,118,483,person
27564,8,person,9,1,13844,21,394,440,533,727,139,287,person
27565,9,person,10,0,13844,26,479,508,663,1018,184,510,person
27566,12,person,13,1,13844,17,737,407,861,547,124,140,person
27567,13,person,14,1,13844,26,712,514,898,1018,186,504,person
27568,15,person,16,1,13844,17,599,469,671,690,72,221,person
27569,16,person,17,1,13844,20,270,723,564,1020,294,297,person
27570,17,person,18,1,13844,23,0,677,283,1020,283,343,person
27571,19,person,20,1,13844,29,640,444,789,997,149,553,person
27572,20,person,21,1,13844,22,886,460,1010,875,124,415,person
27573,21,person,22,1,13844,23,993,642,1255,1020,262,378,person
27574,25,person,26,1,13844,16,657,314,731,421,74,107,person
27575,26,person,27,1,13844,16,465,320,533,403,68,83,person
27576,1,person,2,0,13846,35,2,94,64,252,62,158,person
27577,2,person,3,1,13846,24,32,103,58,237,26,134,person
27578,4,person,5,0,13846,27,227,89,259,193,32,104,person
27579,5,person,6,1,13846,24,218,102,236,178,18,76,person
27580,9,person,10,1,13846,26,182,100,202,177,20,77,person
27581,10,person,11,0,13846,29,162,95,183,190,21,95,person
27582,11,person,12,1,13846,27,146,101,166,186,20,85,person
27583,12,person,13,0,13846,32,127,108,154,191,27,83,person
27584,14,person,15,0,13846,28,56,100,77,200,21,100,person
27585,15,person,16,0,13846,26,115,104,131,189,16,85,person
27586,16,person,17,1,13846,20,74,88,94,138,20,50,person
27587,22,person,23,1,13846,15,92,128,111,163,19,35,person
27588,2,person,3,1,232,47,407,155,542,273,135,118,person
27589,7,person,8,1,232,73,281,55,427,304,146,249,person
27590,15,person,16,1,232,134,88,20,532,402,444,382,person
27591,19,person,20,1,232,115,402,13,664,412,262,399,person
27592,26,person,27,0,232,98,465,103,825,480,360,377,person
27593,37,person,38,0,232,103,2,109,356,471,354,362,person
27594,2,person,3,1,233,63,126,59,388,333,262,274,person
27595,10,person,11,1,233,64,261,4,500,334,239,330,person
27596,9,person,10,0,234,66,319,89,532,565,213,476,person
27597,11,person,12,0,234,26,159,193,172,217,13,24,person
27598,12,person,13,0,235,109,406,89,548,550,142,461,person
27599,28,person,29,0,235,108,591,110,724,565,133,455,person
27600,2,car,3,0,236,19,847,118,889,134,42,16,car
27601,22,bench,23,1,236,159,230,200,805,474,575,274,bench
27602,23,person,24,0,236,198,253,32,494,503,241,471,person
27603,13,bench,14,1,237,68,13,689,524,1199,511,510,bench
27604,14,person,15,0,237,95,243,620,622,1213,379,593,person
27605,2,car,3,0,14997,17,93,1340,239,1414,146,74,car
27606,4,car,5,1,14997,17,249,1332,406,1386,157,54,car
27607,14,bench,15,0,14997,17,850,1376,914,1440,64,64,bench
27608,15,person,16,0,14997,19,898,1311,931,1437,33,126,person
27609,16,bench,17,0,14997,19,1500,1382,1570,1428,70,46,bench
27610,17,bench,18,0,14997,15,1574,1378,1624,1425,50,47,bench
27611,19,bench,20,0,14997,24,1251,1386,1356,1446,105,60,bench
27612,9,bench,10,0,14998,36,1426,1011,1638,1106,212,95,bench
27613,10,person,11,0,14998,35,1409,976,1499,1109,90,133,person
27614,11,person,12,1,14998,17,1545,952,1623,1016,78,64,person
27615,13,person,14,1,14998,89,2063,783,2197,1419,134,636,person
27616,20,person,21,0,14998,19,556,968,601,1042,45,74,person
27617,23,person,24,0,14998,22,53,958,87,1042,34,84,person
27618,30,bicycle,31,0,14998,33,654,968,737,1035,83,67,bicycle
27619,31,person,32,0,14998,24,634,964,675,1035,41,71,person
27620,3,person,4,1,14999,16,969,708,1061,843,92,135,person
27621,4,person,5,1,14999,16,858,696,947,783,89,87,person
27622,7,person,8,0,14999,22,251,805,295,962,44,157,person
27623,12,person,13,0,14999,36,1412,715,1509,944,97,229,person
27624,13,person,14,0,14999,38,1466,736,1566,949,100,213,person
27625,11,person,12,1,15000,17,1864,1047,1914,1100,50,53,person
27626,12,person,13,0,15000,17,1835,1068,1902,1129,67,61,person
27627,13,person,14,0,15000,21,2025,1192,2130,1303,105,111,person
27628,19,person,20,0,15000,16,213,1118,262,1168,49,50,person
27629,23,person,24,0,15000,19,722,1081,772,1144,50,63,person
27630,24,person,25,0,15000,24,944,1022,983,1133,39,111,person
27631,25,person,26,0,15000,20,912,1084,950,1143,38,59,person
27632,26,person,27,0,15000,18,1035,1090,1111,1148,76,58,person
27633,27,person,28,0,15000,17,1227,1080,1275,1146,48,66,person
27634,28,person,29,0,15000,26,1533,1021,1585,1171,52,150,person
27635,30,person,31,0,15000,16,828,1047,867,1098,39,51,person
27636,24,person,25,0,15001,22,225,1170,269,1365,44,195,person
27637,25,person,26,0,15001,21,267,1179,312,1360,45,181,person
27638,28,person,29,0,15002,21,611,909,645,1012,34,103,person
27639,16,person,16,0,15003,21,94,889,145,1051,51,162,person
27640,17,person,17,0,15003,19,172,899,222,1053,50,154,person
27641,18,person,18,0,15003,15,416,906,454,1066,38,160,person
27642,19,person,19,0,15003,19,246,892,324,1073,78,181,person
27643,21,person,21,0,15003,15,1145,980,1255,1028,110,48,person
27644,26,person,26,0,15003,18,144,894,178,1032,34,138,person
27645,10,person,11,0,15004,21,1340,1159,1399,1271,59,112,person
27646,12,person,13,0,15004,18,423,1106,469,1200,46,94,person
27647,18,person,19,0,15005,31,527,1227,616,1455,89,228,person
27648,21,person,22,0,15005,18,1865,1172,1906,1269,41,97,person
27649,29,person,30,0,15005,18,1375,1204,1406,1265,31,61,person
27650,30,person,31,0,15005,15,1339,1207,1355,1268,16,61,person
27651,7,person,8,1,15006,29,761,1279,885,1579,124,300,person
27652,10,person,11,1,15006,31,373,1337,501,1559,128,222,person
27653,22,person,23,1,15006,22,2,1306,113,1477,111,171,person
27654,23,person,24,1,15006,26,2,1401,115,1858,113,457,person
27655,25,person,26,1,15006,16,1414,1399,1538,2048,124,649,person
27656,1,person,2,0,15009,19,397,992,749,1626,352,634,person
27657,8,table,9,0,15009,20,1273,1109,1678,1384,405,275,dining table
27658,9,bench,10,0,15009,17,1159,1188,1511,1390,352,202,bench
27659,11,person,12,1,15009,23,269,954,347,1123,78,169,person
27660,12,table,13,1,15009,17,42,1157,873,1634,831,477,dining table
27661,13,bench,14,0,15009,32,493,1286,1036,1643,543,357,bench
27662,34,person,35,1,15009,26,936,970,999,1082,63,112,person
27663,35,person,36,1,15009,18,914,991,947,1079,33,88,person
27664,36,person,37,0,15009,35,840,979,898,1115,58,136,person
27665,37,person,38,1,15009,21,426,967,468,1084,42,117,person
27666,38,person,39,1,15009,34,163,944,270,1095,107,151,person
27667,39,bicycle,40,1,15009,75,0,1032,223,1267,223,235,bicycle
27668,40,person,41,1,15009,39,1291,1014,1333,1109,42,95,person
27669,41,person,42,0,15009,36,1415,1038,1446,1115,31,77,person
27670,42,person,43,1,15009,25,1629,1000,1682,1145,53,145,person
27671,7,person,7,0,15011,16,984,7,1201,246,217,239,person
27672,9,bench,9,0,15011,30,123,3,579,213,456,210,bench
27673,10,bench,10,0,15011,29,493,8,1003,240,510,232,bench
27674,11,bench,11,0,15011,26,1122,3,1496,249,374,246,bench
27675,4,bench,5,0,15014,21,109,735,314,800,205,65,bench
27676,6,person,7,0,15014,23,1533,689,1600,797,67,108,person
27677,8,person,9,0,15014,19,1714,709,1763,785,49,76,person
27678,9,person,10,0,15014,21,1862,637,1891,787,29,150,person
27679,24,person,25,0,15015,15,401,1014,423,1067,22,53,person
27680,25,person,26,0,15015,17,439,1012,457,1076,18,64,person
27681,26,person,27,0,15015,20,339,1009,359,1071,20,62,person
27682,1,bench,2,0,15016,19,543,967,636,1071,93,104,bench
27683,2,bench,3,0,15016,20,719,999,866,1121,147,122,bench
27684,9,bench,10,1,15016,31,1879,1121,2044,1452,165,331,bench
27685,6,bench,7,0,15017,39,4,968,300,1053,296,85,bench
27686,10,person,11,0,15017,43,1348,926,1409,1094,61,168,person
27687,11,person,12,0,15017,37,1278,931,1331,1100,53,169,person
27688,12,person,13,0,15017,56,1218,922,1299,1112,81,190,person
27689,18,person,19,0,15017,16,781,904,800,953,19,49,person
27690,19,person,20,0,15017,16,756,910,775,953,19,43,person
27691,0,bench,1,0,15018,21,996,1125,1374,1333,378,208,bench
27692,1,person,2,0,15018,29,753,829,822,1010,69,181,person
27693,2,bench,3,0,15018,16,203,921,367,964,164,43,bench
27694,4,person,5,0,15018,30,406,800,486,993,80,193,person
27695,5,person,6,0,15018,26,713,819,768,1008,55,189,person
27696,2,bench,3,0,15020,23,104,338,202,383,98,45,bench
27697,3,bench,4,0,15020,20,62,307,103,331,41,24,bench
27698,4,bench,5,0,15020,16,203,296,239,315,36,19,bench
27699,1,bench,2,0,15021,34,590,1025,1901,1376,1311,351,bench
27700,6,person,7,0,15021,16,643,493,706,548,63,55,person
27701,10,person,11,0,15021,25,1870,411,1928,568,58,157,person
27702,11,person,12,1,15021,17,1841,423,1885,568,44,145,person
27703,9,bench,10,0,15022,15,1283,957,1399,1008,116,51,bench
27704,13,person,14,0,15022,21,2002,924,2031,1015,29,91,person
27705,4,person,5,0,15023,44,267,98,385,317,118,219,person
27706,5,car,6,0,15023,76,1526,194,1905,341,379,147,car
27707,6,person,7,0,15023,51,429,104,506,336,77,232,person
27708,8,hat,9,0,15023,17,1435,115,1469,138,34,23,hat
27709,13,person,14,0,15023,32,1407,109,1478,318,71,209,person
27710,14,truck,15,0,15023,41,944,116,1174,244,230,128,truck
27711,21,car,22,0,15023,33,812,138,984,214,172,76,car
27712,22,car,23,0,15023,19,342,111,508,178,166,67,car
27713,23,car,24,1,15023,27,1934,194,2199,388,265,194,car
27714,32,door,33,0,15023,17,2034,202,2193,367,159,165,door
27715,8,bird,9,0,15024,23,555,595,615,672,60,77,bird
27716,6,person,7,0,15026,20,54,779,86,851,32,72,person
27717,22,person,23,0,15026,26,1166,821,1191,890,25,69,person
27718,24,person,25,0,15026,23,1261,815,1280,869,19,54,person
27719,31,bench,32,0,15026,16,1844,890,1914,908,70,18,bench
27720,7,person,8,0,15027,16,483,704,550,857,67,153,person
27721,8,person,9,0,15027,18,560,705,612,850,52,145,person
27722,9,person,10,0,15027,15,608,719,662,835,54,116,person
27723,13,person,14,0,15027,16,782,735,851,865,69,130,person
27724,1,person,2,0,15028,16,827,871,854,949,27,78,person
27725,2,person,3,0,15028,30,1093,952,1144,1115,51,163,person
27726,3,person,4,0,15028,19,960,910,1008,1034,48,124,person
27727,5,person,6,0,15028,20,885,925,937,1032,52,107,person
27728,12,bench,13,0,15028,18,558,899,745,1060,187,161,bench
27729,28,person,27,0,15028,19,1738,909,1782,1038,44,129,person
27730,4,person,5,0,15029,27,168,984,260,1137,92,153,person
27731,7,person,8,0,15029,19,1601,1022,1664,1118,63,96,person
27732,15,bench,16,0,15029,17,1035,1040,1167,1109,132,69,bench
27733,17,person,18,0,15029,23,807,1027,845,1158,38,131,person
27734,18,person,19,1,15029,19,957,1009,995,1136,38,127,person
27735,19,person,20,0,15029,31,936,1044,988,1181,52,137,person
27736,20,bench,21,0,15029,15,873,1015,947,1052,74,37,bench
27737,21,person,22,0,15029,27,682,1016,715,1107,33,91,person
27738,22,person,23,0,15029,21,845,968,874,1058,29,90,person
27739,23,person,24,0,15029,23,1328,1078,1380,1123,52,45,person
27740,26,person,27,0,15029,21,380,1045,408,1114,28,69,person
27741,27,person,28,0,15029,25,116,1011,152,1126,36,115,person
27742,16,person,10,0,15030,22,1732,867,1778,1006,46,139,person
27743,17,person,11,0,15030,26,1770,880,1840,1019,70,139,person
27744,18,person,12,0,15030,25,1815,891,1894,1021,79,130,person
27745,19,person,13,0,15030,23,543,864,582,950,39,86,person
27746,39,person,33,0,15030,34,1513,851,1559,1003,46,152,person
27747,40,person,34,0,15030,31,1581,851,1620,1021,39,170,person
27748,44,bench,38,0,15030,15,1434,917,1519,954,85,37,bench
27749,55,person,49,1,15030,15,678,829,703,898,25,69,person
27750,56,person,50,1,15030,17,666,831,683,898,17,67,person
27751,57,person,51,0,15030,19,850,834,874,902,24,68,person
27752,58,person,52,0,15030,66,1928,820,2048,1224,120,404,person
27753,0,person,1,0,15031,21,881,829,1005,1148,124,319,person
27754,2,car,3,0,15031,21,1018,870,1172,958,154,88,car
27755,19,car,16,1,15031,19,495,852,696,958,201,106,car
27756,9,person,10,0,15032,20,842,1116,957,1154,115,38,person
27757,23,person,24,0,15032,26,293,1035,354,1148,61,113,person
27758,0,person,1,0,15035,18,802,837,917,1135,115,298,person
27759,15,car,15,0,15035,19,1897,901,1957,924,60,23,car
27760,25,person,25,0,15035,34,1242,865,1267,939,25,74,person
27761,27,person,27,1,15035,21,1967,926,1992,957,25,31,person
27762,28,person,28,1,15035,21,1989,932,2018,961,29,29,person
27763,29,person,29,0,15035,18,1651,882,1679,911,28,29,person
27764,30,person,30,1,15035,17,1618,883,1642,909,24,26,person
27765,0,bench,1,0,15036,17,239,489,963,1012,724,523,bench
27766,1,person,2,0,15037,17,221,501,379,855,158,354,person
27767,14,person,15,1,15037,31,2118,611,2194,1491,76,880,person
27768,15,person,16,0,15037,31,93,518,173,719,80,201,person
27769,16,person,17,0,15037,33,2,484,86,906,84,422,person
27770,24,bench,25,0,15037,26,403,586,509,695,106,109,bench
27771,28,person,29,0,15037,19,387,568,460,674,73,106,person
27772,31,person,32,0,15037,16,210,542,236,617,26,75,person
27773,34,person,35,0,15037,17,1665,574,1699,681,34,107,person
27774,1,person,2,0,15038,29,207,932,277,1065,70,133,person
27775,4,person,5,1,15038,22,819,982,872,1090,53,108,person
27776,9,person,10,0,15038,26,1155,995,1219,1116,64,121,person
27777,1,pot,2,0,15039,20,217,983,639,1373,422,390,potted plant
27778,56,chair,57,0,15039,18,1042,756,1157,934,115,178,chair
27779,24,person,25,0,15041,39,2073,980,2200,1426,127,446,person
27780,25,person,26,0,15041,21,1664,968,1711,1097,47,129,person
27781,6,person,7,0,15042,22,652,865,703,1008,51,143,person
27782,7,person,8,0,15042,20,727,875,793,1008,66,133,person
27783,8,person,9,0,15042,20,819,884,855,1078,36,194,person
27784,10,person,11,0,15042,15,1655,901,1708,1034,53,133,person
27785,11,person,12,0,15042,17,1933,909,1998,1061,65,152,person
27786,14,person,15,0,15042,27,872,858,959,1097,87,239,person
27787,15,person,16,0,15042,28,1174,909,1261,1145,87,236,person
27788,16,person,17,0,15042,21,971,865,1027,1090,56,225,person
27789,3,person,4,0,15045,37,1817,667,1960,1085,143,418,person
27790,4,person,5,0,15045,48,1534,744,1829,1012,295,268,person
27791,19,bench,20,0,15045,16,823,533,925,555,102,22,bench
27792,23,person,24,1,15045,18,1732,541,1800,642,68,101,person
27793,24,person,25,0,15045,33,1745,565,1821,751,76,186,person
27794,25,person,26,1,15045,20,1992,555,2046,816,54,261,person
27795,30,person,31,0,15045,23,731,463,762,567,31,104,person
27796,31,person,32,0,15045,19,561,463,592,551,31,88,person
27797,32,person,33,0,15045,21,619,469,652,551,33,82,person
27798,33,person,34,0,15045,23,1160,484,1201,578,41,94,person
27799,36,person,37,0,15045,15,1189,484,1213,573,24,89,person
27800,38,person,39,0,15045,18,347,460,376,534,29,74,person
27801,39,bird,40,0,15045,16,80,1094,160,1155,80,61,bird
27802,45,person,46,0,15045,33,759,473,788,564,29,91,person
27803,46,person,47,0,15045,24,1115,504,1151,532,36,28,person
27804,47,person,48,0,15045,16,1098,501,1115,528,17,27,person
27805,48,person,49,0,15045,20,1063,504,1092,530,29,26,person
27806,49,person,50,0,15045,21,1059,475,1078,519,19,44,person
27807,50,person,51,0,15045,25,1078,473,1095,521,17,48,person
27808,52,person,53,1,15045,22,589,466,613,550,24,84,person
27809,8,person,9,0,15046,27,238,907,293,1086,55,179,person
27810,9,person,10,0,15046,30,304,907,376,1096,72,189,person
27811,10,person,11,0,15046,26,506,893,532,1004,26,111,person
27812,11,person,12,0,15046,30,446,895,483,1003,37,108,person
27813,18,boat,19,0,15046,34,1755,887,2198,993,443,106,boat
27814,19,person,20,1,15046,17,1930,871,1975,931,45,60,person
27815,26,person,27,0,15046,16,949,759,980,836,31,77,person
27816,27,person,28,0,15046,21,1109,759,1140,836,31,77,person
27817,12,person,13,0,15047,15,678,279,707,309,29,30,person
27818,0,bench,1,0,15049,22,385,328,612,441,227,113,bench
27819,12,bicycle,13,1,15049,19,694,380,800,600,106,220,bicycle
27820,0,person,1,0,15050,30,946,732,1097,1181,151,449,person
27821,1,person,2,0,15050,31,1071,739,1201,1184,130,445,person
27822,18,person,19,0,15051,21,717,651,756,809,39,158,person
27823,19,person,20,0,15051,18,1711,615,1756,745,45,130,person
27824,20,person,21,0,15051,23,1896,602,1949,770,53,168,person
27825,21,person,22,0,15051,16,1541,619,1579,751,38,132,person
27826,4,bench,5,0,15052,30,224,850,338,1023,114,173,bench
27827,8,person,9,0,15052,27,689,687,749,827,60,140,person
27828,9,dog,10,0,15052,23,760,771,835,817,75,46,dog
27829,6,bench,7,0,15053,56,1719,1021,1950,1167,231,146,bench
27830,7,bench,8,0,15053,51,1940,1024,2197,1234,257,210,bench
27831,13,bench,14,0,15053,41,270,993,364,1042,94,49,bench
27832,15,person,16,0,15053,20,386,976,440,1045,54,69,person
27833,19,person,20,0,15053,26,1335,943,1372,1063,37,120,person
27834,20,person,21,0,15053,24,1431,929,1459,1042,28,113,person
27835,54,person,55,0,15053,19,2099,912,2123,971,24,59,person
27836,55,person,56,0,15053,19,2125,916,2147,975,22,59,person
27837,4,person,5,0,15054,16,1061,851,1099,942,38,91,person
27838,14,person,15,0,15054,19,1788,841,1832,964,44,123,person
27839,15,person,16,0,15054,19,1877,838,1918,950,41,112,person
27840,16,person,17,0,15054,19,1839,848,1877,959,38,111,person
27841,23,person,24,0,15054,17,41,876,80,953,39,77,person
27842,24,person,25,0,15054,18,182,868,210,959,28,91,person
27843,1,bench,2,0,15056,15,960,925,1264,1092,304,167,bench
27844,0,person,1,0,15057,66,169,1032,280,1368,111,336,person
27845,1,person,2,0,15057,36,633,1072,700,1253,67,181,person
27846,7,person,8,0,15058,15,1338,885,1388,938,50,53,person
27847,10,person,11,0,15058,15,854,963,907,1019,53,56,person
27848,11,person,12,0,15058,20,342,965,384,1124,42,159,person
27849,25,car,26,1,15060,17,2101,951,2199,1226,98,275,car
27850,4,person,5,0,15062,19,616,1018,699,1119,83,101,person
27851,5,person,6,0,15062,22,430,1074,512,1244,82,170,person
27852,6,person,7,0,15062,29,505,1088,670,1263,165,175,person
27853,0,person,1,0,15063,17,925,869,1031,1211,106,342,person
27854,1,person,2,0,15063,16,1018,953,1114,1211,96,258,person
27855,5,person,6,0,15064,44,1323,425,1455,824,132,399,person
27856,6,person,7,0,15064,36,1674,471,1740,689,66,218,person
27857,7,person,8,1,15064,30,548,428,660,925,112,497,person
27858,8,person,9,0,15064,45,483,420,623,959,140,539,person
27859,9,person,10,0,15064,50,97,341,307,983,210,642,person
27860,20,person,21,0,15064,25,834,462,880,611,46,149,person
27861,21,person,22,0,15064,23,945,478,988,626,43,148,person
27862,25,chair,26,0,15064,24,1051,525,1114,617,63,92,chair
27863,26,person,27,1,15064,30,1437,474,1491,740,54,266,person
27864,27,person,28,0,15064,25,1539,516,1577,616,38,100,person
27865,28,person,29,0,15064,25,1753,497,1800,622,47,125,person
27866,31,person,32,1,15064,16,1958,521,2048,676,90,155,person
27867,8,bench,9,0,15065,20,314,1109,455,1258,141,149,bench
27868,9,person,10,0,15065,36,335,944,500,1249,165,305,person
27869,10,person,11,0,15065,34,193,897,276,1079,83,182,person
27870,12,person,13,0,15065,36,767,892,890,1114,123,222,person
27871,13,person,14,0,15065,21,878,900,989,1055,111,155,person
27872,14,person,15,0,15065,33,975,881,1135,1114,160,233,person
27873,15,table,16,0,15065,15,1355,1011,1745,1199,390,188,dining table
27874,16,person,17,0,15065,52,1704,788,1934,1201,230,413,person
27875,17,person,18,1,15065,26,1867,803,1953,1142,86,339,person
27876,20,bicycle,21,0,15065,74,1935,987,2158,1299,223,312,bicycle
27877,21,table,22,0,15065,15,1166,973,1464,1086,298,113,dining table
27878,26,person,27,0,15065,29,288,901,374,1043,86,142,person
27879,27,person,28,1,15065,17,395,898,440,966,45,68,person
27880,28,person,29,1,15065,15,163,901,199,952,36,51,person
27881,29,person,30,1,15065,17,114,908,166,964,52,56,person
27882,30,person,31,1,15065,15,574,910,622,993,48,83,person
27883,31,person,32,1,15065,15,724,859,755,913,31,54,person
27884,34,person,35,1,15065,15,997,869,1028,922,31,53,person
27885,35,person,36,1,15065,18,948,889,1020,956,72,67,person
27886,36,person,37,1,15065,23,1114,840,1156,937,42,97,person
27887,37,person,38,1,15065,22,1156,853,1189,932,33,79,person
27888,39,person,40,1,15065,29,1256,852,1292,969,36,117,person
27889,40,person,41,1,15065,17,1248,901,1276,969,28,68,person
27890,41,person,42,1,15065,26,1170,872,1252,967,82,95,person
27891,43,person,44,1,15065,17,791,852,838,908,47,56,person
27892,44,person,45,1,15065,24,725,891,793,993,68,102,person
27893,45,person,46,1,15065,17,1092,873,1152,950,60,77,person
27894,46,person,47,1,15065,24,1060,888,1131,1018,71,130,person
27895,47,bench,48,0,15065,16,704,1096,815,1213,111,117,bench
27896,51,bicycle,52,1,15065,60,1448,893,1604,1008,156,115,bicycle
27897,10,boat,11,1,15066,16,1091,928,1506,1004,415,76,boat
27898,12,person,12,0,15066,17,174,904,193,955,19,51,person
27899,13,person,13,0,15066,19,105,904,124,955,19,51,person
27900,14,person,14,0,15066,21,147,903,165,954,18,51,person
27901,6,person,7,0,15067,16,401,352,424,441,23,89,person
27902,1,person,2,1,15068,22,670,734,824,950,154,216,person
27903,8,person,9,1,15068,19,970,732,1033,858,63,126,person
27904,9,person,10,1,15068,18,881,778,970,960,89,182,person
27905,10,person,11,1,15068,32,931,774,1136,960,205,186,person
27906,11,person,12,1,15068,21,1115,715,1276,960,161,245,person
27907,0,person,1,1,15072,40,108,114,142,214,34,100,person
27908,1,person,2,0,15072,38,95,122,126,214,31,92,person
27909,8,person,9,0,15073,20,14,126,27,156,13,30,person
27910,9,person,10,0,15073,19,27,128,38,155,11,27,person
27911,11,person,12,0,15074,20,71,100,79,129,8,29,person
27912,12,person,13,0,15074,15,60,102,69,124,9,22,person
27913,15,bench,16,0,15074,39,0,117,73,188,73,71,bench
27914,16,bench,17,0,15074,35,172,124,255,192,83,68,bench
27915,10,person,11,0,15076,23,208,161,226,195,18,34,person
27916,2,car,3,0,15077,16,43,134,68,147,25,13,car
27917,9,person,10,0,15078,28,115,200,135,236,20,36,person
27918,10,umbrella,11,0,15078,18,107,184,136,203,29,19,umbrella
27919,5,bicycle,6,0,24033,151,427,266,829,632,402,366,bicycle
27920,11,umbrella,12,0,24036,19,214,259,269,288,55,29,umbrella
27921,13,bench,14,0,24036,25,253,311,319,357,66,46,bench
27922,14,bench,15,1,24036,22,315,315,368,360,53,45,bench
27923,20,person,21,0,24036,36,670,290,709,407,39,117,person
27924,21,person,22,0,24036,26,581,290,602,397,21,107,person
27925,22,person,23,0,24036,63,583,252,678,536,95,284,person
27926,23,umbrella,24,0,24036,16,518,258,610,292,92,34,umbrella
27927,24,person,25,0,24036,40,516,290,585,458,69,168,person
27928,25,person,26,0,24036,35,478,277,517,399,39,122,person
27929,26,person,27,0,24036,38,212,273,259,412,47,139,person
27930,27,person,28,0,24036,86,147,219,243,531,96,312,person
27931,28,person,29,0,24036,85,54,216,198,551,144,335,person
27932,29,person,30,0,24036,67,3,239,93,538,90,299,person
27933,30,person,31,0,24036,39,363,281,418,409,55,128,person
27934,31,person,32,0,24036,43,402,285,473,455,71,170,person
27935,33,person,34,0,24036,100,695,252,853,651,158,399,person
27936,10,person,11,0,24038,94,690,137,859,636,169,499,person
27937,11,person,12,0,24038,101,373,87,580,616,207,529,person
27938,12,person,13,0,24038,110,600,82,750,572,150,490,person
27939,13,person,14,1,24038,76,563,119,647,544,84,425,person
27940,14,person,15,1,24038,19,537,240,554,440,17,200,person
27941,15,person,16,1,24038,63,374,114,467,557,93,443,person
27942,16,person,17,1,24038,22,370,178,410,330,40,152,person
27943,17,person,18,1,24038,15,367,197,389,278,22,81,person
27944,18,person,19,0,24038,34,319,202,370,333,51,131,person
27945,19,person,20,1,24038,25,53,205,77,291,24,86,person
27946,20,person,21,0,24039,71,1441,537,1771,1089,330,552,person
27947,21,bicycle,22,0,24039,85,1359,773,1763,1133,404,360,bicycle
27948,12,person,13,0,24040,51,734,650,769,825,35,175,person
27949,13,person,14,0,24040,51,653,637,737,824,84,187,person
27950,14,person,15,0,24040,42,310,671,364,837,54,166,person
27951,1,truck,2,0,24041,41,140,363,330,443,190,80,truck
27952,5,person,6,1,24044,36,384,546,519,767,135,221,person
27953,6,person,7,1,24044,39,251,531,394,767,143,236,person
27954,7,person,8,1,24044,42,80,519,256,768,176,249,person
27955,2,door,3,0,24045,188,0,103,555,685,555,582,door
27956,3,door,4,0,24045,63,873,291,1024,685,151,394,door
27957,13,person,14,0,15295,19,370,246,388,285,18,39,person
27958,14,person,15,1,15295,16,416,232,436,270,20,38,person
27959,3,bench,4,1,15296,32,1,244,151,332,150,88,bench
27960,5,bench,6,0,15296,29,244,210,329,247,85,37,bench
27961,13,person,14,1,24084,24,368,340,525,677,157,337,person
27962,16,person,17,1,24084,23,1621,446,1747,710,126,264,person
27963,17,person,18,1,24084,35,1879,459,2032,756,153,297,person
27964,18,person,19,1,24084,21,2031,465,2146,591,115,126,person
27965,21,bench,22,0,24084,75,2,765,1605,1650,1603,885,bench
27966,22,dog,23,0,24084,49,768,1035,1421,1469,653,434,dog
27967,9,plant pot,10,0,24086,19,866,670,948,775,82,105,potted plant
27968,3,person,4,0,24087,58,693,394,764,649,71,255,person
27969,4,backpack,5,0,24087,20,666,419,724,508,58,89,backpack
27970,5,person,6,0,24087,38,321,475,364,607,43,132,person
27971,4,chair,5,1,15300,16,2,96,70,253,68,157,chair
27972,5,person,6,1,15300,24,208,1,303,181,95,180,person
27973,6,person,7,0,15300,71,41,25,285,385,244,360,person
27974,3,person,4,0,15328,59,83,33,168,190,85,157,person
27975,6,person,7,1,15353,27,41,86,75,156,34,70,person
27976,7,person,8,0,15353,28,60,78,108,151,48,73,person
27977,8,person,9,0,15353,27,175,121,197,210,22,89,person
27978,9,person,10,0,15353,39,207,150,244,203,37,53,person
27979,9,person,9,0,15354,37,1585,574,1696,1054,111,480,person
27980,10,person,10,0,15354,36,1477,604,1630,1071,153,467,person
27981,11,person,11,1,15354,39,1325,540,1483,1091,158,551,person
27982,12,person,12,1,15354,34,1214,564,1323,1105,109,541,person
27983,13,person,13,1,15354,24,1104,547,1254,710,150,163,person
27984,14,person,14,1,15354,35,995,540,1109,1115,114,575,person
27985,15,person,15,1,15354,24,826,516,1000,694,174,178,person
27986,16,person,16,1,15354,37,736,509,858,1091,122,582,person
27987,17,person,17,1,15354,32,581,544,742,1075,161,531,person
27988,18,person,18,1,15354,28,490,508,618,1060,128,552,person
27989,19,person,19,1,15354,23,299,532,447,1028,148,496,person
27990,1,person,2,0,15359,16,1168,142,1256,314,88,172,person
27991,2,car,3,0,15361,25,1405,655,1860,831,455,176,car
27992,17,person,18,0,15361,19,239,1067,349,1500,110,433,person
27993,13,person,13,1,15364,24,897,136,998,312,101,176,person
27994,14,person,14,1,15364,42,735,172,951,428,216,256,person
27995,15,person,15,1,15364,22,840,134,901,293,61,159,person
27996,16,person,16,1,15364,18,608,168,684,250,76,82,person
27997,17,person,17,0,15364,60,574,193,740,450,166,257,person
27998,18,person,18,1,15364,27,730,109,820,245,90,136,person
27999,19,person,19,1,15364,19,829,508,879,606,50,98,person
28000,20,person,20,1,15364,19,829,566,866,715,37,149,person
28001,21,person,21,0,15364,59,48,326,182,662,134,336,person
28002,22,person,22,1,15364,45,4,623,139,881,135,258,person
28003,5,table,6,0,15372,22,200,539,459,617,259,78,dining table
28004,0,person,1,0,15374,19,223,465,347,603,124,138,person
28005,18,table,19,0,15374,26,352,738,995,958,643,220,dining table
28006,20,table,21,0,15374,21,609,485,1025,727,416,242,dining table
28007,8,car,8,0,15375,16,382,643,670,729,288,86,car
28008,14,person,14,1,15376,29,278,268,357,413,79,145,person
28009,15,person,15,1,15376,27,268,333,341,413,73,80,person
28010,16,person,16,1,15376,29,409,329,481,450,72,121,person
28011,17,person,17,1,15376,50,732,374,943,582,211,208,person
28012,18,person,18,1,15376,28,716,331,849,488,133,157,person
28013,26,bench,25,1,15376,29,51,244,164,297,113,53,bench
28014,27,umbrella,26,1,15376,19,57,179,166,296,109,117,umbrella
28015,8,person,7,0,15378,16,986,564,1035,716,49,152,person
28016,9,person,8,0,15378,16,1083,556,1166,694,83,138,person
28017,17,person,16,1,15378,25,437,467,475,532,38,65,person
28018,18,person,17,1,15378,38,359,480,433,558,74,78,person
28019,20,person,19,1,15378,25,679,527,750,609,71,82,person
28020,1,person,2,0,15379,63,340,206,733,812,393,606,person
28021,0,person,1,0,15381,42,990,254,1384,1004,394,750,person
28022,12,table,13,0,15382,22,179,714,519,856,340,142,dining table
28023,14,table,15,0,24120,42,260,395,689,527,429,132,dining table
28024,15,bench,16,1,24120,51,148,495,606,678,458,183,bench
28025,16,person,17,0,24120,43,783,212,893,462,110,250,person
28026,17,person,18,0,24120,52,140,309,367,614,227,305,person
28027,18,person,19,1,24120,50,302,277,397,587,95,310,person
28028,19,person,20,1,24120,56,383,306,514,598,131,292,person
28029,20,person,21,1,24120,78,502,319,798,614,296,295,person
28030,0,person,1,1,24121,63,0,294,424,680,424,386,person
28031,1,person,2,1,24121,53,0,247,194,532,194,285,person
28032,2,person,3,1,24121,25,268,116,367,238,99,122,person
28033,3,person,4,1,24121,88,265,123,455,562,190,439,person
28034,4,person,5,1,24121,142,378,0,1023,677,645,677,person
28035,8,person,9,0,24122,85,177,364,549,784,372,420,person
28036,2,person,3,1,24123,111,374,117,1023,682,649,565,person
28037,2,person,3,1,24125,113,170,19,1004,768,834,749,person
28038,9,person,10,1,947,19,619,230,680,337,61,107,person
28039,10,person,11,1,947,16,549,241,578,295,29,54,person
28040,23,person,24,0,947,78,776,317,1279,719,503,402,person
28041,39,chair,40,1,947,16,1141,325,1236,485,95,160,chair
28042,7,person,8,1,15473,36,479,108,552,260,73,152,person
28043,9,person,10,1,15473,19,147,140,191,211,44,71,person
28044,13,person,14,0,15473,99,192,161,512,479,320,318,person
28045,18,window,19,1,15473,16,412,105,506,219,94,114,window
28046,20,window,21,1,15473,21,152,11,233,206,81,195,window
28047,21,window,22,1,15473,18,271,11,340,206,69,195,window
28048,9,chair,10,1,15475,49,125,496,400,818,275,322,chair
28049,10,chair,11,0,15475,68,555,453,783,816,228,363,chair
28050,11,table,12,1,15475,17,1162,516,1447,608,285,92,dining table
28051,13,chair,14,1,15475,21,1093,464,1224,565,131,101,chair
28052,16,chair,17,1,15475,16,1330,502,1549,643,219,141,chair
28053,7,sofa,8,1,15476,36,45,111,237,173,192,62,couch
28054,16,chair,17,0,15477,15,347,114,371,160,24,46,chair
28055,13,window,14,1,15478,28,479,60,577,203,98,143,window
28056,14,window,15,1,15478,23,612,32,761,218,149,186,window
28057,16,person,17,1,15478,26,339,138,390,232,51,94,person
28058,17,person,18,1,15478,41,349,106,470,273,121,167,person
28059,18,person,19,1,15478,34,483,113,538,259,55,146,person
28060,19,person,20,0,15478,90,603,123,744,472,141,349,person
28061,25,table,26,1,15478,15,0,349,196,500,196,151,dining table
28062,33,person,34,0,15478,45,69,154,142,291,73,137,person
28063,9,chair,10,1,15480,15,10,72,29,113,19,41,chair
28064,18,chair,19,1,15480,17,319,93,342,144,23,51,chair
28065,13,chair,14,1,15481,24,707,614,810,819,103,205,chair
28066,14,chair,15,1,15481,21,572,612,684,807,112,195,chair
28067,6,chair,7,0,15482,24,359,182,415,266,56,84,chair
28068,6,window,7,0,15484,32,264,111,391,235,127,124,window
28069,7,window,8,0,15484,56,567,115,758,304,191,189,window
28070,8,person,9,1,15484,29,330,129,381,232,51,103,person
28071,9,person,10,0,15484,74,599,147,683,327,84,180,person
28072,10,person,11,1,15484,27,135,118,193,199,58,81,person
28073,11,person,12,1,15484,49,124,157,299,286,175,129,person
28074,21,chair,22,0,15484,21,681,306,767,418,86,112,chair
28075,8,person,9,0,15485,72,226,129,324,228,98,99,person
28076,9,person,10,1,15485,25,76,107,113,155,37,48,person
28077,10,person,11,1,15485,45,0,97,42,270,42,173,person
28078,11,chair,12,1,15485,22,319,146,345,215,26,69,chair
28079,12,chair,13,1,15485,21,361,158,408,247,47,89,chair
28080,15,balls,16,0,15486,17,195,252,270,284,75,32,sports ball
28081,21,chair,22,0,15486,19,422,140,452,191,30,51,chair
28082,6,table,7,1,15487,18,351,112,388,168,37,56,dining table
28083,11,table,12,1,15487,21,76,99,125,141,49,42,dining table
28084,13,table,14,0,15488,15,210,134,246,164,36,30,dining table
28085,14,chair,15,0,15488,17,229,141,251,168,22,27,chair
28086,15,chair,16,0,15488,18,209,132,225,163,16,31,chair
28087,8,window,9,1,15490,19,560,1,666,124,106,123,window
28088,9,person,10,1,15490,45,541,79,714,196,173,117,person
28089,10,person,11,1,15490,49,187,53,256,246,69,193,person
28090,11,person,12,1,15490,74,238,115,417,346,179,231,person
28091,15,person,16,0,15490,101,6,47,217,490,211,443,person
28092,27,chair,28,1,15490,21,578,149,623,201,45,52,chair
28093,5,person,6,1,15491,19,211,53,227,83,16,30,person
28094,9,person,10,1,15491,19,113,52,135,78,22,26,person
28095,11,person,12,1,15491,16,83,52,99,84,16,32,person
28096,12,person,13,1,15491,17,71,52,88,92,17,40,person
28097,13,person,14,1,15491,24,47,70,85,126,38,56,person
28098,14,person,15,1,15491,23,157,72,222,100,65,28,person
28099,15,person,16,1,15491,15,221,72,241,111,20,39,person
28100,6,sofa,7,1,15492,33,148,101,247,153,99,52,couch
28101,13,person,14,1,15492,31,2,64,27,159,25,95,person
28102,14,person,15,1,15492,24,73,75,90,118,17,43,person
28103,15,person,16,1,15492,26,81,81,107,120,26,39,person
28104,8,bench,9,0,15589,39,87,384,257,516,170,132,bench
28105,13,chair,14,0,15589,18,426,368,482,453,56,85,chair
28106,16,table,17,1,15590,15,9,345,102,421,93,76,dining table
28107,2,plant pot,3,0,24153,17,315,604,457,722,142,118,potted plant
28108,9,person,10,0,24153,60,144,652,697,1158,553,506,person
28109,3,chair,4,0,24154,35,265,192,528,378,263,186,chair
28110,4,sofa,5,0,24154,50,529,149,811,269,282,120,couch
28111,8,chair,9,1,24154,49,50,309,559,671,509,362,chair
28112,9,person,10,0,24154,69,537,49,709,369,172,320,person
28113,10,person,11,0,24154,96,42,259,796,490,754,231,person
28114,3,person,4,1,24155,32,421,401,531,606,110,205,person
28115,2,door,3,0,24156,43,516,528,869,839,353,311,door
28116,2,chair,3,0,24159,40,29,318,170,454,141,136,chair
28117,3,chair,4,0,24159,30,254,293,311,396,57,103,chair
28118,4,table,5,0,24159,49,277,319,383,413,106,94,dining table
28119,5,chair,6,0,24159,45,372,294,460,407,88,113,chair
28120,6,umbrella,7,0,24159,34,80,103,338,412,258,309,umbrella
28121,11,chair,12,0,24159,23,359,197,401,253,42,56,chair
28122,9,plant pot,10,0,24162,16,0,459,57,549,57,90,potted plant
28123,11,chair,12,1,24162,30,1,408,111,494,110,86,chair
28124,12,chair,13,0,24162,23,107,399,191,496,84,97,chair
28125,14,table,15,0,24162,32,75,372,214,411,139,39,dining table
28126,15,chair,16,0,24162,26,399,355,474,459,75,104,chair
28127,18,table,19,0,24162,16,321,326,378,376,57,50,dining table
28128,36,chair,37,1,24165,16,10,695,146,818,136,123,chair
28129,38,chair,38,0,24165,44,1,782,287,1187,286,405,chair
28130,12,chair,13,0,24167,18,170,228,236,317,66,89,chair
28131,15,plant pot,16,0,24171,16,504,415,543,455,39,40,potted plant
28132,16,chair,17,0,24171,38,731,466,997,680,266,214,chair
28133,17,chair,18,1,24171,25,749,551,1024,680,275,129,chair
28134,19,table,20,0,24171,27,282,516,643,679,361,163,dining table
28135,24,bottle,25,0,24171,20,396,463,434,569,38,106,bottle
28136,25,person,26,1,24171,65,232,300,400,543,168,243,person
28137,26,person,27,0,24171,62,199,430,412,679,213,249,person
28138,17,bench,18,0,24172,32,99,436,234,559,135,123,bench
28139,19,bench,20,0,24172,26,388,331,492,410,104,79,bench
28140,20,bench,21,0,24172,17,464,307,497,356,33,49,bench
28141,21,table,22,1,24172,16,357,296,451,401,94,105,dining table
28142,23,bench,24,0,24172,25,497,293,546,345,49,52,bench
28143,25,person,26,0,24172,46,534,194,580,349,46,155,person
28144,26,person,27,0,24172,46,423,237,491,363,68,126,person
28145,27,person,28,0,24172,68,523,315,709,521,186,206,person
28146,28,person,29,0,24172,48,263,295,429,516,166,221,person
28147,29,person,30,1,24172,31,263,241,304,384,41,143,person
28148,31,person,32,0,24172,59,154,285,341,535,187,250,person
28149,32,backpack,33,1,24172,28,334,431,437,480,103,49,backpack
28150,23,bird,24,0,15603,16,164,253,177,263,13,10,bird
28151,14,person,15,0,15604,17,557,514,600,583,43,69,person
28152,18,person,19,0,15604,15,298,390,334,444,36,54,person
28153,19,bicycle,20,0,15604,17,291,406,346,452,55,46,bicycle
28154,26,person,27,0,15604,20,481,329,509,381,28,52,person
28155,27,person,28,0,15604,20,463,335,485,396,22,61,person
28156,40,person,41,0,15604,26,716,380,746,445,30,65,person
28157,42,person,43,0,15604,18,741,268,760,308,19,40,person
28158,55,person,55,0,15604,22,289,225,300,262,11,37,person
28159,56,person,56,0,15604,24,280,230,289,264,9,34,person
28160,57,person,57,0,15604,19,260,234,273,267,13,33,person
28161,58,person,58,1,15604,19,103,285,114,316,11,31,person
28162,59,person,59,1,15604,21,727,266,743,301,16,35,person
28163,60,person,60,0,15604,22,685,264,700,301,15,37,person
28164,61,person,61,0,15604,16,713,242,727,266,14,24,person
28165,18,bench,19,0,24174,27,853,431,923,511,70,80,bench
28166,19,bench,20,0,24174,27,713,426,802,482,89,56,bench
28167,23,bench,24,0,24174,15,510,440,537,458,27,18,bench
28168,26,person,27,1,24174,21,571,423,588,461,17,38,person
28169,27,person,28,0,24174,19,609,419,628,448,19,29,person
28170,30,person,31,0,24174,18,499,429,523,459,24,30,person
28171,8,person,9,0,24175,26,660,583,675,630,15,47,person
28172,6,person,7,0,24176,29,96,482,123,543,27,61,person
28173,8,person,9,0,24176,19,220,474,235,511,15,37,person
28174,9,person,10,0,24176,18,249,475,266,516,17,41,person
28175,10,person,11,0,24176,20,201,470,221,516,20,46,person
28176,6,person,7,0,24177,102,612,125,804,596,192,471,person
28177,3,person,4,0,24178,32,397,220,426,304,29,84,person
28178,4,person,5,1,24178,32,264,223,297,315,33,92,person
28179,5,person,6,0,24178,41,284,215,317,322,33,107,person
28180,7,person,8,1,24178,16,1,262,23,291,22,29,person
28181,17,person,18,1,242,82,280,70,432,381,152,311,person
28182,19,person,20,1,242,79,220,121,292,374,72,253,person
28183,20,person,21,1,242,78,58,86,219,382,161,296,person
28184,21,backpack,22,0,242,53,28,137,137,330,109,193,backpack
28185,1,person,2,1,243,104,819,297,1499,1465,680,1168,person
28186,10,person,11,0,15637,36,1373,844,1423,955,50,111,person
28187,28,window,29,0,15637,15,1364,751,1427,819,63,68,window
28188,44,window,45,1,15637,15,85,738,144,802,59,64,window
28189,45,window,46,0,15637,15,199,742,255,807,56,65,window
28190,67,person,68,0,15637,17,310,806,321,846,11,40,person
28191,7,bench,8,1,15642,36,930,658,1023,766,93,108,bench
28192,8,bench,9,0,15642,44,152,634,335,745,183,111,bench
28193,9,bench,10,1,15642,18,0,671,210,766,210,95,bench
28194,38,window,39,0,15642,16,909,134,984,203,75,69,window
28195,19,person,20,0,15643,31,251,842,307,933,56,91,person
28196,22,bench,23,0,15643,18,846,899,948,943,102,44,bench
28197,0,horse,1,1,15651,55,35,44,280,202,245,158,horse
28198,1,person,2,0,15651,35,144,22,218,124,74,102,person
28199,2,horse,3,1,15651,23,67,56,215,191,148,135,horse
28200,3,person,4,1,15651,22,119,29,175,90,56,61,person
28201,1,horse,2,0,15652,126,63,265,1184,1157,1121,892,horse
28202,2,person,3,0,15652,43,567,80,803,621,236,541,person
28203,3,person,4,1,15652,24,22,276,248,997,226,721,person
28204,5,horse,6,1,15653,18,47,191,64,216,17,25,horse
28205,6,horse,7,0,15653,29,54,196,89,223,35,27,horse
28206,7,person,8,0,15653,18,64,181,76,204,12,23,person
28207,8,horse,9,0,15653,22,95,193,123,227,28,34,horse
28208,9,person,10,0,15653,16,102,181,116,207,14,26,person
28209,10,horse,11,0,15653,19,143,186,159,222,16,36,horse
28210,11,horse,12,0,15653,17,160,187,177,209,17,22,horse
28211,10,car,11,0,24180,15,497,302,514,323,17,21,car
28212,11,car,12,0,24180,16,520,304,535,323,15,19,car
28213,16,person,17,1,24180,16,542,301,560,324,18,23,person
28214,17,person,18,0,24180,17,508,304,525,324,17,20,person
28215,18,person,19,1,24180,15,483,300,504,323,21,23,person
28216,19,person,20,1,24180,16,475,294,486,323,11,29,person
28217,20,person,21,1,24180,17,452,298,470,322,18,24,person
28218,21,person,22,1,24180,15,434,296,452,320,18,24,person
28219,23,person,24,1,24180,25,393,294,412,323,19,29,person
28220,24,person,25,1,24180,22,376,288,390,317,14,29,person
28221,26,person,27,1,24180,19,364,294,385,319,21,25,person
28222,27,person,28,1,24180,24,343,290,367,320,24,30,person
28223,28,person,29,1,24180,22,326,291,348,320,22,29,person
28224,29,person,30,1,24180,19,307,291,328,320,21,29,person
28225,30,person,31,1,24180,17,279,289,300,320,21,31,person
28226,31,person,32,1,24180,20,256,287,276,320,20,33,person
28227,32,person,33,1,24180,18,238,285,258,320,20,35,person
28228,34,person,35,1,24180,17,220,294,233,319,13,25,person
28229,35,person,36,0,24180,17,192,289,211,319,19,30,person
28230,38,person,39,1,24180,19,151,291,182,317,31,26,person
28231,39,person,40,1,24180,20,102,286,136,315,34,29,person
28232,41,person,42,0,24180,22,28,262,48,305,20,43,person
28233,42,person,43,0,24180,15,0,259,16,305,16,46,person
28234,49,person,50,1,24180,15,864,308,885,331,21,23,person
28235,52,horse,53,0,24180,245,488,165,882,485,394,320,horse
28236,53,person,54,0,24180,85,569,97,734,294,165,197,person
28237,5,horse,6,1,24181,41,453,419,838,767,385,348,horse
28238,6,person,7,0,24181,104,430,28,797,704,367,676,person
28239,3,horse,4,0,24182,181,347,251,801,652,454,401,horse
28240,4,person,5,0,24182,64,382,168,658,404,276,236,person
28241,5,horse,6,0,24182,190,74,209,495,645,421,436,horse
28242,6,person,7,0,24182,60,137,117,357,370,220,253,person
28243,7,horse,8,1,24182,147,611,164,995,548,384,384,horse
28244,8,person,9,0,24182,44,714,137,857,305,143,168,person
28245,0,horse,1,1,24183,140,14,206,704,590,690,384,horse
28246,1,horse,2,0,24183,164,384,145,1012,587,628,442,horse
28247,2,horse,3,1,24183,96,802,144,1024,529,222,385,horse
28248,3,horse,4,1,24183,17,925,150,1001,221,76,71,horse
28249,4,person,5,0,24183,53,595,126,817,336,222,210,person
28250,5,person,6,0,24183,63,208,89,436,354,228,265,person
28251,6,person,7,1,24183,19,959,114,1023,253,64,139,person
28252,6,person,6,0,24184,65,412,208,549,423,137,215,person
28253,7,person,7,0,24184,41,290,275,382,416,92,141,person
28254,8,horse,8,1,24184,59,282,337,367,617,85,280,horse
28255,9,horse,9,1,24184,108,407,250,564,703,157,453,horse
28256,0,horse,1,0,24185,192,368,209,2139,1470,1771,1261,horse
28257,1,person,2,0,24185,68,824,65,1322,970,498,905,person
28258,5,car,6,0,24185,21,2,678,238,933,236,255,car
28259,1,horse,2,0,24186,98,655,519,838,898,183,379,horse
28260,2,horse,3,0,24186,112,393,418,674,953,281,535,horse
28261,3,horse,4,1,24186,88,347,486,533,928,186,442,horse
28262,4,horse,5,1,24186,86,226,515,400,934,174,419,horse
28263,5,horse,6,0,24186,72,139,579,282,926,143,347,horse
28264,6,person,7,1,24186,37,703,477,822,689,119,212,person
28265,7,person,8,0,24186,65,450,353,653,670,203,317,person
28266,8,person,9,1,24186,17,588,490,638,610,50,120,person
28267,9,person,10,1,24186,28,413,430,481,603,68,173,person
28268,10,person,11,1,24186,37,238,450,381,709,143,259,person
28269,11,person,12,0,24186,20,198,523,241,655,43,132,person
28270,13,car,14,0,24186,16,38,792,70,810,32,18,car
28271,4,car,5,0,24187,18,37,135,97,157,60,22,car
28272,7,horse,8,1,24187,159,220,156,683,453,463,297,horse
28273,8,person,9,1,24187,51,392,60,483,316,91,256,person
28274,9,horse,10,0,24187,186,14,96,515,462,501,366,horse
28275,10,person,11,0,24187,52,256,56,358,247,102,191,person
28276,10,person,11,1,15654,19,392,38,417,66,25,28,person
28277,16,car,17,0,15654,28,28,190,136,252,108,62,car
28278,17,car,18,0,15654,18,97,152,173,198,76,46,car
28279,18,car,19,0,15654,26,142,184,228,244,86,60,car
28280,19,car,20,0,15654,22,196,151,265,200,69,49,car
28281,20,car,21,0,15654,15,208,135,267,168,59,33,car
28282,21,car,22,0,15654,17,169,120,227,155,58,35,car
28283,24,car,25,1,15654,17,237,93,279,120,42,27,car
28284,25,car,26,0,15654,20,274,111,325,147,51,36,car
28285,27,car,28,1,15654,15,323,83,359,108,36,25,car
28286,0,car,1,0,15655,62,90,72,1221,818,1131,746,car
28287,8,car,9,1,15655,21,45,353,107,458,62,105,car
28288,9,person,10,0,15655,46,88,220,185,457,97,237,person
28289,10,person,11,1,15655,37,2,225,74,395,72,170,person
28290,13,person,14,0,15655,90,188,191,376,655,188,464,person
28291,14,person,15,1,15655,42,356,239,458,402,102,163,person
28292,15,person,16,1,15655,45,613,233,747,531,134,298,person
28293,16,person,17,0,15655,45,1264,207,1388,614,124,407,person
28294,7,car,8,0,24188,78,190,118,722,307,532,189,car
28295,8,person,9,1,24188,15,424,153,484,196,60,43,person
28296,7,car,8,0,24189,26,0,192,199,263,199,71,car
28297,8,car,9,0,24189,59,72,219,873,561,801,342,car
28298,4,car,5,0,24190,67,99,191,495,397,396,206,car
28299,1,person,2,1,24191,18,454,323,523,382,69,59,person
28300,1,car,2,1,24192,15,1469,0,1934,191,465,191,car
28301,2,car,3,1,24192,21,1229,0,1489,271,260,271,car
28302,3,car,4,1,24192,34,618,0,1290,347,672,347,car
28303,4,car,5,1,24192,35,804,179,1637,537,833,358,car
28304,5,car,6,0,24192,58,746,400,2058,1380,1312,980,car
28305,1,car,2,1,24193,46,217,283,865,512,648,229,car
28306,2,person,3,0,24193,45,800,209,942,515,142,306,person
28307,3,person,4,1,24193,35,119,199,253,467,134,268,person
28308,5,person,6,1,24193,28,691,134,778,254,87,120,person
28309,4,car,5,0,24194,74,45,356,220,437,175,81,car
28310,5,person,6,1,24194,38,119,312,177,388,58,76,person
28311,6,car,7,0,24194,40,183,339,289,409,106,70,car
28312,7,person,8,0,24194,34,222,326,280,373,58,47,person
28313,8,car,9,0,24194,71,270,367,414,448,144,81,car
28314,9,person,10,1,24194,36,321,341,379,397,58,56,person
28315,10,car,11,1,24194,24,369,325,433,397,64,72,car
28316,11,car,12,0,24194,60,385,329,517,421,132,92,car
28317,12,person,13,1,24194,15,443,336,474,376,31,40,person
28318,13,car,14,0,24194,46,523,349,616,406,93,57,car
28319,14,car,15,0,24194,31,539,330,589,369,50,39,car
28320,15,car,16,1,24194,38,494,335,562,379,68,44,car
28321,16,car,17,1,24194,16,540,315,560,337,20,22,car
28322,17,car,18,0,24194,67,560,389,769,485,209,96,car
28323,18,person,19,0,24194,39,622,336,701,399,79,63,person
28324,19,car,20,1,24194,22,720,348,799,412,79,64,car
28325,20,car,21,0,24194,26,717,341,776,379,59,38,car
28326,21,car,22,1,24194,30,736,319,800,354,64,35,car
28327,23,car,24,1,24194,27,637,346,696,370,59,24,car
28328,24,person,25,1,24194,19,650,327,678,346,28,19,person
28329,26,person,27,0,24194,34,18,110,73,225,55,115,person
28330,27,person,28,1,24194,24,6,114,30,228,24,114,person
28331,2,car,3,0,24195,71,15,60,614,416,599,356,car
28332,3,car,4,0,24196,68,65,245,905,510,840,265,car
28333,9,car,10,0,24197,43,257,599,835,901,578,302,car
28334,10,car,11,0,24197,53,750,568,1415,1063,665,495,car
28335,11,car,12,0,24197,52,1371,599,2078,978,707,379,car
28336,0,car,1,0,24198,39,96,217,708,428,612,211,car
28337,3,car,4,0,15788,27,225,142,303,170,78,28,car
28338,4,car,5,0,15788,24,111,139,163,166,52,27,car
28339,16,desk,17,0,15789,26,0,255,531,398,531,143,desk
28340,17,person,18,0,15791,21,135,318,153,363,18,45,person
28341,18,person,19,0,15791,17,194,313,205,355,11,42,person
28342,3,horse,4,0,15853,33,135,113,161,164,26,51,horse
28343,4,person,5,0,15853,26,163,120,176,166,13,46,person
28344,4,horse,5,0,15856,21,222,184,243,199,21,15,horse
28345,5,horse,6,0,15858,238,755,382,2002,1303,1247,921,horse
28346,6,person,7,0,15858,74,1187,127,1450,888,263,761,person
28347,8,person,9,1,15858,20,1708,490,1769,573,61,83,person
28348,9,horse,10,0,15858,128,11,535,394,909,383,374,horse
28349,10,horse,11,0,15858,42,169,434,283,741,114,307,horse
28350,16,horse,17,1,15858,50,861,604,981,768,120,164,horse
28351,5,person,6,0,15924,21,107,109,128,137,21,28,person
28352,6,person,7,0,15924,17,127,121,149,144,22,23,person
28353,7,person,8,0,15924,18,145,101,156,129,11,28,person
28354,8,person,9,0,15924,20,163,119,188,145,25,26,person
28355,9,person,10,0,15924,15,270,130,290,147,20,17,person
28356,2,person,3,1,15925,30,355,29,495,209,140,180,person
28357,5,person,6,0,15925,55,422,176,559,490,137,314,person
28358,6,person,7,0,15925,60,202,73,343,487,141,414,person
28359,10,person,11,0,15925,66,0,43,124,450,124,407,person
28360,9,person,10,0,15927,15,424,227,440,257,16,30,person
28361,10,person,11,0,15927,19,442,233,463,262,21,29,person
28362,11,person,12,0,16072,26,183,26,215,79,32,53,person
28363,12,person,13,0,16072,18,123,31,137,77,14,46,person
28364,14,person,15,0,16073,27,1292,767,1310,805,18,38,person
28365,1,chair,2,1,951,81,840,361,1628,1410,788,1049,chair
28366,9,person,10,0,951,265,734,383,1520,1971,786,1588,person
28367,6,person,7,0,16086,37,46,55,107,149,61,94,person
28368,7,person,8,0,16086,34,189,40,262,139,73,99,person
28369,8,person,9,1,16086,31,177,24,232,122,55,98,person
28370,14,person,15,1,16086,15,234,0,263,33,29,33,person
28371,16,person,17,1,16086,18,169,0,200,31,31,31,person
28372,3,person,4,1,16087,42,209,86,325,262,116,176,person
28373,6,dog,7,1,16087,33,2,132,169,336,167,204,dog
28374,1,person,2,0,16088,79,67,62,310,412,243,350,person
28375,8,person,9,1,16089,19,478,149,499,264,21,115,person
28376,10,person,11,0,16089,46,337,102,433,290,96,188,person
28377,11,person,12,1,16089,17,248,105,276,171,28,66,person
28378,12,person,13,0,16089,26,103,137,146,220,43,83,person
28379,13,person,14,0,16089,16,62,155,95,202,33,47,person
28380,14,person,15,0,16089,18,10,151,55,202,45,51,person
28381,15,person,16,0,16089,17,188,193,229,221,41,28,person
28382,16,person,17,0,16089,21,239,181,277,227,38,46,person
28383,17,person,18,0,16089,22,439,118,469,179,30,61,person
28384,18,person,19,0,16089,19,295,178,327,220,32,42,person
28385,19,person,20,0,16089,21,275,148,294,199,19,51,person
28386,22,person,23,0,16089,22,144,106,170,149,26,43,person
28387,23,person,24,0,16089,21,214,139,244,189,30,50,person
28388,5,person,6,0,16090,31,157,109,251,210,94,101,person
28389,6,person,7,0,16090,31,258,130,354,232,96,102,person
28390,3,person,4,0,16091,64,13,46,110,184,97,138,person
28391,4,person,5,0,16091,56,91,13,156,201,65,188,person
28392,5,person,6,0,16091,53,149,72,238,213,89,141,person
28393,5,person,6,0,16092,42,26,22,85,126,59,104,person
28394,6,person,7,0,16092,34,65,13,107,97,42,84,person
28395,9,person,10,0,16093,42,248,54,363,229,115,175,person
28396,10,person,11,0,16093,53,35,121,186,268,151,147,person
28397,15,person,16,0,16094,27,803,673,1026,987,223,314,person
28398,20,person,21,0,16094,41,222,719,511,1144,289,425,person
28399,3,person,4,0,16095,48,106,1,218,159,112,158,person
28400,6,flowerpots,7,0,16095,16,186,0,261,31,75,31,potted plant
28401,5,person,6,0,16096,40,6,55,149,179,143,124,person
28402,6,person,7,0,16096,27,154,116,209,204,55,88,person
28403,7,person,8,0,16097,18,387,22,409,89,22,67,person
28404,8,person,9,0,16097,15,409,20,430,95,21,75,person
28405,9,person,10,0,16097,27,750,45,793,141,43,96,person
28406,3,person,4,0,16099,48,108,115,470,434,362,319,person
28407,4,person,5,0,16099,56,429,109,667,547,238,438,person
28408,4,person,5,0,24355,80,444,132,703,687,259,555,person
28409,8,chair,9,0,24355,22,152,418,380,589,228,171,chair
28410,11,dog,12,0,24355,41,245,229,377,412,132,183,dog
28411,1,bench,2,1,24356,25,634,216,767,417,133,201,bench
28412,2,bench,3,1,24356,26,190,289,370,382,180,93,bench
28413,5,person,6,1,24356,39,634,146,764,413,130,267,person
28414,6,person,7,0,24356,80,383,1,725,443,342,442,person
28415,7,person,8,1,24356,24,187,237,244,399,57,162,person
28416,8,person,9,0,24356,46,217,50,326,408,109,358,person
28417,9,person,10,1,24356,31,100,176,171,408,71,232,person
28418,12,person,13,1,24356,48,0,502,630,834,630,332,person
28419,13,person,14,0,24356,102,85,335,626,976,541,641,person
28420,18,person,19,1,24357,75,1,445,540,947,539,502,person
28421,19,person,20,0,24357,76,262,316,656,853,394,537,person
28422,20,person,21,1,24357,76,673,266,906,770,233,504,person
28423,21,person,22,1,24357,93,677,324,1452,902,775,578,person
28424,22,person,23,1,24357,83,1214,501,1599,1199,385,698,person
28425,7,person,8,0,16110,54,143,86,273,159,130,73,person
28426,3,bench,4,0,16111,22,2,155,578,326,576,171,bench
28427,7,bench,8,0,16111,26,2,313,607,479,605,166,bench
28428,4,bench,5,0,16112,17,901,637,1239,957,338,320,bench
28429,6,bench,7,0,16112,16,2,652,437,959,435,307,bench
28430,8,bench,9,0,16112,24,124,545,1147,744,1023,199,bench
28431,6,bench,7,0,16113,17,99,151,311,234,212,83,bench
28432,2,bench,3,0,16114,23,0,111,355,216,355,105,bench
28433,4,bench,5,0,16116,16,1267,752,2199,1464,932,712,bench
28434,12,person,13,0,16143,32,98,160,129,233,31,73,person
28435,13,person,14,0,16143,23,125,136,145,189,20,53,person
28436,14,person,15,1,16143,19,137,127,151,183,14,56,person
28437,15,person,16,0,16143,23,143,134,171,201,28,67,person
28438,16,person,17,0,16143,31,186,131,205,179,19,48,person
28439,17,person,18,0,16143,19,238,122,246,151,8,29,person
28440,18,person,19,0,16143,22,269,128,288,176,19,48,person
28441,19,person,20,0,16143,24,292,122,311,180,19,58,person
28442,20,person,21,0,16143,25,318,125,331,171,13,46,person
28443,21,person,22,0,16143,22,329,128,347,175,18,47,person
28444,22,person,23,0,16143,21,355,127,370,171,15,44,person
28445,23,person,24,0,16143,23,376,121,390,160,14,39,person
28446,12,person,13,0,16144,22,70,171,88,230,18,59,person
28447,13,person,14,0,16144,22,99,164,119,230,20,66,person
28448,15,person,16,0,16144,23,28,165,45,223,17,58,person
28449,16,person,17,0,16144,21,12,166,29,224,17,58,person
28450,17,person,18,0,16144,33,350,181,382,266,32,85,person
28451,18,person,19,0,16144,26,401,182,429,233,28,51,person
28452,19,person,20,1,16144,19,372,176,390,243,18,67,person
28453,20,person,21,0,16144,23,450,188,474,259,24,71,person
28454,21,person,22,0,16144,23,473,191,493,261,20,70,person
28455,22,person,23,0,16144,22,492,187,511,260,19,73,person
28456,6,person,7,0,16145,23,320,130,341,190,21,60,person
28457,7,person,8,0,16145,22,346,137,367,187,21,50,person
28458,8,person,9,0,16145,24,369,140,385,189,16,49,person
28459,9,person,10,0,16145,15,274,145,283,173,9,28,person
28460,12,person,13,0,16145,17,8,146,16,171,8,25,person
28461,13,person,14,0,16145,15,0,148,9,172,9,24,person
28462,14,person,15,0,16146,21,167,161,194,216,27,55,person
28463,15,person,16,0,16146,30,119,187,154,299,35,112,person
28464,16,person,17,0,16146,42,68,260,141,475,73,215,person
28465,17,person,18,0,16146,18,561,179,577,227,16,48,person
28466,21,person,22,0,16146,17,441,184,461,240,20,56,person
28467,22,person,23,0,16146,18,306,167,324,219,18,52,person
28468,23,person,24,1,16146,18,325,172,347,227,22,55,person
28469,24,person,25,1,16146,18,258,169,288,224,30,55,person
28470,25,person,26,1,16146,16,244,210,271,321,27,111,person
28471,26,person,27,1,16146,16,262,201,304,300,42,99,person
28472,27,person,28,1,16146,20,310,227,364,342,54,115,person
28473,28,person,29,1,16146,27,237,258,332,471,95,213,person
28474,29,backpack,30,0,16146,15,238,292,304,378,66,86,backpack
28475,30,person,31,1,16146,29,297,305,394,476,97,171,person
28476,32,person,33,0,16146,35,397,211,446,344,49,133,person
28477,33,person,34,0,16146,25,447,214,484,313,37,99,person
28478,35,person,36,0,16146,36,505,210,553,323,48,113,person
28479,36,backpack,37,0,16146,16,506,223,539,275,33,52,backpack
28480,37,person,38,0,16146,26,595,177,630,306,35,129,person
28481,39,person,40,1,16146,21,592,249,639,477,47,228,person
28482,41,person,42,1,16146,15,355,185,371,245,16,60,person
28483,42,person,43,0,16146,24,485,192,510,280,25,88,person
28484,4,person,5,0,16340,24,140,97,172,148,32,51,person
28485,5,person,6,0,16342,33,202,53,245,159,43,106,person
28486,7,person,8,0,16343,38,181,163,271,343,90,180,person
28487,3,person,4,0,16346,19,178,84,196,123,18,39,person
28488,4,person,5,0,16346,15,127,63,146,90,19,27,person
28489,5,person,6,0,16346,15,142,76,157,103,15,27,person
28490,6,person,7,0,16346,23,115,123,156,178,41,55,person
28491,4,person,5,0,16348,30,121,90,143,154,22,64,person
28492,5,person,6,0,16348,17,114,147,132,165,18,18,person
28493,8,person,9,0,16349,19,313,385,326,415,13,30,person
28494,9,person,10,0,16349,18,280,388,294,417,14,29,person
28495,2,person,3,0,16350,29,84,92,111,156,27,64,person
28496,3,person,4,0,16350,29,125,87,140,132,15,45,person
28497,4,person,5,0,16350,23,147,85,157,118,10,33,person
28498,5,person,6,0,16350,26,139,88,147,124,8,36,person
28499,2,person,3,0,24414,60,445,270,558,480,113,210,person
28500,7,person,8,0,24416,99,132,82,330,545,198,463,person
28501,8,person,9,0,24416,87,280,125,433,545,153,420,person
28502,9,person,10,0,24416,110,421,211,716,598,295,387,person
28503,13,skis,14,0,24416,15,195,459,304,591,109,132,skis
28504,4,person,5,0,24417,51,207,396,304,720,97,324,person
28505,5,person,6,1,24417,48,855,454,1024,768,169,314,person
28506,6,backpack,7,0,24417,25,854,532,987,680,133,148,backpack
28507,12,person,13,0,24420,43,445,342,471,411,26,69,person
28508,13,person,14,0,24420,32,471,345,491,412,20,67,person
28509,14,person,15,0,24420,15,487,346,496,381,9,35,person
28510,14,person,15,0,24421,30,54,568,76,624,22,56,person
28511,15,person,16,0,24421,33,157,566,177,620,20,54,person
28512,16,person,17,0,24421,19,221,553,235,587,14,34,person
28513,17,person,18,0,24421,23,244,551,261,588,17,37,person
28514,18,person,19,1,24421,31,282,568,301,633,19,65,person
28515,19,person,20,0,24421,31,293,572,320,635,27,63,person
28516,20,person,21,1,24421,27,320,577,336,635,16,58,person
28517,21,person,22,0,24421,32,330,575,354,633,24,58,person
28518,22,person,23,0,24421,36,343,549,379,644,36,95,person
28519,23,person,24,0,24421,27,406,555,432,644,26,89,person
28520,24,person,25,1,24421,19,420,572,436,634,16,62,person
28521,25,person,26,1,24421,26,432,575,455,637,23,62,person
28522,26,person,27,0,24421,28,499,550,529,635,30,85,person
28523,27,person,28,1,24421,32,477,548,505,637,28,89,person
28524,28,person,29,0,24421,34,868,529,903,620,35,91,person
28525,29,person,30,0,24421,29,917,528,941,611,24,83,person
28526,30,person,31,0,24421,31,827,541,856,623,29,82,person
28527,31,person,32,0,24421,26,795,544,829,622,34,78,person
28528,32,person,33,0,24421,30,745,541,770,622,25,81,person
28529,33,person,34,1,24421,40,726,549,755,623,29,74,person
28530,34,person,35,0,24421,32,678,546,709,631,31,85,person
28531,35,person,36,0,24421,37,693,540,726,628,33,88,person
28532,36,person,37,0,24421,26,945,523,976,610,31,87,person
28533,37,person,38,1,24421,25,938,531,954,603,16,72,person
28534,38,person,39,0,24421,34,974,531,1008,605,34,74,person
28535,39,person,40,0,24421,22,666,551,683,625,17,74,person
28536,40,person,41,0,24421,23,1006,525,1023,603,17,78,person
28537,44,person,45,0,24421,21,485,443,492,454,7,11,person
28538,45,person,46,0,24421,19,464,424,469,435,5,11,person
28539,1,person,2,0,24422,60,357,77,654,476,297,399,person
28540,1,person,2,0,24424,79,540,487,818,1035,278,548,person
28541,6,person,7,0,24424,95,115,7,371,482,256,475,person
28542,1,person,2,0,24425,51,620,183,677,331,57,148,person
28543,2,person,3,0,24425,39,394,169,448,292,54,123,person
28544,3,person,4,1,24425,23,435,241,484,342,49,101,person
28545,4,person,5,1,24425,57,296,412,458,620,162,208,person
28546,2,person,3,0,24427,115,28,132,592,475,564,343,person
28547,5,person,6,0,24428,38,609,688,722,811,113,123,person
28548,6,person,7,0,24428,29,425,559,506,634,81,75,person
28549,7,skis,8,0,24428,34,456,510,527,671,71,161,skis
28550,2,person,3,0,263,75,632,114,872,619,240,505,person
28551,3,ball,4,0,263,20,697,61,778,136,81,75,sports ball
28552,4,person,5,0,263,116,340,184,591,711,251,527,person
28553,5,person,6,0,263,124,457,186,736,730,279,544,person
28554,6,person,7,0,263,53,1,213,221,775,220,562,person
28555,2,person,3,0,264,99,1,47,270,431,269,384,person
28556,1,person,2,1,265,75,86,4,525,500,439,496,person
28557,1,person,2,0,266,152,280,139,1586,1586,1306,1447,person
28558,14,person,15,0,266,173,1081,114,1975,1518,894,1404,person
28559,27,ball,28,0,266,27,859,1373,1096,1612,237,239,sports ball
28560,29,person,30,1,266,50,3,19,227,887,224,868,person
28561,30,person,31,1,266,87,199,1,674,889,475,888,person
28562,31,person,32,1,266,45,660,18,901,466,241,448,person
28563,5,person,6,1,267,54,866,403,1045,825,179,422,person
28564,6,person,7,1,267,80,1038,238,1189,1008,151,770,person
28565,7,person,8,1,267,55,491,443,641,866,150,423,person
28566,8,person,9,0,267,200,327,111,972,1171,645,1060,person
28567,23,person,24,0,267,148,963,109,1512,1204,549,1095,person
28568,2,person,3,1,268,55,506,44,594,365,88,321,person
28569,13,person,14,0,268,124,353,22,476,372,123,350,person
28570,28,person,29,0,268,111,174,26,288,370,114,344,person
28571,37,person,38,1,268,60,16,9,120,266,104,257,person
28572,38,person,39,1,268,41,104,27,174,166,70,139,person
28573,39,person,40,0,268,107,16,45,172,383,156,338,person
28574,1,person,2,1,269,43,3,269,128,741,125,472,person
28575,10,person,11,1,269,50,118,276,332,554,214,278,person
28576,20,person,21,0,269,80,104,374,371,895,267,521,person
28577,28,person,29,0,269,108,336,288,525,742,189,454,person
28578,43,person,44,0,269,113,419,415,680,948,261,533,person
28579,55,person,56,1,269,108,538,241,726,695,188,454,person
28580,71,person,72,0,269,100,630,444,888,995,258,551,person
28581,83,person,84,0,269,87,741,289,925,752,184,463,person
28582,98,person,99,0,269,94,926,436,1191,975,265,539,person
28583,110,person,111,0,269,99,1223,238,1453,699,230,461,person
28584,124,person,125,0,269,90,932,256,1164,651,232,395,person
28585,138,person,139,0,269,107,1120,437,1386,974,266,537,person
28586,149,person,150,0,269,87,1529,346,1664,831,135,485,person
28587,161,person,162,0,269,123,1599,522,1876,1033,277,511,person
28588,171,person,172,0,269,93,1705,346,1912,833,207,487,person
28589,185,person,186,0,269,106,1867,497,2066,1030,199,533,person
28590,196,person,197,1,269,82,1925,317,2106,735,181,418,person
28591,208,person,209,1,269,31,2142,308,2199,700,57,392,person
28592,209,person,210,1,269,45,2051,495,2200,944,149,449,person
28593,2,person,3,0,24475,180,354,229,1023,682,669,453,person
28594,3,person,4,0,24476,63,113,198,393,670,280,472,person
28595,4,person,5,0,24476,106,461,35,848,786,387,751,person
28596,5,person,6,0,24476,125,736,1,973,724,237,723,person
28597,6,person,7,0,24476,22,1,406,65,552,64,146,person
28598,7,person,8,1,24476,18,81,420,177,540,96,120,person
28599,6,person,7,0,24477,112,330,258,543,656,213,398,person
28600,7,person,8,0,24477,86,571,285,712,656,141,371,person
28601,8,person,9,1,24477,31,54,304,152,427,98,123,person
28602,9,person,10,1,24477,46,843,174,951,349,108,175,person
28603,10,person,11,1,24477,31,798,219,873,351,75,132,person
28604,11,person,12,1,24477,53,663,173,806,353,143,180,person
28605,12,person,13,1,24477,48,401,136,484,346,83,210,person
28606,13,person,14,1,24477,57,489,180,587,351,98,171,person
28607,14,person,15,1,24477,22,308,157,384,242,76,85,person
28608,15,person,16,1,24477,40,161,170,229,245,68,75,person
28609,16,person,17,1,24477,38,72,86,152,244,80,158,person
28610,17,person,18,1,24477,23,5,187,73,247,68,60,person
28611,18,person,19,1,24477,43,11,127,84,246,73,119,person
28612,5,person,6,0,24478,25,892,291,970,367,78,76,person
28613,6,person,7,1,24478,15,910,215,954,267,44,52,person
28614,8,person,9,0,24478,74,767,123,904,399,137,276,person
28615,9,person,10,0,24478,66,330,172,447,385,117,213,person
28616,10,person,11,1,24478,58,297,231,375,381,78,150,person
28617,11,person,12,0,24478,43,113,132,213,403,100,271,person
28618,1,person,2,0,24479,73,128,222,247,607,119,385,person
28619,2,person,3,0,24479,90,308,233,528,604,220,371,person
28620,3,person,4,0,24479,73,487,306,631,723,144,417,person
28621,4,person,5,0,24479,71,566,214,734,580,168,366,person
28622,5,person,6,1,24479,40,695,288,796,505,101,217,person
28623,6,person,7,0,24479,88,771,188,998,555,227,367,person
28624,7,person,8,1,24479,36,928,63,1023,393,95,330,person
28625,1,person,2,0,24480,90,134,178,342,596,208,418,person
28626,2,person,3,0,24480,90,731,182,884,595,153,413,person
28627,5,ball,6,0,24480,17,234,586,307,655,73,69,sports ball
28628,5,person,6,0,24481,94,829,261,1024,550,195,289,person
28629,6,person,7,0,24481,79,380,216,582,516,202,300,person
28630,7,person,8,0,24481,77,471,154,573,418,102,264,person
28631,8,person,9,0,24481,52,343,205,450,503,107,298,person
28632,9,person,10,1,24481,36,310,244,371,354,61,110,person
28633,10,person,11,1,24481,67,209,149,317,434,108,285,person
28634,11,person,12,0,24481,79,134,253,295,524,161,271,person
28635,12,person,13,0,24481,33,89,291,154,430,65,139,person
28636,13,ball,14,0,24481,16,739,457,789,499,50,42,sports ball
28637,4,person,5,1,24482,39,212,119,300,343,88,224,person
28638,5,person,6,0,24482,60,584,123,671,342,87,219,person
28639,6,person,7,0,24482,48,639,134,720,343,81,209,person
28640,7,person,8,0,24482,75,853,91,1013,339,160,248,person
28641,9,person,10,0,24482,111,36,50,263,699,227,649,person
28642,6,umbrella,7,0,16707,44,448,194,939,697,491,503,umbrella
28643,13,bed,14,0,16707,58,839,577,1799,1152,960,575,bed
28644,15,bed,16,0,16707,27,0,618,1455,1198,1455,580,bed
28645,21,vase,22,1,16707,29,22,566,146,677,124,111,vase
28646,12,bed,13,0,16709,40,375,1015,2094,1649,1719,634,bed
28647,2,bed,3,1,16711,34,0,102,151,173,151,71,bed
28648,3,bed,4,1,16711,23,132,96,189,150,57,54,bed
28649,4,bed,5,1,16711,16,215,96,267,151,52,55,bed
28650,6,bed,7,1,16711,18,0,150,178,212,178,62,bed
28651,17,person,18,0,16711,28,47,85,118,133,71,48,person
28652,8,chair,9,1,16712,22,29,88,93,147,64,59,chair
28653,11,bed,12,0,16713,18,160,500,536,601,376,101,bed
28654,12,bed,13,0,16713,27,80,540,624,742,544,202,bed
28655,17,door,18,0,16713,16,471,213,537,570,66,357,door
28656,13,bed,14,0,16714,32,36,151,309,240,273,89,bed
28657,3,chair,4,1,16715,21,407,1129,958,1267,551,138,chair
28658,4,bed,5,1,16715,34,4,1234,1365,2195,1361,961,bed
28659,5,vase,6,0,16715,21,956,421,1068,711,112,290,vase
28660,11,door,12,0,16715,20,784,775,1285,1369,501,594,door
28661,13,chair,14,0,16717,18,105,232,177,312,72,80,chair
28662,8,person,9,0,16729,54,523,853,763,1460,240,607,person
28663,9,person,10,0,16729,52,977,817,1270,1403,293,586,person
28664,7,person,8,0,16730,67,45,206,242,403,197,197,person
28665,8,person,9,0,16730,63,445,181,558,387,113,206,person
28666,4,person,5,0,16732,56,108,83,182,185,74,102,person
28667,5,person,6,0,16732,48,301,52,343,193,42,141,person
28668,6,person,7,0,16743,19,76,249,89,279,13,30,person
28669,9,person,10,1,16743,23,38,260,66,314,28,54,person
28670,10,person,11,1,16743,15,173,264,190,293,17,29,person
28671,13,person,14,1,16743,16,367,260,384,287,17,27,person
28672,15,person,16,1,16743,18,425,250,442,291,17,41,person
28673,9,person,10,1,16746,40,86,195,147,354,61,159,person
28674,10,person,11,1,16746,33,154,208,209,336,55,128,person
28675,6,person,7,1,16747,20,118,187,146,236,28,49,person
28676,10,person,11,0,16747,43,136,119,192,207,56,88,person
28677,11,person,12,0,16747,22,188,59,196,87,8,28,person
28678,12,person,13,0,16747,21,288,64,298,92,10,28,person
28679,13,person,14,1,16747,19,0,137,15,230,15,93,person
28680,15,person,16,0,16747,19,145,49,154,70,9,21,person
28681,6,person,7,1,16748,18,205,207,245,242,40,35,person
28682,12,person,13,1,16748,16,156,218,176,243,20,25,person
28683,15,person,16,1,16748,15,46,213,80,243,34,30,person
28684,8,person,9,1,16750,19,13,185,42,223,29,38,person
28685,9,person,10,1,16750,15,54,215,75,240,21,25,person
28686,2,person,3,0,25175,92,185,229,379,547,194,318,person
28687,3,person,4,0,25175,88,347,205,477,514,130,309,person
28688,11,person,12,0,16752,19,188,169,196,195,8,26,person
28689,4,person,5,0,25176,59,635,264,750,475,115,211,person
28690,5,person,6,0,25176,67,819,353,956,599,137,246,person
28691,6,person,7,0,25176,72,476,261,619,508,143,247,person
28692,7,person,8,0,25176,72,236,281,375,550,139,269,person
28693,8,person,9,0,25176,76,64,299,193,600,129,301,person
28694,9,person,10,0,25176,67,49,142,152,342,103,200,person
28695,8,car,9,0,16757,18,2,433,42,465,40,32,car
28696,13,person,14,0,16757,21,1005,420,1021,493,16,73,person
28697,4,person,5,0,16758,27,1597,571,1742,787,145,216,person
28698,11,person,12,1,16760,17,919,1077,951,1158,32,81,person
28699,12,person,13,1,16760,18,905,1055,938,1136,33,81,person
28700,13,person,14,0,16760,20,741,1033,775,1121,34,88,person
28701,14,person,15,1,16760,18,768,1051,806,1111,38,60,person
28702,39,chair,40,0,16760,31,1607,1396,1696,1486,89,90,chair
28703,40,chair,41,0,16760,32,1706,1416,1811,1522,105,106,chair
28704,41,chair,42,0,16760,30,1525,1380,1609,1460,84,80,chair
28705,42,chair,43,0,16760,24,1403,1354,1472,1425,69,71,chair
28706,43,chair,44,0,16760,29,1457,1366,1534,1440,77,74,chair
28707,44,chair,45,1,16760,18,1472,1347,1534,1370,62,23,chair
28708,45,chair,46,1,16760,21,1533,1357,1606,1389,73,32,chair
28709,46,chair,47,1,16760,19,1531,1339,1597,1369,66,30,chair
28710,47,chair,48,1,16760,25,1601,1369,1682,1425,81,56,chair
28711,48,chair,49,1,16760,25,1602,1348,1677,1382,75,34,chair
28712,49,chair,50,1,16760,27,1689,1384,1780,1453,91,69,chair
28713,50,chair,51,1,16760,23,1678,1359,1759,1404,81,45,chair
28714,51,chair,52,1,16760,24,1673,1340,1742,1374,69,34,chair
28715,52,chair,53,0,16760,31,1828,1439,1947,1531,119,92,chair
28716,53,chair,54,1,16760,28,1799,1405,1900,1477,101,72,chair
28717,54,chair,55,1,16760,25,1774,1372,1859,1427,85,55,chair
28718,55,chair,56,1,16760,24,1751,1351,1829,1391,78,40,chair
28719,56,chair,57,1,16760,28,1853,1365,1938,1413,85,48,chair
28720,57,chair,58,1,16760,30,1892,1393,1993,1452,101,59,chair
28721,1,person,2,0,25179,120,156,313,696,593,540,280,person
28722,2,ball,3,0,25179,18,559,480,627,552,68,72,sports ball
28723,0,person,1,0,25180,126,52,74,502,1008,450,934,person
28724,1,person,2,0,25180,63,402,32,627,642,225,610,person
28725,2,person,3,1,25180,23,308,86,430,213,122,127,person
28726,3,person,4,1,25180,22,1,121,85,701,84,580,person
28727,5,ball,6,0,25180,18,230,876,369,1008,139,132,sports ball
28728,1,person,2,0,25181,84,140,335,240,629,100,294,person
28729,2,person,3,0,25181,67,219,335,311,598,92,263,person
28730,3,person,4,0,25181,66,462,230,556,494,94,264,person
28731,4,person,5,0,25181,79,546,282,659,586,113,304,person
28732,5,person,6,0,25181,78,601,300,730,619,129,319,person
28733,6,person,7,0,25181,51,659,209,731,442,72,233,person
28734,7,person,8,0,25181,67,317,320,412,591,95,271,person
28735,9,person,10,1,25181,18,458,687,546,766,88,79,person
28736,2,person,3,0,25182,72,94,246,491,628,397,382,person
28737,3,person,4,1,25182,23,334,63,423,226,89,163,person
28738,5,person,6,0,25183,138,519,65,727,570,208,505,person
28739,6,person,7,1,25183,44,436,83,491,320,55,237,person
28740,7,person,8,1,25183,56,237,37,331,322,94,285,person
28741,8,person,9,0,25183,183,171,2,649,571,478,569,person
28742,9,person,10,0,25183,23,36,128,79,230,43,102,person
28743,10,ball,11,0,25183,17,60,490,139,567,79,77,sports ball
28744,1,person,2,0,25184,174,37,113,634,983,597,870,person
28745,2,person,3,0,25184,118,56,125,373,740,317,615,person
28746,3,ball,4,0,25184,17,93,300,206,412,113,112,sports ball
28747,3,person,4,1,25185,17,516,1,615,127,99,126,person
28748,7,person,8,0,25185,59,320,268,648,397,328,129,person
28749,4,person,5,1,16774,26,177,123,209,173,32,50,person
28750,5,person,6,1,16774,21,209,125,232,173,23,48,person
28751,6,person,7,1,16774,22,228,120,249,174,21,54,person
28752,7,person,8,1,16774,17,204,123,215,173,11,50,person
28753,8,person,9,1,16774,18,7,141,46,187,39,46,person
28754,10,person,11,1,16774,19,42,145,66,177,24,32,person
28755,12,person,13,1,16774,19,86,141,115,207,29,66,person
28756,13,person,14,1,16774,15,104,144,124,181,20,37,person
28757,14,person,15,0,16774,21,112,153,150,207,38,54,person
28758,15,person,16,1,16774,15,140,147,161,180,21,33,person
28759,17,person,18,0,16774,25,150,149,192,207,42,58,person
28760,19,person,20,1,16774,17,228,149,263,178,35,29,person
28761,20,person,21,1,16774,17,259,142,278,172,19,30,person
28762,21,person,22,1,16774,16,262,151,291,181,29,30,person
28763,28,chair,29,0,16774,17,182,188,222,221,40,33,chair
28764,29,chair,30,1,16774,27,149,186,184,223,35,37,chair
28765,3,person,4,1,25189,157,172,132,683,682,511,550,person
28766,0,person,1,0,25190,104,205,158,463,950,258,792,person
28767,12,table,13,0,25190,16,0,623,242,755,242,132,dining table
28768,13,table,14,0,25190,22,370,607,678,726,308,119,dining table
28769,22,person,23,1,25190,19,182,566,205,648,23,82,person
28770,2,person,3,1,16838,20,2,69,21,127,19,58,person
28771,3,person,4,1,16838,19,34,72,57,100,23,28,person
28772,4,person,5,1,16838,15,147,69,162,104,15,35,person
28773,5,horse,6,0,16838,40,15,97,65,163,50,66,horse
28774,7,horse,8,0,16838,48,57,84,108,166,51,82,horse
28775,9,horse,10,1,16838,51,94,89,133,167,39,78,horse
28776,11,horse,12,0,16838,51,130,86,183,166,53,80,horse
28777,13,horse,14,1,16838,32,175,93,205,164,30,71,horse
28778,14,horse,15,1,16838,29,201,90,256,165,55,75,horse
28779,16,horse,17,1,16838,32,243,92,268,163,25,71,horse
28780,12,horse,13,0,16839,29,25,161,50,231,25,70,horse
28781,13,person,14,0,16839,22,22,146,44,198,22,52,person
28782,14,horse,15,0,16839,29,67,161,92,231,25,70,horse
28783,15,person,16,0,16839,18,66,151,85,199,19,48,person
28784,16,horse,17,0,16839,26,104,163,135,232,31,69,horse
28785,17,person,18,0,16839,19,107,151,125,196,18,45,person
28786,18,horse,19,0,16839,28,145,165,171,233,26,68,horse
28787,19,person,20,0,16839,17,145,151,169,195,24,44,person
28788,20,horse,21,0,16839,34,190,154,224,234,34,80,horse
28789,21,person,22,0,16839,17,194,151,213,197,19,46,person
28790,22,horse,23,0,16839,37,226,158,257,232,31,74,horse
28791,23,person,24,0,16839,18,231,148,253,195,22,47,person
28792,24,horse,25,0,16839,39,261,156,294,232,33,76,horse
28793,25,person,26,0,16839,19,264,148,283,196,19,48,person
28794,26,horse,27,0,16839,40,301,154,339,229,38,75,horse
28795,27,person,28,0,16839,16,312,151,327,196,15,45,person
28796,28,horse,29,0,16839,38,342,161,386,229,44,68,horse
28797,29,person,30,0,16839,16,350,153,376,196,26,43,person
28798,30,horse,31,0,16839,29,384,168,412,231,28,63,horse
28799,31,person,32,0,16839,16,387,150,407,195,20,45,person
28800,4,person,5,0,16840,57,43,131,98,300,55,169,person
28801,10,person,11,0,16841,15,184,482,229,743,45,261,person
28802,1,boat,2,0,18967,67,0,1,285,200,285,199,boat
28803,2,person,3,0,18967,35,145,61,166,120,21,59,person
28804,6,table,7,0,18967,15,187,148,211,169,24,21,dining table
28805,9,chair,10,1,18969,15,2,91,22,167,20,76,chair
28806,5,person,6,0,18970,26,378,136,430,239,52,103,person
28807,6,person,7,1,18970,16,323,135,380,175,57,40,person
28808,7,boat,8,1,18970,18,2,3,623,419,621,416,boat
28809,5,boat,6,1,18971,16,0,0,613,459,613,459,boat
28810,9,table,10,1,18971,18,251,234,361,317,110,83,dining table
28811,11,chair,12,0,18971,17,97,168,169,228,72,60,chair
28812,12,person,13,1,18971,20,13,81,40,157,27,76,person
28813,15,chair,16,0,18971,17,206,164,284,238,78,74,chair
28814,16,person,17,1,18971,19,231,127,275,185,44,58,person
28815,19,person,20,1,18971,20,142,84,170,162,28,78,person
28816,23,person,24,0,18971,25,415,125,475,223,60,98,person
28817,24,person,25,0,18971,18,491,96,520,157,29,61,person
28818,3,boat,4,0,18972,29,0,0,249,201,249,201,boat
28819,5,person,6,0,18972,33,145,81,182,125,37,44,person
28820,3,boat,4,0,18973,70,0,21,300,199,300,178,boat
28821,5,person,6,1,18973,21,86,106,122,133,36,27,person
28822,6,person,7,1,18973,21,156,98,185,130,29,32,person
28823,7,person,8,0,18973,49,2,117,88,195,86,78,person
28824,8,person,9,0,18973,38,202,119,278,199,76,80,person
28825,9,person,10,0,18973,29,226,115,275,165,49,50,person
28826,5,boat,6,1,18974,15,2,506,1409,944,1407,438,boat
28827,6,person,7,0,18974,23,355,438,412,639,57,201,person
28828,7,person,8,0,18974,54,176,446,351,891,175,445,person
28829,8,person,9,1,18974,23,34,554,173,825,139,271,person
28830,9,person,10,1,18974,22,8,698,260,941,252,243,person
28831,10,person,11,0,18974,33,381,539,592,899,211,360,person
28832,11,person,12,0,18974,25,916,546,1145,688,229,142,person
28833,12,person,13,1,18974,26,728,573,931,846,203,273,person
28834,15,chair,16,0,18974,19,700,546,791,679,91,133,chair
28835,3,boat,4,1,18975,30,2,0,502,331,500,331,boat
28836,8,chair,9,0,18975,22,328,135,398,215,70,80,chair
28837,9,chair,10,0,18975,23,406,138,476,217,70,79,chair
28838,11,chair,12,0,18975,23,197,130,241,181,44,51,chair
28839,12,chair,13,0,18975,21,250,131,288,182,38,51,chair
28840,13,chair,14,0,18975,17,126,129,160,165,34,36,chair
28841,15,table,16,0,18975,17,258,216,353,258,95,42,dining table
28842,10,chair,11,0,18976,20,164,121,234,162,70,41,chair
28843,11,chair,12,0,18976,25,263,109,368,197,105,88,chair
28844,13,chair,14,0,18976,27,22,110,141,208,119,98,chair
28845,8,chair,9,0,19019,16,209,214,242,247,33,33,chair
28846,18,person,19,1,19019,20,128,307,169,357,41,50,person
28847,19,person,20,1,19019,21,86,294,125,333,39,39,person
28848,4,sofa,5,0,19020,15,49,91,93,122,44,31,couch
28849,11,table,12,1,19020,15,114,99,168,128,54,29,dining table
28850,12,person,13,0,19023,32,187,358,306,434,119,76,person
28851,16,chair,17,1,19023,24,420,365,577,478,157,113,chair
28852,6,person,7,1,19024,34,183,247,280,351,97,104,person
28853,7,person,8,1,19024,26,447,233,521,315,74,82,person
28854,8,person,9,1,19024,16,384,142,425,183,41,41,person
28855,10,person,11,1,19024,15,20,239,73,295,53,56,person
28856,11,person,12,1,19024,20,35,133,102,188,67,55,person
28857,13,person,14,1,19024,27,32,0,65,88,33,88,person
28858,14,person,15,1,19024,21,204,1,234,63,30,62,person
28859,12,person,13,1,19025,17,284,175,309,226,25,51,person
28860,13,person,14,1,19025,17,140,255,160,281,20,26,person
28861,11,chair,12,1,19026,23,459,399,640,479,181,80,chair
28862,5,person,6,1,19027,15,256,204,269,220,13,16,person
28863,1,person,2,1,19028,36,59,149,166,263,107,114,person
28864,2,person,3,1,19028,17,201,140,250,202,49,62,person
28865,3,person,4,1,19028,18,260,165,305,230,45,65,person
28866,4,person,5,1,19028,26,120,21,163,85,43,64,person
28867,5,person,6,1,19028,36,48,20,104,106,56,86,person
28868,12,ball,13,1,19028,18,442,138,490,188,48,50,sports ball
28869,13,balls,14,0,19028,25,477,153,550,256,73,103,sports ball
28870,15,balls,16,0,19028,21,92,27,139,60,47,33,sports ball
28871,3,person,4,0,19030,63,32,17,152,191,120,174,person
28872,4,person,5,0,19030,35,106,71,302,162,196,91,person
28873,5,person,6,0,19030,29,227,101,369,153,142,52,person
28874,12,person,13,1,19032,24,127,126,203,178,76,52,person
28875,32,chair,33,0,25198,19,378,307,432,361,54,54,chair
28876,33,chair,34,1,25198,16,273,314,337,376,64,62,chair
28877,2,person,3,1,25199,20,594,346,798,433,204,87,person
28878,3,person,4,1,25199,19,442,282,582,349,140,67,person
28879,4,person,5,1,25199,17,645,244,768,289,123,45,person
28880,5,person,6,1,25199,18,126,325,260,413,134,88,person
28881,7,person,8,1,25199,29,217,0,254,70,37,70,person
28882,8,person,9,1,25199,20,254,0,296,65,42,65,person
28883,9,person,10,1,25199,28,438,0,479,53,41,53,person
28884,10,person,11,1,25199,16,470,0,502,48,32,48,person
28885,11,person,12,1,25199,25,512,1,542,52,30,51,person
28886,12,person,13,1,25199,27,547,0,583,52,36,52,person
28887,15,person,16,1,25199,24,875,0,915,46,40,46,person
28888,17,chair,16,0,25201,27,111,200,195,293,84,93,chair
28889,7,flowerpot,8,0,960,17,1886,976,1995,1066,109,90,potted plant
28890,29,person,30,1,19036,21,325,347,350,367,25,20,person
28891,4,motorbike,5,0,19039,17,128,32,144,54,16,22,motorcycle
28892,24,chair,25,0,19042,16,88,182,125,218,37,36,chair
28893,10,table,11,0,19043,17,2,64,54,86,52,22,dining table
28894,10,chair,11,0,19045,15,88,230,125,263,37,33,chair
28895,11,table,12,0,19045,15,85,253,109,279,24,26,dining table
28896,12,table,13,0,19049,15,442,362,508,426,66,64,dining table
28897,1,umbrella,2,0,19053,30,30,233,183,749,153,516,umbrella
28898,11,person,12,0,25202,21,568,508,595,544,27,36,person
28899,12,person,13,0,25202,23,869,525,905,576,36,51,person
28900,13,person,14,0,25202,24,855,483,877,558,22,75,person
28901,1,person,2,1,25203,47,241,252,601,528,360,276,person
28902,2,person,3,1,25203,76,199,257,793,563,594,306,person
28903,9,umbrella,10,0,25204,23,109,212,186,240,77,28,umbrella
28904,3,umbrella,4,1,25207,16,530,113,640,273,110,160,umbrella
28905,7,umbrella,8,0,25207,18,320,247,382,285,62,38,umbrella
28906,20,chair,21,1,25207,21,545,364,616,480,71,116,chair
28907,10,chair,11,0,25208,26,607,227,639,270,32,43,chair
28908,11,chair,12,0,25208,25,672,225,713,273,41,48,chair
28909,9,table,10,0,25209,16,569,348,602,378,33,30,dining table
28910,11,table,12,0,25209,17,649,320,710,378,61,58,dining table
28911,12,chair,13,0,25209,23,676,355,733,396,57,41,chair
28912,13,chair,14,0,25209,17,638,284,690,333,52,49,chair
28913,14,table,15,0,25209,16,616,173,657,223,41,50,dining table
28914,15,chair,16,0,25209,17,575,164,618,218,43,54,chair
28915,17,chair,18,1,25209,15,637,172,685,221,48,49,chair
28916,11,umbrella,12,0,25212,17,482,317,532,371,50,54,umbrella
28917,18,person,19,1,25212,16,481,362,497,384,16,22,person
28918,22,person,23,0,25212,21,615,348,636,375,21,27,person
28919,23,person,24,1,25212,19,630,330,648,366,18,36,person
28920,25,umbrella,26,0,25212,20,760,314,803,374,43,60,umbrella
28921,47,chair,48,0,25212,18,1114,380,1155,421,41,41,chair
28922,66,person,67,0,25212,20,210,357,247,375,37,18,person
28923,68,person,69,0,25212,21,233,356,271,376,38,20,person
28924,22,ball,23,0,25213,16,811,939,886,1019,75,80,sports ball
28925,6,plant pot,7,0,25214,20,111,316,191,412,80,96,potted plant
28926,3,plant pot,4,0,25217,36,501,211,573,270,72,59,potted plant
28927,26,plant pot,27,0,25217,18,353,237,366,247,13,10,potted plant
28928,31,chair,32,0,25217,31,470,353,522,398,52,45,chair
28929,12,person,13,0,19128,40,43,143,74,210,31,67,person
28930,13,person,14,0,19129,17,818,436,846,522,28,86,person
28931,14,person,15,0,19129,17,886,442,903,524,17,82,person
28932,15,person,16,0,19129,26,498,428,547,537,49,109,person
28933,9,person,10,1,19130,21,1451,831,1500,955,49,124,person
28934,10,person,11,0,19130,72,894,796,1036,1260,142,464,person
28935,11,person,12,1,19130,19,0,816,71,1089,71,273,person
28936,2,bench,3,0,19131,17,295,120,325,136,30,16,bench
28937,5,person,6,0,19142,36,72,77,158,189,86,112,person
28938,7,backpack,8,0,19142,19,2,136,68,210,66,74,backpack
28939,3,bicycle,4,1,19145,96,14,165,239,435,225,270,bicycle
28940,3,backpack,4,1,22242,50,50,151,188,230,138,79,backpack
28941,7,person,8,0,19301,81,83,100,246,536,163,436,person
28942,8,person,9,0,19301,27,270,162,312,280,42,118,person
28943,9,person,10,1,19301,23,219,144,259,284,40,140,person
28944,2,shoe,3,0,19303,24,428,170,456,221,28,51,shoe
28945,3,person,4,0,19303,71,209,0,453,227,244,227,person
28946,7,person,8,0,19303,68,206,1,459,230,253,229,person
28947,9,person,10,0,19303,57,157,40,346,217,189,177,person
28948,10,person,11,1,19303,54,34,18,237,183,203,165,person
28949,11,person,12,1,19303,56,2,7,149,189,147,182,person
28950,9,person,10,0,19304,43,409,253,467,478,58,225,person
28951,10,person,11,0,19304,27,486,275,545,449,59,174,person
28952,11,person,12,0,19304,26,750,277,780,435,30,158,person
28953,12,person,13,0,19304,37,545,270,610,460,65,190,person
28954,13,person,14,0,19304,22,794,299,862,369,68,70,person
28955,14,person,15,1,19304,16,979,308,1014,352,35,44,person
28956,15,person,16,0,19304,17,871,260,895,359,24,99,person
28957,5,car,6,0,19310,38,207,135,383,210,176,75,car
28958,8,motorbike,9,0,19310,42,118,146,178,186,60,40,motorcycle
28959,8,person,9,1,19489,26,430,1,485,59,55,58,person
28960,5,bicycle,6,0,19492,40,30,190,157,259,127,69,bicycle
28961,6,person,7,0,19492,46,76,154,144,246,68,92,person
28962,7,person,8,0,19492,29,138,158,179,217,41,59,person
28963,8,bicycle,9,1,19492,25,142,192,193,234,51,42,bicycle
28964,9,person,10,0,19492,26,177,150,215,198,38,48,person
28965,10,bicycle,11,0,19492,39,184,223,264,269,80,46,bicycle
28966,11,person,12,0,19492,28,213,196,259,256,46,60,person
28967,12,bicycle,13,0,19492,38,274,231,331,269,57,38,bicycle
28968,13,person,14,0,19492,26,289,203,328,256,39,53,person
28969,14,bicycle,15,0,19492,23,341,209,373,232,32,23,bicycle
28970,15,person,16,0,19492,21,345,190,373,225,28,35,person
28971,16,person,17,1,19492,17,279,190,308,221,29,31,person
28972,17,person,18,1,19492,19,231,175,259,208,28,33,person
28973,18,person,19,1,19492,17,265,174,294,201,29,27,person
28974,19,bicycle,20,1,19492,18,172,169,221,215,49,46,bicycle
28975,3,bicycle,4,0,19493,29,261,153,315,243,54,90,bicycle
28976,4,person,5,0,19493,36,256,99,317,219,61,120,person
28977,7,bicycle,8,0,19494,24,176,133,192,151,16,18,bicycle
28978,6,bicycle,7,0,19496,41,469,217,540,306,71,89,bicycle
28979,7,person,8,0,19496,40,495,169,574,294,79,125,person
28980,8,bicycle,9,0,19496,48,381,205,465,306,84,101,bicycle
28981,9,person,10,0,19496,40,415,152,506,280,91,128,person
28982,10,person,11,1,19496,24,406,121,462,193,56,72,person
28983,11,person,12,1,19496,30,331,119,408,283,77,164,person
28984,12,bicycle,13,1,19496,28,288,197,374,296,86,99,bicycle
28985,13,person,14,1,19496,29,284,109,371,273,87,164,person
28986,14,person,15,1,19496,33,212,105,328,344,116,239,person
28987,15,person,16,0,19496,53,98,52,288,359,190,307,person
28988,16,bicycle,17,0,19496,67,44,179,223,401,179,222,bicycle
28989,7,bench,8,1,19497,17,297,341,401,426,104,85,bench
28990,8,bicycle,9,0,19497,30,569,252,632,318,63,66,bicycle
28991,9,person,10,0,19497,38,571,217,622,299,51,82,person
28992,10,bicycle,11,0,19497,37,472,265,528,324,56,59,bicycle
28993,11,person,12,0,19497,30,471,234,516,312,45,78,person
28994,12,bicycle,13,0,19497,32,336,186,390,240,54,54,bicycle
28995,13,person,14,0,19497,26,336,161,377,228,41,67,person
28996,14,bicycle,15,0,19497,34,347,263,406,321,59,58,bicycle
28997,15,person,16,0,19497,30,347,236,400,310,53,74,person
28998,16,bicycle,17,0,19497,38,256,257,312,311,56,54,bicycle
28999,17,person,18,0,19497,25,255,233,304,296,49,63,person
29000,18,bicycle,19,0,19497,38,145,268,198,316,53,48,bicycle
29001,19,person,20,0,19497,27,144,247,179,310,35,63,person
29002,20,motorbike,21,0,19497,36,11,259,78,311,67,52,motorcycle
29003,21,person,22,0,19497,23,27,239,64,300,37,61,person
29004,5,person,6,1,19580,47,1179,324,1409,832,230,508,person
29005,6,person,7,0,19580,33,17,590,77,697,60,107,person
29006,7,person,8,1,19580,21,433,605,485,720,52,115,person
29007,8,person,9,1,19580,36,373,654,452,785,79,131,person
29008,9,person,10,0,19580,26,379,703,440,839,61,136,person
29009,10,person,11,1,19580,38,581,625,671,780,90,155,person
29010,11,person,12,1,19580,33,677,625,766,753,89,128,person
29011,12,person,13,0,19580,24,815,600,882,722,67,122,person
29012,13,person,14,1,19580,20,880,593,927,718,47,125,person
29013,14,person,15,1,19580,30,871,704,942,851,71,147,person
29014,15,person,16,0,19580,34,546,693,656,847,110,154,person
29015,16,person,17,0,19580,40,683,705,769,852,86,147,person
29016,17,person,18,0,19580,44,770,697,848,852,78,155,person
29017,18,person,19,1,19580,26,1030,592,1110,802,80,210,person
29018,19,person,20,1,19580,19,1148,649,1215,781,67,132,person
29019,20,person,21,1,19580,18,1211,639,1295,739,84,100,person
29020,21,person,22,0,19580,121,1380,351,1769,1294,389,943,person
29021,22,person,23,0,19580,60,912,322,1064,903,152,581,person
29022,23,person,24,0,19580,67,76,555,224,911,148,356,person
29023,4,person,5,1,19581,78,1598,603,1764,1045,166,442,person
29024,5,person,6,0,19581,106,1521,274,1855,986,334,712,person
29025,6,person,7,0,19581,72,1831,606,1983,969,152,363,person
29026,7,person,8,0,19581,35,2015,552,2096,706,81,154,person
29027,8,person,9,0,19581,32,2079,642,2149,801,70,159,person
29028,9,person,10,1,19581,26,1744,549,1825,699,81,150,person
29029,10,person,11,1,19581,27,1537,581,1601,743,64,162,person
29030,12,person,13,0,19581,23,1349,588,1415,755,66,167,person
29031,13,person,14,0,19581,77,1195,530,1445,1011,250,481,person
29032,14,person,15,1,19581,30,1193,486,1268,638,75,152,person
29033,15,person,16,1,19581,17,1027,580,1073,688,46,108,person
29034,16,person,17,0,19581,29,1043,641,1121,789,78,148,person
29035,17,person,18,0,19581,84,758,455,1114,1295,356,840,person
29036,18,person,19,1,19581,26,756,581,841,721,85,140,person
29037,19,person,20,1,19581,15,782,665,830,765,48,100,person
29038,20,person,21,0,19581,24,686,724,806,846,120,122,person
29039,21,person,22,0,19581,21,614,719,713,841,99,122,person
29040,22,person,23,0,19581,38,460,608,538,821,78,213,person
29041,23,person,24,0,19581,53,321,589,420,913,99,324,person
29042,41,ball,42,0,19581,16,1550,136,1625,210,75,74,sports ball
29043,6,person,7,0,19584,19,247,50,262,88,15,38,person
29044,7,person,8,0,19584,16,214,61,228,93,14,32,person
29045,8,person,9,0,19584,31,104,127,133,185,29,58,person
29046,9,person,10,0,19584,27,213,139,240,199,27,60,person
29047,10,person,11,1,19584,31,274,264,313,335,39,71,person
29048,11,person,12,1,19584,31,95,265,127,335,32,70,person
29049,12,person,13,0,19584,17,408,84,430,146,22,62,person
29050,13,person,14,1,19584,18,169,67,184,109,15,42,person
29051,12,person,13,0,19585,26,308,170,326,202,18,32,person
29052,13,person,14,0,19585,43,255,189,303,247,48,58,person
29053,14,person,15,0,19585,38,420,167,458,222,38,55,person
29054,15,person,16,1,19585,29,461,182,500,256,39,74,person
29055,16,person,17,1,19585,26,65,179,123,298,58,119,person
29056,17,person,18,0,19585,16,220,166,229,199,9,33,person
29057,18,person,19,0,19585,17,234,175,244,199,10,24,person
29058,19,person,20,1,19585,17,441,160,454,186,13,26,person
29059,20,person,21,0,19585,23,147,183,171,231,24,48,person
29060,3,person,4,0,19587,26,40,111,65,184,25,73,person
29061,4,person,5,0,19587,25,59,109,77,198,18,89,person
29062,5,person,6,0,19587,27,90,113,115,168,25,55,person
29063,6,person,7,1,19587,21,118,122,130,163,12,41,person
29064,7,person,8,0,19587,30,127,122,144,172,17,50,person
29065,8,person,9,0,19587,36,185,120,208,182,23,62,person
29066,9,person,10,0,19587,29,233,107,251,166,18,59,person
29067,10,person,11,0,19587,50,160,102,189,198,29,96,person
29068,9,person,10,0,19589,21,210,216,227,279,17,63,person
29069,10,person,11,0,19589,24,409,210,435,278,26,68,person
29070,11,person,12,0,19589,42,302,206,341,334,39,128,person
29071,12,person,13,0,19589,37,126,206,190,350,64,144,person
29072,13,person,14,1,19589,22,523,206,559,285,36,79,person
29073,14,person,15,1,19589,34,544,198,598,378,54,180,person
29074,16,person,17,0,19589,19,385,208,404,260,19,52,person
29075,0,ball,1,0,19596,15,611,45,803,239,192,194,sports ball
29076,1,person,2,1,19596,65,594,243,1341,1194,747,951,person
29077,2,person,3,1,19596,40,519,649,788,1194,269,545,person
29078,3,person,4,1,19596,38,0,668,297,1198,297,530,person
29079,5,person,6,0,25258,108,593,183,750,643,157,460,person
29080,6,person,7,0,25258,78,376,191,529,538,153,347,person
29081,8,racket,9,0,25258,19,446,143,482,221,36,78,tennis racket
29082,9,racket,10,0,25258,21,547,253,616,333,69,80,tennis racket
29083,1,person,2,1,302,73,194,176,465,429,271,253,person
29084,14,person,15,1,302,49,177,0,293,143,116,143,person
29085,3,person,4,1,24687,23,583,201,621,249,38,48,person
29086,4,person,5,1,24687,27,525,217,559,271,34,54,person
29087,5,person,6,1,24687,35,378,178,434,228,56,50,person
29088,6,person,7,1,24687,36,29,244,164,297,135,53,person
29089,7,person,8,1,24687,25,116,225,167,274,51,49,person
29090,8,person,9,1,24687,42,217,165,302,258,85,93,person
29091,9,person,10,1,24687,26,284,183,328,252,44,69,person
29092,10,person,11,1,24687,45,142,159,214,228,72,69,person
29093,11,person,12,1,24687,33,91,185,157,244,66,59,person
29094,12,person,13,1,24687,22,97,175,152,217,55,42,person
29095,13,person,14,1,24688,84,93,662,533,769,440,107,person
29096,4,chair,5,0,20113,16,198,175,243,242,45,67,chair
29097,5,person,6,1,20113,24,188,151,234,230,46,79,person
29098,8,person,9,1,20113,33,332,160,368,229,36,69,person
29099,9,chair,10,1,20113,16,341,189,378,219,37,30,chair
29100,10,person,11,1,20113,20,377,144,400,183,23,39,person
29101,11,person,12,1,20113,26,278,148,323,207,45,59,person
29102,12,chair,13,1,20113,27,287,195,332,250,45,55,chair
29103,14,chair,15,0,20113,21,242,206,299,266,57,60,chair
29104,15,person,16,1,20113,28,310,171,400,266,90,95,person
29105,17,chair,18,1,20113,19,243,171,285,210,42,39,chair
29106,4,person,5,0,20114,58,372,574,1128,1148,756,574,person
29107,5,person,6,0,20114,46,1375,283,1707,1010,332,727,person
29108,6,person,7,1,20114,39,1321,150,1564,944,243,794,person
29109,7,person,8,1,20114,29,1215,153,1390,919,175,766,person
29110,8,person,9,0,20114,42,1018,271,1279,899,261,628,person
29111,9,person,10,1,20114,36,921,121,1126,811,205,690,person
29112,11,person,12,1,20114,16,1478,2,1641,259,163,257,person
29113,12,person,13,1,20114,16,1579,187,1683,367,104,180,person
29114,13,person,14,1,20114,20,1678,333,1831,803,153,470,person
29115,15,person,16,1,20114,19,1668,160,1823,372,155,212,person
29116,16,person,17,1,20114,17,1616,2,1831,278,215,276,person
29117,18,person,19,1,20114,23,429,163,636,493,207,330,person
29118,19,person,20,1,20114,18,278,200,416,441,138,241,person
29119,20,person,21,1,20114,25,241,313,471,747,230,434,person
29120,21,person,22,1,20114,21,57,224,249,591,192,367,person
29121,22,person,23,1,20114,19,0,485,212,919,212,434,person
29122,3,person,4,0,20115,34,495,360,687,822,192,462,person
29123,4,person,5,0,20115,26,600,137,1189,463,589,326,person
29124,5,person,6,0,20115,37,510,99,907,855,397,756,person
29125,17,person,18,1,20115,16,174,698,239,769,65,71,person
29126,4,person,5,1,20116,44,269,71,472,286,203,215,person
29127,5,person,6,0,20116,36,283,40,463,211,180,171,person
29128,0,person,1,1,20117,56,81,96,342,369,261,273,person
29129,1,person,2,1,20117,54,241,69,422,369,181,300,person
29130,3,person,3,1,20117,42,15,123,151,369,136,246,person
29131,8,chair,8,0,20119,22,101,273,185,372,84,99,chair
29132,9,chair,9,1,20119,17,171,267,229,359,58,92,chair
29133,10,chair,10,0,20119,26,208,287,299,370,91,83,chair
29134,11,chair,11,0,20119,29,269,283,355,370,86,87,chair
29135,12,person,1,0,20120,65,78,359,1192,1352,1114,993,person
29136,13,person,2,0,20120,59,1069,417,1670,1352,601,935,person
29137,23,table,12,1,20120,21,1258,793,1905,1170,647,377,dining table
29138,25,chair,14,1,20120,16,829,787,969,1136,140,349,chair
29139,0,person,1,1,20121,92,1197,308,1808,1648,611,1340,person
29140,2,person,3,1,20121,63,609,510,1088,1569,479,1059,person
29141,3,person,4,1,20121,32,0,411,306,1615,306,1204,person
29142,7,person,7,1,20121,17,1724,1311,1892,1518,168,207,person
29143,8,person,8,1,20121,20,1553,1467,1726,1647,173,180,person
29144,10,person,10,1,20121,23,1240,1435,1427,1647,187,212,person
29145,11,person,11,1,20121,15,1129,1490,1220,1647,91,157,person
29146,12,person,12,1,20121,25,573,1347,772,1647,199,300,person
29147,17,person,17,1,20121,52,59,848,525,1647,466,799,person
29148,3,person,4,0,20122,35,104,144,147,284,43,140,person
29149,4,person,5,0,20122,34,26,237,218,287,192,50,person
29150,2,elephant,3,0,20204,48,192,47,338,151,146,104,elephant
29151,5,person,6,1,20204,25,51,89,74,152,23,63,person
29152,7,person,8,1,20204,25,117,86,142,148,25,62,person
29153,8,person,9,1,20204,17,151,95,178,150,27,55,person
29154,4,elephant,5,0,20209,88,288,251,632,770,344,519,elephant
29155,5,elephant,6,0,20209,83,406,220,969,724,563,504,elephant
29156,6,elephant,7,0,20209,46,1057,106,1262,488,205,382,elephant
29157,4,person,5,1,20210,17,977,700,1014,776,37,76,person
29158,5,person,6,0,20210,28,1014,718,1059,819,45,101,person
29159,3,door,4,0,1041,23,2,32,118,217,116,185,door
29160,4,person,5,1,1041,63,173,48,232,247,59,199,person
29161,5,door,6,0,1044,16,285,936,702,1357,417,421,door
29162,9,person,10,0,1044,48,711,689,1230,1834,519,1145,person
29163,8,person,9,0,1045,34,597,423,685,731,88,308,person
29164,9,person,10,0,1045,58,474,421,590,739,116,318,person
29165,10,person,11,1,1045,42,390,417,494,708,104,291,person
29166,4,person,5,0,1046,61,178,149,316,351,138,202,person
29167,8,door,9,0,1046,18,378,90,498,280,120,190,door
29168,7,door,8,0,1047,16,466,28,510,797,44,769,door
29169,8,door,9,0,1048,23,102,121,334,1105,232,984,door
29170,0,person,1,0,20216,80,10,106,395,423,385,317,person
29171,1,person,2,1,20216,40,371,99,638,393,267,294,person
29172,9,person,10,0,4,95,328,18,473,409,145,391,person
29173,24,person,25,1,4,83,95,128,368,409,273,281,person
29174,6,person,7,0,1049,28,331,133,375,241,44,108,person
29175,9,person,10,0,1049,49,92,140,192,374,100,234,person
29176,10,person,11,1,1049,31,64,198,111,372,47,174,person
29177,12,person,13,1,1049,20,2,229,79,374,77,145,person
29178,2,window,3,1,1050,17,232,30,272,127,40,97,window
29179,2,person,3,1,1051,86,11,6,215,215,204,209,person
29180,11,window,12,1,1051,17,145,10,203,100,58,90,window
29181,12,window,13,0,1051,40,54,12,109,101,55,89,window
29182,7,window,8,0,1054,15,398,128,443,179,45,51,window
29183,8,window,9,0,1054,15,334,115,372,164,38,49,window
29184,9,window,10,0,1054,16,271,105,304,151,33,46,window
29185,17,sofa,17,1,1055,16,327,196,367,245,40,49,couch
29186,19,sofa,19,0,1055,43,267,200,498,399,231,199,couch
29187,7,sofa,8,1,1056,28,140,79,237,203,97,124,couch
29188,14,window,15,0,1056,15,376,68,405,147,29,79,window
29189,6,window,7,0,1058,16,4,256,75,408,71,152,window
29190,17,window,18,0,1058,16,1123,256,1194,410,71,154,window
29191,39,table,40,1,1058,32,2,448,437,799,435,351,dining table
29192,48,table,49,1,1058,21,749,453,1199,801,450,348,dining table
29193,56,fork,57,0,1058,16,876,555,901,627,25,72,fork
29194,5,table,6,1,1059,28,301,160,425,213,124,53,dining table
29195,7,person,8,1,1059,40,284,39,432,202,148,163,person
29196,9,suitcase,10,0,1059,22,305,171,416,271,111,100,suitcase
29197,14,window,15,1,1059,19,331,55,367,122,36,67,window
29198,15,window,16,1,1059,15,398,50,450,120,52,70,window
29199,16,window,17,1,1059,16,153,61,183,148,30,87,window
29200,26,window,27,1,1060,16,141,168,177,225,36,57,window
29201,28,window,29,1,1060,17,354,171,394,232,40,61,window
29202,11,sofa,12,0,1061,20,171,116,406,260,235,144,couch
29203,14,person,15,1,1061,18,201,98,226,117,25,19,person
29204,8,person,9,1,1062,15,203,53,220,103,17,50,person
29205,14,person,15,0,1062,21,310,55,331,123,21,68,person
29206,3,window,4,1,1064,23,154,28,371,373,217,345,window
29207,4,window,5,1,1064,18,475,125,560,336,85,211,window
29208,7,suitcase,8,1,1064,34,867,208,1028,626,161,418,suitcase
29209,11,backpack,12,1,1064,26,265,594,447,821,182,227,backpack
29210,14,person,15,0,1064,113,375,142,972,823,597,681,person
29211,6,door,7,0,1065,17,173,150,246,266,73,116,door
29212,18,window,19,1,1065,15,328,182,345,209,17,27,window
29213,9,window,10,0,1066,16,271,1,305,69,34,68,window
29214,11,window,12,0,1066,15,8,6,83,107,75,101,window
29215,50,person,51,1,1,15,1139,1465,1190,1497,51,32,person
29216,55,person,56,0,1,24,1409,1196,1439,1273,30,77,person
29217,56,person,57,0,1,26,1430,1205,1459,1286,29,81,person
29218,57,person,58,1,1,22,1473,1255,1512,1335,39,80,person
29219,58,person,59,0,1,25,1451,1311,1487,1426,36,115,person
29220,59,person,60,0,1,26,1690,1324,1730,1440,40,116,person
29221,61,person,62,0,1,27,1761,1307,1800,1410,39,103,person
29222,62,person,63,0,1,22,1596,1250,1624,1349,28,99,person
29223,63,person,64,0,1,28,1336,1119,1355,1177,19,58,person
29224,64,person,65,0,1,21,1310,1118,1336,1173,26,55,person
29225,65,person,66,0,1,27,1281,1137,1311,1205,30,68,person
29226,67,person,68,1,1,20,1457,1190,1487,1248,30,58,person
29227,68,person,69,0,1,26,1488,1190,1514,1271,26,81,person
29228,69,person,70,1,1,18,1506,1188,1524,1260,18,72,person
29229,71,person,72,0,1,29,1641,1221,1670,1304,29,83,person
29230,72,person,73,0,1,24,1709,1194,1740,1274,31,80,person
29231,73,person,74,0,1,25,1554,1177,1577,1264,23,87,person
29232,74,person,75,1,1,21,1825,1396,1869,1502,44,106,person
29233,76,person,77,1,1,22,1526,1158,1552,1224,26,66,person
29234,77,person,78,0,1,19,1675,1197,1704,1280,29,83,person
29235,78,person,79,1,1,22,1588,1187,1616,1272,28,85,person
29236,79,person,80,0,1,34,705,1357,737,1484,32,127,person
29237,80,person,81,1,1,18,783,1215,802,1275,19,60,person
29238,81,person,82,1,1,25,776,1205,794,1279,18,74,person
29239,82,person,83,0,1,19,756,1227,775,1285,19,58,person
29240,83,person,84,1,1,23,732,1223,758,1292,26,69,person
29241,87,person,88,1,1,24,780,1129,800,1201,20,72,person
29242,88,person,89,0,1,27,788,1141,815,1204,27,63,person
29243,89,person,90,0,1,18,762,1079,778,1123,16,44,person
29244,93,person,94,1,1,16,405,956,433,990,28,34,person
29245,95,person,96,1,1,20,299,967,338,993,39,26,person
29246,15,chair,16,0,2,17,813,687,905,804,92,117,chair
29247,16,person,17,1,2,16,790,641,877,711,87,70,person
29248,17,person,18,1,2,31,629,545,660,728,31,183,person
29249,18,person,19,0,2,27,644,543,691,741,47,198,person
29250,19,person,20,1,2,15,684,636,710,725,26,89,person
29251,20,person,21,0,2,36,999,655,1090,807,91,152,person
29252,22,person,23,1,2,22,1147,631,1203,773,56,142,person
29253,23,person,24,1,2,17,1198,697,1280,773,82,76,person
29254,31,window,32,0,2,21,1851,290,2199,743,348,453,window
29255,36,person,37,1,2,27,1419,668,1521,772,102,104,person
29256,41,chair,42,0,2,25,1232,773,1416,919,184,146,chair
29257,42,chair,43,0,2,27,1086,771,1278,977,192,206,chair
29258,45,person,46,1,2,42,1431,742,1614,860,183,118,person
29259,46,backpack,47,0,2,16,1604,800,1673,862,69,62,backpack
29260,48,chair,49,1,2,26,1302,859,1446,1080,144,221,chair
29261,49,person,50,1,2,34,1772,688,1968,857,196,169,person
29262,57,chair,58,1,2,18,1911,772,2056,853,145,81,chair
29263,58,person,59,1,2,51,1911,693,2198,851,287,158,person
29264,61,person,62,1,2,33,2006,750,2199,1139,193,389,person
29265,65,chair,66,1,2,26,1965,852,2193,1142,228,290,chair
29266,66,chair,67,1,2,21,1810,856,2016,1076,206,220,chair
29267,67,chair,68,1,2,19,1597,860,1695,1043,98,183,chair
29268,68,chair,69,1,2,48,1407,878,1593,1182,186,304,chair
29269,69,person,70,0,2,63,1652,749,1847,1217,195,468,person
29270,70,person,71,0,2,75,1438,742,1775,1224,337,482,person
29271,71,backpack,72,0,2,29,1819,1016,1952,1227,133,211,backpack
29272,81,flowerpot,82,0,2,25,331,993,591,1222,260,229,potted plant
29273,90,chair,91,1,2,20,2049,1193,2198,1450,149,257,chair
29274,3,person,4,0,1093,15,357,110,368,151,11,41,person
29275,4,person,5,0,1093,23,334,105,355,153,21,48,person
29276,2,person,3,0,1094,22,334,350,379,462,45,112,person
29277,4,person,5,1,1094,30,2,323,75,695,73,372,person
29278,8,person,9,0,1094,30,71,345,128,457,57,112,person
29279,9,person,10,0,1094,29,138,350,192,462,54,112,person
29280,10,person,11,0,1094,21,288,347,321,455,33,108,person
29281,14,person,15,0,1094,43,400,327,481,571,81,244,person
29282,16,person,17,0,1094,29,469,398,518,533,49,135,person
29283,17,person,18,0,1094,48,766,348,917,727,151,379,person
29284,35,person,36,0,1094,20,542,352,575,425,33,73,person
29285,62,person,63,1,1094,38,472,359,507,422,35,63,person
29286,7,person,8,0,1095,28,381,810,500,1155,119,345,person
29287,8,person,9,0,1095,16,0,866,77,1110,77,244,person
29288,0,person,1,0,1098,53,30,147,114,383,84,236,person
29289,2,person,3,0,1098,85,108,116,194,457,86,341,person
29290,3,person,4,0,1098,93,175,122,291,484,116,362,person
29291,5,suitcase,6,1,1098,15,156,304,268,436,112,132,suitcase
29292,1,bench,2,0,1099,16,11,204,66,225,55,21,bench
29293,3,person,4,0,1100,19,71,214,89,254,18,40,person
29294,4,person,5,0,1100,18,106,208,118,254,12,46,person
29295,5,person,6,0,1100,25,139,208,157,267,18,59,person
29296,6,person,7,0,1100,22,270,210,289,266,19,56,person
29297,7,person,8,0,1100,30,323,200,366,300,43,100,person
29298,8,person,9,0,1100,20,242,211,261,273,19,62,person
29299,10,person,11,0,1100,20,312,210,331,263,19,53,person
29300,11,person,12,1,1101,23,38,794,111,967,73,173,person
29301,13,person,14,0,1101,24,122,806,188,995,66,189,person
29302,25,person,26,1,1101,15,972,1078,1026,1116,54,38,person
29303,31,person,32,0,1101,18,1167,1062,1202,1180,35,118,person
29304,32,person,33,0,1101,18,1208,1051,1251,1189,43,138,person
29305,33,person,34,0,1101,18,1291,1059,1332,1195,41,136,person
29306,34,person,35,0,1101,19,1235,921,1274,1036,39,115,person
29307,35,person,36,1,1101,20,1423,999,1474,1099,51,100,person
29308,37,person,38,0,1101,24,1574,1121,1620,1254,46,133,person
29309,39,table,40,0,1101,15,1641,920,1752,992,111,72,dining table
29310,41,person,42,1,1101,21,1913,1174,1995,1299,82,125,person
29311,44,person,45,0,1101,17,1372,959,1406,1069,34,110,person
29312,45,person,46,1,1101,19,1826,1011,1874,1103,48,92,person
29313,47,person,48,0,1101,15,1854,1097,1892,1211,38,114,person
29314,48,person,49,0,1101,15,1910,1134,1970,1287,60,153,person
29315,49,person,50,0,1101,19,1280,917,1312,1015,32,98,person
29316,50,person,51,0,1101,18,1313,874,1340,964,27,90,person
29317,52,person,53,0,1101,19,1387,858,1421,962,34,104,person
29318,53,person,54,0,1101,19,1432,871,1470,976,38,105,person
29319,55,person,56,1,1101,18,1710,983,1736,1100,26,117,person
29320,56,person,57,0,1101,15,1725,1022,1763,1111,38,89,person
29321,57,person,58,0,1101,21,888,846,923,948,35,102,person
29322,58,person,59,0,1101,18,843,896,877,1003,34,107,person
29323,59,person,60,0,1101,21,602,649,645,782,43,133,person
29324,60,person,61,0,1101,17,658,652,691,780,33,128,person
29325,61,person,62,0,1101,21,688,650,743,777,55,127,person
29326,62,person,63,0,1101,18,381,671,425,808,44,137,person
29327,74,person,75,0,1101,18,1181,669,1196,730,15,61,person
29328,75,person,76,0,1101,22,1200,691,1226,761,26,70,person
29329,76,person,77,0,1101,15,1146,695,1168,755,22,60,person
29330,77,person,78,0,1101,16,1239,688,1258,749,19,61,person
29331,79,person,80,0,1101,21,1345,850,1372,945,27,95,person
29332,80,person,81,0,1101,16,1388,781,1417,859,29,78,person
29333,82,person,83,0,1101,22,1005,783,1028,861,23,78,person
29334,83,person,84,0,1101,18,967,779,999,861,32,82,person
29335,84,person,85,0,1101,23,1488,881,1517,981,29,100,person
29336,85,person,86,0,1101,16,1519,883,1541,979,22,96,person
29337,86,person,87,0,1101,18,1525,921,1559,1016,34,95,person
29338,87,person,88,1,1101,16,1674,839,1700,923,26,84,person
29339,88,person,89,0,1101,22,1419,734,1443,813,24,79,person
29340,89,person,90,0,1101,16,1441,747,1467,816,26,69,person
29341,90,person,91,0,1101,20,1320,689,1343,751,23,62,person
29342,91,person,92,0,1101,17,1263,757,1293,834,30,77,person
29343,93,person,94,0,1101,17,1274,626,1289,681,15,55,person
29344,96,person,97,0,1101,16,1487,634,1507,684,20,50,person
29345,97,person,98,0,1101,20,1639,725,1660,791,21,66,person
29346,98,person,99,0,1101,18,1609,663,1632,723,23,60,person
29347,99,person,100,0,1101,19,1569,684,1591,739,22,55,person
29348,100,person,101,0,1101,15,1547,680,1565,736,18,56,person
29349,103,person,104,1,1101,22,684,1052,727,1169,43,117,person
29350,104,person,105,1,1101,26,663,1127,718,1274,55,147,person
29351,105,person,106,0,1101,27,631,1183,688,1318,57,135,person
29352,106,person,107,1,1101,22,1033,1201,1073,1318,40,117,person
29353,109,person,110,0,1101,16,1800,821,1825,921,25,100,person
29354,1,person,2,0,1103,38,373,64,430,219,57,155,person
29355,3,person,4,0,1103,42,427,63,489,220,62,157,person
29356,5,person,6,0,1103,41,146,75,202,219,56,144,person
29357,7,person,8,0,1103,48,14,5,82,222,68,217,person
29358,9,person,10,0,1103,20,280,129,308,221,28,92,person
29359,10,person,11,0,1103,32,298,100,345,220,47,120,person
29360,11,person,12,0,1103,19,244,146,265,219,21,73,person
29361,13,person,14,0,1103,22,192,143,230,220,38,77,person
29362,17,person,18,1,1103,21,73,73,102,217,29,144,person
29363,56,person,56,1,1103,23,91,164,104,219,13,55,person
29364,57,person,57,1,1103,27,101,162,114,219,13,57,person
29365,19,person,20,0,1105,60,968,402,1114,709,146,307,person
29366,24,chair,25,1,1105,15,1075,704,1202,793,127,89,chair
29367,28,person,29,1,1105,21,924,434,949,605,25,171,person
29368,29,person,30,0,1105,30,934,423,993,618,59,195,person
29369,30,person,31,0,1105,26,865,449,921,600,56,151,person
29370,33,person,34,0,1105,30,803,427,856,595,53,168,person
29371,36,person,37,0,1105,21,676,460,712,583,36,123,person
29372,39,person,40,1,1105,20,656,461,677,575,21,114,person
29373,40,person,41,0,1105,22,639,454,673,582,34,128,person
29374,41,person,42,0,1105,23,619,454,643,577,24,123,person
29375,42,person,43,0,1105,27,586,457,626,578,40,121,person
29376,43,person,44,0,1105,25,566,465,590,577,24,112,person
29377,44,person,45,0,1105,22,543,455,570,574,27,119,person
29378,0,person,1,0,1106,73,325,35,414,353,89,318,person
29379,1,person,2,1,1106,90,252,19,331,337,79,318,person
29380,2,person,3,1,1106,67,165,55,215,340,50,285,person
29381,3,person,4,0,1106,94,90,51,191,352,101,301,person
29382,4,person,5,0,1106,85,188,61,297,351,109,290,person
29383,5,suitcase,6,0,1106,33,385,209,462,341,77,132,suitcase
29384,6,person,7,1,1106,45,53,76,105,245,52,169,person
29385,7,person,8,1,1106,31,25,36,100,132,75,96,person
29386,8,person,9,1,1106,17,97,73,121,141,24,68,person
29387,10,person,11,1,1106,18,193,70,229,112,36,42,person
29388,11,person,12,0,1106,37,445,52,492,180,47,128,person
29389,18,person,19,1,1108,15,173,325,202,370,29,45,person
29390,19,person,20,1,1108,15,78,323,98,371,20,48,person
29391,8,person,9,0,1109,27,268,286,289,336,21,50,person
29392,9,person,10,1,1110,24,227,120,261,199,34,79,person
29393,10,person,11,0,1110,30,236,130,267,199,31,69,person
29394,2,person,3,0,1111,29,293,54,348,236,55,182,person
29395,3,person,4,0,1111,64,190,41,282,283,92,242,person
29396,5,person,6,0,1111,27,13,52,72,262,59,210,person
29397,6,person,7,0,1112,39,321,149,355,251,34,102,person
29398,7,person,8,1,1112,20,344,140,368,185,24,45,person
29399,8,person,9,1,1112,22,265,147,292,197,27,50,person
29400,9,person,10,1,1112,24,224,143,262,187,38,44,person
29401,10,person,11,1,1112,18,202,143,228,188,26,45,person
29402,11,person,12,1,1112,27,160,165,242,297,82,132,person
29403,12,person,13,1,1112,16,88,153,123,237,35,84,person
29404,13,person,14,1,1112,28,69,151,117,281,48,130,person
29405,14,person,15,1,1112,26,9,176,77,295,68,119,person
29406,15,person,16,1,1112,32,236,177,330,299,94,122,person
29407,16,person,17,1,1112,17,301,209,344,297,43,88,person
29408,1,person,2,1,1113,53,345,99,476,385,131,286,person
29409,2,suitcase,3,0,1113,18,297,218,427,470,130,252,suitcase
29410,3,suitcase,4,1,1113,15,456,210,499,469,43,259,suitcase
29411,6,person,7,1,1113,21,424,80,460,200,36,120,person
29412,7,person,8,0,1113,17,57,113,83,188,26,75,person
29413,11,person,12,0,1114,20,43,180,67,259,24,79,person
29414,12,person,13,1,1114,17,81,171,107,223,26,52,person
29415,13,suitcase,14,0,1114,15,78,210,104,257,26,47,suitcase
29416,14,person,15,0,1114,26,102,183,137,273,35,90,person
29417,16,person,17,0,1114,43,338,208,393,394,55,186,person
29418,18,person,19,0,1114,24,173,168,199,262,26,94,person
29419,19,person,20,0,1114,23,416,181,446,306,30,125,person
29420,20,person,21,0,1114,23,444,232,475,320,31,88,person
29421,21,person,22,0,1114,28,474,182,518,316,44,134,person
29422,24,person,25,0,1114,18,289,190,307,274,18,84,person
29423,25,person,26,1,1114,25,373,180,403,298,30,118,person
29424,26,person,27,0,1114,40,324,183,351,291,27,108,person
29425,32,person,33,1,1114,30,273,181,294,228,21,47,person
29426,38,person,39,1,1114,31,240,181,262,230,22,49,person
29427,12,person,13,0,1115,58,648,438,969,1401,321,963,person
29428,13,person,14,0,1115,52,943,430,1161,1355,218,925,person
29429,14,person,15,0,1115,57,1095,450,1330,1364,235,914,person
29430,0,person,1,0,1116,69,306,105,433,396,127,291,person
29431,5,person,6,0,1117,21,109,170,125,218,16,48,person
29432,7,person,8,0,1117,27,91,171,110,242,19,71,person
29433,9,person,10,0,1117,37,412,172,450,240,38,68,person
29434,10,suitcase,11,0,1117,24,444,208,460,245,16,37,suitcase
29435,7,person,8,0,1118,19,614,973,699,1094,85,121,person
29436,7,person,7,0,1119,19,541,849,641,1141,100,292,person
29437,11,car,10,1,1119,17,108,866,340,981,232,115,car
29438,34,person,27,0,1119,33,644,893,681,1010,37,117,person
29439,35,person,28,0,1119,36,703,917,750,1010,47,93,person
29440,36,person,29,0,1119,30,774,953,828,1015,54,62,person
29441,37,person,30,0,1119,24,823,897,852,977,29,80,person
29442,38,person,31,0,1119,23,799,895,819,966,20,71,person
29443,41,person,34,0,1119,18,897,894,916,969,19,75,person
29444,44,person,37,0,1119,23,1259,891,1288,977,29,86,person
29445,45,person,38,0,1119,22,1363,879,1396,970,33,91,person
29446,6,person,7,0,1120,15,341,256,353,304,12,48,person
29447,11,person,12,0,1120,15,310,261,321,304,11,43,person
29448,6,person,7,0,1121,17,72,182,85,220,13,38,person
29449,9,person,10,0,1121,21,131,179,152,240,21,61,person
29450,12,person,13,0,1121,16,183,191,191,211,8,20,person
29451,6,person,7,0,1123,29,51,223,75,301,24,78,person
29452,7,person,8,0,1123,28,99,225,124,315,25,90,person
29453,8,person,9,0,1123,31,185,221,206,282,21,61,person
29454,9,person,10,0,1123,24,223,222,242,282,19,60,person
29455,10,person,11,0,1123,23,354,219,369,284,15,65,person
29456,12,person,13,0,1123,19,269,223,282,265,13,42,person
29457,14,person,15,0,1123,26,112,221,145,294,33,73,person
29458,16,person,17,0,1123,18,300,221,314,257,14,36,person
29459,21,person,22,0,1123,23,383,223,400,273,17,50,person
29460,22,person,23,0,1123,21,337,218,353,269,16,51,person
29461,23,person,24,0,1123,26,206,221,223,270,17,49,person
29462,2,person,3,0,1127,24,77,157,84,188,7,31,person
29463,6,person,7,0,1127,15,43,131,49,151,6,20,person
29464,7,flowerpot,8,0,1130,17,12,161,47,190,35,29,potted plant
29465,5,person,6,0,1131,40,192,94,222,179,30,85,person
29466,6,suitcase,7,0,1131,19,168,139,204,191,36,52,suitcase
29467,7,person,8,1,1131,45,11,97,62,215,51,118,person
29468,8,suitcase,9,0,1131,18,49,157,78,222,29,65,suitcase
29469,5,person,6,0,1132,28,124,202,153,299,29,97,person
29470,6,person,7,0,1132,25,164,208,197,305,33,97,person
29471,7,person,8,0,1132,23,317,213,337,301,20,88,person
29472,8,person,9,0,1132,22,345,217,369,303,24,86,person
29473,10,person,11,0,1132,15,250,206,267,267,17,61,person
29474,11,person,12,0,1132,37,536,222,642,448,106,226,person
29475,12,person,13,1,1132,34,505,202,577,431,72,229,person
29476,13,person,14,1,1132,19,494,197,541,293,47,96,person
29477,14,person,15,0,1132,43,651,189,731,427,80,238,person
29478,17,person,18,1,1132,16,417,209,444,258,27,49,person
29479,20,person,21,1,1132,19,621,213,664,381,43,168,person
29480,10,airplane,11,0,1133,27,119,103,197,144,78,41,airplane
29481,7,person,8,0,1134,38,615,297,775,644,160,347,person
29482,8,person,9,0,1134,34,349,300,426,540,77,240,person
29483,9,person,10,0,1134,27,271,323,335,522,64,199,person
29484,10,person,11,0,1134,20,538,323,569,427,31,104,person
29485,11,person,12,0,1134,20,446,313,494,456,48,143,person
29486,11,person,11,0,1135,23,0,485,149,767,149,282,person
29487,12,person,12,0,1135,19,389,534,448,728,59,194,person
29488,13,person,13,0,1135,26,464,520,542,727,78,207,person
29489,14,person,14,0,1135,22,701,523,767,699,66,176,person
29490,17,person,17,1,1135,46,882,520,922,657,40,137,person
29491,27,person,27,0,1135,69,831,533,897,674,66,141,person
29492,38,person,38,0,1135,71,932,527,995,698,63,171,person
29493,58,person,58,1,1135,78,620,528,674,688,54,160,person
29494,70,person,70,0,1135,78,559,534,626,747,67,213,person
29495,74,person,74,1,1135,22,251,522,280,573,29,51,person
29496,75,person,75,1,1135,41,200,538,254,676,54,138,person
29497,76,person,76,0,1135,63,166,516,226,689,60,173,person
29498,77,person,77,0,1135,45,119,527,173,685,54,158,person
29499,78,person,78,0,1135,33,286,520,311,590,25,70,person
29500,5,person,6,1,1137,27,142,304,173,363,31,59,person
29501,6,person,7,1,1137,18,135,317,153,373,18,56,person
29502,7,person,8,0,1137,24,126,321,145,380,19,59,person
29503,8,suitcase,9,0,1137,17,101,345,128,379,27,34,suitcase
29504,11,person,12,0,1137,17,317,278,328,326,11,48,person
29505,22,person,23,0,1137,19,364,265,379,298,15,33,person
29506,32,person,33,0,1137,16,255,236,266,264,11,28,person
29507,32,person,29,0,1139,15,796,501,876,689,80,188,person
29508,45,motorbike,42,0,1139,22,1372,482,1454,526,82,44,motorcycle
29509,49,person,46,1,1139,20,1064,497,1098,548,34,51,person
29510,50,person,47,0,1139,17,1096,479,1121,516,25,37,person
29511,10,person,11,0,1140,28,301,275,341,341,40,66,person
29512,4,person,5,0,1141,26,243,383,374,689,131,306,person
29513,5,person,6,0,1141,18,848,418,945,677,97,259,person
29514,34,person,34,0,1141,38,101,490,199,672,98,182,person
29515,9,person,10,0,1142,29,530,239,576,343,46,104,person
29516,10,person,11,0,1142,24,366,248,396,350,30,102,person
29517,11,person,12,0,1142,51,241,236,349,508,108,272,person
29518,14,person,15,0,1142,58,133,222,228,492,95,270,person
29519,16,person,17,0,1142,20,622,251,640,293,18,42,person
29520,17,person,18,0,1142,19,449,245,467,305,18,60,person
29521,21,person,22,1,1142,16,500,243,519,299,19,56,person
29522,6,person,7,0,1144,25,49,121,156,227,107,106,person
29523,8,person,9,0,1144,25,351,113,376,176,25,63,person
29524,1,person,2,0,1145,21,1110,316,1234,877,124,561,person
29525,20,person,21,0,1145,54,420,310,478,478,58,168,person
29526,31,person,32,0,1145,61,484,290,538,479,54,189,person
29527,42,person,43,0,1145,49,330,307,373,462,43,155,person
29528,51,person,52,1,1145,51,361,305,408,467,47,162,person
29529,59,person,60,0,1145,54,390,316,437,475,47,159,person
29530,70,person,71,0,1145,87,993,277,1072,541,79,264,person
29531,1,person,2,0,1146,47,331,94,408,309,77,215,person
29532,3,person,4,0,1146,39,252,111,301,264,49,153,person
29533,5,person,6,0,1146,32,183,114,224,245,41,131,person
29534,7,person,8,0,1146,89,33,88,108,284,75,196,person
29535,11,person,12,0,1146,28,153,131,175,194,22,63,person
29536,14,person,15,1,1146,22,2,125,28,203,26,78,person
29537,6,person,7,0,1147,33,159,276,201,425,42,149,person
29538,7,person,8,0,1147,32,30,271,81,497,51,226,person
29539,8,person,9,0,1147,31,283,276,330,404,47,128,person
29540,10,person,11,0,1147,26,364,285,398,387,34,102,person
29541,11,person,12,0,1147,28,372,337,413,413,41,76,person
29542,2,chair,3,0,1148,21,17,214,42,248,25,34,chair
29543,13,person,14,0,1148,19,155,177,166,211,11,34,person
29544,15,person,16,0,1148,17,191,176,199,208,8,32,person
29545,5,person,6,0,1149,17,240,208,253,243,13,35,person
29546,6,person,7,0,1149,19,222,209,236,246,14,37,person
29547,11,person,12,0,1150,16,449,251,473,283,24,32,person
29548,33,person,34,0,1150,19,403,217,420,246,17,29,person
29549,0,person,1,0,1151,45,82,57,146,244,64,187,person
29550,2,person,3,0,1151,60,239,80,289,250,50,170,person
29551,3,person,4,0,1151,51,328,80,382,190,54,110,person
29552,27,person,28,0,1151,89,118,69,216,236,98,167,person
29553,6,person,7,0,1152,30,290,132,322,235,32,103,person
29554,7,person,8,1,1152,23,429,136,457,233,28,97,person
29555,8,person,9,1,1152,15,451,135,475,198,24,63,person
29556,3,person,4,0,1153,44,260,23,324,221,64,198,person
29557,4,person,5,0,1153,35,357,39,418,219,61,180,person
29558,5,suitcase,6,0,1153,21,245,149,294,223,49,74,suitcase
29559,6,suitcase,7,1,1153,16,332,155,375,218,43,63,suitcase
29560,28,person,22,0,1154,46,398,470,511,738,113,268,person
29561,29,person,23,1,1154,20,333,471,386,584,53,113,person
29562,30,person,24,0,1154,43,302,483,397,738,95,255,person
29563,31,person,25,0,1154,36,207,484,288,740,81,256,person
29564,32,person,26,1,1154,21,628,501,655,591,27,90,person
29565,33,person,27,0,1154,36,583,542,686,680,103,138,person
29566,34,person,28,1,1154,37,850,545,927,693,77,148,person
29567,35,person,29,1,1154,31,918,540,1025,687,107,147,person
29568,36,person,30,0,1154,33,1024,490,1080,680,56,190,person
29569,18,person,19,1,1156,20,881,266,932,323,51,57,person
29570,0,person,1,1,1157,17,100,466,327,756,227,290,person
29571,1,person,2,1,1157,21,432,470,675,751,243,281,person
29572,2,person,3,0,1157,22,717,498,951,742,234,244,person
29573,14,person,14,0,1157,15,1172,663,1274,970,102,307,person
29574,48,door,46,1,1157,19,210,435,364,707,154,272,door
29575,5,person,5,0,1158,26,1336,649,1598,1198,262,549,person
29576,13,person,13,0,1158,15,582,660,671,867,89,207,person
29577,1,person,2,0,1159,27,105,176,145,257,40,81,person
29578,8,person,9,0,1159,31,63,162,94,257,31,95,person
29579,6,person,7,1,1160,28,52,211,206,321,154,110,person
29580,7,person,8,1,1160,31,178,187,307,305,129,118,person
29581,8,person,9,1,1160,28,260,186,360,288,100,102,person
29582,11,chair,12,1,1160,16,285,280,591,444,306,164,chair
29583,12,person,13,0,1160,26,367,129,401,241,34,112,person
29584,13,person,14,0,1160,33,401,121,450,275,49,154,person
29585,14,person,15,0,1160,34,448,125,496,264,48,139,person
29586,15,person,16,0,1160,29,488,150,518,249,30,99,person
29587,2,person,3,0,1163,36,200,201,245,360,45,159,person
29588,3,person,4,0,1163,21,257,234,301,359,44,125,person
29589,4,person,5,0,1163,15,309,271,336,356,27,85,person
29590,0,person,1,0,1165,51,1421,787,1632,1306,211,519,person
29591,1,person,2,0,1165,54,1719,838,1865,1305,146,467,person
29592,2,person,3,0,1165,41,1916,799,2108,1318,192,519,person
29593,15,person,16,0,1165,62,762,770,889,1179,127,409,person
29594,23,person,24,1,1165,86,664,799,807,1194,143,395,person
29595,35,person,36,1,1165,49,1668,810,1760,1081,92,271,person
29596,68,suitcase,69,0,1165,24,724,980,856,1068,132,88,suitcase
29597,69,suitcase,70,0,1165,23,754,1065,851,1193,97,128,suitcase
29598,70,suitcase,71,1,1165,26,1837,1125,1962,1307,125,182,suitcase
29599,72,person,73,0,1165,68,236,818,320,1012,84,194,person
29600,75,suitcase,76,0,1165,39,103,908,221,1045,118,137,suitcase
29601,87,person,88,0,1165,44,548,823,609,971,61,148,person
29602,88,person,89,1,1165,39,595,808,634,943,39,135,person
29603,89,suitcase,90,0,1165,32,590,900,630,969,40,69,suitcase
29604,90,suitcase,91,1,1165,39,103,951,221,1028,118,77,suitcase
29605,91,suitcase,92,0,1165,19,114,979,191,1021,77,42,suitcase
29606,93,person,94,0,1165,65,222,821,265,965,43,144,person
29607,103,person,104,0,1165,54,1105,787,1168,1005,63,218,person
29608,3,person,4,0,1166,31,323,199,387,358,64,159,person
29609,4,person,5,0,1166,29,386,214,424,358,38,144,person
29610,5,person,6,0,1166,40,415,211,485,358,70,147,person
29611,27,person,28,0,1167,27,1083,555,1140,648,57,93,person
29612,28,person,29,0,1167,34,956,511,988,597,32,86,person
29613,29,person,30,0,1167,25,1064,509,1094,586,30,77,person
29614,29,bench,30,0,1168,20,406,202,459,235,53,33,bench
29615,32,person,33,0,1168,24,342,174,363,233,21,59,person
29616,6,person,7,0,1169,26,91,340,124,419,33,79,person
29617,2,person,3,0,1170,73,227,68,398,363,171,295,person
29618,3,backpack,4,0,1170,31,109,147,239,233,130,86,backpack
29619,4,backpack,5,0,1170,18,251,296,340,366,89,70,backpack
29620,5,person,6,0,1170,51,335,105,481,365,146,260,person
29621,8,person,9,1,1170,17,455,85,499,164,44,79,person
29622,9,person,10,1,1170,36,54,50,185,178,131,128,person
29623,12,person,13,1,1170,21,232,82,260,141,28,59,person
29624,13,person,14,1,1170,15,257,90,284,142,27,52,person
29625,17,car,17,0,1173,21,560,365,763,439,203,74,car
29626,18,car,18,0,1173,19,468,353,652,436,184,83,car
29627,1,person,2,0,1174,32,55,396,123,604,68,208,person
29628,4,table,5,0,1174,23,250,530,350,622,100,92,dining table
29629,1,person,2,1,1175,34,302,165,471,374,169,209,person
29630,2,person,3,1,1175,39,185,156,331,374,146,218,person
29631,3,person,4,1,1175,32,2,161,139,374,137,213,person
29632,4,person,5,1,1175,39,58,111,166,326,108,215,person
29633,5,backpack,6,0,1175,20,79,163,151,279,72,116,backpack
29634,6,person,7,1,1175,27,173,129,251,272,78,143,person
29635,7,person,8,1,1175,26,151,161,196,271,45,110,person
29636,9,person,10,1,1175,26,135,116,194,193,59,77,person
29637,10,person,11,1,1175,26,292,126,367,263,75,137,person
29638,12,person,13,1,1175,25,326,124,378,242,52,118,person
29639,13,person,14,1,1175,25,424,152,500,320,76,168,person
29640,15,person,16,1,1175,15,419,139,454,196,35,57,person
29641,16,person,17,1,1175,19,370,129,410,177,40,48,person
29642,1,person,2,0,1177,23,270,252,290,313,20,61,person
29643,2,person,3,0,1177,25,298,252,320,320,22,68,person
29644,3,person,4,0,1177,33,436,249,469,316,33,67,person
29645,18,person,19,0,1177,16,388,249,399,276,11,27,person
29646,7,person,6,0,1178,17,274,666,368,843,94,177,person
29647,8,person,7,0,1178,16,158,600,222,797,64,197,person
29648,18,person,13,0,1178,38,477,595,527,709,50,114,person
29649,19,person,14,0,1178,24,456,601,490,693,34,92,person
29650,20,person,15,0,1178,32,679,653,791,785,112,132,person
29651,21,person,16,0,1178,27,760,644,808,758,48,114,person
29652,23,person,18,1,1178,21,580,665,616,747,36,82,person
29653,26,person,21,0,1178,24,522,602,543,680,21,78,person
29654,27,person,22,0,1178,36,220,594,267,703,47,109,person
29655,29,person,24,1,1178,25,74,599,118,702,44,103,person
29656,30,person,25,1,1178,44,32,596,85,770,53,174,person
29657,34,person,29,0,1178,45,0,589,65,832,65,243,person
29658,38,person,33,1,1178,20,715,653,758,727,43,74,person
29659,39,person,34,1,1178,22,892,603,919,684,27,81,person
29660,40,person,35,1,1178,32,883,650,959,721,76,71,person
29661,41,person,36,1,1178,24,1231,566,1296,710,65,144,person
29662,42,person,37,1,1178,20,1229,667,1285,780,56,113,person
29663,43,person,38,1,1178,32,1094,591,1194,864,100,273,person
29664,44,person,39,1,1178,39,1128,628,1285,863,157,235,person
29665,45,person,40,1,1178,30,1054,594,1102,693,48,99,person
29666,48,person,43,1,1178,28,444,600,469,687,25,87,person
29667,0,person,1,0,1180,33,114,162,150,258,36,96,person
29668,1,suitcase,2,0,1180,18,107,214,124,248,17,34,suitcase
29669,3,person,4,0,1180,19,150,168,170,237,20,69,person
29670,4,person,5,0,1180,27,150,197,220,257,70,60,person
29671,10,person,11,1,1180,29,308,210,348,261,40,51,person
29672,12,person,13,1,1180,27,239,202,295,262,56,60,person
29673,13,person,14,1,1180,27,212,201,271,261,59,60,person
29674,15,person,16,1,1180,29,176,197,205,226,29,29,person
29675,16,person,17,0,1180,19,234,169,246,204,12,35,person
29676,17,person,18,1,1180,17,191,165,204,201,13,36,person
29677,18,person,19,1,1180,17,294,169,316,203,22,34,person
29678,2,person,3,0,1181,36,150,137,187,237,37,100,person
29679,3,person,4,0,1181,33,208,170,323,206,115,36,person
29680,8,person,9,0,1181,20,389,118,413,205,24,87,person
29681,0,person,1,0,1182,32,61,69,108,219,47,150,person
29682,1,person,2,1,1182,17,79,80,110,214,31,134,person
29683,0,person,1,1,1183,34,236,299,501,958,265,659,person
29684,3,person,4,0,1183,46,777,405,1004,958,227,553,person
29685,7,person,8,1,1183,28,489,388,654,878,165,490,person
29686,8,person,9,1,1183,15,610,432,724,811,114,379,person
29687,9,person,10,1,1183,21,690,430,805,774,115,344,person
29688,19,person,20,0,1184,22,207,205,222,258,15,53,person
29689,20,person,21,1,1184,16,224,200,240,257,16,57,person
29690,21,person,22,0,1184,16,237,202,249,259,12,57,person
29691,22,suitcase,23,0,1184,17,252,225,270,267,18,42,suitcase
29692,24,person,25,1,1184,16,262,196,277,229,15,33,person
29693,26,person,27,1,1184,15,280,198,296,224,16,26,person
29694,27,person,28,0,1184,21,294,195,317,274,23,79,person
29695,29,person,30,1,1184,20,338,193,354,257,16,64,person
29696,30,person,31,1,1184,19,316,202,342,299,26,97,person
29697,32,person,33,0,1184,43,358,190,404,318,46,128,person
29698,33,person,34,1,1184,23,387,194,414,300,27,106,person
29699,16,person,17,0,1185,30,469,634,535,838,66,204,person
29700,17,person,18,0,1185,42,174,613,268,861,94,248,person
29701,21,person,22,1,1185,22,1145,644,1212,866,67,222,person
29702,25,person,26,0,1185,19,717,688,748,783,31,95,person
29703,19,person,20,1,1186,24,691,334,779,482,88,148,person
29704,20,person,21,0,1186,16,37,222,62,279,25,57,person
29705,26,person,27,0,1186,20,343,226,359,294,16,68,person
29706,28,person,29,0,1186,26,359,270,377,330,18,60,person
29707,30,person,31,0,1186,25,382,234,402,294,20,60,person
29708,31,person,32,0,1186,21,403,267,432,317,29,50,person
29709,10,person,11,0,1188,33,185,255,231,415,46,160,person
29710,10,person,11,0,1191,18,268,577,292,653,24,76,person
29711,11,person,12,0,1192,28,1058,859,1317,1411,259,552,person
29712,18,person,18,0,1192,26,321,898,645,1335,324,437,person
29713,29,person,29,1,1192,26,1076,737,1265,936,189,199,person
29714,30,person,30,1,1192,35,912,722,1095,1040,183,318,person
29715,31,person,31,1,1192,28,918,753,1032,1044,114,291,person
29716,8,person,9,0,1193,39,196,126,247,254,51,128,person
29717,9,person,10,0,1193,32,289,121,335,270,46,149,person
29718,10,person,11,0,1193,29,264,123,300,256,36,133,person
29719,11,person,12,1,1193,26,326,118,359,246,33,128,person
29720,12,person,13,0,1193,25,353,122,384,243,31,121,person
29721,13,person,14,0,1193,27,391,128,425,212,34,84,person
29722,14,person,15,1,1193,19,410,129,431,204,21,75,person
29723,15,person,16,1,1193,17,2,117,33,258,31,141,person
29724,16,person,17,1,1193,23,16,130,49,244,33,114,person
29725,19,person,20,1,1193,23,40,120,68,236,28,116,person
29726,14,person,15,0,1194,33,410,93,448,179,38,86,person
29727,15,person,16,0,1194,19,343,151,353,181,10,30,person
29728,16,person,17,0,1194,20,317,154,328,181,11,27,person
29729,17,person,18,0,1194,25,264,129,284,182,20,53,person
29730,1,person,2,1,1195,44,1249,807,1843,1647,594,840,person
29731,3,person,4,0,20218,36,102,160,129,243,27,83,person
29732,0,person,1,0,20219,32,61,69,108,219,47,150,person
29733,1,person,2,1,20219,17,79,80,110,214,31,134,person
29734,2,airplane,3,0,22604,84,266,214,867,387,601,173,airplane
29735,13,person,14,1,22605,20,521,247,581,303,60,56,person
29736,14,person,15,1,22605,19,594,233,630,288,36,55,person
29737,15,person,16,1,22605,28,624,204,678,282,54,78,person
29738,16,person,17,1,22605,23,674,187,748,270,74,83,person
29739,17,person,18,1,22605,22,748,197,799,256,51,59,person
29740,19,person,20,1,22605,31,794,160,861,242,67,82,person
29741,20,person,21,1,22605,31,856,147,933,236,77,89,person
29742,21,person,22,1,22605,20,474,256,525,312,51,56,person
29743,22,person,23,1,22605,19,434,259,482,319,48,60,person
29744,23,person,24,1,22605,24,935,148,1003,220,68,72,person
29745,26,person,27,1,22605,19,383,283,436,332,53,49,person
29746,28,person,29,1,22605,22,325,295,384,349,59,54,person
29747,29,person,30,1,22605,26,280,288,343,362,63,74,person
29748,30,person,31,1,22605,23,260,293,311,368,51,75,person
29749,31,person,32,1,22605,18,237,314,278,373,41,59,person
29750,32,person,33,1,22605,17,211,332,241,381,30,49,person
29751,33,person,34,1,22605,22,186,318,227,387,41,69,person
29752,34,person,35,1,22605,19,131,335,190,403,59,68,person
29753,35,person,36,1,22605,26,111,344,161,408,50,64,person
29754,36,person,37,1,22605,18,99,352,143,410,44,58,person
29755,37,person,38,0,22605,18,78,369,114,417,36,48,person
29756,38,person,39,1,22605,16,58,383,83,425,25,42,person
29757,39,person,40,1,22605,19,37,382,63,428,26,46,person
29758,40,person,41,1,22605,18,1,366,39,424,38,58,person
29759,56,person,57,1,22605,18,372,704,439,767,67,63,person
29760,59,person,60,1,22605,22,234,707,303,767,69,60,person
29761,60,person,61,1,22605,16,206,723,239,767,33,44,person
29762,61,person,62,1,22605,15,173,725,209,767,36,42,person
29763,62,person,63,1,22605,18,151,718,189,767,38,49,person
29764,63,person,64,1,22605,21,51,706,131,767,80,61,person
29765,66,person,67,1,22605,17,33,721,76,766,43,45,person
29766,67,person,68,1,22605,16,1,719,47,767,46,48,person
29767,68,person,69,1,22605,15,0,694,41,743,41,49,person
29768,69,person,70,1,22605,17,523,716,571,768,48,52,person
29769,71,person,72,1,22605,21,638,705,683,768,45,63,person
29770,72,person,73,1,22605,16,664,727,731,768,67,41,person
29771,73,person,74,1,22605,18,738,722,790,768,52,46,person
29772,75,person,76,1,22605,24,837,702,891,767,54,65,person
29773,76,person,77,1,22605,15,875,710,965,767,90,57,person
29774,9,person,10,1,1199,32,337,191,484,309,147,118,person
29775,12,person,13,1,1199,20,187,187,253,282,66,95,person
29776,14,person,15,1,1199,15,130,203,167,253,37,50,person
29777,5,person,6,0,1201,22,130,316,173,480,43,164,person
29778,6,person,7,1,1201,17,168,338,199,474,31,136,person
29779,7,person,8,1,1201,15,539,317,593,424,54,107,person
29780,9,person,10,1,1201,24,382,326,460,565,78,239,person
29781,10,person,11,0,1201,29,413,316,510,573,97,257,person
29782,6,person,7,0,1202,59,467,142,664,418,197,276,person
29783,2,person,3,1,1205,18,317,70,369,162,52,92,person
29784,3,person,4,1,1205,25,393,44,512,173,119,129,person
29785,4,person,5,1,1205,19,279,81,328,145,49,64,person
29786,7,person,8,1,1205,38,156,64,289,368,133,304,person
29787,9,person,10,0,1205,40,92,43,190,347,98,304,person
29788,11,person,12,1,1205,34,51,59,104,320,53,261,person
29789,12,person,13,0,1205,34,0,59,70,338,70,279,person
29790,5,person,6,1,1206,43,206,218,302,439,96,221,person
29791,7,person,8,1,1206,51,374,195,474,439,100,244,person
29792,8,person,9,1,1206,32,506,208,553,414,47,206,person
29793,9,person,10,1,1206,16,534,204,585,439,51,235,person
29794,4,person,5,0,1597,32,393,316,431,439,38,123,person
29795,15,person,16,1,1598,19,457,227,475,311,18,84,person
29796,16,person,17,1,1598,21,432,234,464,301,32,67,person
29797,17,person,18,1,1598,18,400,234,435,282,35,48,person
29798,18,person,19,1,1598,28,495,267,563,333,68,66,person
29799,19,person,20,1,1598,16,553,263,599,394,46,131,person
29800,20,person,21,1,1598,18,534,233,572,278,38,45,person
29801,21,window,22,0,1598,19,280,165,590,263,310,98,window
29802,14,person,15,0,1600,32,314,209,346,328,32,119,person
29803,16,person,17,1,1600,22,291,217,316,325,25,108,person
29804,8,person,9,1,2118,24,1248,300,1365,868,117,568,person
29805,9,person,10,1,2118,34,1147,245,1349,492,202,247,person
29806,12,person,13,1,2118,39,1031,306,1168,760,137,454,person
29807,13,person,14,1,2118,16,856,329,933,432,77,103,person
29808,16,person,17,1,2118,24,674,270,800,435,126,165,person
29809,17,person,18,1,2118,33,559,262,683,418,124,156,person
29810,24,person,25,1,2118,25,350,244,479,432,129,188,person
29811,25,person,26,1,2118,18,466,333,576,441,110,108,person
29812,27,person,28,1,2118,21,330,300,432,453,102,153,person
29813,28,person,29,1,2118,42,1124,370,1333,868,209,498,person
29814,29,person,30,1,2118,52,886,257,1097,771,211,514,person
29815,30,person,31,1,2118,43,647,279,960,860,313,581,person
29816,31,person,32,1,2118,45,479,303,691,856,212,553,person
29817,33,person,34,1,2118,39,341,339,507,709,166,370,person
29818,34,person,35,1,2118,34,236,283,383,679,147,396,person
29819,35,person,36,1,2118,35,83,191,312,707,229,516,person
29820,3,suitcase,4,0,2119,20,2,132,116,222,114,90,suitcase
29821,5,suitcase,6,1,2119,17,104,116,153,144,49,28,suitcase
29822,6,person,7,1,2119,79,115,51,213,211,98,160,person
29823,7,person,8,1,2119,35,226,63,251,112,25,49,person
29824,8,person,9,1,2119,24,268,43,295,95,27,52,person
29825,15,suitcase,16,0,2119,16,235,123,281,188,46,65,suitcase
29826,8,person,9,0,2123,28,278,98,294,138,16,40,person
29827,17,person,18,1,2126,37,421,121,499,331,78,210,person
29828,0,window,1,0,2128,35,133,0,446,134,313,134,window
29829,13,person,14,1,2128,66,304,68,384,309,80,241,person
29830,3,suitcase,4,0,2129,15,75,344,216,451,141,107,suitcase
29831,14,chair,15,0,2129,16,982,204,1093,293,111,89,chair
29832,15,chair,16,0,2129,15,994,238,1110,330,116,92,chair
29833,16,chair,17,0,2129,18,1006,276,1130,373,124,97,chair
29834,17,chair,18,0,2129,17,1023,316,1152,423,129,107,chair
29835,18,chair,19,0,2129,16,1038,361,1177,472,139,111,chair
29836,19,chair,20,0,2129,22,1054,407,1192,579,138,172,chair
29837,20,person,21,0,2129,53,1377,442,1498,716,121,274,person
29838,25,person,26,0,2129,58,393,194,502,450,109,256,person
29839,27,person,28,1,2129,21,383,227,422,352,39,125,person
29840,30,person,31,1,2129,39,295,592,438,854,143,262,person
29841,31,suitcase,32,1,2129,28,302,700,400,827,98,127,suitcase
29842,32,person,33,1,2129,39,315,727,414,1070,99,343,person
29843,2,person,3,1,2130,89,135,19,409,349,274,330,person
29844,3,suitcase,4,1,2130,43,344,191,535,306,191,115,suitcase
29845,16,chair,17,1,2131,16,3,716,69,894,66,178,chair
29846,5,suitcase,6,1,2132,16,1433,446,1816,580,383,134,suitcase
29847,7,suitcase,8,1,2132,30,957,446,1263,706,306,260,suitcase
29848,9,suitcase,10,1,2132,25,445,465,746,711,301,246,suitcase
29849,10,suitcase,11,1,2132,19,379,468,583,662,204,194,suitcase
29850,5,person,6,1,2133,17,218,580,268,753,50,173,person
29851,6,person,7,1,2133,16,155,592,235,776,80,184,person
29852,7,person,8,1,2133,18,305,629,388,723,83,94,person
29853,8,person,9,1,2133,16,592,648,696,796,104,148,person
29854,18,suitcase,19,0,2133,17,141,715,492,1003,351,288,suitcase
29855,19,suitcase,20,0,2133,21,800,580,1902,1195,1102,615,suitcase
29856,19,suitcase,20,0,2134,16,365,781,517,895,152,114,suitcase
29857,20,suitcase,21,0,2134,19,510,843,692,916,182,73,suitcase
29858,21,suitcase,22,0,2134,17,660,780,826,910,166,130,suitcase
29859,33,person,34,0,2134,46,1356,407,1468,661,112,254,person
29860,35,person,36,0,2134,52,31,656,203,1026,172,370,person
29861,36,person,37,1,2134,33,97,628,226,881,129,253,person
29862,39,person,40,1,2134,20,103,510,188,659,85,149,person
29863,40,person,41,1,2134,23,172,208,220,400,48,192,person
29864,43,person,44,1,2134,25,294,168,350,315,56,147,person
29865,44,person,45,1,2134,23,417,118,462,284,45,166,person
29866,45,person,46,1,2134,19,307,97,372,239,65,142,person
29867,47,person,48,0,2134,24,368,101,410,250,42,149,person
29868,49,person,50,0,2134,29,172,69,234,207,62,138,person
29869,52,person,53,1,2134,21,49,66,90,176,41,110,person
29870,53,person,54,0,2134,26,15,75,81,199,66,124,person
29871,54,person,55,1,2134,15,11,49,46,116,35,67,person
29872,5,person,6,1,2136,43,363,98,415,336,52,238,person
29873,6,person,7,1,2136,39,388,96,458,363,70,267,person
29874,12,suitcase,13,0,2136,15,166,230,274,307,108,77,suitcase
29875,13,suitcase,14,1,2136,22,65,236,181,331,116,95,suitcase
29876,16,suitcase,17,0,2136,16,289,215,365,266,76,51,suitcase
29877,22,person,23,1,2136,20,457,148,484,276,27,128,person
29878,10,suitcase,11,0,2137,20,87,192,168,225,81,33,suitcase
29879,4,suitcase,5,0,2138,23,754,527,1708,1138,954,611,suitcase
29880,6,suitcase,7,0,2138,21,103,364,714,759,611,395,suitcase
29881,1,person,2,0,20272,53,156,41,190,129,34,88,person
29882,8,person,9,0,20272,61,65,90,115,219,50,129,person
29883,9,person,10,0,20272,20,10,100,24,138,14,38,person
29884,5,window,6,0,4264,20,73,94,260,194,187,100,window
29885,2,bed,3,1,4267,22,2,185,897,596,895,411,bed
29886,7,bed,8,1,4274,16,0,146,169,269,169,123,bed
29887,8,chair,9,1,4275,22,139,108,192,209,53,101,chair
29888,5,bed,6,1,4276,43,16,76,274,235,258,159,bed
29889,6,bed,7,1,4276,16,0,117,155,235,155,118,bed
29890,1,sofa,2,1,4277,18,0,37,776,1647,776,1610,couch
29891,2,sofa,3,1,4277,27,1487,6,2200,1650,713,1644,couch
29892,2,person,3,1,4281,49,116,181,533,478,417,297,person
29893,3,bed,4,0,22894,22,132,540,1330,1225,1198,685,bed
29894,4,bed,5,0,22894,18,226,1122,1302,1650,1076,528,bed
29895,6,window,7,0,22894,16,1100,32,1931,1038,831,1006,window
29896,11,bus,12,1,4846,22,5,103,128,281,123,178,bus
29897,18,bus,19,0,4846,23,103,103,182,277,79,174,bus
29898,23,bus,24,1,4846,20,259,105,400,299,141,194,bus
29899,3,bus,4,1,4847,15,161,161,493,665,332,504,bus
29900,4,bus,5,0,4847,24,452,150,942,673,490,523,bus
29901,19,mirror,20,0,4847,15,430,378,466,443,36,65,mirror
29902,8,person,9,0,67,75,151,185,258,522,107,337,person
29903,18,person,19,1,67,33,234,200,271,323,37,123,person
29904,19,person,20,0,67,89,267,211,345,467,78,256,person
29905,26,backpack,27,0,67,25,286,244,343,336,57,92,backpack
29906,27,suitcase,28,0,67,26,329,322,372,457,43,135,suitcase
29907,28,suitcase,29,1,67,19,225,373,274,466,49,93,suitcase
29908,29,person,30,0,67,67,614,225,739,495,125,270,person
29909,36,backpack,37,0,67,32,680,257,747,369,67,112,backpack
29910,1,person,2,1,4861,34,2,128,205,359,203,231,person
29911,2,person,3,1,4861,41,76,126,191,331,115,205,person
29912,3,person,4,1,4861,46,129,117,206,334,77,217,person
29913,4,person,5,1,4861,35,147,101,216,242,69,141,person
29914,5,person,6,1,4861,45,206,94,272,198,66,104,person
29915,6,person,7,1,4861,42,261,101,332,245,71,144,person
29916,7,person,8,0,4861,50,189,133,316,359,127,226,person
29917,8,person,9,1,4861,59,277,100,419,358,142,258,person
29918,9,person,10,1,4861,40,346,107,480,358,134,251,person
29919,3,person,4,1,4862,29,148,68,270,178,122,110,person
29920,4,person,5,1,4862,27,266,116,376,368,110,252,person
29921,5,person,6,1,4862,24,464,83,533,180,69,97,person
29922,7,person,8,1,4862,44,25,161,193,398,168,237,person
29923,8,person,9,1,4862,39,192,250,505,399,313,149,person
29924,11,person,12,1,4862,33,397,145,532,398,135,253,person
29925,3,person,4,1,4863,19,50,1,94,81,44,80,person
29926,2,sofa,3,0,4864,15,189,104,531,218,342,114,couch
29927,3,sofa,4,0,4864,28,2,142,300,477,298,335,couch
29928,4,sofa,5,0,4864,27,431,147,640,480,209,333,couch
29929,11,person,12,1,4865,26,2,235,168,435,166,200,person
29930,13,person,14,1,4865,22,80,213,135,313,55,100,person
29931,14,person,15,1,4865,21,95,235,170,312,75,77,person
29932,16,person,17,1,4865,39,190,215,322,381,132,166,person
29933,18,person,19,1,4865,18,273,243,346,322,73,79,person
29934,21,person,22,1,4865,38,338,191,475,313,137,122,person
29935,22,person,23,1,4865,51,432,168,649,435,217,267,person
29936,23,person,24,1,4865,23,574,191,634,311,60,120,person
29937,4,window,5,0,4866,16,153,126,225,257,72,131,window
29938,5,window,6,0,4866,18,0,114,156,353,156,239,window
29939,8,window,9,0,4866,15,581,98,658,334,77,236,window
29940,5,bed,6,0,4868,28,335,97,489,331,154,234,bed
29941,9,person,10,1,4871,19,646,255,768,375,122,120,person
29942,10,person,11,1,4871,17,448,266,570,358,122,92,person
29943,13,person,14,1,4871,22,329,206,424,362,95,156,person
29944,16,person,17,1,4871,18,281,217,373,353,92,136,person
29945,18,person,19,1,4871,47,2,236,261,594,259,358,person
29946,19,person,20,1,4871,28,490,129,546,276,56,147,person
29947,26,person,27,1,4871,15,394,465,669,597,275,132,person
29948,0,person,1,1,4873,18,106,116,166,171,60,55,person
29949,1,person,2,1,4873,32,29,118,237,373,208,255,person
29950,2,person,3,1,4873,34,268,126,357,257,89,131,person
29951,3,person,4,1,4873,32,313,127,426,333,113,206,person
29952,4,person,5,1,4873,15,441,119,498,197,57,78,person
29953,3,window,4,0,4875,20,459,89,639,302,180,213,window
29954,8,person,9,1,4876,30,2,165,190,425,188,260,person
29955,11,person,12,1,4876,39,130,144,288,411,158,267,person
29956,13,person,14,1,4876,19,197,192,283,309,86,117,person
29957,15,person,16,1,4876,21,261,198,312,285,51,87,person
29958,18,person,19,1,4876,30,362,220,545,399,183,179,person
29959,22,person,23,1,4876,17,526,200,583,238,57,38,person
29960,24,person,25,1,4876,34,335,172,427,326,92,154,person
29961,27,person,28,1,4876,16,293,193,323,242,30,49,person
29962,29,person,30,1,4876,18,340,187,387,252,47,65,person
29963,3,person,4,1,4877,18,355,414,490,612,135,198,person
29964,4,person,5,1,4877,31,374,389,596,685,222,296,person
29965,6,person,7,1,4877,20,810,398,895,560,85,162,person
29966,7,person,8,1,4877,19,873,396,973,656,100,260,person
29967,8,person,9,1,4877,31,948,295,1146,645,198,350,person
29968,9,person,10,1,4877,34,741,556,937,1187,196,631,person
29969,11,person,12,1,4877,34,864,557,1232,1193,368,636,person
29970,14,person,15,1,4877,28,1077,688,1593,1194,516,506,person
29971,17,window,18,1,4877,17,1194,310,1596,701,402,391,window
29972,19,person,20,1,4877,20,456,574,618,748,162,174,person
29973,20,person,21,1,4877,30,552,594,797,1194,245,600,person
29974,22,person,23,1,4877,19,125,506,318,723,193,217,person
29975,23,person,24,1,4877,17,34,596,533,1005,499,409,person
29976,24,window,25,1,4877,19,2,288,336,714,334,426,window
29977,4,person,5,1,4878,15,347,326,437,373,90,47,person
29978,5,person,6,1,4878,25,271,287,315,369,44,82,person
29979,6,person,7,1,4878,20,199,291,253,366,54,75,person
29980,7,person,8,1,4878,15,222,321,276,368,54,47,person
29981,8,person,9,1,4878,22,79,315,151,373,72,58,person
29982,7,person,6,1,4881,16,499,269,536,437,37,168,person
29983,8,person,7,0,4881,30,467,248,522,511,55,263,person
29984,10,person,9,1,4881,23,428,283,478,466,50,183,person
29985,12,person,11,1,4881,19,403,337,466,525,63,188,person
29986,14,person,13,1,4881,41,160,228,330,599,170,371,person
29987,16,person,15,1,4881,18,0,242,117,598,117,356,person
29988,22,person,21,1,4881,16,650,452,799,599,149,147,person
29989,25,person,24,1,4881,21,532,360,660,570,128,210,person
29990,26,person,25,1,4881,18,552,359,650,489,98,130,person
29991,6,bus,7,0,4893,35,86,30,358,255,272,225,bus
29992,3,bus,4,0,4894,63,480,142,984,521,504,379,bus
29993,4,bus,5,1,4894,45,129,147,540,480,411,333,bus
29994,5,bus,6,1,4894,34,0,163,219,473,219,310,bus
29995,12,person,13,1,4895,15,178,264,206,313,28,49,person
29996,14,person,15,0,4895,36,139,286,201,391,62,105,person
29997,15,person,16,0,4895,35,306,235,394,426,88,191,person
29998,16,bench,17,1,4895,23,357,369,599,448,242,79,bench
29999,18,person,19,0,4895,25,265,264,296,323,31,59,person
30000,19,person,20,1,4895,26,536,259,573,370,37,111,person
30001,20,person,21,1,4895,17,546,236,587,336,41,100,person
30002,22,person,23,0,4895,16,111,235,123,275,12,40,person
30003,2,bus,2,0,4896,19,41,97,139,128,98,31,bus
30004,3,bus,3,1,4896,22,164,72,299,144,135,72,bus
30005,8,person,8,0,4896,32,25,118,48,193,23,75,person
30006,9,person,9,1,4896,29,68,119,87,172,19,53,person
30007,10,person,10,0,4896,37,81,116,108,182,27,66,person
30008,11,person,11,0,4896,28,106,141,127,183,21,42,person
30009,18,bench,19,0,24869,96,254,289,452,350,198,61,bench
30010,20,person,21,1,24869,30,248,261,279,319,31,58,person
30011,21,person,22,0,24869,52,269,276,310,364,41,88,person
30012,22,person,23,0,24869,48,355,277,399,361,44,84,person
30013,23,person,24,0,24869,52,417,281,463,354,46,73,person
30014,24,person,25,1,24869,25,608,252,623,324,15,72,person
30015,35,person,36,1,24869,17,408,273,422,288,14,15,person
30016,36,person,37,1,24869,31,403,248,420,289,17,41,person
30017,37,person,38,1,24869,29,378,245,402,288,24,43,person
30018,38,person,39,1,24869,28,364,241,381,280,17,39,person
30019,1,door,2,1,5065,18,96,0,227,99,131,99,door
30020,1,window,2,1,5066,16,261,0,1358,191,1097,191,window
30021,7,door,8,1,5067,32,222,0,516,212,294,212,door
30022,0,window,1,0,5068,19,38,0,293,49,255,49,window
30023,2,door,3,1,5068,21,325,0,383,209,58,209,door
30024,7,door,8,0,5069,28,664,0,1077,447,413,447,door
30025,2,person,3,1,5070,50,2,49,338,376,336,327,person
30026,5,door,6,0,5071,23,165,0,690,470,525,470,door
30027,9,door,10,1,5073,44,107,2,402,284,295,282,door
30028,6,person,7,0,5074,69,360,156,933,666,573,510,person
30029,10,door,11,1,5074,35,469,187,806,492,337,305,door
30030,5,door,6,0,5075,18,350,0,559,285,209,285,door
30031,6,door,7,0,5076,24,64,12,316,301,252,289,door
30032,8,window,9,1,5076,21,339,49,495,160,156,111,window
30033,0,door,1,0,5077,21,0,1,73,191,73,190,door
30034,9,door,10,1,5078,20,483,1,749,259,266,258,door
30035,10,door,11,1,5078,19,0,0,156,467,156,467,door
30036,0,door,1,1,5079,22,0,0,51,362,51,362,door
30037,7,door,8,1,5080,25,0,0,175,243,175,243,door
30038,3,door,4,1,5081,31,2,4,399,695,397,691,door
30039,1,door,2,1,5082,26,0,1,287,374,287,373,door
30040,1,door,2,1,5083,25,350,0,499,190,149,190,door
30041,0,door,1,1,5084,28,468,5,1079,580,611,575,door
30042,6,window,7,1,5084,20,1170,37,1598,315,428,278,window
30043,8,person,9,1,5107,85,267,120,415,449,148,329,person
30044,5,person,6,0,5110,34,324,204,359,305,35,101,person
30045,6,person,7,0,5110,41,369,197,425,347,56,150,person
30046,7,person,8,0,5110,76,482,143,578,473,96,330,person
30047,5,person,6,0,5111,80,1410,580,1560,1089,150,509,person
30048,6,person,7,0,5113,55,121,44,167,159,46,115,person
30049,3,person,4,1,5115,28,566,50,819,355,253,305,person
30050,4,person,5,0,5115,52,483,297,953,847,470,550,person
30051,5,person,6,0,5115,53,113,275,570,927,457,652,person
30052,14,car,15,0,5128,33,453,363,764,630,311,267,car
30053,15,dog,16,0,5128,32,168,700,304,898,136,198,dog
30054,8,car,9,1,5130,37,147,136,313,239,166,103,car
30055,7,car,8,1,5131,20,104,170,262,240,158,70,car
30056,13,car,14,0,5132,32,45,214,235,354,190,140,car
30057,14,car,15,1,5132,28,229,212,377,311,148,99,car
30058,15,car,16,0,5132,36,306,233,639,425,333,192,car
30059,16,window,17,0,5132,20,441,252,585,295,144,43,window
30060,1,window,2,0,117,40,160,135,792,341,632,206,window
30061,2,window,3,0,117,16,2,108,226,359,224,251,window
30062,3,window,4,0,117,16,1020,129,1199,284,179,155,window
30063,6,chair,7,1,117,24,1,126,467,674,466,548,chair
30064,7,chair,8,1,117,15,904,163,1199,675,295,512,chair
30065,8,person,9,0,117,72,675,102,1136,675,461,573,person
30066,14,person,15,0,117,66,170,161,647,669,477,508,person
30067,2,person,3,1,5890,72,0,49,175,240,175,191,person
30068,3,person,4,1,5890,42,165,61,320,239,155,178,person
30069,6,window,7,0,5890,20,108,71,202,111,94,40,window
30070,7,window,8,0,5890,19,219,66,294,103,75,37,window
30071,8,window,9,0,5890,17,218,6,310,44,92,38,window
30072,9,window,10,0,5890,15,60,21,140,51,80,30,window
30073,0,window,1,0,5893,24,167,0,2197,518,2030,518,window
30074,10,window,11,0,5893,23,1405,1022,2197,1474,792,452,window
30075,11,window,12,0,5893,17,158,1008,797,1485,639,477,window
30076,6,person,7,1,5894,67,153,95,469,829,316,734,person
30077,8,person,9,1,5894,40,539,268,907,830,368,562,person
30078,4,person,5,0,5895,34,180,341,502,958,322,617,person
30079,5,person,6,1,5895,36,314,438,658,787,344,349,person
30080,6,person,7,1,5895,31,765,465,1000,958,235,493,person
30081,9,window,10,0,5895,18,527,426,801,561,274,135,window
30082,7,person,8,0,5896,21,449,3,638,368,189,365,person
30083,1,window,2,0,5898,27,44,1,511,282,467,281,window
30084,6,window,5,0,5899,30,0,16,499,103,499,87,window
30085,1,person,2,1,5900,42,3,220,708,1389,705,1169,person
30086,2,person,3,1,5900,45,1174,203,2097,1394,923,1191,person
30087,4,window,5,0,5900,41,344,302,1651,720,1307,418,window
30088,3,window,4,0,5901,23,281,185,1538,688,1257,503,window
30089,4,person,5,1,5901,31,284,289,1000,1850,716,1561,person
30090,4,chair,5,1,5902,25,0,300,97,479,97,179,chair
30091,5,chair,6,1,5902,19,529,305,639,479,110,174,chair
30092,0,person,1,1,5903,42,0,368,1104,1629,1104,1261,person
30093,0,window,1,0,5904,21,0,0,2009,1029,2009,1029,window
30094,2,window,3,0,5907,38,310,259,877,372,567,113,window
30095,5,person,6,1,5907,45,635,281,856,618,221,337,person
30096,6,person,7,1,5907,45,316,301,580,624,264,323,person
30097,0,person,1,1,5908,64,3,44,574,652,571,608,person
30098,1,person,2,1,5908,20,806,297,999,663,193,366,person
30099,2,chair,3,1,5908,19,0,422,571,664,571,242,chair
30100,3,chair,4,1,5908,17,757,488,999,665,242,177,chair
30101,4,window,5,0,5908,38,277,141,996,298,719,157,window
30102,0,window,1,0,5909,46,449,165,1600,532,1151,367,window
30103,1,window,2,0,5909,17,95,210,345,622,250,412,window
30104,2,person,3,1,5909,63,1141,300,1887,1376,746,1076,person
30105,3,person,4,1,5909,57,162,292,784,1408,622,1116,person
30106,5,window,6,0,5910,21,94,222,905,435,811,213,window
30107,0,airplane,1,1,5911,21,0,0,1918,1077,1918,1077,airplane
30108,1,window,2,0,5911,15,218,161,617,797,399,636,window
30109,2,window,3,0,5911,28,619,32,1367,610,748,578,window
30110,1,window,2,0,5915,30,0,998,1849,1390,1849,392,window
30111,2,person,3,1,5915,26,1849,978,2198,1647,349,669,person
30112,2,window,3,0,5916,28,0,19,1498,1274,1498,1255,window
30113,0,person,1,1,5917,42,1118,503,1771,1464,653,961,person
30114,2,person,3,1,5917,21,1702,351,1990,1464,288,1113,person
30115,3,person,4,1,5917,43,0,341,818,1464,818,1123,person
30116,6,window,7,0,5917,29,200,251,1139,572,939,321,window
30117,7,window,8,0,5917,21,1241,284,1998,587,757,303,window
30118,3,person,4,1,5918,57,137,16,242,139,105,123,person
30119,5,airplane,6,1,5918,23,0,0,299,240,299,240,airplane
30120,0,person,1,1,5919,83,359,389,1775,1338,1416,949,person
30121,0,window,1,0,5920,21,761,20,1534,594,773,574,window
30122,1,window,2,0,5920,25,0,18,720,530,720,512,window
30123,0,window,1,0,5922,26,0,0,2045,656,2045,656,window
30124,3,window,4,0,5923,28,0,0,1599,227,1599,227,window
30125,1,window,2,0,5924,27,50,114,760,221,710,107,window
30126,0,window,1,0,5925,27,0,0,1598,294,1598,294,window
30127,3,person,4,1,5925,51,2,77,569,1188,567,1111,person
30128,8,person,9,1,5925,40,1228,0,1598,1195,370,1195,person
30129,1,window,2,0,5926,20,0,100,700,712,700,612,window
30130,2,person,3,1,5926,41,0,196,734,2139,734,1943,person
30131,0,person,1,1,5927,64,1292,375,2197,1757,905,1382,person
30132,1,person,2,1,5927,54,77,388,1055,1446,978,1058,person
30133,2,window,3,0,5927,29,65,283,1099,791,1034,508,window
30134,3,window,4,0,5927,25,1200,317,2197,806,997,489,window
30135,0,window,1,0,5928,45,93,20,986,273,893,253,window
30136,0,person,1,1,20520,44,699,907,2198,1309,1499,402,person
30137,11,person,12,1,6670,23,185,207,216,258,31,51,person
30138,15,chair,16,0,6670,17,2,251,97,356,95,105,chair
30139,16,chair,17,0,6670,22,62,254,199,360,137,106,chair
30140,17,chair,18,0,6670,25,184,254,305,360,121,106,chair
30141,18,chair,19,0,6670,26,301,254,433,360,132,106,chair
30142,19,chair,20,0,6670,18,405,254,499,360,94,106,chair
30143,14,person,15,1,6671,24,575,543,728,675,153,132,person
30144,15,person,16,1,6671,24,771,592,903,694,132,102,person
30145,16,person,17,1,6671,30,901,560,1088,714,187,154,person
30146,17,chair,18,1,6671,22,28,565,121,738,93,173,chair
30147,18,person,19,1,6671,20,2,494,89,658,87,164,person
30148,19,chair,20,1,6671,25,98,563,235,728,137,165,chair
30149,20,person,21,1,6671,27,75,469,213,591,138,122,person
30150,21,chair,22,0,6671,31,201,533,335,675,134,142,chair
30151,24,chair,25,1,6671,20,299,531,416,659,117,128,chair
30152,25,chair,26,1,6671,15,365,506,461,591,96,85,chair
30153,26,person,27,1,6671,19,221,461,304,531,83,70,person
30154,27,person,28,1,6671,21,291,452,366,506,75,54,person
30155,28,person,29,1,6671,16,447,378,503,473,56,95,person
30156,29,person,30,0,6671,42,462,388,556,646,94,258,person
30157,32,chair,33,0,6671,50,409,655,674,961,265,306,chair
30158,33,chair,34,0,6671,27,534,676,846,910,312,234,chair
30159,34,chair,35,0,6671,26,742,689,1035,919,293,230,chair
30160,35,chair,36,1,6671,36,932,713,1247,1061,315,348,chair
30161,36,chair,37,1,6671,17,1209,733,1477,926,268,193,chair
30162,37,person,38,1,6671,15,1312,868,1598,1061,286,193,person
30163,39,person,40,1,6671,27,816,387,911,645,95,258,person
30164,42,person,43,0,6671,21,918,453,966,589,48,136,person
30165,44,person,45,1,6671,21,996,445,1056,509,60,64,person
30166,45,person,46,1,6671,15,1030,441,1059,487,29,46,person
30167,48,person,49,1,6671,21,1062,476,1140,578,78,102,person
30168,50,person,51,1,6671,22,981,508,1081,581,100,73,person
30169,52,chair,53,1,6671,17,1055,581,1187,714,132,133,chair
30170,55,person,56,1,6671,35,1273,488,1430,737,157,249,person
30171,56,chair,57,1,6671,15,1390,599,1454,735,64,136,chair
30172,58,person,59,1,6671,18,1207,499,1312,594,105,95,person
30173,59,person,60,1,6671,18,1473,577,1598,787,125,210,person
30174,61,person,62,1,6671,33,4,801,241,966,237,165,person
30175,62,person,63,1,6671,17,1467,515,1585,608,118,93,person
30176,63,person,64,1,6671,26,1414,480,1529,604,115,124,person
30177,64,person,65,1,6671,20,1384,462,1469,550,85,88,person
30178,65,person,66,1,6671,17,1177,455,1240,516,63,61,person
30179,66,person,67,1,6671,16,1155,452,1201,515,46,63,person
30180,71,person,72,1,6671,17,1533,462,1572,517,39,55,person
30181,72,person,73,1,6671,19,1254,479,1323,584,69,105,person
30182,27,table,28,0,6672,15,342,506,483,553,141,47,dining table
30183,30,person,31,0,6673,66,772,371,996,724,224,353,person
30184,71,person,72,1,6673,30,1290,324,1496,488,206,164,person
30185,72,person,73,1,6673,16,1879,271,1914,456,35,185,person
30186,32,chair,33,0,6674,16,749,599,842,722,93,123,chair
30187,38,chair,39,1,6674,22,427,611,561,751,134,140,chair
30188,39,chair,40,1,6674,20,585,651,771,791,186,140,chair
30189,40,chair,41,0,6674,25,543,644,716,827,173,183,chair
30190,41,chair,42,0,6674,16,509,637,666,751,157,114,chair
30191,42,chair,43,0,6674,16,455,615,590,716,135,101,chair
30192,43,chair,44,0,6674,27,476,624,633,786,157,162,chair
30193,44,table,45,0,6674,45,643,719,859,920,216,201,dining table
30194,45,table,46,0,6674,22,1036,626,1153,709,117,83,dining table
30195,20,table,21,0,6675,15,195,998,377,1078,182,80,dining table
30196,26,table,27,0,6675,17,4,1286,455,1489,451,203,dining table
30197,43,person,44,1,6675,24,1305,798,1343,889,38,91,person
30198,44,person,45,0,6675,19,1099,795,1132,878,33,83,person
30199,3,table,4,1,6778,29,92,204,546,411,454,207,dining table
30200,8,sofa,9,0,6779,17,554,313,839,611,285,298,couch
30201,9,sofa,10,0,6779,22,113,321,393,613,280,292,couch
30202,1,sofa,2,0,6780,20,0,130,421,382,421,252,couch
30203,3,table,4,0,6780,33,137,203,444,382,307,179,dining table
30204,5,plate,6,0,6780,17,194,246,277,285,83,39,plate
30205,8,plate,9,0,6780,15,327,206,396,240,69,34,plate
30206,10,table,11,0,6781,15,144,178,413,356,269,178,dining table
30207,8,table,9,0,6783,26,81,84,160,212,79,128,dining table
30208,10,table,11,0,6784,27,785,616,1478,1404,693,788,dining table
30209,8,table,9,0,6785,25,2,154,213,282,211,128,dining table
30210,11,table,12,0,6787,42,519,887,1766,1647,1247,760,dining table
30211,23,flowerpot,23,0,6788,19,1088,817,1238,937,150,120,potted plant
30212,12,table,13,0,6790,23,281,407,677,719,396,312,dining table
30213,2,table,3,0,6791,25,386,216,1221,623,835,407,dining table
30214,16,sofa,17,0,6793,24,1166,635,1669,994,503,359,couch
30215,24,sofa,25,0,6793,37,402,564,1036,1153,634,589,couch
30216,3,window,4,1,6794,20,580,515,809,599,229,84,window
30217,9,sofa,10,0,6794,44,3,899,1469,1735,1466,836,couch
30218,10,table,11,0,6794,25,182,1072,1251,1785,1069,713,dining table
30219,10,table,11,0,6795,42,375,382,763,718,388,336,dining table
30220,8,table,9,0,6796,17,55,126,216,225,161,99,dining table
30221,12,bowl,13,0,6796,15,149,142,183,169,34,27,bowl
30222,3,door,4,0,6797,17,580,30,758,736,178,706,door
30223,8,sofa,9,0,6798,24,2,195,601,767,599,572,couch
30224,9,table,10,0,6798,39,266,340,766,767,500,427,dining table
30225,7,table,8,0,6799,28,95,67,222,181,127,114,dining table
30226,7,table,8,0,6800,20,149,113,289,184,140,71,dining table
30227,10,sofa,11,0,6802,18,215,112,274,180,59,68,couch
30228,13,table,14,0,6803,15,2,665,442,863,440,198,dining table
30229,2,window,3,0,6804,16,736,223,1146,992,410,769,window
30230,6,table,7,0,6804,15,5,1108,2045,1646,2040,538,dining table
30231,5,table,6,0,6805,22,252,285,783,725,531,440,dining table
30232,18,bowl,19,0,6805,33,493,249,625,355,132,106,bowl
30233,6,table,7,0,6806,20,464,496,1245,1101,781,605,dining table
30234,13,sofa,14,1,6807,34,923,869,1615,1464,692,595,couch
30235,14,sofa,15,1,6807,19,1095,1259,2199,1464,1104,205,couch
30236,16,table,17,0,6807,18,985,1018,1903,1466,918,448,dining table
30237,17,table,18,0,6808,26,803,726,1700,1026,897,300,dining table
30238,18,chair,19,0,6808,36,976,835,1692,1463,716,628,chair
30239,19,chair,20,0,6808,73,1660,706,2140,1373,480,667,chair
30240,12,table,13,0,6809,26,45,86,219,205,174,119,dining table
30241,5,table,6,0,6810,15,94,411,971,767,877,356,dining table
30242,12,table,13,0,6812,34,464,549,1053,1025,589,476,dining table
30243,4,window,5,0,6813,15,161,47,197,85,36,38,window
30244,15,sofa,16,1,6814,38,0,847,655,1463,655,616,couch
30245,16,table,17,0,6814,16,0,925,532,1465,532,540,dining table
30246,17,sofa,18,0,6814,43,690,830,2197,1465,1507,635,couch
30247,18,table,19,0,6814,28,813,920,1566,1341,753,421,dining table
30248,4,window,5,0,6816,19,30,9,229,120,199,111,window
30249,7,table,8,0,6816,16,97,139,273,226,176,87,dining table
30250,9,plate,10,0,6816,19,122,162,180,183,58,21,plate
30251,13,plate,14,1,6816,20,176,155,230,173,54,18,plate
30252,15,chair,16,0,6817,35,116,476,596,1145,480,669,chair
30253,16,chair,17,0,6817,49,985,473,1467,1131,482,658,chair
30254,12,person,13,1,6818,15,75,107,114,145,39,38,person
30255,13,person,14,1,6818,20,26,107,94,164,68,57,person
30256,14,person,15,1,6818,24,123,69,193,193,70,124,person
30257,16,person,17,1,6818,26,206,112,254,211,48,99,person
30258,18,person,19,1,6818,27,241,100,318,211,77,111,person
30259,27,table,28,1,6818,26,304,177,473,265,169,88,dining table
30260,32,person,33,1,6818,22,323,102,380,152,57,50,person
30261,5,person,6,1,6819,32,189,60,238,143,49,83,person
30262,13,person,14,1,6819,21,123,60,154,98,31,38,person
30263,14,person,15,1,6819,18,97,61,134,98,37,37,person
30264,15,person,16,1,6819,21,8,124,59,182,51,58,person
30265,23,table,24,1,6820,15,210,99,232,144,22,45,dining table
30266,25,table,26,1,6820,18,234,120,261,179,27,59,dining table
30267,28,table,29,1,6820,26,281,162,334,243,53,81,dining table
30268,42,plate,43,1,6820,15,109,295,179,336,70,41,plate
30269,21,table,21,1,6821,23,169,1100,790,1490,621,390,dining table
30270,7,table,8,1,6822,23,7,376,358,540,351,164,dining table
30271,11,table,12,1,6822,23,467,381,795,558,328,177,dining table
30272,7,person,8,1,6823,31,133,45,153,107,20,62,person
30273,8,person,9,1,6823,22,145,42,162,95,17,53,person
30274,9,person,10,1,6823,30,173,41,196,112,23,71,person
30275,24,table,25,1,6823,19,67,89,138,128,71,39,dining table
30276,26,table,27,0,6823,20,3,107,110,155,107,48,dining table
30277,28,table,29,1,6823,16,0,155,44,217,44,62,dining table
30278,1,window,2,0,6824,21,2,0,248,216,246,216,window
30279,2,person,3,1,6824,15,315,110,359,160,44,50,person
30280,4,window,5,1,6824,21,327,26,418,157,91,131,window
30281,6,person,7,1,6824,57,125,59,348,271,223,212,person
30282,8,person,9,1,6824,88,198,23,547,371,349,348,person
30283,9,person,10,1,6824,16,487,113,548,161,61,48,person
30284,14,bottle,15,0,6824,15,131,180,159,275,28,95,bottle
30285,25,table,26,1,6824,73,1,226,434,373,433,147,dining table
30286,23,chair,24,1,6825,15,104,159,178,176,74,17,chair
30287,29,chair,30,1,6825,19,65,168,162,225,97,57,chair
30288,33,table,34,1,6825,20,231,152,261,215,30,63,dining table
30289,34,table,35,1,6825,18,196,159,241,223,45,64,dining table
30290,4,table,5,0,6826,57,619,792,1895,1648,1276,856,dining table
30291,10,plate,11,0,6826,15,1258,997,1599,1179,341,182,plate
30292,11,plate,12,1,6826,15,919,828,1147,960,228,132,plate
30293,18,person,19,1,6826,81,515,171,1150,1646,635,1475,person
30294,21,table,22,0,6826,24,0,458,521,858,521,400,dining table
30295,58,bowl,58,0,6826,15,1222,732,1312,847,90,115,bowl
30296,6,person,7,1,6827,39,30,44,187,305,157,261,person
30297,9,person,10,1,6827,74,290,38,499,332,209,294,person
30298,11,plate,12,0,6827,15,247,220,337,267,90,47,plate
30299,12,plate,13,1,6827,16,134,202,191,234,57,32,plate
30300,16,plate,17,0,6827,16,169,277,262,331,93,54,plate
30301,13,table,14,1,6829,17,78,194,200,260,122,66,dining table
30302,19,table,20,1,6830,19,170,417,631,627,461,210,dining table
30303,20,table,21,0,6830,18,0,643,561,1099,561,456,dining table
30304,23,table,24,0,6830,29,781,411,1259,643,478,232,dining table
30305,24,table,25,0,6830,18,873,633,1374,1097,501,464,dining table
30306,41,chair,42,1,6830,18,308,532,575,727,267,195,chair
30307,50,chair,51,1,6830,17,836,542,1103,764,267,222,chair
30308,66,spoon,67,0,6830,15,266,791,339,892,73,101,spoon
30309,70,table,71,0,6830,30,372,335,663,459,291,124,dining table
30310,0,sofa,1,0,6831,15,201,261,561,410,360,149,couch
30311,14,chair,15,1,6831,18,141,243,218,326,77,83,chair
30312,2,window,3,0,6832,16,0,38,725,711,725,673,window
30313,11,person,12,1,6832,57,481,330,1108,735,627,405,person
30314,12,person,13,1,6832,35,1085,312,1489,786,404,474,person
30315,18,plate,19,1,6832,16,968,730,1272,810,304,80,plate
30316,24,fork,25,0,6832,16,300,889,596,1055,296,166,fork
30317,25,fork,26,1,6832,16,355,870,604,1009,249,139,fork
30318,44,glasses,45,0,6832,25,805,405,948,436,143,31,eye glasses
30319,65,fork,66,1,6832,23,13,773,261,863,248,90,fork
30320,66,fork,67,0,6832,18,6,794,211,885,205,91,fork
30321,67,fork,68,0,6832,17,780,723,884,758,104,35,fork
30322,8,window,9,0,6833,17,2,32,126,179,124,147,window
30323,9,window,10,0,6833,16,73,76,164,171,91,95,window
30324,11,window,12,0,6833,16,352,28,497,179,145,151,window
30325,12,window,13,0,6833,16,324,73,411,169,87,96,window
30326,13,window,14,0,6833,15,311,95,369,165,58,70,window
30327,8,person,8,0,6834,36,264,112,318,261,54,149,person
30328,2,window,3,1,6835,23,80,24,144,89,64,65,window
30329,5,table,6,1,6835,19,0,90,93,128,93,38,dining table
30330,7,person,8,1,6835,35,126,61,195,149,69,88,person
30331,8,person,9,1,6835,64,45,58,162,245,117,187,person
30332,9,person,10,1,6835,46,125,82,299,245,174,163,person
30333,12,plate,13,0,6835,16,104,152,154,174,50,22,plate
30334,9,dog,10,0,7316,34,101,347,198,446,97,99,dog
30335,9,door,10,0,7319,25,230,0,363,614,133,614,door
30336,2,car,3,1,7325,16,186,144,228,182,42,38,car
30337,12,backpack,13,0,7326,23,318,1751,729,2059,411,308,backpack
30338,7,bench,8,0,7327,23,4,287,79,359,75,72,bench
30339,9,dog,10,0,7334,94,234,175,433,667,199,492,dog
30340,24,table,25,1,7337,25,0,1375,693,1920,693,545,dining table
30341,7,window,8,0,7338,16,22,26,73,122,51,96,window
30342,10,shoe,11,1,7339,16,442,1408,542,1501,100,93,shoe
30343,11,shoe,12,0,7339,26,313,1421,485,1511,172,90,shoe
30344,5,person,6,0,7543,34,327,123,370,270,43,147,person
30345,4,window,5,0,7544,20,1346,244,1683,461,337,217,window
30346,5,window,6,0,7544,19,1387,397,1835,722,448,325,window
30347,6,window,7,0,7544,17,962,311,1272,495,310,184,window
30348,7,window,8,0,7544,19,882,480,1293,750,411,270,window
30349,9,person,10,1,7548,24,0,118,18,322,18,204,person
30350,6,bicycle,7,0,7553,41,143,408,344,600,201,192,bicycle
30351,7,person,8,0,7553,46,140,200,333,671,193,471,person
30352,8,person,9,0,7553,49,381,152,543,770,162,618,person
30353,4,person,5,0,7569,41,138,63,191,206,53,143,person
30354,12,flowerpot,13,0,7571,15,121,485,277,615,156,130,potted plant
30355,22,person,23,0,23300,52,526,272,571,432,45,160,person
30356,23,person,24,0,23300,60,469,255,531,449,62,194,person
30357,24,person,25,1,23300,33,450,286,475,396,25,110,person
30358,25,person,26,0,23300,44,426,287,467,399,41,112,person
30359,4,person,5,0,23301,50,172,33,447,1198,275,1165,person
30360,1,person,2,1,23303,42,1,60,526,789,525,729,person
30361,1,person,2,1,23304,26,884,341,973,547,89,206,person
30362,4,chair,5,1,23304,21,880,595,973,767,93,172,chair
30363,6,chair,7,1,23304,24,882,546,1008,675,126,129,chair
30364,10,person,11,1,23304,53,453,214,882,765,429,551,person
30365,11,person,12,1,23304,47,52,184,489,764,437,580,person
30366,20,mirror,21,0,7608,21,18,99,58,174,40,75,mirror
30367,21,mirror,22,0,7608,18,335,101,373,180,38,79,mirror
30368,21,chair,21,0,7609,15,18,240,34,263,16,23,chair
30369,15,sofa,15,1,7614,23,2,355,86,436,84,81,couch
30370,12,chair,13,0,7615,19,221,201,270,319,49,118,chair
30371,5,door,6,0,23320,26,428,19,565,771,137,752,door
30372,8,person,9,1,23323,31,160,402,391,710,231,308,person
30373,9,person,10,1,23323,32,323,424,451,709,128,285,person
30374,10,person,11,1,23323,49,445,381,604,708,159,327,person
30375,11,person,12,1,23323,55,589,380,700,710,111,330,person
30376,12,person,13,1,23323,36,708,434,860,684,152,250,person
30377,13,person,14,1,23323,18,847,434,947,566,100,132,person
30378,5,chair,6,1,23325,53,460,358,594,517,134,159,chair
30379,8,person,9,0,23325,92,451,256,590,534,139,278,person
30380,9,chair,10,1,23325,53,176,348,314,525,138,177,chair
30381,10,person,11,0,23325,67,187,245,325,540,138,295,person
30382,12,sofa,13,1,23326,52,0,405,305,568,305,163,couch
30383,13,sofa,14,1,23326,27,0,501,281,767,281,266,couch
30384,19,clock,20,0,23326,18,76,227,179,320,103,93,clock
30385,4,door,5,0,23327,16,94,240,188,499,94,259,door
30386,6,table,7,0,23327,20,303,390,433,493,130,103,dining table
30387,7,table,8,0,23327,19,0,469,174,662,174,193,dining table
30388,18,chair,19,1,23327,21,265,373,304,482,39,109,chair
30389,3,car,4,0,7747,32,163,288,464,615,301,327,car
30390,4,car,5,1,7747,24,169,141,361,304,192,163,car
30391,5,car,6,1,7747,19,145,13,298,185,153,172,car
30392,6,car,7,0,7747,40,484,332,915,697,431,365,car
30393,7,car,8,0,7747,35,374,170,630,390,256,220,car
30394,8,car,9,1,7747,25,308,81,493,217,185,136,car
30395,9,car,10,1,7747,17,256,1,384,108,128,107,car
30396,10,car,11,1,7747,15,829,321,1021,591,192,270,car
30397,11,car,12,1,7747,28,598,137,959,396,361,259,car
30398,12,car,13,1,7747,21,442,57,676,202,234,145,car
30399,13,car,14,1,7747,16,374,3,543,79,169,76,car
30400,3,car,4,0,7748,31,114,259,958,1069,844,810,car
30401,4,suitcase,5,0,7748,16,318,179,630,279,312,100,suitcase
30402,7,car,8,1,7748,15,606,160,788,286,182,126,car
30403,8,car,9,1,7748,16,713,216,958,628,245,412,car
30404,4,car,5,1,7749,17,1860,838,2199,997,339,159,car
30405,5,car,6,1,7749,25,1477,931,2199,1498,722,567,car
30406,6,truck,7,1,7749,24,1581,510,1978,809,397,299,truck
30407,13,car,14,1,7749,15,634,706,1006,822,372,116,car
30408,17,car,18,1,7749,15,900,762,1244,975,344,213,car
30409,18,car,19,1,7749,22,428,803,1035,1163,607,360,car
30410,19,car,20,1,7749,15,1550,787,1766,1018,216,231,car
30411,20,car,21,1,7749,30,1003,794,1653,1431,650,637,car
30412,21,car,22,1,7749,29,544,1069,1278,1647,734,578,car
30413,22,car,23,1,7749,17,1247,1331,2197,1647,950,316,car
30414,0,truck,1,1,7750,25,445,0,1150,639,705,639,truck
30415,2,truck,3,1,7750,19,0,0,182,745,182,745,truck
30416,5,car,6,0,7750,29,199,33,501,249,302,216,car
30417,6,car,7,1,7750,16,199,3,340,91,141,88,car
30418,9,car,10,0,7750,34,224,213,941,646,717,433,car
30419,5,car,6,0,7751,41,290,509,1290,1456,1000,947,car
30420,6,person,7,1,7751,18,667,374,761,599,94,225,person
30421,8,car,9,1,7751,22,1889,343,2198,786,309,443,car
30422,10,car,11,1,7751,15,1998,680,2198,1481,200,801,car
30423,11,person,12,0,7751,41,1858,642,2067,1185,209,543,person
30424,22,door,22,0,7751,22,489,383,618,718,129,335,door
30425,23,window,23,0,7751,17,498,400,586,538,88,138,window
30426,1,car,2,0,7752,34,44,294,535,765,491,471,car
30427,2,car,3,1,7752,32,9,108,324,367,315,259,car
30428,3,car,4,1,7752,15,0,0,182,225,182,225,car
30429,4,car,5,1,7752,28,207,1,467,188,260,187,car
30430,5,car,6,1,7752,40,316,80,719,404,403,324,car
30431,7,car,8,1,7752,21,579,0,1021,307,442,307,car
30432,8,car,9,0,7752,30,513,241,1023,767,510,526,car
30433,4,person,5,0,7753,34,1354,783,1521,1354,167,571,person
30434,5,person,6,1,7753,28,1496,754,1646,1362,150,608,person
30435,6,bicycle,7,0,7753,47,359,1541,1167,1925,808,384,bicycle
30436,7,bicycle,8,1,7753,28,0,1092,342,1692,342,600,bicycle
30437,8,bicycle,9,0,7753,27,954,1217,1379,1421,425,204,bicycle
30438,5,car,6,1,7754,18,0,362,440,518,440,156,car
30439,7,car,8,1,7754,15,0,453,367,645,367,192,car
30440,8,car,9,1,7754,15,375,404,625,469,250,65,car
30441,10,car,11,1,7754,18,413,435,691,531,278,96,car
30442,16,car,17,1,7754,23,1087,405,1276,640,189,235,car
30443,17,car,18,1,7754,19,1111,440,1276,827,165,387,car
30444,18,car,19,1,7754,17,927,391,1076,524,149,133,car
30445,19,car,20,1,7754,20,862,411,1058,584,196,173,car
30446,20,car,21,1,7754,27,644,427,1031,658,387,231,car
30447,21,car,22,1,7754,33,0,507,1060,958,1060,451,car
30448,3,motorbike,4,0,7755,78,241,282,1023,767,782,485,motorcycle
30449,4,motorbike,5,0,7755,51,515,224,995,575,480,351,motorcycle
30450,8,motorbike,9,0,7755,16,169,228,277,292,108,64,motorcycle
30451,10,chair,11,0,7757,25,1529,803,1878,1258,349,455,chair
30452,12,person,13,1,7757,15,1925,1220,2199,1645,274,425,person
30453,13,chair,14,1,7757,20,1497,1205,2018,1646,521,441,chair
30454,14,chair,15,1,7757,15,1580,1124,2061,1403,481,279,chair
30455,15,chair,16,1,7757,21,1105,1033,1550,1425,445,392,chair
30456,16,chair,17,1,7757,15,737,967,1111,1122,374,155,chair
30457,17,chair,18,1,7757,19,813,1122,1495,1648,682,526,chair
30458,18,chair,19,1,7757,29,381,1049,1095,1648,714,599,chair
30459,19,person,20,1,7757,18,569,503,724,632,155,129,person
30460,20,chair,21,0,7757,28,681,622,997,988,316,366,chair
30461,21,chair,22,1,7757,22,494,607,721,965,227,358,chair
30462,24,chair,25,1,7757,33,315,711,694,1137,379,426,chair
30463,26,chair,27,1,7757,21,0,735,405,1213,405,478,chair
30464,27,suitcase,28,0,7757,25,6,666,260,1020,254,354,suitcase
30465,31,backpack,32,0,7757,19,1290,1429,1791,1646,501,217,backpack
30466,0,window,1,0,164,28,1,1,384,160,383,159,window
30467,3,person,4,0,164,94,54,2,621,436,567,434,person
30468,11,person,12,0,164,33,435,1,640,443,205,442,person
30469,4,sink,5,0,165,34,170,187,575,432,405,245,sink
30470,24,person,25,1,165,71,64,53,257,432,193,379,person
30471,19,bottle,20,0,8305,18,282,217,336,359,54,142,bottle
30472,4,window,5,0,8309,17,457,133,687,391,230,258,window
30473,19,sofa,20,1,8309,15,0,509,435,834,435,325,couch
30474,14,bowl,15,0,8310,16,7,161,71,184,64,23,bowl
30475,10,window,11,0,8311,17,72,47,112,60,40,13,window
30476,25,sink,26,0,8312,16,1351,863,1669,967,318,104,sink
30477,26,sink,27,0,8312,27,1570,788,2016,965,446,177,sink
30478,34,window,35,0,8312,29,0,218,671,470,671,252,window
30479,1,window,2,0,8313,20,954,8,1443,238,489,230,window
30480,5,window,6,0,8314,15,4,38,37,75,33,37,window
30481,7,window,8,0,8314,18,104,28,179,81,75,53,window
30482,10,bowl,11,0,8314,17,240,99,284,125,44,26,bowl
30483,19,sink,20,0,8315,15,545,752,953,954,408,202,sink
30484,24,bowl,25,0,8315,16,748,489,959,628,211,139,bowl
30485,38,sofa,39,1,8315,18,0,612,668,1218,668,606,couch
30486,47,door,48,0,8315,42,804,320,1244,535,440,215,door
30487,7,sink,8,0,8316,15,749,577,995,655,246,78,sink
30488,24,plate,25,0,8317,27,201,891,580,1008,379,117,plate
30489,51,bowl,52,0,8318,16,513,464,617,519,104,55,bowl
30490,8,bottle,9,0,8319,17,907,456,971,699,64,243,bottle
30491,12,plate,13,0,8319,15,521,699,756,763,235,64,plate
30492,11,window,12,0,8322,48,778,122,1300,371,522,249,window
30493,23,sink,24,0,8322,18,828,618,1277,807,449,189,sink
30494,2,window,3,0,8324,18,120,16,806,514,686,498,window
30495,3,window,4,0,8324,15,783,147,1131,466,348,319,window
30496,5,window,6,0,8325,23,0,0,154,463,154,463,window
30497,19,person,20,1,8325,20,0,272,91,441,91,169,person
30498,21,window,22,0,8325,15,389,91,520,165,131,74,window
30499,34,window,35,0,8325,15,559,66,1022,214,463,148,window
30500,36,door,37,0,8325,16,694,441,846,692,152,251,door
30501,11,table,12,0,8327,21,203,109,300,198,97,89,dining table
30502,6,bottle,7,0,8328,16,718,644,823,830,105,186,bottle
30503,17,chair,18,1,8329,16,254,102,279,182,25,80,chair
30504,3,bottle,4,0,8333,15,1746,659,2130,791,384,132,bottle
30505,2,person,3,0,172,22,132,93,142,136,10,43,person
30506,6,person,7,0,172,28,117,89,136,176,19,87,person
30507,7,person,8,0,172,37,96,76,125,185,29,109,person
30508,8,person,9,0,172,16,144,91,153,118,9,27,person
30509,9,person,10,0,172,18,191,92,198,119,7,27,person
30510,10,person,11,0,172,26,201,89,212,127,11,38,person
30511,11,person,12,0,172,32,229,82,249,160,20,78,person
30512,12,person,13,0,172,57,241,69,306,279,65,210,person
30513,22,window,23,0,8833,26,461,519,787,741,326,222,window
30514,9,vase,10,1,8840,18,58,137,87,223,29,86,vase
30515,12,table,13,0,8841,33,148,172,256,255,108,83,dining table
30516,19,chair,20,0,8842,25,64,165,95,226,31,61,chair
30517,0,chair,1,0,8843,24,96,47,142,141,46,94,chair
30518,10,table,11,0,8850,23,309,256,368,325,59,69,dining table
30519,14,vase,15,0,8853,15,72,131,95,178,23,47,vase
30520,16,chair,17,0,8854,18,107,127,144,188,37,61,chair
30521,2,person,2,0,8856,17,167,207,205,253,38,46,person
30522,14,hat,15,0,8857,19,89,479,166,626,77,147,hat
30523,35,clock,36,0,8857,20,475,430,573,646,98,216,clock
30524,4,person,5,0,8862,21,77,113,90,135,13,22,person
30525,1,airplane,2,0,8863,73,6,118,371,195,365,77,airplane
30526,5,airplane,6,0,8864,36,688,487,950,606,262,119,airplane
30527,9,airplane,10,0,8865,50,1,108,639,255,638,147,airplane
30528,5,airplane,6,1,8866,30,1409,700,2197,1217,788,517,airplane
30529,6,airplane,7,1,8866,48,290,478,1253,934,963,456,airplane
30530,7,airplane,8,1,8866,37,0,660,563,1031,563,371,airplane
30531,4,airplane,5,1,8867,39,954,429,1492,719,538,290,airplane
30532,5,airplane,6,0,8867,58,241,476,1093,810,852,334,airplane
30533,6,airplane,7,1,8867,22,2,491,215,697,213,206,airplane
30534,4,airplane,5,0,8869,62,1194,700,2135,1116,941,416,airplane
30535,5,airplane,6,0,8869,47,42,739,693,1029,651,290,airplane
30536,11,airplane,12,0,8870,89,3,275,1265,737,1262,462,airplane
30537,5,airplane,6,0,8872,71,65,150,294,293,229,143,airplane
30538,6,airplane,7,0,8872,40,432,190,567,270,135,80,airplane
30539,2,person,3,1,20890,39,70,50,215,228,145,178,person
30540,36,person,37,0,10854,26,543,257,570,344,27,87,person
30541,37,chair,38,0,10854,19,498,289,521,326,23,37,chair
30542,38,person,39,1,10854,17,377,260,403,302,26,42,person
30543,39,person,40,1,10854,17,349,262,376,302,27,40,person
30544,40,person,41,1,10854,17,329,258,349,301,20,43,person
30545,42,person,43,1,10854,20,268,253,292,301,24,48,person
30546,43,person,44,1,10854,16,191,255,215,303,24,48,person
30547,44,person,45,1,10854,21,170,260,193,332,23,72,person
30548,45,person,46,1,10854,21,118,283,161,382,43,99,person
30549,46,person,47,1,10854,36,68,293,109,408,41,115,person
30550,47,person,48,1,10854,18,399,253,416,303,17,50,person
30551,17,vase,18,1,10859,22,2,889,184,1241,182,352,vase
30552,13,bottle,14,1,11065,16,1351,512,1445,695,94,183,bottle
30553,16,sofa,17,0,11066,24,0,289,453,731,453,442,couch
30554,1,door,2,0,11067,16,0,0,128,1477,128,1477,door
30555,2,door,3,0,11067,21,1871,0,2197,1231,326,1231,door
30556,8,window,9,0,11067,20,292,7,1778,320,1486,313,window
30557,4,window,5,0,11068,18,409,184,822,347,413,163,window
30558,3,window,4,0,11070,15,1256,221,1698,378,442,157,window
30559,4,window,5,0,11071,23,272,43,1022,281,750,238,window
30560,0,window,1,0,11072,18,277,65,476,158,199,93,window
30561,8,person,9,0,11074,54,389,368,819,1062,430,694,person
30562,11,window,12,0,11074,19,533,346,1129,447,596,101,window
30563,2,chair,2,0,15319,42,142,63,242,244,100,181,chair
30564,7,chair,8,0,15322,36,236,62,303,203,67,141,chair
30565,1,door,2,0,15849,19,311,117,743,626,432,509,door
30566,2,person,3,1,16164,33,230,162,379,395,149,233,person
30567,3,person,4,1,16164,28,357,111,441,300,84,189,person
30568,4,person,5,1,16164,40,424,84,501,394,77,310,person
30569,5,person,6,1,16164,31,469,89,608,395,139,306,person
30570,9,person,10,1,16164,18,568,110,609,189,41,79,person
30571,1,person,2,0,16165,54,30,76,140,307,110,231,person
30572,12,backpack,13,0,16165,21,420,206,535,323,115,117,backpack
30573,16,person,17,1,16165,34,364,48,461,223,97,175,person
30574,5,person,6,1,16167,30,363,143,608,435,245,292,person
30575,6,person,7,1,16167,52,254,21,492,306,238,285,person
30576,7,person,8,1,16167,38,283,52,415,355,132,303,person
30577,8,person,9,1,16167,44,7,30,123,435,116,405,person
30578,11,person,12,1,16167,18,566,76,606,165,40,89,person
30579,12,person,13,1,16167,16,172,75,212,108,40,33,person
30580,14,person,15,1,16168,34,6,66,96,232,90,166,person
30581,15,person,16,1,16168,51,82,0,182,210,100,210,person
30582,17,person,18,1,16168,39,22,150,155,372,133,222,person
30583,19,person,20,1,16168,19,290,96,330,169,40,73,person
30584,20,person,21,1,16168,43,285,29,406,255,121,226,person
30585,7,person,8,1,16198,37,84,68,127,225,43,157,person
30586,1,person,2,0,16201,57,56,58,150,255,94,197,person
30587,2,chair,3,1,16201,15,46,147,73,223,27,76,chair
30588,15,person,16,0,956,66,208,199,251,372,43,173,person
30589,23,person,24,0,956,65,136,194,192,383,56,189,person
30590,27,person,28,1,956,26,332,375,373,447,41,72,person
30591,28,person,29,1,956,32,312,343,375,422,63,79,person
30592,29,person,30,0,956,72,275,243,375,445,100,202,person
30593,30,person,31,0,956,49,248,239,315,358,67,119,person
30594,31,person,32,1,956,30,299,235,327,308,28,73,person
30595,32,person,33,1,956,31,249,211,270,285,21,74,person
30596,34,person,35,1,956,20,1,430,57,499,56,69,person
30597,36,person,37,0,956,61,1,286,97,496,96,210,person
30598,37,person,38,1,956,105,1,250,146,485,145,235,person
30599,38,person,39,1,956,44,74,199,114,333,40,134,person
30600,0,window,1,0,18918,15,270,53,322,159,52,106,window
30601,4,person,5,1,18918,31,122,91,305,328,183,237,person
30602,5,person,6,1,18918,26,373,132,454,248,81,116,person
30603,6,person,7,1,18918,25,415,138,497,226,82,88,person
30604,0,person,1,1,18919,89,56,45,307,327,251,282,person
30605,1,book,2,0,18919,20,61,218,154,285,93,67,book
30606,2,person,3,1,18919,28,296,207,474,327,178,120,person
30607,4,person,5,1,18919,42,295,100,408,271,113,171,person
30608,5,person,6,1,18919,17,117,185,170,250,53,65,person
30609,11,person,12,1,18919,27,110,121,187,209,77,88,person
30610,16,person,17,1,18919,24,297,241,381,301,84,60,person
30611,3,person,4,1,18920,35,168,368,356,590,188,222,person
30612,4,person,5,1,18920,41,12,354,246,585,234,231,person
30613,2,person,3,1,18921,31,76,324,204,496,128,172,person
30614,5,person,6,1,18921,22,2,178,56,497,54,319,person
30615,0,person,1,1,18922,32,27,123,131,366,104,243,person
30616,2,person,3,1,18922,30,153,212,206,366,53,154,person
30617,7,person,8,1,18922,36,173,199,221,357,48,158,person
30618,8,person,9,1,18922,27,161,153,208,231,47,78,person
30619,10,person,11,1,18922,28,390,232,481,367,91,135,person
30620,11,bicycle,12,1,18922,34,325,276,499,367,174,91,bicycle
30621,15,person,16,1,18922,27,270,224,323,367,53,143,person
30622,16,person,17,1,18922,20,298,157,335,206,37,49,person
30623,18,person,19,1,18922,16,214,154,241,182,27,28,person
30624,0,person,1,1,18923,46,0,0,153,328,153,328,person
30625,1,person,2,1,18923,32,127,43,188,211,61,168,person
30626,5,person,6,0,18923,31,210,107,266,201,56,94,person
30627,7,person,8,0,18923,63,332,16,496,366,164,350,person
30628,0,person,1,1,18924,21,0,104,90,379,90,275,person
30629,1,book,2,1,18924,16,0,66,49,141,49,75,book
30630,2,person,3,1,18924,86,13,38,215,301,202,263,person
30631,3,person,4,1,18924,41,49,77,122,282,73,205,person
30632,4,person,5,1,18924,18,85,91,114,161,29,70,person
30633,6,person,7,1,18924,19,124,127,146,169,22,42,person
30634,7,person,8,1,18924,31,141,111,178,180,37,69,person
30635,8,person,9,0,18924,28,198,125,230,234,32,109,person
30636,9,person,10,0,18924,29,185,126,208,229,23,103,person
30637,10,person,11,0,18924,75,282,110,466,323,184,213,person
30638,11,person,12,1,18924,49,306,114,422,310,116,196,person
30639,12,backpack,13,0,18924,19,261,218,334,304,73,86,backpack
30640,13,person,14,1,18924,32,314,123,395,217,81,94,person
30641,14,person,15,1,18924,26,300,97,338,196,38,99,person
30642,15,person,16,1,18924,29,256,195,341,259,85,64,person
30643,2,person,3,1,18925,35,52,125,253,373,201,248,person
30644,3,person,4,1,18925,33,220,97,427,374,207,277,person
30645,6,person,7,1,18926,23,275,89,352,156,77,67,person
30646,8,person,9,1,18926,18,249,85,292,129,43,44,person
30647,9,person,10,1,18926,15,216,79,248,111,32,32,person
30648,10,person,11,0,18926,74,143,35,218,240,75,205,person
30649,11,person,12,1,18926,41,128,56,162,179,34,123,person
30650,12,person,13,1,18926,44,34,137,143,284,109,147,person
30651,13,hat,14,0,18926,30,48,137,110,179,62,42,hat
30652,14,person,15,1,18926,29,2,98,78,182,76,84,person
30653,15,person,16,1,18926,20,47,97,94,148,47,51,person
30654,16,person,17,1,18926,16,79,85,111,116,32,31,person
30655,17,person,18,1,18926,15,66,83,88,107,22,24,person
30656,18,person,19,1,18926,15,90,58,104,91,14,33,person
30657,0,person,1,0,18927,60,2,23,123,302,121,279,person
30658,1,person,2,0,18927,55,95,27,211,344,116,317,person
30659,2,person,3,0,18927,60,211,32,318,349,107,317,person
30660,3,person,4,0,18927,74,312,30,431,364,119,334,person
30661,4,person,5,1,18927,36,401,11,499,363,98,352,person
30662,1,person,2,0,18929,45,299,129,424,291,125,162,person
30663,3,person,4,0,18929,32,122,116,201,223,79,107,person
30664,4,person,5,1,18929,26,2,155,132,332,130,177,person
30665,5,window,6,0,18929,15,11,20,97,172,86,152,window
30666,8,person,9,1,18929,19,160,72,186,180,26,108,person
30667,9,person,10,1,18929,32,171,59,241,212,70,153,person
30668,19,person,20,1,18929,26,260,101,311,170,51,69,person
30669,20,person,21,1,18929,26,435,57,497,200,62,143,person
30670,0,person,1,0,18930,40,392,35,519,367,127,332,person
30671,1,person,2,1,18930,36,175,173,264,316,89,143,person
30672,2,person,3,1,18930,27,145,167,201,302,56,135,person
30673,3,person,4,1,18930,36,89,161,191,344,102,183,person
30674,4,person,5,1,18930,26,67,186,179,368,112,182,person
30675,5,person,6,1,18930,29,206,174,275,284,69,110,person
30676,17,person,18,1,18930,26,265,173,332,254,67,81,person
30677,2,person,3,1,18932,42,2,106,159,333,157,227,person
30678,2,person,2,0,18934,82,7,91,215,483,208,392,person
30679,7,door,7,0,18934,40,65,1,253,275,188,274,door
30680,5,person,6,0,18935,57,30,128,185,341,155,213,person
30681,8,person,9,1,18935,25,258,160,303,226,45,66,person
30682,11,person,12,0,18935,77,174,14,457,169,283,155,person
30683,13,person,14,1,18935,31,314,146,399,254,85,108,person
30684,1,person,2,1,18936,23,225,226,498,471,273,245,person
30685,2,person,3,1,18936,34,128,1,498,471,370,470,person
30686,3,person,4,1,18936,25,262,71,347,298,85,227,person
30687,4,person,5,0,18936,48,52,187,204,375,152,188,person
30688,5,person,6,1,18936,23,98,193,201,320,103,127,person
30689,13,person,14,1,18936,25,352,0,457,265,105,265,person
30690,2,person,3,1,18937,67,149,92,373,496,224,404,person
30691,4,person,5,0,18938,25,270,393,392,556,122,163,person
30692,6,person,7,0,18938,30,347,328,420,528,73,200,person
30693,8,person,9,0,18938,34,386,273,480,490,94,217,person
30694,10,person,11,1,18938,18,491,383,586,550,95,167,person
30695,13,person,14,1,18938,24,25,359,200,556,175,197,person
30696,1,person,2,1,18939,29,160,164,208,229,48,65,person
30697,0,window,1,0,18941,17,276,12,493,209,217,197,window
30698,8,person,9,0,18941,63,33,129,168,348,135,219,person
30699,0,person,1,1,18942,53,179,20,383,330,204,310,person
30700,1,person,2,1,18942,25,407,52,460,210,53,158,person
30701,2,person,3,1,18942,16,401,212,452,275,51,63,person
30702,3,person,4,1,18942,15,466,45,499,332,33,287,person
30703,21,person,22,1,18943,41,174,118,303,239,129,121,person
30704,22,person,23,1,18943,26,212,115,259,200,47,85,person
30705,24,person,25,1,18943,31,0,61,24,239,24,178,person
30706,25,person,26,1,18943,38,49,116,121,239,72,123,person
30707,27,person,28,1,18943,43,95,119,163,230,68,111,person
30708,29,person,30,1,18943,33,129,127,177,215,48,88,person
30709,5,person,6,0,18948,24,246,153,255,195,9,42,person
30710,6,person,7,0,18948,38,257,137,301,239,44,102,person
30711,10,person,11,0,18950,22,389,164,415,234,26,70,person
30712,11,person,12,0,18950,29,185,171,218,277,33,106,person
30713,16,person,17,0,18950,18,428,172,446,231,18,59,person
30714,4,person,5,0,18951,49,302,148,365,336,63,188,person
30715,5,person,6,0,18951,48,363,151,418,335,55,184,person
30716,12,person,13,1,18953,15,260,206,273,228,13,22,person
30717,3,person,4,0,18956,34,379,206,446,275,67,69,person
30718,11,person,12,1,957,40,388,56,425,155,37,99,person
30719,15,person,16,1,957,98,264,7,403,307,139,300,person
30720,20,person,21,1,957,93,303,21,404,306,101,285,person
30721,6,train,7,1,958,50,800,489,2047,873,1247,384,train
30722,19,person,20,0,958,26,594,791,630,890,36,99,person
30723,20,person,21,0,958,25,632,796,657,903,25,107,person
30724,22,person,23,1,958,28,514,829,595,918,81,89,person
30725,23,person,24,0,958,26,500,830,564,921,64,91,person
30726,24,bench,25,1,958,20,495,863,547,919,52,56,bench
30727,26,person,27,1,958,70,1,716,197,1536,196,820,person
30728,8,person,9,0,18957,27,344,304,375,377,31,73,person
30729,9,person,10,0,18957,28,366,289,399,378,33,89,person
30730,10,person,11,0,18957,32,396,300,425,388,29,88,person
30731,11,person,12,0,18957,27,411,282,444,388,33,106,person
30732,12,person,13,1,18957,27,388,271,422,367,34,96,person
30733,13,person,14,1,18957,15,363,266,382,306,19,40,person
30734,1,person,2,0,18958,91,136,72,413,375,277,303,person
30735,0,train,1,0,18959,26,0,146,251,269,251,123,train
30736,1,train,2,0,18961,36,9,4,456,320,447,316,train
30737,6,window,7,0,18961,16,270,51,421,149,151,98,window
30738,11,person,12,0,18964,15,172,100,180,122,8,22,person
30739,5,person,6,1,18965,43,0,74,87,299,87,225,person
30740,7,person,8,1,18965,41,123,92,208,299,85,207,person
30741,8,person,9,1,18965,38,222,114,301,299,79,185,person
30742,9,person,10,1,18965,36,306,101,396,298,90,197,person
30743,10,train,11,0,18965,32,234,56,385,185,151,129,train
30744,6,person,7,0,18966,23,265,346,289,415,24,69,person
30745,3,person,4,0,25191,100,356,84,471,479,115,395,person
30746,3,person,4,1,25194,48,514,111,640,479,126,368,person
30747,4,person,5,1,25194,45,393,140,536,478,143,338,person
30748,5,person,6,1,25194,51,300,163,408,478,108,315,person
30749,6,person,7,0,25194,53,236,222,309,429,73,207,person
30750,7,person,8,0,25194,62,162,187,247,433,85,246,person
30751,8,person,9,1,25194,30,134,212,176,386,42,174,person
30752,9,person,10,0,25194,41,2,208,58,369,56,161,person
30753,10,suitcase,11,1,25194,16,114,444,276,479,162,35,suitcase
30754,18,person,19,0,25196,36,754,426,918,615,164,189,person
30755,19,person,20,0,25196,21,625,386,641,423,16,37,person
30756,20,person,21,0,25196,23,599,378,612,416,13,38,person
30757,21,person,22,0,25196,22,586,375,599,414,13,39,person
30758,22,person,23,0,25196,23,575,377,588,415,13,38,person
30759,4,person,5,0,25197,73,203,146,321,538,118,392,person
30760,8,person,9,0,25197,52,324,173,429,464,105,291,person
30761,9,backpack,10,0,25197,23,339,238,400,347,61,109,backpack
30762,11,person,12,0,25197,68,425,156,519,489,94,333,person
30763,14,person,15,0,25197,45,499,166,586,491,87,325,person
30764,16,person,17,0,25197,46,617,164,691,485,74,321,person
30765,18,person,19,1,25197,67,703,124,815,427,112,303,person
30766,19,person,20,1,25197,37,684,165,741,436,57,271,person
30767,20,person,21,1,25197,58,768,157,859,473,91,316,person
30768,21,person,22,1,25197,55,889,113,987,519,98,406,person
30769,22,person,23,0,25197,66,827,174,982,555,155,381,person
30770,23,umbrella,24,0,25197,19,829,337,854,533,25,196,umbrella
30771,29,person,30,1,25197,33,343,141,430,264,87,123,person
30772,2,person,3,1,294,44,458,1,852,479,394,478,person
30773,5,person,6,1,294,46,163,7,579,480,416,473,person
30774,7,window,8,0,19312,15,866,56,997,430,131,374,window
30775,11,person,12,1,19313,31,248,86,349,291,101,205,person
30776,14,person,15,1,19313,44,210,109,336,383,126,274,person
30777,18,person,19,1,19313,43,2,149,104,384,102,235,person
30778,19,person,20,0,19313,55,51,127,260,431,209,304,person
30779,22,window,23,0,19313,25,59,76,176,165,117,89,window
30780,26,person,27,1,19313,18,457,79,509,133,52,54,person
30781,27,person,28,1,19313,18,523,74,563,136,40,62,person
30782,30,person,31,1,19313,24,528,86,585,168,57,82,person
30783,31,person,32,1,19313,43,434,97,547,207,113,110,person
30784,32,person,33,1,19313,36,543,106,640,265,97,159,person
30785,37,person,38,1,19313,60,341,137,561,431,220,294,person
30786,38,person,39,1,19313,25,560,176,649,402,89,226,person
30787,39,table,40,1,19313,20,507,365,649,431,142,66,dining table
30788,40,person,41,1,19313,33,373,271,564,431,191,160,person
30789,42,person,43,1,19313,27,304,89,372,254,68,165,person
30790,0,window,1,0,24579,40,0,1,767,455,767,454,window
30791,3,person,4,1,24579,108,2,145,767,1024,765,879,person
30792,0,train,1,0,19331,64,54,69,529,276,475,207,train
30793,1,train,2,0,19335,24,154,137,475,499,321,362,train
30794,3,train,4,0,19336,22,10,55,500,242,490,187,train
30795,6,person,7,0,19337,16,378,184,390,216,12,32,person
30796,8,person,9,0,19337,18,414,188,426,220,12,32,person
30797,0,train,1,0,25242,93,0,22,886,679,886,657,train
30798,9,car,10,1,25242,15,891,176,1023,240,132,64,car
30799,13,person,14,1,25242,29,960,246,1023,452,63,206,person
30800,1,train,2,0,25243,90,149,236,1023,539,874,303,train
30801,1,train,2,0,25244,33,72,124,1024,768,952,644,train
30802,6,train,7,0,25245,26,258,57,1024,645,766,588,train
30803,8,train,9,0,25246,61,39,144,898,557,859,413,train
30804,2,train,3,0,25247,57,464,186,679,437,215,251,train
30805,5,person,6,1,25247,22,710,327,736,422,26,95,person
30806,6,person,7,1,25247,18,630,331,654,378,24,47,person
30807,7,person,8,0,25247,87,610,309,724,661,114,352,person
30808,8,person,9,1,25247,40,482,320,519,471,37,151,person
30809,9,person,10,0,25247,40,448,337,496,473,48,136,person
30810,11,person,12,1,25247,30,435,335,469,470,34,135,person
30811,12,person,13,1,25247,101,35,247,237,679,202,432,person
30812,13,person,14,1,25247,19,1,471,42,679,41,208,person
30813,2,train,3,0,25248,42,704,366,1023,473,319,107,train
30814,11,person,12,0,25249,80,413,232,511,488,98,256,person
30815,2,train,3,0,25250,22,1,97,935,571,934,474,train
30816,6,person,7,0,19338,34,49,204,97,333,48,129,person
30817,7,person,8,0,19338,28,149,199,175,288,26,89,person
30818,8,person,9,0,19338,26,167,203,185,280,18,77,person
30819,9,person,10,0,19338,20,127,203,140,250,13,47,person
30820,10,person,11,0,19338,22,101,205,117,261,16,56,person
30821,11,person,12,0,19338,25,323,197,339,252,16,55,person
30822,12,person,13,0,19338,41,357,196,405,321,48,125,person
30823,17,person,18,1,19338,18,232,200,256,250,24,50,person
30824,18,person,19,1,19338,29,217,209,311,332,94,123,person
30825,19,person,20,0,19338,23,340,201,366,296,26,95,person
30826,21,person,22,1,19338,21,0,206,56,333,56,127,person
30827,22,person,23,0,19338,39,408,210,466,333,58,123,person
30828,31,person,32,0,19338,20,206,209,230,274,24,65,person
30829,32,person,33,1,19338,17,86,206,101,244,15,38,person
30830,1,person,2,0,19339,27,250,200,275,259,25,59,person
30831,3,person,4,0,19339,30,123,204,150,263,27,59,person
30832,19,person,20,1,19339,17,18,178,36,218,18,40,person
30833,20,person,21,0,19339,32,442,159,470,222,28,63,person
30834,21,person,22,0,19339,18,430,175,443,202,13,27,person
30835,22,person,23,0,19339,19,396,173,412,208,16,35,person
30836,24,person,25,1,19339,19,53,171,72,208,19,37,person
30837,8,person,9,0,19341,42,163,223,238,391,75,168,person
30838,9,person,10,0,19341,29,234,244,283,393,49,149,person
30839,10,person,11,1,19341,27,24,229,92,392,68,163,person
30840,11,person,12,0,19341,33,290,223,332,364,42,141,person
30841,14,person,15,0,19341,25,139,205,162,274,23,69,person
30842,15,person,16,0,19341,23,117,201,146,273,29,72,person
30843,1,person,2,0,19342,28,805,249,920,556,115,307,person
30844,2,person,3,1,19342,44,904,379,1090,851,186,472,person
30845,3,backpack,4,0,19342,19,1039,690,1136,849,97,159,backpack
30846,4,person,5,0,19342,39,26,238,132,527,106,289,person
30847,5,person,6,0,19342,22,379,309,446,505,67,196,person
30848,6,person,7,0,19342,28,225,320,304,503,79,183,person
30849,7,person,8,1,19342,22,291,333,342,492,51,159,person
30850,8,person,9,0,19342,16,653,371,690,465,37,94,person
30851,9,person,10,1,19342,22,933,263,1006,468,73,205,person
30852,2,person,3,1,19343,24,10,266,53,338,43,72,person
30853,13,person,14,0,19343,26,199,277,228,364,29,87,person
30854,14,person,15,0,19343,31,226,258,258,345,32,87,person
30855,15,person,16,0,19343,28,404,373,453,476,49,103,person
30856,16,person,17,0,19343,25,274,278,301,357,27,79,person
30857,17,person,18,0,19343,29,346,246,374,312,28,66,person
30858,18,person,19,0,19343,28,582,269,611,345,29,76,person
30859,20,person,21,0,19343,21,446,242,464,299,18,57,person
30860,21,person,22,0,19343,20,427,248,444,303,17,55,person
30861,20,person,21,0,19344,15,442,227,454,256,12,29,person
30862,21,person,22,0,19344,20,263,250,279,290,16,40,person
30863,27,person,28,0,19344,18,199,284,215,331,16,47,person
30864,2,train,3,0,19369,17,106,60,350,179,244,119,train
30865,12,person,13,0,19371,16,76,103,82,123,6,20,person
30866,13,person,14,0,19371,16,45,103,52,125,7,22,person
30867,17,person,18,0,19371,17,249,110,267,128,18,18,person
30868,6,motorbike,7,1,19372,16,2,176,132,224,130,48,motorcycle
30869,7,car,8,1,19374,22,172,0,320,240,148,240,car
30870,6,car,7,1,19377,16,2,1388,1830,1530,1828,142,car
30871,5,person,6,0,19470,45,704,417,1085,955,381,538,person
30872,20,door,21,1,19470,29,822,340,1118,867,296,527,door
30873,0,window,1,1,19473,16,4,1,614,238,610,237,window
30874,1,person,2,1,19473,37,93,14,271,227,178,213,person
30875,2,person,3,1,19473,38,269,72,473,284,204,212,person
30876,3,person,4,1,19473,38,433,43,594,288,161,245,person
30877,6,person,7,0,19473,24,14,132,235,398,221,266,person
30878,8,person,9,1,19473,16,589,160,704,260,115,100,person
30879,1,window,2,0,19475,15,237,163,327,604,90,441,window
30880,4,person,5,0,19475,52,842,325,1063,831,221,506,person
30881,14,window,15,1,19475,16,1245,124,1348,421,103,297,window
30882,0,door,1,0,19476,15,141,76,209,422,68,346,door
30883,1,door,2,0,19476,17,92,51,166,446,74,395,door
30884,16,door,17,0,19476,16,572,54,644,447,72,393,door
30885,2,person,3,0,17,173,36,120,377,682,341,562,person
30886,16,person,17,0,17,180,371,25,677,638,306,613,person
30887,29,person,30,0,17,151,714,163,976,662,262,499,person
30888,3,person,4,0,18,90,198,10,305,319,107,309,person
30889,21,person,22,0,18,85,452,59,520,243,68,184,person
30890,1,person,2,1,20,49,423,373,601,554,178,181,person
30891,8,person,9,1,20,58,210,325,457,534,247,209,person
30892,16,person,17,1,20,44,50,382,312,532,262,150,person
30893,8,person,9,1,21,113,109,191,1459,1196,1350,1005,person
30894,17,bottle,18,0,21,16,1228,421,1339,901,111,480,bottle
30895,21,chair,22,1,21,18,221,715,975,1200,754,485,chair
30896,5,person,6,0,39,89,343,413,865,1625,522,1212,person
30897,18,person,19,0,39,102,781,637,1088,1588,307,951,person
30898,27,ball,28,0,39,25,906,970,1058,1124,152,154,sports ball
30899,28,person,29,0,39,66,1168,699,1402,1649,234,950,person
30900,38,person,39,0,39,80,1394,549,1701,1629,307,1080,person
30901,48,person,49,0,39,61,1647,561,2107,1649,460,1088,person
30902,15,boat,15,1,76,31,1,182,468,319,467,137,boat
30903,16,person,16,1,76,29,204,130,244,207,40,77,person
30904,17,person,17,1,76,21,300,129,318,184,18,55,person
30905,18,person,18,1,76,38,240,125,309,222,69,97,person
30906,19,person,19,1,76,35,154,129,217,208,63,79,person
30907,10,person,11,1,77,71,1338,724,1646,979,308,255,person
30908,22,boat,21,0,78,54,1094,661,2101,1064,1007,403,boat
30909,29,person,27,1,78,76,221,553,472,1210,251,657,person
30910,36,person,34,0,78,129,249,676,654,1552,405,876,person
30911,47,person,45,1,78,23,1287,596,1378,679,91,83,person
30912,48,person,46,0,78,37,1677,589,1806,806,129,217,person
30913,49,person,47,1,78,42,1866,581,1977,804,111,223,person
30914,0,car,1,1,23041,19,0,0,800,600,800,600,car
30915,1,car,2,1,23042,18,804,141,1023,323,219,182,car
30916,2,car,3,1,23042,29,811,13,1023,140,212,127,car
30917,3,car,4,1,23042,95,8,21,811,263,803,242,car
30918,6,person,7,1,23042,33,203,0,338,184,135,184,person
30919,7,person,8,1,23042,45,44,0,207,255,163,255,person
30920,8,person,9,1,23042,21,24,28,75,133,51,105,person
30921,13,person,14,1,23042,20,457,50,500,98,43,48,person
30922,14,person,15,0,23042,23,408,47,451,102,43,55,person
30923,1,car,2,1,23043,28,0,1,640,480,640,479,car
30924,0,door,1,0,91,24,173,1,443,242,270,241,door
30925,4,bottle,5,0,91,19,1,329,68,424,67,95,bottle
30926,7,person,8,1,91,82,127,1,596,423,469,422,person
30927,0,car,1,1,95,85,128,0,466,117,338,117,car
30928,5,person,5,1,95,30,317,88,466,310,149,222,person
30929,6,person,6,1,95,52,344,1,466,171,122,170,person
30930,10,person,10,1,95,38,264,8,353,145,89,137,person
30931,14,person,14,1,95,31,174,0,275,115,101,115,person
30932,18,person,18,1,95,37,59,0,146,93,87,93,person
30933,20,person,20,1,95,35,0,7,85,309,85,302,person
30934,24,person,24,1,95,42,67,22,213,310,146,288,person
30935,5,person,6,0,96,37,592,1102,621,1170,29,68,person
30936,6,person,7,0,96,26,643,1101,666,1168,23,67,person
30937,7,person,8,0,96,24,665,1102,685,1169,20,67,person
30938,8,person,9,0,96,33,690,1099,715,1169,25,70,person
30939,9,person,10,1,96,24,678,1101,698,1167,20,66,person
30940,10,bench,11,0,96,30,713,1132,765,1157,52,25,bench
30941,11,person,12,0,96,32,720,1119,748,1157,28,38,person
30942,30,person,31,1,96,27,230,1117,269,1208,39,91,person
30943,31,person,32,1,96,29,180,1115,232,1208,52,93,person
30944,36,clock,37,0,96,16,375,401,426,448,51,47,clock
30945,1,person,2,1,102,38,538,111,611,273,73,162,person
30946,2,person,3,1,102,22,560,155,634,372,74,217,person
30947,4,person,5,1,102,18,419,235,574,371,155,136,person
30948,5,person,6,1,102,34,279,157,427,372,148,215,person
30949,10,person,11,1,102,39,167,170,282,372,115,202,person
30950,18,person,19,1,102,20,142,224,189,372,47,148,person
30951,19,person,20,1,102,45,33,154,162,372,129,218,person
30952,25,person,26,1,102,26,0,185,56,372,56,187,person
30953,10,bench,11,0,104,35,368,348,490,403,122,55,bench
30954,11,bench,12,1,104,22,573,342,640,402,67,60,bench
30955,14,person,15,0,104,28,309,333,330,403,21,70,person
30956,1,car,2,1,134,87,14,30,486,203,472,173,car
30957,1,car,2,1,135,21,235,73,311,98,76,25,car
30958,4,car,5,0,135,32,160,65,262,162,102,97,car
30959,11,car,12,0,135,41,68,216,204,358,136,142,car
30960,0,door,1,0,146,67,1,1,526,412,525,411,door
30961,3,vase,4,0,146,18,453,256,588,413,135,157,vase
30962,6,person,7,1,146,65,137,30,363,410,226,380,person
30963,13,person,14,0,169,37,604,64,661,238,57,174,person
30964,14,person,15,1,169,34,656,139,699,222,43,83,person
30965,15,person,16,0,169,42,542,111,616,203,74,92,person
30966,17,person,18,0,169,41,473,82,549,205,76,123,person
30967,28,person,29,0,169,62,391,75,448,217,57,142,person
30968,39,person,40,0,169,80,286,51,364,223,78,172,person
30969,55,person,56,0,169,111,136,5,242,219,106,214,person
30970,75,bottle,76,0,169,15,118,205,129,239,11,34,bottle
30971,12,person,13,1,170,62,158,1,331,243,173,242,person
30972,13,person,14,1,170,51,391,0,521,193,130,193,person
30973,14,person,15,1,170,64,628,0,859,242,231,242,person
30974,15,person,16,1,170,58,795,1,953,194,158,193,person
30975,16,person,17,1,170,27,942,0,999,241,57,241,person
30976,17,person,18,1,170,80,742,1,992,305,250,304,person
30977,18,person,19,1,170,84,492,0,867,383,375,383,person
30978,23,person,24,1,170,86,269,0,536,296,267,296,person
30979,29,person,30,1,170,104,0,0,349,384,349,384,person
30980,5,person,6,0,171,100,46,11,451,452,405,441,person
30981,29,umbrella,30,0,184,23,502,136,589,226,87,90,umbrella
30982,30,person,31,0,184,29,512,195,531,241,19,46,person
30983,31,person,32,0,184,49,553,188,590,275,37,87,person
30984,32,person,33,0,184,28,416,245,442,298,26,53,person
30985,33,person,34,0,184,32,442,246,461,286,19,40,person
30986,34,person,35,0,184,39,496,338,533,401,37,63,person
30987,35,person,36,0,184,28,59,299,94,339,35,40,person
30988,1,car,2,1,187,17,295,161,372,231,77,70,car
30989,2,person,3,1,187,21,353,155,426,291,73,136,person
30990,3,person,4,1,187,22,99,213,153,299,54,86,person
30991,4,person,5,1,187,19,35,209,89,274,54,65,person
30992,7,person,8,0,187,107,141,44,307,632,166,588,person
30993,20,person,21,0,187,54,283,190,383,535,100,345,person
30994,12,person,13,0,188,35,226,368,243,415,17,47,person
30995,13,person,14,0,188,28,366,372,383,410,17,38,person
30996,14,person,15,0,188,46,435,371,470,441,35,70,person
30997,15,person,16,0,188,30,537,374,559,400,22,26,person
30998,16,person,17,0,188,23,589,363,609,413,20,50,person
30999,17,person,18,0,188,35,598,364,617,412,19,48,person
31000,18,person,19,0,188,23,431,375,447,414,16,39,person
31001,19,person,20,0,188,29,297,369,308,410,11,41,person
31002,20,person,21,0,188,37,278,370,298,425,20,55,person
31003,21,person,22,0,188,45,157,372,200,456,43,84,person
31004,22,person,23,1,188,17,440,368,452,389,12,21,person
31005,21,boat,22,0,194,15,2083,991,2148,1039,65,48,boat
31006,35,boat,36,0,194,18,1934,1060,2080,1085,146,25,boat
31007,103,person,104,1,194,18,1052,1061,1077,1091,25,30,person
31008,104,person,105,0,194,17,723,1048,748,1078,25,30,person
31009,105,person,106,1,194,18,689,1041,721,1079,32,38,person
31010,9,person,10,1,195,24,62,260,81,285,19,25,person
31011,10,person,11,1,195,22,81,259,96,285,15,26,person
31012,17,person,18,0,195,22,719,262,742,294,23,32,person
31013,18,person,19,0,195,21,703,251,719,296,16,45,person
31014,29,person,30,1,195,15,499,257,511,276,12,19,person
31015,11,person,12,1,196,16,347,372,373,414,26,42,person
31016,12,person,13,1,196,19,296,368,333,410,37,42,person
31017,13,person,14,1,196,16,612,365,639,396,27,31,person
31018,12,person,13,1,197,58,418,436,593,538,175,102,person
31019,22,person,23,0,197,92,210,294,319,491,109,197,person
31020,2,person,3,1,206,149,1,6,601,799,600,793,person
31021,17,book,18,1,206,15,167,421,491,509,324,88,book
31022,20,book,21,0,206,15,161,545,484,594,323,49,book
31023,22,book,23,1,206,18,157,630,468,717,311,87,book
31024,24,book,25,1,206,16,190,714,521,774,331,60,book
31025,25,book,26,1,206,22,179,766,506,799,327,33,book
31026,0,motorbike,1,0,12291,22,408,681,1375,1243,967,562,motorcycle
31027,2,person,3,0,12291,38,279,428,473,991,194,563,person
31028,5,person,6,1,12291,21,920,470,1078,728,158,258,person
31029,6,person,7,1,12291,26,1104,503,1234,946,130,443,person
31030,0,truck,1,0,12292,17,445,386,959,580,514,194,truck
31031,5,car,6,0,12292,19,1384,481,1500,537,116,56,car
31032,6,car,7,0,12292,22,1569,483,1697,534,128,51,car
31033,8,car,9,0,12292,16,1802,485,1916,537,114,52,car
31034,4,chair,5,1,12299,26,53,340,187,534,134,194,chair
31035,5,sofa,6,1,12299,17,317,278,449,431,132,153,couch
31036,16,table,17,1,12299,16,221,450,798,534,577,84,dining table
31037,6,cup,7,0,12300,18,483,1039,687,1182,204,143,cup
31038,7,cup,8,0,12300,16,610,848,743,933,133,85,cup
31039,19,table,19,0,12300,16,0,699,409,892,409,193,dining table
31040,23,chair,23,1,12300,18,1178,755,1431,1095,253,340,chair
31041,24,chair,24,1,12300,27,865,674,1234,1095,369,421,chair
31042,25,chair,25,1,12300,20,604,647,883,794,279,147,chair
31043,26,chair,26,1,12300,16,515,600,628,832,113,232,chair
31044,45,chair,45,1,12300,15,833,582,939,652,106,70,chair
31045,46,table,46,1,12300,16,626,613,898,659,272,46,dining table
31046,49,cup,49,0,12300,16,769,638,823,666,54,28,cup
31047,52,spoon,52,0,12300,16,1112,695,1183,720,71,25,spoon
31048,53,cup,53,0,12300,21,1202,657,1262,687,60,30,cup
31049,54,chair,54,0,12300,22,996,624,1112,670,116,46,chair
31050,56,spoon,56,0,12300,16,449,897,580,945,131,48,spoon
31051,57,cup,57,0,12300,15,956,631,1002,652,46,21,cup
31052,88,plate,88,0,12300,31,576,1010,807,1068,231,58,plate
31053,90,bowl,90,0,12300,33,226,927,381,1014,155,87,bowl
31054,93,plate,93,0,12300,27,447,1110,735,1196,288,86,plate
31055,94,plate,94,0,12300,24,575,897,758,951,183,54,plate
31056,97,plate,97,0,12300,15,1195,677,1274,696,79,19,plate
31057,100,plate,100,0,12300,16,108,751,219,774,111,23,plate
31058,24,truck,25,0,12301,15,895,1018,977,1157,82,139,truck
31059,0,backpack,1,0,12302,16,766,488,1074,789,308,301,backpack
31060,1,suitcase,2,0,12302,50,191,512,512,1368,321,856,suitcase
31061,5,sofa,6,0,12302,22,482,505,1805,1267,1323,762,couch
31062,6,table,7,1,12302,17,1777,589,2039,1234,262,645,dining table
31063,0,car,1,0,12306,24,326,710,731,1010,405,300,car
31064,1,person,2,0,12306,45,1473,629,1638,1065,165,436,person
31065,5,car,6,1,12306,25,2,790,561,1467,559,677,car
31066,19,car,20,1,12306,17,560,689,745,864,185,175,car
31067,20,car,21,0,12306,16,497,628,575,661,78,33,car
31068,21,car,22,0,12306,19,420,617,496,664,76,47,car
31069,7,table,7,0,12307,22,1242,1006,1596,1158,354,152,dining table
31070,8,chair,8,0,12307,51,991,955,1196,1152,205,197,chair
31071,9,chair,9,0,12307,25,1656,1006,1888,1285,232,279,chair
31072,11,chair,11,0,12307,27,692,928,831,1092,139,164,chair
31073,5,chair,6,1,12308,18,583,295,657,354,74,59,chair
31074,7,chair,8,0,12308,17,409,300,504,536,95,236,chair
31075,8,chair,9,0,12308,22,503,308,626,559,123,251,chair
31076,12,chair,13,1,12308,27,621,306,745,557,124,251,chair
31077,0,traffic light,1,0,12309,140,461,729,671,958,210,229,traffic light
31078,6,car,7,0,12310,16,1894,985,2029,1041,135,56,car
31079,11,person,12,0,12310,19,633,1141,787,1261,154,120,person
31080,12,person,13,0,12310,20,1079,1046,1117,1152,38,106,person
31081,13,person,14,0,12310,18,1042,1035,1080,1153,38,118,person
31082,14,person,15,0,12310,17,939,1046,975,1159,36,113,person
31083,15,person,16,0,12310,23,977,1039,1033,1174,56,135,person
31084,3,person,4,1,12313,26,770,930,843,1154,73,224,person
31085,4,person,5,0,12313,46,643,868,754,1317,111,449,person
31086,5,dog,6,0,12313,21,613,1160,683,1322,70,162,dog
31087,15,person,16,0,12313,20,1314,1000,1354,1096,40,96,person
31088,1,chair,2,0,12314,42,958,830,1321,1333,363,503,chair
31089,2,table,3,0,12314,18,956,579,1591,937,635,358,dining table
31090,3,umbrella,4,1,12314,24,375,2,2047,1477,1672,1475,umbrella
31091,11,motorbike,12,0,12314,35,1451,458,1726,607,275,149,motorcycle
31092,20,umbrella,21,1,12314,22,282,45,1245,624,963,579,umbrella
31093,22,chair,23,1,12314,20,609,605,754,856,145,251,chair
31094,1,person,2,0,12315,16,916,841,947,923,31,82,person
31095,18,chair,19,0,12317,21,866,1131,987,1233,121,102,chair
31096,24,person,25,0,12320,49,400,1584,463,1755,63,171,person
31097,25,person,26,0,12320,54,446,1584,518,1759,72,175,person
31098,26,person,27,0,12320,23,73,1574,96,1648,23,74,person
31099,0,car,1,0,12326,23,280,1011,1040,1294,760,283,car
31100,1,car,2,0,12326,21,1253,972,1724,1180,471,208,car
31101,5,car,6,1,12326,15,1080,987,1426,1170,346,183,car
31102,6,car,7,1,12326,15,190,1011,635,1239,445,228,car
31103,32,person,32,1,12326,17,1409,940,1445,987,36,47,person
31104,34,boat,34,1,12326,22,1097,955,1163,1071,66,116,boat
31105,35,boat,35,0,12326,30,180,1009,223,1085,43,76,boat
31106,37,person,37,1,12326,20,718,1030,773,1104,55,74,person
31107,78,door,78,0,12326,17,1515,981,1605,1135,90,154,door
31108,81,door,81,0,12326,18,1582,981,1665,1129,83,148,door
31109,13,person,14,0,12327,26,895,1260,939,1387,44,127,person
31110,17,car,18,1,12332,19,4,929,257,1146,253,217,car
31111,18,car,19,0,12332,26,197,867,545,996,348,129,car
31112,19,car,20,0,12332,28,419,908,802,1073,383,165,car
31113,20,car,21,1,12332,15,845,916,961,1034,116,118,car
31114,29,car,30,1,12332,15,1479,884,1669,983,190,99,car
31115,0,car,1,0,12338,38,828,979,1204,1305,376,326,car
31116,1,car,2,0,12338,22,2,962,373,1226,371,264,car
31117,8,truck,9,1,12338,16,1093,825,1356,1209,263,384,truck
31118,9,car,10,1,12338,24,552,971,878,1161,326,190,car
31119,15,car,16,0,12338,15,1645,995,1849,1080,204,85,car
31120,0,car,1,0,12339,18,824,1172,1063,1319,239,147,car
31121,3,bench,4,1,12340,19,1313,1004,1488,1125,175,121,bench
31122,4,person,5,0,12340,40,1376,938,1525,1137,149,199,person
31123,6,person,7,0,12340,28,1216,938,1280,1073,64,135,person
31124,7,bench,8,1,12340,18,1108,969,1249,1122,141,153,bench
31125,8,person,9,0,12340,27,1115,947,1206,1124,91,177,person
31126,10,person,11,0,12340,42,254,898,336,1144,82,246,person
31127,11,bench,12,1,12340,30,565,1070,715,1208,150,138,bench
31128,12,person,13,0,12340,49,582,972,781,1203,199,231,person
31129,19,person,20,1,12340,24,347,919,393,1086,46,167,person
31130,20,person,21,0,12340,28,369,933,419,1083,50,150,person
31131,21,person,22,0,12340,36,523,921,591,1087,68,166,person
31132,22,person,23,1,12340,19,613,924,648,1029,35,105,person
31133,23,person,24,1,12340,41,671,991,794,1157,123,166,person
31134,28,person,29,1,12340,59,741,977,852,1160,111,183,person
31135,30,person,31,1,12340,29,1617,843,1680,958,63,115,person
31136,33,person,34,0,12340,54,1907,835,2048,1238,141,403,person
31137,3,person,4,0,12343,22,1529,1171,1613,1446,84,275,person
31138,4,person,5,0,12343,21,1613,1176,1692,1435,79,259,person
31139,5,person,6,0,12343,20,1695,1164,1793,1424,98,260,person
31140,8,person,9,0,12343,28,1233,1155,1311,1361,78,206,person
31141,9,person,10,0,12343,26,1127,1171,1193,1373,66,202,person
31142,14,person,15,0,12343,21,825,1170,866,1322,41,152,person
31143,16,person,17,0,12343,17,793,1187,817,1266,24,79,person
31144,18,person,19,0,12343,34,725,1177,779,1339,54,162,person
31145,19,person,20,0,12343,28,642,1182,688,1329,46,147,person
31146,0,person,1,0,12345,30,480,648,749,1003,269,355,person
31147,20,person,20,0,12345,23,323,598,565,967,242,369,person
31148,28,person,28,0,12345,30,159,451,285,847,126,396,person
31149,16,person,17,0,12346,34,1686,783,1796,1114,110,331,person
31150,0,mirror,1,0,12347,17,227,177,281,260,54,83,mirror
31151,5,umbrella,6,0,12347,24,197,304,220,403,23,99,umbrella
31152,6,table,7,0,12347,44,129,314,192,421,63,107,dining table
31153,24,person,25,1,12350,19,899,968,940,1080,41,112,person
31154,10,chair,11,0,12351,29,621,483,850,766,229,283,chair
31155,11,chair,12,0,12351,35,569,448,717,714,148,266,chair
31156,22,table,23,0,12351,17,621,432,1022,763,401,331,dining table
31157,0,boat,1,0,12352,17,836,552,974,666,138,114,boat
31158,4,person,5,0,12356,28,970,753,1003,846,33,93,person
31159,5,person,6,0,12356,29,1003,747,1033,845,30,98,person
31160,6,person,7,0,12356,23,1048,745,1082,843,34,98,person
31161,7,bench,8,0,12356,52,1356,989,2046,1535,690,546,bench
31162,8,bench,9,0,12356,28,1104,813,1177,884,73,71,bench
31163,16,car,17,1,12356,19,1954,790,2048,858,94,68,car
31164,17,car,18,1,12356,17,1887,786,1974,850,87,64,car
31165,18,car,19,0,12356,29,1758,783,1892,842,134,59,car
31166,20,car,21,1,12356,18,1689,781,1759,830,70,49,car
31167,21,car,22,1,12356,15,1655,779,1721,826,66,47,car
31168,24,car,25,1,12356,18,1548,775,1612,812,64,37,car
31169,32,person,33,0,12356,43,206,752,264,947,58,195,person
31170,56,person,57,1,12356,18,2021,750,2039,787,18,37,person
31171,37,person,37,0,12357,16,97,405,109,447,12,42,person
31172,11,person,12,0,12358,30,1447,609,1587,928,140,319,person
31173,12,bicycle,13,0,12358,27,1529,732,1580,935,51,203,bicycle
31174,13,person,14,0,12358,33,1196,655,1317,930,121,275,person
31175,14,bicycle,15,0,12358,24,1259,737,1324,933,65,196,bicycle
31176,15,person,16,0,12358,29,1041,635,1148,913,107,278,person
31177,17,person,18,0,12358,49,822,628,1012,1107,190,479,person
31178,18,bicycle,19,1,12358,20,838,836,911,1157,73,321,bicycle
31179,0,car,1,0,12359,28,809,1028,981,1110,172,82,car
31180,8,car,9,0,12359,28,85,1048,381,1165,296,117,car
31181,10,car,11,1,12359,15,2,1055,112,1153,110,98,car
31182,20,person,21,0,12360,19,1433,892,1505,1056,72,164,person
31183,22,person,23,0,12360,23,510,766,550,901,40,135,person
31184,23,person,24,0,12360,24,1766,662,1826,835,60,173,person
31185,24,person,25,0,12360,17,1830,680,1863,810,33,130,person
31186,25,person,26,1,12360,23,1859,1267,2016,1532,157,265,person
31187,26,person,27,0,12360,21,1493,812,1607,912,114,100,person
31188,27,person,28,0,12360,17,1428,773,1515,848,87,75,person
31189,34,person,35,0,12360,24,1493,636,1528,721,35,85,person
31190,35,person,36,0,12360,19,1352,642,1377,732,25,90,person
31191,37,person,38,1,12360,16,1291,631,1314,709,23,78,person
31192,38,person,39,0,12360,28,1905,646,1967,803,62,157,person
31193,40,bicycle,41,0,12360,31,1450,694,1510,778,60,84,bicycle
31194,45,bicycle,46,0,12360,60,1783,783,1891,907,108,124,bicycle
31195,13,bench,14,1,12364,16,17,997,48,1061,31,64,bench
31196,14,bench,15,0,12364,19,39,1000,120,1063,81,63,bench
31197,15,bench,16,0,12364,42,1420,1157,1791,1428,371,271,bench
31198,17,person,18,0,12364,29,85,976,126,1056,41,80,person
31199,18,person,19,1,12364,20,114,978,139,1038,25,60,person
31200,19,bench,20,0,12364,16,127,997,182,1064,55,67,bench
31201,21,bench,22,0,12364,20,181,993,264,1056,83,63,bench
31202,22,person,23,0,12364,30,184,978,241,1056,57,78,person
31203,24,person,25,0,12364,32,289,974,349,1047,60,73,person
31204,28,person,29,1,12364,26,368,977,403,1041,35,64,person
31205,29,chair,30,0,12364,19,373,991,411,1041,38,50,chair
31206,32,bicycle,33,0,12364,40,480,1017,517,1068,37,51,bicycle
31207,33,person,34,0,12364,23,564,965,604,1053,40,88,person
31208,34,chair,35,0,12364,23,586,993,620,1050,34,57,chair
31209,36,person,37,1,12364,24,841,952,873,1006,32,54,person
31210,37,person,38,1,12364,29,821,979,872,1063,51,84,person
31211,38,chair,39,0,12364,17,825,1015,861,1064,36,49,chair
31212,9,boat,10,0,12365,20,352,322,482,476,130,154,boat
31213,10,boat,11,0,12365,33,469,276,661,526,192,250,boat
31214,0,car,1,0,12366,23,1642,848,1972,1093,330,245,car
31215,18,person,19,0,12368,26,1074,1116,1120,1243,46,127,person
31216,19,person,20,1,12368,19,1119,1113,1165,1178,46,65,person
31217,3,car,4,0,12370,20,1276,1073,1496,1196,220,123,car
31218,4,car,5,0,12370,22,1498,1066,1694,1208,196,142,car
31219,3,bicycle,4,0,12373,43,100,1169,184,1227,84,58,bicycle
31220,4,car,5,1,12373,16,314,1150,505,1238,191,88,car
31221,5,person,6,0,12373,28,974,1146,1049,1344,75,198,person
31222,5,chair,6,1,12377,20,81,306,185,398,104,92,chair
31223,6,chair,7,1,12377,42,185,323,296,508,111,185,chair
31224,7,chair,8,0,12377,33,274,315,398,502,124,187,chair
31225,8,table,9,0,12377,37,55,282,379,513,324,231,dining table
31226,16,plate,17,0,12377,16,213,299,276,323,63,24,plate
31227,12,person,10,0,12378,69,1714,732,2005,1418,291,686,person
31228,49,person,47,0,12378,16,496,1038,511,1079,15,41,person
31229,3,chair,4,0,12382,23,755,391,877,601,122,210,chair
31230,10,chair,11,0,12382,19,649,387,764,650,115,263,chair
31231,28,table,28,0,12382,16,2,481,169,642,167,161,dining table
31232,29,table,29,0,12382,28,689,472,827,526,138,54,dining table
31233,42,bench,40,0,12385,20,23,435,341,562,318,127,bench
31234,60,table,58,0,12385,17,246,569,700,769,454,200,dining table
31235,80,window,77,0,12385,17,206,184,276,282,70,98,window
31236,11,window,12,0,12386,31,1596,114,1878,626,282,512,window
31237,16,person,17,1,12387,28,1196,1067,1276,1262,80,195,person
31238,17,person,18,0,12387,33,1234,1056,1311,1278,77,222,person
31239,18,person,19,0,12387,29,1114,1063,1169,1189,55,126,person
31240,19,person,20,0,12387,26,1064,1069,1113,1185,49,116,person
31241,0,car,1,0,12389,15,988,1144,1448,1304,460,160,car
31242,1,bicycle,2,0,12390,39,1490,872,1939,1221,449,349,bicycle
31243,34,bicycle,30,0,12390,34,469,1012,772,1401,303,389,bicycle
31244,6,bench,7,0,12391,22,1534,983,1636,1082,102,99,bench
31245,19,car,19,0,12392,31,569,1228,733,1314,164,86,car
31246,0,car,1,0,12393,83,681,571,1686,1304,1005,733,car
31247,6,person,7,0,12397,18,761,807,800,871,39,64,person
31248,7,door,8,0,12399,22,353,536,553,979,200,443,door
31249,8,door,9,0,12399,23,553,524,749,988,196,464,door
31250,30,car,24,1,12400,17,1057,792,1090,815,33,23,car
31251,1,car,1,0,12402,33,576,946,1439,1589,863,643,car
31252,3,car,3,0,12402,20,586,612,811,846,225,234,car
31253,4,car,4,0,12402,16,798,493,980,564,182,71,car
31254,23,car,23,1,12402,18,1903,1317,2193,1646,290,329,car
31255,2,chair,2,0,12403,37,3,749,574,1650,571,901,chair
31256,3,chair,3,0,12403,42,1175,598,1694,1350,519,752,chair
31257,11,table,9,0,12403,36,551,713,1333,1637,782,924,dining table
31258,12,chair,10,1,12403,32,952,989,1765,1650,813,661,chair
31259,4,clock,5,0,12408,16,1012,268,1098,345,86,77,clock
31260,5,bench,6,0,12408,19,169,1318,392,1399,223,81,bench
31261,8,chair,9,0,12410,33,160,224,270,432,110,208,chair
31262,11,table,12,0,12410,27,4,235,229,454,225,219,dining table
31263,14,window,15,0,12411,16,585,1046,663,1140,78,94,window
31264,15,traffic light,16,0,12411,34,466,826,676,1028,210,202,traffic light
31265,24,traffic light,25,0,12411,22,400,954,607,993,207,39,traffic light
31266,0,motorbike,1,0,12412,43,651,483,1492,1170,841,687,motorcycle
31267,1,bicycle,2,0,12412,18,1711,528,1991,770,280,242,bicycle
31268,8,motorbike,9,1,12412,41,1316,534,1539,941,223,407,motorcycle
31269,11,motorbike,12,0,12412,27,1989,477,2120,744,131,267,motorcycle
31270,5,person,6,0,12414,24,634,1478,818,1761,184,283,person
31271,6,person,7,0,12414,37,927,1186,1034,1433,107,247,person
31272,16,person,17,0,12415,28,1789,977,1963,1436,174,459,person
31273,20,handbag,10,0,12417,19,1647,790,1719,990,72,200,handbag
31274,37,person,27,0,12417,29,457,722,552,931,95,209,person
31275,38,person,28,1,12417,25,411,736,483,929,72,193,person
31276,39,person,29,1,12417,35,299,734,372,987,73,253,person
31277,40,person,30,0,12417,48,249,751,356,1030,107,279,person
31278,41,person,31,0,12417,55,141,730,239,1010,98,280,person
31279,44,dog,34,0,12417,23,1152,760,1198,798,46,38,dog
31280,46,person,36,0,12417,71,1363,659,1534,1315,171,656,person
31281,47,person,37,0,12417,67,1492,690,1720,1339,228,649,person
31282,48,person,38,1,12417,50,1899,689,2043,1256,144,567,person
31283,49,person,39,0,12417,38,1699,690,1772,888,73,198,person
31284,50,person,40,1,12417,19,1665,697,1704,827,39,130,person
31285,3,person,4,0,12418,17,1585,1035,1631,1135,46,100,person
31286,6,person,7,0,12418,31,1177,1005,1282,1336,105,331,person
31287,9,person,10,0,12418,29,651,976,738,1249,87,273,person
31288,10,person,11,0,12418,34,530,970,632,1259,102,289,person
31289,7,person,8,0,12419,20,757,1326,818,1525,61,199,person
31290,7,person,8,0,12420,24,800,859,842,976,42,117,person
31291,8,person,9,0,12420,31,1877,826,1969,964,92,138,person
31292,9,person,10,0,12420,35,1993,834,2092,975,99,141,person
31293,11,person,12,0,12420,31,1528,832,1618,972,90,140,person
31294,12,person,13,0,12420,28,1453,841,1508,969,55,128,person
31295,13,person,14,0,12420,37,1132,852,1202,986,70,134,person
31296,14,person,15,0,12420,31,1199,846,1271,986,72,140,person
31297,15,person,16,0,12420,27,443,876,503,1004,60,128,person
31298,44,person,45,1,12420,26,1239,845,1276,971,37,126,person
31299,45,person,46,1,12420,33,1270,851,1305,968,35,117,person
31300,42,table,42,0,12423,21,286,394,411,519,125,125,dining table
31301,43,chair,43,0,12423,17,290,382,371,508,81,126,chair
31302,44,chair,44,0,12423,26,324,400,420,491,96,91,chair
31303,53,table,53,0,12423,19,467,381,584,507,117,126,dining table
31304,54,chair,54,0,12423,16,542,384,597,460,55,76,chair
31305,72,table,72,0,12423,17,5,410,231,459,226,49,dining table
31306,74,table,74,0,12423,25,401,431,557,610,156,179,dining table
31307,77,chair,77,0,12423,20,0,431,64,606,64,175,chair
31308,92,chair,92,0,12423,26,8,445,111,674,103,229,chair
31309,93,chair,93,0,12423,33,56,482,162,709,106,227,chair
31310,103,chair,103,0,12423,23,591,392,676,550,85,158,chair
31311,107,chair,107,0,12423,15,705,415,787,497,82,82,chair
31312,127,chair,127,0,12423,15,407,411,506,526,99,115,chair
31313,128,chair,128,0,12423,20,468,439,581,611,113,172,chair
31314,153,table,153,0,12423,20,817,449,1034,656,217,207,dining table
31315,154,chair,154,0,12423,26,796,430,911,633,115,203,chair
31316,155,chair,155,0,12423,39,928,464,1071,686,143,222,chair
31317,156,chair,156,0,12423,28,103,501,298,801,195,300,chair
31318,157,chair,157,0,12423,16,295,487,456,672,161,185,chair
31319,158,table,158,0,12423,22,122,513,504,838,382,325,dining table
31320,159,chair,159,0,12423,21,348,532,537,777,189,245,chair
31321,161,chair,161,0,12423,26,683,506,842,660,159,154,chair
31322,175,spoon,175,0,12423,15,697,732,789,756,92,24,spoon
31323,182,chair,182,0,12423,24,764,665,1037,897,273,232,chair
31324,184,chair,183,1,12423,15,409,846,699,900,290,54,chair
31325,185,chair,184,0,12423,29,140,572,354,893,214,321,chair
31326,186,chair,185,0,12423,27,223,632,491,897,268,265,chair
31327,13,person,14,1,12426,15,2086,1265,2199,1647,113,382,person
31328,14,person,15,1,12426,20,2034,1339,2101,1554,67,215,person
31329,1,car,2,0,12427,20,865,810,1021,927,156,117,car
31330,4,car,5,0,12427,15,1448,807,1672,886,224,79,car
31331,17,car,17,1,12427,23,3,775,255,928,252,153,car
31332,18,car,18,0,12427,30,205,776,422,930,217,154,car
31333,19,car,19,0,12427,30,480,776,636,931,156,155,car
31334,20,car,20,1,12427,22,807,798,958,881,151,83,car
31335,22,car,22,0,12427,26,1040,808,1201,927,161,119,car
31336,23,car,23,1,12427,21,1184,809,1382,922,198,113,car
31337,27,car,27,0,12427,22,1677,824,1819,882,142,58,car
31338,28,car,28,0,12427,25,1889,842,2044,917,155,75,car
31339,30,car,30,1,12427,15,1363,801,1453,859,90,58,car
31340,36,car,36,1,12427,15,1834,828,1931,873,97,45,car
31341,11,boat,12,0,12429,22,98,752,278,836,180,84,boat
31342,20,boat,21,0,12429,29,1162,768,1533,878,371,110,boat
31343,23,boat,24,0,12429,16,1011,713,1101,801,90,88,boat
31344,68,boat,69,0,12429,28,1674,678,1810,788,136,110,boat
31345,9,person,10,0,12430,16,2038,1210,2101,1305,63,95,person
31346,15,person,16,0,12430,21,1175,1159,1229,1257,54,98,person
31347,22,person,23,0,12430,16,997,1125,1052,1240,55,115,person
31348,0,car,1,0,12431,19,1412,942,1506,984,94,42,car
31349,23,table,22,1,12432,29,413,850,1452,1645,1039,795,dining table
31350,5,person,6,0,12434,28,1708,497,1821,657,113,160,person
31351,8,person,8,0,12434,21,533,546,726,643,193,97,person
31352,9,person,9,1,12434,15,764,552,845,648,81,96,person
31353,10,person,10,1,12434,17,828,526,895,654,67,128,person
31354,11,person,11,0,12434,21,925,522,1059,652,134,130,person
31355,12,person,12,0,12434,19,1068,535,1170,648,102,113,person
31356,13,person,13,1,12434,16,1170,547,1219,652,49,105,person
31357,14,person,14,1,12434,17,1250,535,1310,660,60,125,person
31358,15,person,15,1,12434,18,1261,535,1376,660,115,125,person
31359,16,person,16,1,12434,15,1350,563,1427,656,77,93,person
31360,4,bench,5,0,12435,26,29,1198,1006,1451,977,253,bench
31361,9,person,10,0,12438,16,1552,1040,1593,1187,41,147,person
31362,12,traffic light,13,0,12441,15,1553,520,1655,633,102,113,traffic light
31363,13,traffic light,14,0,12441,15,1594,601,1694,709,100,108,traffic light
31364,2,plate,3,0,12444,15,493,1053,742,1180,249,127,plate
31365,6,chair,7,0,12444,17,1313,552,1660,1090,347,538,chair
31366,23,chair,24,0,12444,18,586,1063,1294,1533,708,470,chair
31367,24,chair,25,0,12444,22,922,760,1387,1338,465,578,chair
31368,25,chair,26,0,12444,16,1412,476,1685,820,273,344,chair
31369,24,person,25,0,12445,29,645,989,714,1163,69,174,person
31370,25,person,26,1,12445,17,716,972,765,1062,49,90,person
31371,27,person,28,0,12445,28,783,972,918,1156,135,184,person
31372,13,person,14,0,12446,23,1805,736,1862,866,57,130,person
31373,14,person,15,0,12446,25,1743,727,1805,876,62,149,person
31374,8,person,9,0,12448,21,1743,938,1801,1156,58,218,person
31375,15,person,16,0,12448,23,2000,937,2067,1058,67,121,person
31376,33,door,34,1,12448,16,204,899,284,1045,80,146,door
31377,21,table,22,0,12450,22,536,344,580,422,44,78,dining table
31378,24,table,25,0,12450,16,767,320,810,372,43,52,dining table
31379,38,sofa,33,0,12450,34,645,338,861,471,216,133,couch
31380,51,sofa,44,0,12450,20,858,415,1200,608,342,193,couch
31381,5,person,6,1,12452,23,1224,561,1280,753,56,192,person
31382,6,person,7,1,12452,21,1184,606,1267,799,83,193,person
31383,7,person,8,1,12452,35,1073,550,1246,937,173,387,person
31384,8,person,9,1,12452,30,786,634,903,958,117,324,person
31385,9,person,10,1,12452,40,845,630,1152,960,307,330,person
31386,10,person,11,1,12452,25,560,661,663,880,103,219,person
31387,11,person,12,1,12452,26,577,640,816,958,239,318,person
31388,1,person,2,0,12453,18,854,682,1093,1533,239,851,person
31389,2,person,3,0,12453,26,1070,392,1358,1370,288,978,person
31390,29,person,28,0,12453,71,1622,478,1885,1473,263,995,person
31391,30,person,29,0,12453,89,1804,488,2198,1483,394,995,person
31392,31,person,30,1,12453,18,2135,567,2197,802,62,235,person
31393,6,person,7,0,12456,34,1061,974,1130,1246,69,272,person
31394,8,person,9,0,12458,21,686,643,794,809,108,166,person
31395,12,person,13,0,12458,31,1406,564,1505,809,99,245,person
31396,13,person,14,0,12458,26,1218,565,1281,785,63,220,person
31397,14,person,15,0,12458,25,875,565,954,776,79,211,person
31398,18,person,19,1,12458,21,1897,664,2042,957,145,293,person
31399,30,person,31,0,12458,43,980,590,1049,777,69,187,person
31400,31,person,32,1,12458,32,806,577,853,690,47,113,person
31401,32,person,33,0,12458,35,555,601,631,673,76,72,person
31402,33,person,34,1,12458,34,741,562,793,666,52,104,person
31403,34,person,35,1,12458,22,652,587,689,660,37,73,person
31404,2,chair,3,0,12462,24,115,474,690,1228,575,754,chair
31405,6,table,7,1,12462,18,531,569,1581,1194,1050,625,dining table
31406,9,chair,10,0,12462,25,851,527,1394,1367,543,840,chair
31407,10,chair,11,1,12462,17,859,414,1262,581,403,167,chair
31408,11,chair,12,0,12462,34,1499,493,2102,1217,603,724,chair
31409,5,person,6,0,12464,19,241,845,269,934,28,89,person
31410,6,person,7,0,12464,20,222,841,240,929,18,88,person
31411,7,person,8,0,12464,20,192,847,217,929,25,82,person
31412,8,person,9,0,12464,17,163,841,189,927,26,86,person
31413,13,person,14,0,12464,18,1256,912,1280,991,24,79,person
31414,14,person,15,0,12464,20,1220,901,1252,987,32,86,person
31415,18,person,19,0,12464,15,965,864,985,946,20,82,person
31416,22,person,23,0,12464,25,688,869,739,980,51,111,person
31417,23,person,24,0,12464,19,746,875,784,982,38,107,person
31418,24,person,25,0,12464,35,770,923,823,1098,53,175,person
31419,29,person,30,0,12464,39,1938,963,2081,1247,143,284,person
31420,30,person,31,1,12464,22,2068,959,2137,1183,69,224,person
31421,31,person,32,1,12464,25,2079,983,2200,1651,121,668,person
31422,4,car,5,0,12465,19,1176,1031,1400,1186,224,155,car
31423,11,bench,12,0,12465,15,1135,1350,2198,1585,1063,235,bench
31424,4,backpack,4,0,12467,15,291,213,400,366,109,153,backpack
31425,5,person,5,0,12467,32,5,125,218,456,213,331,person
31426,6,person,6,0,12467,36,153,161,411,461,258,300,person
31427,8,backpack,8,0,12467,15,171,162,234,275,63,113,backpack
31428,45,person,32,1,12467,25,398,208,441,324,43,116,person
31429,49,person,36,1,12467,58,177,123,283,421,106,298,person
31430,50,person,37,1,12467,72,112,160,198,423,86,263,person
31431,51,person,38,1,12467,23,501,164,524,204,23,40,person
31432,17,car,18,0,12468,34,761,996,1798,1416,1037,420,car
31433,2,person,3,0,12469,21,297,1087,368,1253,71,166,person
31434,3,person,4,0,12469,24,408,1053,474,1311,66,258,person
31435,4,person,5,0,12469,23,689,1076,756,1303,67,227,person
31436,5,person,6,0,12469,24,756,1080,832,1288,76,208,person
31437,15,person,16,0,12469,16,1152,989,1183,1096,31,107,person
31438,16,person,17,0,12469,16,1316,1009,1344,1114,28,105,person
31439,17,person,18,0,12469,18,1732,986,1772,1106,40,120,person
31440,18,bicycle,19,0,12469,29,1984,1173,2071,1320,87,147,bicycle
31441,19,person,20,0,12469,26,1973,1068,2091,1276,118,208,person
31442,10,pot,11,0,12472,17,1075,783,1240,1174,165,391,potted plant
31443,11,pot,12,0,12472,21,913,785,1092,1133,179,348,potted plant
31444,12,pot,13,0,12472,25,773,773,940,1095,167,322,potted plant
31445,13,pot,14,0,12472,23,672,771,809,1063,137,292,potted plant
31446,14,pot,15,0,12472,19,568,773,696,1039,128,266,potted plant
31447,15,pot,16,0,12472,20,493,771,611,1017,118,246,potted plant
31448,1,mirror,2,0,12475,17,364,6,1304,963,940,957,mirror
31449,7,clock,8,0,12475,23,777,868,1069,1221,292,353,clock
31450,14,table,15,1,12476,16,743,775,1084,971,341,196,dining table
31451,2,person,3,0,12480,20,1230,990,1318,1077,88,87,person
31452,29,person,29,0,12480,16,516,1031,535,1090,19,59,person
31453,30,person,30,0,12480,21,923,995,980,1064,57,69,person
31454,32,person,32,0,12480,17,737,1013,787,1065,50,52,person
31455,0,car,1,0,12481,38,170,653,1684,1412,1514,759,car
31456,12,door,13,0,12481,16,1064,675,1400,1197,336,522,door
31457,15,door,16,0,12481,17,1309,668,1585,1112,276,444,door
31458,5,door,6,0,12482,17,107,1167,687,1923,580,756,door
31459,6,door,7,0,12482,16,687,1169,1323,1953,636,784,door
31460,7,chair,8,1,12485,16,216,1033,621,1215,405,182,chair
31461,15,traffic light,14,0,12486,19,586,874,687,987,101,113,traffic light
31462,11,person,12,1,12488,32,1637,1184,1717,1411,80,227,person
31463,9,bicycle,8,0,12489,117,537,238,1262,1532,725,1294,bicycle
31464,8,car,8,0,12491,15,986,1095,1046,1135,60,40,car
31465,13,car,13,0,12491,23,823,1143,1095,1243,272,100,car
31466,14,truck,14,0,12491,17,737,1149,839,1252,102,103,truck
31467,9,chair,10,0,12492,16,223,274,284,394,61,120,chair
31468,1,bird,2,0,12493,15,1401,565,1426,597,25,32,bird
31469,6,person,7,0,12493,24,1324,1063,1387,1198,63,135,person
31470,1,table,1,0,12495,19,5,549,1273,1446,1268,897,dining table
31471,6,pot,3,0,12495,29,120,0,455,597,335,597,potted plant
31472,11,chair,6,0,12495,29,52,351,826,659,774,308,chair
31473,12,chair,7,1,12495,19,982,236,1494,716,512,480,chair
31474,14,desk,9,0,12495,35,773,3,2124,785,1351,782,desk
31475,15,person,10,1,12495,20,1144,1,1590,177,446,176,person
31476,16,glasses,11,0,12495,20,1125,149,1231,199,106,50,eye glasses
31477,24,chair,19,1,12495,47,823,697,1823,1470,1000,773,chair
31478,8,person,7,0,12500,45,1584,440,2028,1653,444,1213,person
31479,4,person,5,0,12501,19,169,578,213,706,44,128,person
31480,7,cow,8,0,12501,23,995,603,1096,656,101,53,cow
31481,5,chair,6,0,12502,19,418,191,562,422,144,231,chair
31482,8,chair,9,0,12502,39,234,199,409,453,175,254,chair
31483,9,table,10,1,12502,15,277,190,499,440,222,250,dining table
31484,2,plate,3,1,12503,15,388,553,1558,1264,1170,711,plate
31485,0,table,1,0,12504,61,561,1185,1526,1653,965,468,dining table
31486,7,chair,8,0,12504,19,375,962,918,1653,543,691,chair
31487,21,chair,19,0,12505,27,2,429,141,735,139,306,chair
31488,28,pot,25,0,12505,17,525,352,585,414,60,62,potted plant
31489,31,baseball,27,0,12505,16,729,575,780,629,51,54,sports ball
31490,34,mirror,30,0,12505,59,528,38,679,272,151,234,mirror
31491,48,door,43,0,12505,20,309,72,506,741,197,669,door
31492,2,person,3,0,12506,19,1892,959,1940,1080,48,121,person
31493,3,person,4,0,12506,24,1851,950,1892,1082,41,132,person
31494,5,person,6,0,12506,26,1670,946,1709,1060,39,114,person
31495,6,person,7,0,12506,17,1728,969,1754,1044,26,75,person
31496,7,person,8,0,12506,25,1968,979,2025,1065,57,86,person
31497,8,bus,9,0,12506,30,916,766,1588,1078,672,312,bus
31498,10,bus,11,0,12506,31,409,714,826,1074,417,360,bus
31499,15,person,16,0,12506,19,279,932,306,992,27,60,person
31500,16,person,17,0,12506,18,339,933,357,995,18,62,person
31501,20,car,18,0,12508,15,1924,871,1968,889,44,18,car
31502,1,person,2,0,12509,44,890,789,1003,1169,113,380,person
31503,3,person,4,0,12509,23,1795,744,1862,896,67,152,person
31504,10,car,11,0,12509,16,962,788,1060,872,98,84,car
31505,17,car,18,0,12510,26,1596,1018,1795,1124,199,106,car
31506,1,fire hydrant,2,0,12511,17,26,1304,170,1529,144,225,fire hydrant
31507,8,person,9,0,12518,22,727,1029,762,1119,35,90,person
31508,15,fire hydrant,16,0,12518,17,256,1171,334,1298,78,127,fire hydrant
31509,9,person,10,0,12526,22,477,920,510,990,33,70,person
31510,9,chair,10,0,12528,19,1209,947,1532,1304,323,357,chair
31511,26,sofa,24,1,12528,20,1032,1209,1833,1645,801,436,couch
31512,1,bus,2,0,12529,25,511,593,882,951,371,358,bus
31513,2,person,3,1,12530,15,1170,498,1278,819,108,321,person
31514,3,person,4,1,12530,15,1093,943,1237,1272,144,329,person
31515,20,person,17,1,12530,17,646,826,699,918,53,92,person
31516,21,person,18,1,12530,21,598,831,657,915,59,84,person
31517,22,person,19,1,12530,26,783,659,867,742,84,83,person
31518,23,person,20,1,12530,44,772,736,869,923,97,187,person
31519,24,person,21,1,12530,21,934,822,972,922,38,100,person
31520,1,car,2,0,12534,20,1194,981,1595,1122,401,141,car
31521,15,person,16,0,12535,18,2056,944,2085,1032,29,88,person
31522,0,person,1,0,12536,37,547,828,622,1091,75,263,person
31523,1,person,2,0,12536,40,953,816,1076,1237,123,421,person
31524,12,person,13,0,12536,17,448,818,533,1115,85,297,person
31525,13,window,12,0,12537,16,1299,699,1353,752,54,53,window
31526,17,car,18,1,12539,17,200,1026,314,1074,114,48,car
31527,24,car,25,1,12539,17,943,1013,1016,1056,73,43,car
31528,31,car,32,1,12539,15,745,1026,800,1074,55,48,car
31529,21,bicycle,22,0,12540,38,1477,891,1606,1168,129,277,bicycle
31530,22,bicycle,23,0,12540,26,1407,911,1481,1178,74,267,bicycle
31531,23,bicycle,24,0,12540,62,731,917,909,1178,178,261,bicycle
31532,24,bicycle,25,0,12540,64,632,909,781,1184,149,275,bicycle
31533,29,bicycle,30,0,12540,31,6,934,232,1168,226,234,bicycle
31534,30,bicycle,31,0,12540,28,173,897,364,1180,191,283,bicycle
31535,31,bicycle,32,0,12540,18,375,898,577,1170,202,272,bicycle
31536,5,person,6,0,12542,16,748,1129,777,1215,29,86,person
31537,6,person,7,0,12542,15,782,1132,806,1214,24,82,person
31538,8,table,9,0,12542,17,582,1171,718,1214,136,43,dining table
31539,0,person,1,1,12545,16,365,3,494,303,129,300,person
31540,1,person,2,0,12545,36,433,377,731,756,298,379,person
31541,4,person,5,1,12545,18,2,663,213,961,211,298,person
31542,5,person,6,0,12545,34,748,327,1027,607,279,280,person
31543,8,table,9,0,12545,18,855,178,1276,520,421,342,dining table
31544,9,car,10,1,12545,19,2,2,712,106,710,104,car
31545,17,person,18,1,12545,16,1169,1,1279,240,110,239,person
31546,14,person,15,0,12547,20,525,936,582,1069,57,133,person
31547,15,person,16,0,12547,19,442,934,504,1069,62,135,person
31548,21,skis,22,0,12547,20,1953,931,2012,1334,59,403,skis
31549,22,skis,23,0,12547,21,1804,963,1849,1334,45,371,skis
31550,23,skis,24,0,12547,19,1878,860,1924,1313,46,453,skis
31551,24,skis,25,0,12547,21,2043,968,2091,1329,48,361,skis
31552,19,chair,13,0,12548,41,422,644,711,836,289,192,chair
31553,22,person,15,1,12548,15,561,404,593,441,32,37,person
31554,23,person,16,1,12548,15,606,413,635,445,29,32,person
31555,25,person,18,1,12548,16,683,403,715,441,32,38,person
31556,26,person,19,1,12548,17,719,404,756,441,37,37,person
31557,27,person,20,1,12548,16,760,406,798,439,38,33,person
31558,28,person,21,1,12548,16,876,396,921,430,45,34,person
31559,52,person,45,1,12548,31,719,505,868,644,149,139,person
31560,53,person,46,1,12548,28,902,533,1017,641,115,108,person
31561,54,person,47,1,12548,28,677,482,759,562,82,80,person
31562,55,person,48,1,12548,31,370,503,501,617,131,114,person
31563,56,person,49,1,12548,25,443,491,528,593,85,102,person
31564,57,person,50,1,12548,25,850,464,930,541,80,77,person
31565,58,person,51,1,12548,27,472,466,541,566,69,100,person
31566,59,person,52,1,12548,38,1,393,338,762,337,369,person
31567,60,chair,53,1,12548,30,704,582,879,782,175,200,chair
31568,64,person,57,1,12548,20,201,482,269,543,68,61,person
31569,65,chair,58,1,12548,22,802,535,914,679,112,144,chair
31570,67,person,60,1,12548,29,607,507,738,695,131,188,person
31571,68,person,61,1,12548,23,748,459,795,514,47,55,person
31572,69,person,62,1,12548,19,173,472,231,529,58,57,person
31573,70,person,63,1,12548,24,140,476,196,557,56,81,person
31574,71,person,64,1,12548,18,366,476,414,531,48,55,person
31575,72,person,65,1,12548,15,978,432,1028,494,50,62,person
31576,9,car,10,0,12549,41,1064,745,1466,939,402,194,car
31577,12,car,13,1,12549,20,1643,1121,2198,1648,555,527,car
31578,13,car,14,1,12549,21,698,721,1028,942,330,221,car
31579,14,car,15,0,12549,45,385,796,1223,1369,838,573,car
31580,2,person,3,0,12550,22,2,1189,70,1389,68,200,person
31581,8,person,9,0,12550,34,143,1215,234,1440,91,225,person
31582,2,person,3,0,12553,17,8,1045,50,1127,42,82,person
31583,14,person,15,0,12553,43,1686,951,1824,1284,138,333,person
31584,15,person,16,1,12553,36,1973,986,2197,1648,224,662,person
31585,16,person,17,0,12553,22,1190,1005,1233,1137,43,132,person
31586,21,person,22,0,12553,15,632,1036,666,1106,34,70,person
31587,22,person,23,0,12553,17,194,1054,217,1118,23,64,person
31588,4,person,5,1,12555,15,1336,452,1406,586,70,134,person
31589,8,person,9,0,12555,46,358,568,631,1087,273,519,person
31590,9,person,10,0,12555,34,63,523,347,1136,284,613,person
31591,4,person,5,0,12556,28,71,1127,166,1280,95,153,person
31592,8,person,9,0,12556,21,899,1047,923,1118,24,71,person
31593,9,person,10,0,12556,15,979,1045,996,1108,17,63,person
31594,10,person,11,0,12556,17,1030,1039,1058,1103,28,64,person
31595,11,person,12,0,12556,16,1221,1071,1262,1118,41,47,person
31596,13,person,14,0,12556,16,1316,1066,1361,1116,45,50,person
31597,18,person,19,0,12556,18,494,1126,546,1243,52,117,person
31598,22,bench,23,0,12556,56,69,1305,696,1462,627,157,bench
31599,23,person,24,0,12556,50,202,1220,362,1494,160,274,person
31600,30,bench,31,0,12556,57,821,1232,1022,1395,201,163,bench
31601,36,bench,37,0,12556,21,1017,1174,1129,1275,112,101,bench
31602,43,bicycle,44,0,12556,50,1357,1103,1470,1181,113,78,bicycle
31603,44,person,45,0,12556,29,1823,1043,1892,1191,69,148,person
31604,6,person,7,0,12558,18,272,673,301,766,29,93,person
31605,8,person,9,0,12558,17,518,660,542,735,24,75,person
31606,15,person,16,1,12559,17,6,668,35,762,29,94,person
31607,16,person,17,0,12559,21,48,678,73,768,25,90,person
31608,17,car,18,1,12561,21,1389,776,1575,913,186,137,car
31609,0,boat,1,0,12563,19,1520,1213,1595,1254,75,41,boat
31610,2,car,3,0,12563,27,628,1042,670,1060,42,18,car
31611,3,car,4,0,12563,18,1134,1032,1153,1041,19,9,car
31612,4,boat,5,0,12563,37,1169,1015,1270,1061,101,46,boat
31613,5,boat,6,0,12563,29,1321,1018,1419,1059,98,41,boat
31614,6,person,7,0,12563,16,1535,1212,1552,1238,17,26,person
31615,33,car,34,1,12564,16,189,1098,333,1156,144,58,car
31616,39,motorbikes,40,0,12564,21,392,1104,491,1160,99,56,motorcycle
31617,44,car,45,0,12564,17,680,1093,805,1145,125,52,car
31618,45,car,46,0,12564,18,811,1078,955,1141,144,63,car
31619,47,person,48,0,12564,16,1233,1082,1272,1209,39,127,person
31620,51,person,52,1,12564,15,1175,1078,1205,1205,30,127,person
31621,52,person,53,0,12564,22,1201,1093,1229,1212,28,119,person
31622,63,person,64,0,12564,16,1847,1088,1888,1145,41,57,person
31623,67,person,68,0,12564,27,498,1080,528,1159,30,79,person
31624,68,person,69,0,12564,27,1516,1069,1546,1188,30,119,person
31625,69,person,70,0,12564,31,1410,1075,1454,1174,44,99,person
31626,71,person,72,0,12564,26,1590,1071,1623,1133,33,62,person
31627,72,person,73,0,12564,30,1475,1083,1514,1190,39,107,person
31628,73,person,74,0,12564,29,1451,1073,1477,1189,26,116,person
31629,12,car,13,1,12565,15,833,812,1071,932,238,120,car
31630,17,car,18,1,12565,25,2,799,462,1053,460,254,car
31631,20,car,21,1,12565,25,1941,803,2197,1054,256,251,car
31632,21,car,22,1,12565,16,2091,909,2200,1108,109,199,car
31633,0,person,1,0,12567,22,1403,823,1854,1597,451,774,person
31634,8,person,9,0,12567,26,2111,904,2179,1114,68,210,person
31635,9,person,10,0,12567,30,2027,916,2082,1116,55,200,person
31636,11,person,12,0,12567,25,1707,984,1766,1128,59,144,person
31637,12,car,13,1,12567,15,1938,996,2046,1107,108,111,car
31638,14,car,15,1,12567,17,958,951,1254,1116,296,165,car
31639,15,person,16,0,12567,49,850,891,970,1169,120,278,person
31640,16,person,17,0,12567,44,749,920,859,1175,110,255,person
31641,18,person,19,0,12567,30,79,928,144,1096,65,168,person
31642,26,car,27,1,12567,19,149,959,445,1060,296,101,car
31643,28,car,29,1,12567,16,317,962,499,1059,182,97,car
31644,30,car,31,1,12567,19,428,966,682,1073,254,107,car
31645,34,car,35,1,12567,21,636,944,779,1096,143,152,car
31646,35,car,36,1,12567,17,822,990,878,1118,56,128,car
31647,36,car,37,1,12567,18,1200,956,1409,1056,209,100,car
31648,37,car,38,1,12567,22,1249,967,1493,1090,244,123,car
31649,38,car,39,1,12567,16,1329,1016,1396,1101,67,85,car
31650,39,car,40,1,12567,28,1386,934,1611,1108,225,174,car
31651,40,car,41,1,12567,16,1681,931,1814,1055,133,124,car
31652,41,car,42,1,12567,23,1745,957,2003,1110,258,153,car
31653,42,car,43,1,12567,17,1921,966,2032,1104,111,138,car
31654,2,person,3,1,12569,16,3,3,712,666,709,663,person
31655,7,vase,8,0,12569,20,909,8,1513,697,604,689,vase
31656,9,plate,10,0,12569,18,3,692,1398,1516,1395,824,plate
31657,16,bottle,17,0,12569,19,1590,3,1790,661,200,658,bottle
31658,19,person,20,1,12569,36,1356,42,2041,630,685,588,person
31659,8,person,9,0,12570,35,742,1031,821,1270,79,239,person
31660,9,person,10,0,12570,28,819,1188,985,1369,166,181,person
31661,12,person,13,0,12570,27,497,1225,601,1342,104,117,person
31662,13,person,14,0,12570,23,550,1201,649,1342,99,141,person
31663,4,person,5,0,12571,16,1902,992,1929,1043,27,51,person
31664,10,pot,11,0,12572,19,532,1331,698,1419,166,88,potted plant
31665,15,person,16,0,12572,25,905,1066,947,1236,42,170,person
31666,4,car,5,0,12574,16,283,1186,461,1249,178,63,car
31667,5,car,6,0,12574,20,13,1175,254,1260,241,85,car
31668,5,table,6,0,12576,63,352,570,1459,1433,1107,863,dining table
31669,6,chair,7,0,12576,47,387,516,963,1456,576,940,chair
31670,7,chair,8,1,12576,41,26,404,436,1141,410,737,chair
31671,11,chair,12,1,12576,18,974,370,1209,642,235,272,chair
31672,12,chair,13,1,12576,37,1338,401,1633,1026,295,625,chair
31673,13,chair,14,0,12576,50,1290,605,1857,1522,567,917,chair
31674,20,bowl,21,0,12576,83,481,309,611,402,130,93,bowl
31675,12,door,13,0,12577,18,1515,877,1643,1095,128,218,door
31676,2,car,3,1,12578,16,344,1389,823,1650,479,261,car
31677,6,person,7,0,12579,33,515,867,579,1159,64,292,person
31678,7,person,8,0,12579,44,588,897,701,1169,113,272,person
31679,8,person,9,0,12579,26,943,893,1029,1066,86,173,person
31680,9,person,10,0,12579,32,1077,895,1147,1110,70,215,person
31681,10,person,11,0,12579,37,1201,891,1301,1153,100,262,person
31682,11,person,12,0,12579,32,1453,889,1532,1138,79,249,person
31683,12,person,13,0,12579,32,1554,882,1612,1135,58,253,person
31684,13,person,14,0,12579,34,1833,873,1883,1102,50,229,person
31685,14,person,15,0,12579,37,1928,876,1997,1104,69,228,person
31686,15,person,16,0,12579,26,1729,879,1786,1066,57,187,person
31687,16,person,17,0,12579,30,1794,889,1836,1059,42,170,person
31688,18,person,19,0,12579,31,110,882,166,1003,56,121,person
31689,19,person,20,0,12579,37,759,895,824,1088,65,193,person
31690,20,person,21,0,12579,35,830,887,879,1079,49,192,person
31691,21,person,22,0,12579,19,1011,808,1037,919,26,111,person
31692,24,person,25,0,12579,22,1057,864,1104,989,47,125,person
31693,25,person,26,1,12579,15,1076,802,1106,867,30,65,person
31694,26,person,27,1,12579,21,1051,803,1085,917,34,114,person
31695,30,person,31,1,12579,21,1775,871,1810,1015,35,144,person
31696,34,person,35,1,12579,30,1275,907,1335,1140,60,233,person
31697,35,person,36,1,12579,28,1161,907,1225,1149,64,242,person
31698,36,person,37,1,12579,25,678,877,731,1083,53,206,person
31699,38,person,39,0,12579,34,399,903,448,1063,49,160,person
31700,39,person,40,0,12579,28,186,864,227,1001,41,137,person
31701,40,person,41,1,12579,23,258,862,303,1011,45,149,person
31702,43,person,44,0,12579,26,442,865,489,1015,47,150,person
31703,44,person,45,1,12579,17,443,829,480,879,37,50,person
31704,45,person,46,0,12579,25,734,859,762,968,28,109,person
31705,46,person,47,1,12579,25,556,813,597,865,41,52,person
31706,48,person,49,1,12579,16,571,877,608,944,37,67,person
31707,50,person,51,1,12579,17,638,821,665,871,27,50,person
31708,56,person,57,1,12579,15,852,850,876,893,24,43,person
31709,57,person,58,1,12579,24,865,869,920,1062,55,193,person
31710,58,person,59,1,12579,21,1286,864,1332,960,46,96,person
31711,61,person,62,1,12579,21,1657,885,1692,1036,35,151,person
31712,63,person,64,1,12579,17,1595,874,1635,937,40,63,person
31713,64,person,65,1,12579,27,1623,906,1677,1102,54,196,person
31714,65,person,66,1,12579,21,1593,891,1654,1106,61,215,person
31715,66,person,67,0,12579,31,154,871,189,1003,35,132,person
31716,67,person,68,0,12579,25,21,893,53,978,32,85,person
31717,69,person,70,1,12579,22,295,888,327,1011,32,123,person
31718,70,person,71,0,12579,37,365,890,408,1024,43,134,person
31719,73,person,74,1,12579,19,801,831,832,890,31,59,person
31720,76,person,77,1,12579,23,761,852,788,925,27,73,person
31721,77,person,78,1,12579,26,578,898,632,1078,54,180,person
31722,79,person,80,1,12579,17,1352,806,1379,883,27,77,person
31723,80,person,81,1,12579,22,1333,823,1363,893,30,70,person
31724,82,person,83,1,12579,16,1454,869,1485,926,31,57,person
31725,83,person,84,1,12579,30,1419,890,1472,1120,53,230,person
31726,84,person,85,1,12579,30,1322,871,1369,1094,47,223,person
31727,85,person,86,1,12579,23,1350,880,1392,1097,42,217,person
31728,86,person,87,1,12579,17,1518,862,1559,939,41,77,person
31729,87,person,88,1,12579,20,1531,910,1576,1098,45,188,person
31730,89,person,90,1,12579,20,1167,870,1213,956,46,86,person
31731,90,person,91,1,12579,23,1136,864,1183,993,47,129,person
31732,7,car,8,1,12582,20,809,1080,906,1118,97,38,car
31733,21,car,22,0,12582,19,879,1084,1012,1138,133,54,car
31734,24,car,25,1,12582,20,1064,1093,1131,1133,67,40,car
31735,31,car,32,1,12582,15,666,1075,758,1119,92,44,car
31736,0,person,1,0,12583,34,622,1415,941,2051,319,636,person
31737,6,person,7,0,12583,26,979,1496,1077,1658,98,162,person
31738,7,person,8,0,12583,21,1072,1470,1174,1620,102,150,person
31739,9,person,10,0,12583,30,255,1465,337,1743,82,278,person
31740,10,person,11,0,12583,36,322,1450,420,1738,98,288,person
31741,12,person,13,0,12583,29,127,1445,189,1632,62,187,person
31742,14,person,15,0,12583,20,475,1450,535,1603,60,153,person
31743,18,person,19,0,12583,24,5,1413,87,1676,82,263,person
31744,24,person,25,0,12583,20,539,1505,600,1607,61,102,person
31745,26,person,27,0,12583,19,590,1454,664,1630,74,176,person
31746,8,umbrella,9,1,12586,17,7,804,626,1322,619,518,umbrella
31747,10,chair,11,0,12586,21,570,1204,735,1390,165,186,chair
31748,11,person,12,0,12586,31,655,1137,768,1386,113,249,person
31749,12,chair,13,0,12586,19,932,1232,1057,1397,125,165,chair
31750,13,person,14,0,12586,42,878,1128,1010,1395,132,267,person
31751,14,chair,15,0,12586,22,1121,1249,1258,1397,137,148,chair
31752,15,chair,16,0,12586,19,1251,1234,1362,1381,111,147,chair
31753,17,chair,18,0,12586,17,1423,1234,1565,1388,142,154,chair
31754,18,person,19,1,12586,15,991,1136,1064,1218,73,82,person
31755,19,person,20,1,12586,15,1045,1126,1092,1222,47,96,person
31756,20,person,21,1,12586,15,1330,1068,1399,1201,69,133,person
31757,23,chair,24,0,12586,16,302,1203,406,1344,104,141,chair
31758,24,person,25,1,12586,26,363,1110,452,1222,89,112,person
31759,25,person,26,1,12586,19,506,1114,598,1226,92,112,person
31760,26,table,27,1,12586,17,381,1197,575,1265,194,68,dining table
31761,27,person,28,1,12586,20,427,1101,514,1198,87,97,person
31762,36,person,37,1,12586,21,258,1028,333,1170,75,142,person
31763,46,person,47,1,12586,16,1215,1128,1272,1206,57,78,person
31764,47,chair,48,0,12586,15,1805,1232,1895,1367,90,135,chair
31765,3,traffic light,4,0,12588,67,652,12,1536,2042,884,2030,traffic light
31766,21,car,18,0,12589,18,1957,809,2057,846,100,37,car
31767,22,car,19,0,12589,23,1782,816,1876,850,94,34,car
31768,23,car,20,0,12589,20,1157,853,1249,898,92,45,car
31769,24,car,21,0,12589,22,1327,841,1393,880,66,39,car
31770,24,chair,25,0,12591,15,589,506,687,749,98,243,chair
31771,29,bench,30,0,12591,22,259,359,1023,543,764,184,bench
31772,40,table,41,1,12591,22,418,468,1020,603,602,135,dining table
31773,29,person,30,0,12593,17,322,667,384,776,62,109,person
31774,51,person,51,0,12593,26,982,662,1044,767,62,105,person
31775,14,person,15,0,12595,20,1628,516,1669,617,41,101,person
31776,13,person,14,0,12596,38,7,1961,60,2098,53,137,person
31777,15,person,16,0,12596,32,120,1935,161,2083,41,148,person
31778,16,person,17,1,12596,28,154,1933,215,2025,61,92,person
31779,17,person,18,0,12596,40,223,1943,283,2088,60,145,person
31780,18,person,19,0,12596,47,283,1933,344,2125,61,192,person
31781,19,person,20,0,12596,38,446,1934,503,2095,57,161,person
31782,20,person,21,0,12596,40,620,1944,679,2095,59,151,person
31783,21,person,22,1,12596,35,757,1910,792,2084,35,174,person
31784,22,person,23,0,12596,32,708,1941,765,2089,57,148,person
31785,23,car,24,1,12596,37,876,1941,1362,2136,486,195,car
31786,24,bicycle,25,0,12596,64,879,2022,1049,2172,170,150,bicycle
31787,25,person,26,0,12596,51,888,1934,1018,2136,130,202,person
31788,32,window,33,0,12596,15,1300,1651,1367,1809,67,158,window
31789,5,person,6,1,12599,29,1426,775,1548,967,122,192,person
31790,6,person,7,0,12599,59,1105,868,1253,1272,148,404,person
31791,8,person,9,0,12599,50,1657,855,1814,1373,157,518,person
31792,10,person,11,1,12599,15,1567,1138,1682,1294,115,156,person
31793,11,person,12,1,12599,29,1344,961,1468,1183,124,222,person
31794,12,person,13,1,12599,44,1408,954,1569,1311,161,357,person
31795,19,person,20,1,12599,23,672,971,738,1173,66,202,person
31796,20,person,21,1,12599,18,550,971,627,1055,77,84,person
31797,21,person,22,1,12599,17,818,965,892,1070,74,105,person
31798,23,person,24,1,12599,25,499,983,620,1202,121,219,person
31799,26,person,27,1,12599,44,97,851,225,1476,128,625,person
31800,27,person,28,1,12599,46,4,932,190,1534,186,602,person
31801,32,person,33,1,12599,26,897,946,989,1210,92,264,person
31802,33,person,34,0,12599,28,711,963,837,1235,126,272,person
31803,34,bicycle,32,0,12600,35,1178,1026,1278,1105,100,79,bicycle
31804,40,bicycle,38,1,12600,16,1897,1009,1936,1032,39,23,bicycle
31805,26,person,23,0,12601,23,774,1149,800,1247,26,98,person
31806,27,person,24,0,12601,24,970,1158,1012,1304,42,146,person
31807,28,person,25,0,12601,36,1759,1132,1832,1350,73,218,person
31808,29,car,26,1,12601,33,1192,1165,1662,1301,470,136,car
31809,6,person,7,0,12602,21,834,797,934,1027,100,230,person
31810,8,person,9,0,12602,16,1075,790,1109,929,34,139,person
31811,22,person,23,0,12602,22,1229,778,1285,978,56,200,person
31812,23,person,24,0,12602,15,1965,758,2013,981,48,223,person
31813,4,car,5,0,12603,26,1377,1161,1589,1332,212,171,car
31814,7,car,8,0,12603,24,1628,1094,1885,1337,257,243,car
31815,9,person,10,0,12603,63,791,1065,908,1377,117,312,person
31816,26,window,27,0,12603,18,1667,1101,1854,1189,187,88,window
31817,33,car,34,1,12603,19,1895,1084,1971,1322,76,238,car
31818,20,car,21,1,12609,23,4,1125,635,1615,631,490,car
31819,21,car,22,1,12609,24,553,1016,1441,1441,888,425,car
31820,5,person,6,0,12610,15,705,1071,747,1176,42,105,person
31821,6,person,7,0,12610,16,742,1074,783,1177,41,103,person
31822,0,chair,1,0,12614,58,80,170,848,1536,768,1366,chair
31823,5,motorbike,6,1,12615,35,919,602,1150,799,231,197,motorcycle
31824,40,car,39,0,12616,16,904,1004,932,1020,28,16,car
31825,24,person,20,0,12617,58,425,1548,595,1900,170,352,person
31826,25,person,21,1,12617,33,669,1543,753,1801,84,258,person
31827,26,person,22,0,12617,46,716,1570,816,1846,100,276,person
31828,27,person,23,1,12617,45,553,1555,652,1851,99,296,person
31829,0,person,1,0,12618,21,1274,605,1539,1529,265,924,person
31830,1,person,2,0,12618,35,1726,647,2192,1634,466,987,person
31831,12,person,13,1,12618,33,1732,794,1870,1331,138,537,person
31832,13,person,14,0,12618,25,727,834,814,1104,87,270,person
31833,14,person,15,0,12618,27,811,852,904,1099,93,247,person
31834,7,boat,8,0,12620,19,2000,442,2190,491,190,49,boat
31835,31,car,29,1,12620,18,817,1078,950,1170,133,92,car
31836,32,car,30,1,12620,18,905,1013,1005,1093,100,80,car
31837,33,car,31,1,12620,15,997,948,1069,1028,72,80,car
31838,5,car,6,0,12622,25,365,1123,666,1242,301,119,car
31839,4,chair,4,0,12623,35,388,666,977,1439,589,773,chair
31840,13,table,13,0,12623,36,323,554,1430,1244,1107,690,dining table
31841,0,table,1,0,12624,19,2,265,300,474,298,209,dining table
31842,3,person,4,0,12627,19,100,1433,169,1614,69,181,person
31843,4,person,5,0,12627,19,330,1556,369,1787,39,231,person
31844,5,person,6,0,12627,15,407,1464,465,1625,58,161,person
31845,6,person,7,0,12627,20,461,1533,576,1679,115,146,person
31846,7,person,8,0,12627,22,695,1433,780,1660,85,227,person
31847,8,person,9,0,12627,21,772,1410,826,1652,54,242,person
31848,15,chair,16,1,12629,22,223,326,348,503,125,177,chair
31849,15,bicycle,16,1,12634,38,308,865,461,1064,153,199,bicycle
31850,26,person,22,0,12635,48,1331,626,1568,1186,237,560,person
31851,27,person,23,0,12635,87,1411,649,1986,1644,575,995,person
31852,28,backpack,24,0,12635,36,1581,795,1829,1219,248,424,backpack
31853,29,person,25,0,12635,52,433,664,592,1139,159,475,person
31854,30,person,26,0,12635,53,714,639,918,1142,204,503,person
31855,32,person,28,1,12635,23,1538,698,1605,841,67,143,person
31856,34,skis,30,0,12635,21,1641,314,1831,831,190,517,skis
31857,8,table,9,1,12636,25,122,348,381,532,259,184,dining table
31858,15,person,16,0,12637,15,610,798,647,898,37,100,person
31859,2,book,3,0,12638,19,72,38,613,457,541,419,book
31860,0,person,1,0,12639,32,695,765,827,1131,132,366,person
31861,1,person,2,0,12639,50,810,768,911,1124,101,356,person
31862,20,car,21,1,12639,20,1674,848,1798,938,124,90,car
31863,21,car,22,1,12639,18,1556,845,1695,925,139,80,car
31864,22,car,23,1,12639,16,1356,833,1459,897,103,64,car
31865,23,car,24,1,12639,18,1434,837,1569,910,135,73,car
31866,24,car,25,1,12639,16,1283,818,1403,890,120,72,car
31867,25,car,26,1,12639,16,1221,822,1296,882,75,60,car
31868,27,chair,22,0,12640,30,1803,828,1956,1056,153,228,chair
31869,28,chair,23,0,12640,22,2071,803,2194,980,123,177,chair
31870,29,chair,24,0,12640,37,1946,801,2091,990,145,189,chair
31871,30,chair,25,0,12640,32,1636,838,1803,1050,167,212,chair
31872,31,chair,26,0,12640,46,1477,836,1641,1051,164,215,chair
31873,32,chair,27,0,12640,47,1303,836,1471,1062,168,226,chair
31874,33,chair,28,1,12640,30,908,854,1099,1089,191,235,chair
31875,34,chair,29,0,12640,41,198,940,456,1347,258,407,chair
31876,35,table,30,1,12640,34,311,1132,1652,1646,1341,514,dining table
31877,36,chair,31,1,12640,37,569,1075,1062,1633,493,558,chair
31878,37,chair,32,1,12640,22,872,1142,1430,1645,558,503,chair
31879,5,person,6,0,12642,55,513,468,769,805,256,337,person
31880,7,person,8,0,12642,36,1107,462,1263,796,156,334,person
31881,0,car,1,0,12643,26,661,789,1267,1254,606,465,car
31882,1,car,2,0,12643,23,1379,825,1732,1091,353,266,car
31883,10,person,11,0,12644,24,31,1133,172,1322,141,189,person
31884,3,car,4,0,12645,17,821,1017,975,1090,154,73,car
31885,5,bicycle,6,0,12647,18,328,1236,536,1401,208,165,bicycle
31886,21,person,19,0,12648,21,902,1159,920,1225,18,66,person
31887,22,person,20,0,12648,23,868,1156,887,1215,19,59,person
31888,23,person,21,0,12648,20,847,1162,864,1218,17,56,person
31889,24,person,22,0,12648,23,823,1155,844,1220,21,65,person
31890,25,person,23,0,12648,39,1050,1156,1101,1317,51,161,person
31891,30,person,28,0,12648,18,576,1166,598,1226,22,60,person
31892,31,person,29,0,12648,19,709,1157,727,1217,18,60,person
31893,25,person,26,1,12649,28,398,1901,477,2095,79,194,person
31894,26,person,27,1,12649,25,460,1969,522,2161,62,192,person
31895,27,person,28,1,12649,23,501,2046,573,2199,72,153,person
31896,28,person,29,0,12649,20,1436,1391,1468,1502,32,111,person
31897,29,person,30,0,12649,17,1466,1394,1501,1526,35,132,person
31898,10,person,11,0,12653,27,1209,1227,1309,1487,100,260,person
31899,18,vase,19,1,12653,22,1973,794,2199,1317,226,523,vase
31900,0,person,1,0,12657,24,1080,847,1181,1092,101,245,person
31901,5,person,6,0,12657,26,243,875,280,984,37,109,person
31902,6,person,7,0,12657,25,280,893,316,986,36,93,person
31903,8,person,9,0,12657,25,342,893,362,971,20,78,person
31904,9,person,10,0,12657,21,165,883,189,958,24,75,person
31905,13,person,14,0,12657,26,753,876,813,1015,60,139,person
31906,28,traffic light,18,0,12658,18,611,452,675,506,64,54,traffic light
31907,0,person,1,0,12659,28,711,246,763,397,52,151,person
31908,1,person,2,0,12659,27,510,176,559,344,49,168,person
31909,2,person,3,0,12659,32,361,242,415,388,54,146,person
31910,3,person,4,0,12659,41,400,95,447,247,47,152,person
31911,4,person,5,0,12659,39,238,48,304,205,66,157,person
31912,5,person,6,0,12659,38,290,12,334,154,44,142,person
31913,11,car,12,1,12660,17,2,779,126,961,124,182,car
31914,8,car,9,0,12663,44,441,695,1812,1301,1371,606,car
31915,9,chair,10,0,12666,16,344,223,454,386,110,163,chair
31916,10,chair,11,0,12666,32,441,245,571,423,130,178,chair
31917,23,chair,24,0,12668,16,580,703,674,812,94,109,chair
31918,6,person,7,1,12669,25,195,674,289,1272,94,598,person
31919,18,person,19,0,12671,29,304,1090,418,1382,114,292,person
31920,19,person,20,1,12671,20,2,1177,259,1529,257,352,person
31921,13,boat,6,0,12672,18,471,554,519,579,48,25,boat
31922,17,person,10,0,12672,15,1271,760,1281,793,10,33,person
31923,21,person,14,1,12672,15,859,800,879,833,20,33,person
31924,23,person,16,0,12672,20,462,847,511,868,49,21,person
31925,24,person,17,0,12672,18,467,858,514,869,47,11,person
31926,67,boat,60,0,12672,38,2,1353,379,1451,377,98,boat
31927,68,person,61,1,12672,19,248,1366,289,1411,41,45,person
31928,70,person,63,1,12672,28,169,1336,223,1399,54,63,person
31929,71,person,64,1,12672,25,103,1298,155,1395,52,97,person
31930,72,person,65,1,12672,24,46,1344,95,1393,49,49,person
31931,20,table,21,1,12673,16,1870,1100,2046,1226,176,126,dining table
31932,1,person,2,0,12674,23,813,478,1020,1413,207,935,person
31933,8,person,7,0,12674,54,994,493,1220,1177,226,684,person
31934,31,mirror,28,0,12674,57,1331,160,1593,657,262,497,mirror
31935,36,chair,33,1,12674,39,42,991,870,1649,828,658,chair
31936,2,bicycle,3,0,12677,27,302,597,420,689,118,92,bicycle
31937,4,bicycle,5,0,12677,16,377,608,481,676,104,68,bicycle
31938,8,bench,9,0,12679,22,883,1035,1011,1105,128,70,bench
31939,1,window,2,0,12681,25,344,406,408,674,64,268,window
31940,10,person,10,0,12685,46,433,1012,516,1285,83,273,person
31941,11,person,11,0,12685,43,301,1012,399,1281,98,269,person
31942,15,car,15,0,12685,20,62,1052,196,1113,134,61,car
31943,0,table,1,0,12686,51,300,942,1054,1643,754,701,dining table
31944,14,chair,15,1,12686,106,684,843,1056,1551,372,708,chair
31945,15,chair,16,1,12686,108,209,880,640,1618,431,738,chair
31946,16,chair,17,1,12686,124,1324,933,1789,1646,465,713,chair
31947,17,table,18,1,12686,56,1288,1069,2192,1647,904,578,dining table
31948,12,dog,13,0,12687,31,413,1124,689,1232,276,108,dog
31949,17,person,18,0,12688,26,1280,942,1372,1093,92,151,person
31950,26,bicycle,27,0,12688,70,1445,1215,1647,1357,202,142,bicycle
31951,27,car,28,1,12688,26,1638,1146,2197,1391,559,245,car
31952,30,car,31,0,12688,33,287,1196,1143,1506,856,310,car
31953,17,person,18,0,12689,32,1720,834,1757,998,37,164,person
31954,18,person,19,0,12689,31,1633,828,1693,989,60,161,person
31955,27,person,25,0,12692,21,381,842,405,892,24,50,person
31956,28,person,26,0,12692,21,405,842,424,892,19,50,person
31957,14,dog,15,0,12693,88,435,305,1448,1199,1013,894,dog
31958,52,traffic light,41,0,12694,30,1005,598,1083,722,78,124,traffic light
31959,55,car,44,1,12694,15,1076,665,1137,691,61,26,car
31960,56,window,45,0,12694,20,1551,245,1605,336,54,91,window
31961,4,bench,5,0,12695,17,1124,864,1441,1082,317,218,bench
31962,7,person,8,0,12695,16,1332,699,1385,867,53,168,person
31963,9,person,10,0,12695,15,1366,755,1444,868,78,113,person
31964,9,person,10,1,12696,19,777,764,833,905,56,141,person
31965,10,person,11,0,12696,24,791,772,893,944,102,172,person
31966,11,person,12,0,12696,21,614,821,641,934,27,113,person
31967,0,person,1,0,12698,21,1323,715,1453,1250,130,535,person
31968,7,person,8,0,12698,40,7,797,182,1064,175,267,person
31969,13,person,14,0,12698,42,1520,766,1655,1131,135,365,person
31970,14,person,15,1,12698,33,1884,794,1986,1052,102,258,person
31971,16,person,17,0,12698,25,1958,953,2034,1076,76,123,person
31972,18,person,19,0,12698,37,1225,778,1322,1052,97,274,person
31973,37,person,38,0,12698,35,1721,725,1843,1141,122,416,person
31974,6,person,7,0,12700,20,879,878,919,1013,40,135,person
31975,10,car,11,1,12700,17,572,879,785,1060,213,181,car
31976,11,car,12,1,12700,25,431,873,722,1120,291,247,car
31977,12,car,13,1,12700,31,4,796,525,1307,521,511,car
31978,13,car,14,0,12702,31,521,938,1052,1200,531,262,car
31979,0,sofa,1,0,12706,18,602,738,1520,1528,918,790,couch
31980,0,bottle,1,0,12708,56,1028,445,1351,1379,323,934,bottle
31981,1,bottle,2,0,12708,33,358,427,615,1167,257,740,bottle
31982,2,bottle,3,0,12708,33,754,330,969,997,215,667,bottle
31983,4,bottle,5,0,12708,24,1417,420,1664,1119,247,699,bottle
31984,7,table,8,0,12708,24,254,729,2199,1643,1945,914,dining table
31985,9,person,10,0,12708,21,1911,7,2091,480,180,473,person
31986,11,bottle,12,0,12708,32,1263,317,1409,808,146,491,bottle
31987,12,bottle,13,0,12708,24,1052,401,1195,673,143,272,bottle
31988,19,traffic light,20,0,12709,48,278,386,1569,1215,1291,829,traffic light
31989,2,person,3,0,12712,80,1285,140,1672,1537,387,1397,person
31990,9,person,10,1,12712,34,495,109,773,447,278,338,person
31991,10,person,11,1,12712,46,387,575,754,1462,367,887,person
31992,11,person,12,1,12712,19,524,164,747,449,223,285,person
31993,12,person,13,0,12712,38,36,428,227,776,191,348,person
31994,13,person,14,0,12712,47,1677,275,1856,764,179,489,person
31995,14,person,15,1,12712,25,1885,278,2049,969,164,691,person
31996,17,person,18,1,12712,17,1631,447,1723,923,92,476,person
31997,2,chair,3,0,12713,34,225,951,419,1246,194,295,chair
31998,3,chair,4,0,12713,35,472,979,655,1277,183,298,chair
31999,4,table,5,0,12713,22,309,994,565,1241,256,247,dining table
32000,0,bottle,1,0,12714,40,1647,247,1918,1201,271,954,bottle
32001,5,plate,6,0,12714,19,407,446,760,582,353,136,plate
32002,7,chair,8,0,12714,41,1194,263,2007,711,813,448,chair
32003,0,car,1,0,12715,24,870,1106,1192,1336,322,230,car
32004,1,car,2,0,12715,18,1392,1030,1844,1255,452,225,car
32005,2,car,3,0,12715,45,1223,1046,1421,1190,198,144,car
32006,22,car,18,0,12716,23,631,1196,702,1240,71,44,car
32007,29,car,25,0,12716,28,49,1207,142,1289,93,82,car
32008,0,person,1,0,12718,47,1241,981,1454,1338,213,357,person
32009,19,skis,19,0,12718,25,706,1019,863,1220,157,201,skis
32010,26,person,26,0,12718,25,323,1033,368,1156,45,123,person
32011,27,person,27,0,12718,22,371,1039,418,1159,47,120,person
32012,28,person,28,0,12718,19,406,1090,440,1169,34,79,person
32013,29,person,29,0,12718,20,210,1031,250,1136,40,105,person
32014,40,person,40,0,12718,50,533,1002,630,1266,97,264,person
32015,43,person,43,0,12718,41,485,996,558,1224,73,228,person
32016,15,car,16,1,12721,15,267,1585,516,1731,249,146,car
32017,25,car,26,1,12721,20,1130,1965,1501,2174,371,209,car
32018,28,car,29,0,12721,21,205,1792,560,1988,355,196,car
32019,29,car,30,1,12721,15,3,1741,196,1907,193,166,car
32020,2,chair,3,0,12722,16,497,1151,999,1573,502,422,chair
32021,10,person,11,0,12722,26,1922,940,2199,1313,277,373,person
32022,4,bench,5,0,12723,22,830,916,1073,1026,243,110,bench
32023,5,person,6,0,12723,29,897,891,968,1028,71,137,person
32024,6,car,7,0,12723,25,470,824,652,933,182,109,car
32025,9,person,10,1,12723,21,59,819,95,975,36,156,person
32026,26,door,27,0,12723,15,865,743,971,922,106,179,door
32027,29,bench,30,1,12723,84,2,1155,718,1534,716,379,bench
32028,12,person,13,0,12724,18,2,8,703,999,701,991,person
32029,6,person,7,0,12728,20,688,933,708,1002,20,69,person
32030,12,person,13,0,12728,16,1172,976,1206,1071,34,95,person
32031,18,bicycle,19,0,12728,38,1017,1024,1073,1092,56,68,bicycle
32032,19,bicycle,20,0,12728,42,1098,1025,1159,1095,61,70,bicycle
32033,22,bicycle,23,0,12728,26,934,1028,991,1070,57,42,bicycle
32034,23,person,24,0,12728,33,565,961,635,1116,70,155,person
32035,20,traffic light,19,0,12729,29,276,750,481,995,205,245,traffic light
32036,8,table,9,1,12730,19,104,272,388,509,284,237,dining table
32037,10,chair,11,0,12730,20,81,272,249,511,168,239,chair
32038,11,chair,12,0,12730,25,223,291,423,512,200,221,chair
32039,6,car,7,0,12731,15,1137,1092,1214,1121,77,29,car
32040,4,chair,5,1,12732,23,1495,811,1921,1287,426,476,chair
32041,11,vase,11,0,12732,30,885,914,1230,1379,345,465,vase
32042,12,plate,12,0,12732,16,522,1315,820,1472,298,157,plate
32043,16,window,17,0,12733,30,1556,683,1617,769,61,86,window
32044,0,person,1,0,12736,39,1698,292,1858,638,160,346,person
32045,4,person,5,0,12736,20,525,311,582,500,57,189,person
32046,5,person,6,0,12736,20,646,319,709,506,63,187,person
32047,9,person,10,0,12736,19,1291,358,1326,438,35,80,person
32048,10,person,11,0,12736,25,1320,322,1375,476,55,154,person
32049,12,car,13,1,12736,17,2037,250,2200,500,163,250,car
32050,0,person,1,1,12737,21,746,519,1060,696,314,177,person
32051,16,person,17,1,12737,30,730,498,921,703,191,205,person
32052,2,person,3,0,12739,18,1257,1181,1347,1293,90,112,person
32053,13,person,14,0,12740,27,961,917,1018,1062,57,145,person
32054,6,person,7,0,12743,47,64,1492,191,1840,127,348,person
32055,7,person,8,0,12743,42,610,1476,706,1774,96,298,person
32056,8,person,9,0,12743,38,717,1492,801,1783,84,291,person
32057,9,person,10,0,12743,52,777,1492,903,1798,126,306,person
32058,10,person,11,0,12743,31,1194,1476,1276,1778,82,302,person
32059,11,person,12,0,12743,40,992,1483,1157,1809,165,326,person
32060,12,person,13,0,12743,48,1316,1467,1427,1785,111,318,person
32061,13,person,14,0,12743,36,1114,1465,1201,1778,87,313,person
32062,14,person,15,0,12743,32,400,1483,477,1756,77,273,person
32063,15,person,16,1,12743,36,160,1485,253,1802,93,317,person
32064,16,person,17,0,12743,33,324,1465,404,1771,80,306,person
32065,17,person,18,0,12743,34,4,1485,80,1842,76,357,person
32066,18,person,19,1,12743,24,1405,1478,1476,1767,71,289,person
32067,19,person,20,1,12743,33,872,1461,970,1771,98,310,person
32068,3,window,3,0,12746,39,300,379,361,448,61,69,window
32069,5,clock,4,0,12746,23,328,36,357,94,29,58,clock
32070,6,backpack,5,0,12746,19,41,937,175,1073,134,136,backpack
32071,13,person,12,0,12746,45,0,741,219,1069,219,328,person
32072,7,bench,8,0,12747,16,843,802,944,849,101,47,bench
32073,9,car,10,0,12747,20,338,750,460,810,122,60,car
32074,9,table,10,0,12749,17,1472,812,1886,1535,414,723,dining table
32075,0,person,1,0,12751,70,1214,399,1523,1390,309,991,person
32076,2,person,3,0,12751,58,526,356,734,964,208,608,person
32077,4,person,4,1,12751,42,1028,382,1146,892,118,510,person
32078,5,person,5,0,12751,55,937,413,1062,951,125,538,person
32079,10,person,10,1,12751,49,1137,372,1311,949,174,577,person
32080,11,person,11,0,12751,34,1637,455,1722,709,85,254,person
32081,8,person,9,0,12754,20,270,771,341,1006,71,235,person
32082,9,person,10,0,12754,22,217,771,281,984,64,213,person
32083,10,chair,11,0,12754,21,427,887,517,988,90,101,chair
32084,42,car,43,0,12755,15,1181,1129,1254,1196,73,67,car
32085,43,car,44,0,12755,19,970,1134,1144,1264,174,130,car
32086,46,car,47,0,12755,28,401,1133,705,1332,304,199,car
32087,15,person,16,1,12757,17,1026,330,1109,431,83,101,person
32088,19,person,20,1,12757,15,1365,303,1428,443,63,140,person
32089,4,door,5,0,12760,56,718,616,1162,1484,444,868,door
32090,5,door,6,0,12760,53,1225,667,1556,1469,331,802,door
32091,4,car,5,1,12761,16,351,510,480,623,129,113,car
32092,4,table,5,0,12762,22,351,874,1188,1647,837,773,dining table
32093,6,chair,7,0,12762,33,460,922,1045,1636,585,714,chair
32094,7,chair,8,1,12762,15,676,710,1007,865,331,155,chair
32095,8,chair,9,1,12762,17,1129,807,1338,1518,209,711,chair
32096,10,person,11,0,12763,42,1096,788,1147,924,51,136,person
32097,11,person,12,0,12763,36,1138,775,1193,925,55,150,person
32098,13,bench,14,1,12763,18,1683,848,1816,945,133,97,bench
32099,14,person,15,1,12763,19,1985,804,2015,865,30,61,person
32100,15,bench,16,1,12763,15,1977,866,2046,986,69,120,bench
32101,16,person,17,0,12763,45,1898,803,1999,1017,101,214,person
32102,17,person,18,0,12763,39,1873,783,1954,1004,81,221,person
32103,18,person,19,0,12763,51,1801,761,1898,1004,97,243,person
32104,20,vase,21,0,12763,20,1656,757,1695,807,39,50,vase
32105,22,window,23,0,12763,17,1863,395,2010,661,147,266,window
32106,24,person,25,1,12763,18,1711,805,1741,854,30,49,person
32107,29,vase,30,0,12763,20,1537,762,1566,804,29,42,vase
32108,32,person,33,0,12763,22,1476,793,1498,890,22,97,person
32109,33,person,34,1,12763,22,1496,817,1521,890,25,73,person
32110,35,person,36,0,12763,24,1206,798,1256,840,50,42,person
32111,48,bench,49,0,12763,25,2,905,350,1280,348,375,bench
32112,50,vase,51,0,12763,22,194,655,295,779,101,124,vase
32113,57,vase,58,0,12763,17,396,686,468,785,72,99,vase
32114,64,vase,65,0,12763,16,588,724,631,776,43,52,vase
32115,76,person,76,0,12763,15,1009,780,1025,825,16,45,person
32116,0,car,1,0,12764,23,711,1072,1255,1478,544,406,car
32117,27,door,27,0,12766,15,1651,1029,1829,1326,178,297,door
32118,3,person,3,1,12767,44,184,108,403,420,219,312,person
32119,13,boat,14,0,12768,25,127,596,321,841,194,245,boat
32120,6,sofa,7,1,12769,20,333,145,485,261,152,116,couch
32121,8,table,9,1,12769,19,395,167,481,286,86,119,dining table
32122,4,person,5,1,12770,17,1633,1318,1678,1388,45,70,person
32123,48,football,46,0,12771,30,730,518,866,596,136,78,sports ball
32124,51,basketball,49,0,12771,16,939,513,1022,556,83,43,sports ball
32125,0,bicycle,1,0,12772,40,322,743,715,972,393,229,bicycle
32126,1,car,2,0,12772,27,5,1005,904,1399,899,394,car
32127,8,window,9,0,12772,17,1305,389,1423,519,118,130,window
32128,9,window,10,0,12772,18,1020,387,1145,519,125,132,window
32129,11,window,12,0,12772,17,1305,70,1409,186,104,116,window
32130,12,window,13,0,12772,17,1022,70,1133,191,111,121,window
32131,17,bicycle,18,1,12772,35,838,1015,940,1087,102,72,bicycle
32132,23,door,24,0,12772,21,122,1027,429,1331,307,304,door
32133,24,door,25,0,12772,23,367,1027,622,1327,255,300,door
32134,16,car,17,1,12778,23,1156,1070,1401,1246,245,176,car
32135,17,car,18,0,12778,32,775,1100,1204,1327,429,227,car
32136,1,person,2,0,12779,24,1417,754,1504,1059,87,305,person
32137,23,person,24,1,12779,18,1055,796,1092,903,37,107,person
32138,24,person,25,1,12779,17,1200,773,1237,882,37,109,person
32139,35,person,36,0,12779,32,1081,799,1120,899,39,100,person
32140,0,bus,1,0,12781,36,363,628,1506,1461,1143,833,bus
32141,11,car,12,1,12781,19,1358,895,2200,1648,842,753,car
32142,16,person,14,0,12782,24,1882,834,1925,949,43,115,person
32143,3,person,4,0,12786,16,2,938,42,1045,40,107,person
32144,4,car,5,0,12786,22,33,957,216,1043,183,86,car
32145,5,car,6,1,12786,15,201,959,304,1039,103,80,car
32146,24,car,25,1,12786,22,1927,1192,2168,1334,241,142,car
32147,25,car,26,0,12786,27,1569,1159,1952,1324,383,165,car
32148,14,chair,15,0,12787,21,791,435,988,584,197,149,chair
32149,25,chair,26,0,12787,18,251,500,451,765,200,265,chair
32150,33,chair,34,0,12787,18,593,413,696,625,103,212,chair
32151,34,chair,35,0,12787,34,431,456,620,712,189,256,chair
32152,35,chair,36,0,12787,22,294,445,447,645,153,200,chair
32153,43,chair,44,0,12787,16,174,401,285,534,111,133,chair
32154,44,chair,45,0,12787,15,21,429,183,542,162,113,chair
32155,2,chair,3,0,12788,20,1089,517,1928,1547,839,1030,chair
32156,8,backpack,9,0,12788,15,1835,1024,2197,1421,362,397,backpack
32157,20,chair,19,1,12788,23,1078,205,1688,822,610,617,chair
32158,21,chair,20,1,12788,41,373,225,832,898,459,673,chair
32159,22,chair,21,1,12788,42,386,338,1081,1350,695,1012,chair
32160,0,person,1,0,12791,34,1682,807,2046,1532,364,725,person
32161,4,window,4,0,12791,28,1237,171,2033,1369,796,1198,window
32162,0,chair,1,0,12792,79,947,944,1413,1490,466,546,chair
32163,1,chair,2,1,12792,28,1238,796,1499,1114,261,318,chair
32164,2,table,3,1,12792,25,969,900,1521,1086,552,186,dining table
32165,3,chair,4,0,12792,75,317,982,807,1572,490,590,chair
32166,5,chair,6,0,12792,76,51,869,438,1350,387,481,chair
32167,4,sofa,5,0,12799,23,24,467,1118,1295,1094,828,couch
32168,8,table,8,0,12799,17,3,760,177,1271,174,511,dining table
32169,19,car,20,0,12800,17,63,1185,235,1315,172,130,car
32170,5,car,6,0,12802,15,1185,1745,1370,1824,185,79,car
32171,8,car,9,0,12802,15,850,1743,1064,1822,214,79,car
32172,26,person,27,0,12802,18,581,1766,626,1875,45,109,person
32173,27,person,28,0,12802,17,804,1831,861,1907,57,76,person
32174,28,person,29,1,12802,15,831,1779,865,1875,34,96,person
32175,6,bus,7,1,12806,19,21,93,100,180,79,87,bus
32176,14,window,14,0,12811,36,666,875,1290,1857,624,982,window
32177,23,person,23,1,12813,22,925,1226,955,1327,30,101,person
32178,12,person,10,0,12814,30,306,311,328,381,22,70,person
32179,4,bench,5,0,12816,15,478,852,1100,911,622,59,bench
32180,3,person,4,0,12817,21,448,1003,492,1097,44,94,person
32181,4,person,5,0,12817,35,205,978,331,1303,126,325,person
32182,7,window,8,0,12818,15,945,1097,996,1178,51,81,window
32183,18,window,19,0,12818,16,1337,1354,1423,1439,86,85,window
32184,0,bird,1,0,12819,45,429,32,605,209,176,177,bird
32185,1,bird,2,0,12819,33,278,205,455,415,177,210,bird
32186,2,bird,3,0,12819,34,622,4,785,133,163,129,bird
32187,3,bird,4,0,12819,34,657,220,800,376,143,156,bird
32188,4,bird,5,0,12819,35,32,218,195,348,163,130,bird
32189,5,bird,6,1,12819,34,121,10,288,152,167,142,bird
32190,6,bird,7,0,12819,30,139,15,316,156,177,141,bird
32191,7,bird,8,0,12819,38,10,406,177,588,167,182,bird
32192,8,bird,9,0,12819,23,595,465,748,591,153,126,bird
32193,9,bird,10,1,12819,19,693,362,800,459,107,97,bird
32194,13,person,14,0,12823,24,50,841,127,963,77,122,person
32195,27,car,28,0,12824,19,1923,1280,2095,1395,172,115,car
32196,7,pot,8,0,12825,16,1435,795,1539,1008,104,213,potted plant
32197,9,pot,10,0,12825,21,1162,877,1310,1128,148,251,potted plant
32198,10,pot,11,0,12825,19,1034,894,1189,1153,155,259,potted plant
32199,11,pot,12,0,12825,22,889,906,1051,1182,162,276,potted plant
32200,12,pot,13,0,12825,25,715,921,892,1220,177,299,potted plant
32201,13,pot,14,0,12825,20,524,935,710,1256,186,321,potted plant
32202,14,pot,15,0,12825,21,297,957,505,1300,208,343,potted plant
32203,26,pot,27,0,12825,18,1778,1266,1989,1488,211,222,potted plant
32204,1,person,2,0,12829,34,167,690,313,1122,146,432,person
32205,5,person,6,0,12829,15,674,726,779,1045,105,319,person
32206,7,person,8,0,12829,17,1810,686,1976,1167,166,481,person
32207,14,person,13,0,12829,46,850,885,1125,1285,275,400,person
32208,0,person,1,0,12830,19,1,1,76,476,75,475,person
32209,1,person,2,0,12830,38,85,89,508,530,423,441,person
32210,0,bottle,1,0,12831,18,450,222,481,338,31,116,bottle
32211,11,table,12,0,12831,30,409,324,1002,769,593,445,dining table
32212,14,chair,15,0,12831,23,241,325,472,705,231,380,chair
32213,15,chair,16,0,12831,24,179,386,433,769,254,383,chair
32214,16,chair,17,0,12831,30,243,419,512,768,269,349,chair
32215,17,chair,18,0,12831,40,739,550,1024,769,285,219,chair
32216,19,bench,20,0,12831,25,787,292,1025,722,238,430,bench
32217,24,fork,25,0,12831,15,689,403,785,415,96,12,fork
32218,30,fork,31,0,12831,18,532,491,656,525,124,34,fork
32219,31,spoon,32,0,12831,21,535,493,692,532,157,39,spoon
32220,43,plate,44,0,12831,15,717,414,878,457,161,43,plate
32221,45,plate,46,0,12831,17,454,421,598,464,144,43,plate
32222,49,plate,50,0,12831,16,434,377,566,407,132,30,plate
32223,58,flowerpot,58,1,12831,15,506,286,564,341,58,55,potted plant
32224,59,flowerpot,59,1,12831,15,561,280,603,335,42,55,potted plant
32225,20,person,21,1,12834,16,120,722,301,971,181,249,person
32226,4,person,5,0,12836,42,38,558,156,908,118,350,person
32227,9,person,10,0,12836,38,707,605,837,911,130,306,person
32228,10,person,11,0,12836,38,837,577,974,924,137,347,person
32229,11,person,12,0,12836,52,956,547,1088,1012,132,465,person
32230,17,person,18,0,12836,103,1386,655,1771,1651,385,996,person
32231,18,person,19,0,12836,76,1809,525,2159,1651,350,1126,person
32232,19,person,20,1,12836,31,1664,603,1854,1007,190,404,person
32233,20,person,21,0,12836,42,1298,580,1445,1022,147,442,person
32234,21,person,22,0,12836,39,1092,605,1185,911,93,306,person
32235,61,person,62,1,12836,38,1228,613,1302,912,74,299,person
32236,62,person,63,1,12836,39,1181,694,1244,907,63,213,person
32237,64,person,65,1,12836,28,2114,553,2198,1044,84,491,person
32238,66,person,67,1,12836,15,0,595,21,902,21,307,person
32239,5,bench,6,0,12837,17,684,1200,878,1401,194,201,bench
32240,6,person,7,0,12837,21,757,1126,946,1394,189,268,person
32241,7,bench,8,0,12837,20,932,1211,1127,1441,195,230,bench
32242,9,bench,10,0,12837,27,1149,1189,1401,1425,252,236,bench
32243,10,person,11,1,12837,24,1153,1125,1243,1327,90,202,person
32244,11,bench,12,1,12837,17,1357,1176,1451,1377,94,201,bench
32245,13,person,14,1,12837,21,1044,1116,1165,1344,121,228,person
32246,14,chair,15,0,12837,17,205,1187,319,1309,114,122,chair
32247,17,person,18,0,12837,39,475,1121,592,1337,117,216,person
32248,18,table,19,0,12837,21,569,1198,698,1344,129,146,dining table
32249,19,person,20,1,12837,17,654,1120,747,1200,93,80,person
32250,20,person,21,0,12837,22,2102,991,2147,1139,45,148,person
32251,21,bicycle,22,1,12837,34,1739,1139,1922,1255,183,116,bicycle
32252,25,person,26,1,12837,25,392,1114,508,1299,116,185,person
32253,26,person,27,1,12837,19,351,1112,435,1187,84,75,person
32254,31,person,32,1,12837,45,153,1114,291,1277,138,163,person
32255,32,table,33,0,12837,31,67,1173,210,1280,143,107,dining table
32256,33,table,34,1,12837,22,286,1183,424,1260,138,77,dining table
32257,42,person,43,1,12837,19,974,1098,1033,1146,59,48,person
32258,44,person,45,1,12837,24,946,1077,995,1131,49,54,person
32259,45,person,46,1,12837,24,1019,1077,1060,1143,41,66,person
32260,46,person,47,1,12837,49,1279,1078,1395,1193,116,115,person
32261,47,person,48,1,12837,21,1258,1082,1317,1147,59,65,person
32262,48,person,49,1,12837,30,1486,1114,1518,1211,32,97,person
32263,49,table,50,0,12837,19,1395,1110,1490,1188,95,78,dining table
32264,50,person,51,1,12837,32,1384,1064,1446,1145,62,81,person
32265,51,person,52,1,12837,30,829,1089,929,1185,100,96,person
32266,52,chair,53,1,12837,16,929,1158,996,1213,67,55,chair
32267,54,chair,55,1,12837,29,629,1209,722,1350,93,141,chair
32268,55,chair,56,1,12837,21,2,1178,91,1292,89,114,chair
32269,56,person,57,1,12837,20,1221,1069,1264,1127,43,58,person
32270,57,person,58,1,12837,21,1253,1066,1293,1140,40,74,person
32271,58,person,59,1,12837,27,1474,1063,1517,1137,43,74,person
32272,59,person,60,1,12837,23,1203,1068,1232,1121,29,53,person
32273,60,person,61,1,12837,19,1164,1070,1198,1130,34,60,person
32274,61,person,62,1,12837,21,1127,1069,1171,1117,44,48,person
32275,62,person,63,1,12837,36,1036,1087,1132,1170,96,83,person
32276,63,person,64,1,12837,20,622,1109,670,1177,48,68,person
32277,64,person,65,1,12837,15,488,1118,529,1177,41,59,person
32278,65,person,66,1,12837,47,283,1081,375,1185,92,104,person
32279,66,person,67,1,12837,23,741,1103,789,1175,48,72,person
32280,67,person,68,1,12837,16,715,1111,749,1153,34,42,person
32281,68,person,69,1,12837,17,793,1082,841,1127,48,45,person
32282,69,person,70,1,12837,17,565,1098,605,1165,40,67,person
32283,71,person,72,1,12837,19,678,1082,716,1125,38,43,person
32284,72,person,73,1,12837,16,707,1080,738,1125,31,45,person
32285,73,person,74,1,12837,17,1892,1049,1952,1101,60,52,person
32286,76,person,77,1,12837,15,1627,1061,1682,1097,55,36,person
32287,80,person,81,1,12837,17,1508,1064,1542,1113,34,49,person
32288,6,person,7,0,12838,40,1090,495,1254,867,164,372,person
32289,7,person,8,0,12838,18,981,809,1133,969,152,160,person
32290,13,person,14,0,12838,17,1904,92,1960,217,56,125,person
32291,14,person,15,0,12838,27,1525,80,1583,208,58,128,person
32292,16,person,17,1,12838,21,817,768,913,925,96,157,person
32293,17,person,18,1,12838,23,913,780,1027,940,114,160,person
32294,18,person,19,1,12838,15,747,843,860,954,113,111,person
32295,19,person,20,1,12838,15,860,875,976,976,116,101,person
32296,1,table,2,0,12839,21,1580,925,1987,1448,407,523,dining table
32297,0,car,1,0,12840,19,40,1002,270,1207,230,205,car
32298,11,car,12,1,12840,30,1841,1036,2048,1259,207,223,car
32299,0,car,1,0,12841,38,346,835,992,1235,646,400,car
32300,43,door,44,0,12841,18,829,851,918,1092,89,241,door
32301,9,plate,10,0,12843,15,444,528,701,598,257,70,plate
32302,19,chair,20,0,12843,15,53,400,641,767,588,367,chair
32303,20,chair,21,1,12843,18,760,352,1024,498,264,146,chair
32304,32,window,33,0,12843,19,298,3,437,318,139,315,window
32305,33,window,34,0,12843,20,785,3,938,357,153,354,window
32306,46,cup,45,0,12843,27,628,128,655,164,27,36,cup
32307,1,person,2,0,12845,24,1837,1003,1993,1268,156,265,person
32308,3,person,4,0,12846,27,1419,1065,1520,1280,101,215,person
32309,4,person,5,0,12846,31,1534,1046,1627,1277,93,231,person
32310,12,bench,13,0,12846,22,106,1205,1141,1329,1035,124,bench
32311,14,bicycle,15,1,12846,69,3,1118,207,1376,204,258,bicycle
32312,15,bicycle,16,1,12846,16,2,1283,170,1504,168,221,bicycle
32313,6,table,7,1,12849,20,683,437,800,597,117,160,dining table
32314,0,boat,1,0,12851,15,1281,486,1708,1204,427,718,boat
32315,0,person,1,0,12855,20,343,591,403,798,60,207,person
32316,1,person,2,0,12855,20,138,564,229,778,91,214,person
32317,2,person,3,0,12855,29,223,578,285,793,62,215,person
32318,17,person,17,0,12855,16,1398,624,1464,859,66,235,person
32319,19,person,19,1,12855,23,1070,605,1112,773,42,168,person
32320,20,person,20,1,12855,20,1436,603,1486,746,50,143,person
32321,0,person,1,0,12856,27,267,906,486,1439,219,533,person
32322,43,person,43,0,12856,32,1046,966,1177,1333,131,367,person
32323,3,person,4,0,12860,35,1633,1104,1711,1295,78,191,person
32324,6,person,7,1,12860,19,1886,1113,1917,1225,31,112,person
32325,7,person,8,0,12860,31,1836,1113,1888,1300,52,187,person
32326,9,person,10,0,12860,41,1917,1111,1983,1306,66,195,person
32327,6,person,7,0,12862,21,167,1259,201,1374,34,115,person
32328,12,person,13,0,12862,20,635,1271,666,1350,31,79,person
32329,13,person,14,0,12862,17,666,1262,688,1335,22,73,person
32330,16,person,17,0,12862,17,817,1272,840,1361,23,89,person
32331,17,person,18,1,12862,19,1753,1183,1793,1355,40,172,person
32332,18,person,19,0,12862,35,1673,1176,1760,1429,87,253,person
32333,19,person,20,0,12862,17,1051,1269,1083,1350,32,81,person
32334,21,person,22,0,12862,19,1123,1269,1155,1348,32,79,person
32335,29,person,30,0,12862,20,1030,1254,1052,1324,22,70,person
32336,7,person,8,0,12863,28,393,954,533,1276,140,322,person
32337,8,person,9,1,12863,22,9,991,150,1524,141,533,person
32338,7,chair,8,0,12864,15,528,495,628,618,100,123,chair
32339,46,chair,47,0,12864,22,59,372,111,482,52,110,chair
32340,47,chair,48,0,12864,15,68,423,126,545,58,122,chair
32341,48,chair,49,0,12864,26,68,481,141,621,73,140,chair
32342,60,table,61,0,12864,27,118,441,316,647,198,206,dining table
32343,61,table,62,0,12864,20,285,427,492,622,207,195,dining table
32344,64,chair,65,0,12864,16,470,398,555,536,85,138,chair
32345,65,table,66,0,12864,23,444,412,656,600,212,188,dining table
32346,66,chair,67,0,12864,22,180,535,283,674,103,139,chair
32347,68,chair,69,0,12864,18,566,277,632,366,66,89,chair
32348,69,table,70,0,12864,16,549,283,702,394,153,111,dining table
32349,72,chair,73,0,12864,15,976,618,1200,810,224,192,chair
32350,79,chair,80,0,12864,19,839,458,944,578,105,120,chair
32351,84,table,85,0,12864,17,602,312,706,392,104,80,dining table
32352,86,table,87,0,12864,16,592,399,810,578,218,179,dining table
32353,94,flowerpot,95,0,12864,16,418,141,445,161,27,20,potted plant
32354,0,person,1,0,12865,55,1330,1287,1479,1645,149,358,person
32355,1,car,2,0,12865,35,2027,1274,2135,1309,108,35,car
32356,31,person,32,0,12865,21,1643,1311,1686,1410,43,99,person
32357,34,person,35,0,12865,21,1556,1315,1590,1429,34,114,person
32358,42,person,43,0,12865,37,1699,1288,1776,1450,77,162,person
32359,44,person,45,0,12865,31,1516,1311,1560,1430,44,119,person
32360,6,car,7,1,12867,17,2,1521,89,1608,87,87,car
32361,7,car,8,1,12867,18,93,1525,158,1596,65,71,car
32362,41,boat,42,1,12867,22,50,1000,457,1107,407,107,boat
32363,1,person,2,0,12868,31,812,1018,918,1259,106,241,person
32364,15,person,16,0,12868,15,1307,957,1347,1103,40,146,person
32365,21,person,22,0,12868,15,676,963,721,1053,45,90,person
32366,22,person,23,0,12868,15,1152,970,1192,1096,40,126,person
32367,19,table,20,0,12869,17,1043,565,1195,817,152,252,dining table
32368,6,window,7,0,12873,15,546,567,711,1023,165,456,window
32369,9,person,10,1,12874,33,1577,516,1976,837,399,321,person
32370,0,car,1,0,12879,17,1451,1230,1692,1366,241,136,car
32371,0,boat,1,0,12894,33,27,265,910,607,883,342,boat
32372,4,person,5,0,12894,15,92,422,129,521,37,99,person
32373,20,person,19,0,12895,17,1595,857,1620,951,25,94,person
32374,21,person,20,0,12895,24,1630,862,1665,978,35,116,person
32375,25,bench,24,0,12895,18,124,887,249,938,125,51,bench
32376,27,person,26,0,12895,21,364,866,423,926,59,60,person
32377,30,person,29,1,12895,16,873,859,895,914,22,55,person
32378,36,person,35,0,12895,15,1381,856,1404,926,23,70,person
32379,37,person,36,0,12895,30,1804,846,1857,1001,53,155,person
32380,38,person,37,1,12895,25,1846,849,1882,970,36,121,person
32381,39,person,38,0,12895,28,1766,866,1806,966,40,100,person
32382,41,person,40,1,12895,29,2001,837,2047,1053,46,216,person
32383,42,person,41,0,12895,35,1916,853,1971,993,55,140,person
32384,43,bicycle,42,1,12895,17,1923,915,1965,996,42,81,bicycle
32385,51,person,50,0,12895,17,1410,859,1433,927,23,68,person
32386,52,person,51,0,12895,20,1456,860,1479,932,23,72,person
32387,58,person,57,0,12895,23,536,844,566,920,30,76,person
32388,59,person,58,0,12895,18,614,848,648,917,34,69,person
32389,60,person,59,0,12895,16,688,849,711,911,23,62,person
32390,61,person,60,0,12895,22,710,848,736,911,26,63,person
32391,62,person,61,0,12895,21,751,846,773,913,22,67,person
32392,64,person,63,0,12895,16,1270,856,1290,925,20,69,person
32393,65,person,64,0,12895,20,1438,864,1458,928,20,64,person
32394,66,person,65,0,12895,17,1035,866,1048,900,13,34,person
32395,67,person,66,1,12895,17,1025,863,1039,899,14,36,person
32396,7,bench,8,0,12896,18,1896,1050,2001,1167,105,117,bench
32397,16,person,17,0,12896,15,1133,976,1147,1039,14,63,person
32398,17,person,18,0,12896,21,1036,981,1066,1052,30,71,person
32399,18,person,19,0,12896,18,1074,987,1089,1051,15,64,person
32400,7,bicycle,8,0,12897,29,408,869,460,940,52,71,bicycle
32401,8,person,9,0,12897,19,409,830,461,922,52,92,person
32402,0,car,1,0,12898,22,362,1039,548,1159,186,120,car
32403,5,person,6,0,12899,27,153,1078,228,1232,75,154,person
32404,2,person,3,0,12903,22,1161,1212,1231,1426,70,214,person
32405,3,person,4,0,12903,20,1304,1132,1356,1316,52,184,person
32406,4,person,5,0,12903,23,1415,1130,1490,1316,75,186,person
32407,6,person,7,1,12903,17,1488,1166,1534,1287,46,121,person
32408,7,person,8,0,12903,19,1570,1137,1626,1291,56,154,person
32409,8,person,9,0,12903,19,1767,1234,1840,1339,73,105,person
32410,10,person,11,0,12903,22,1924,1188,1999,1378,75,190,person
32411,11,person,12,0,12903,27,2013,1185,2078,1360,65,175,person
32412,12,person,13,0,12903,17,1459,980,1508,1057,49,77,person
32413,13,person,14,0,12903,17,1221,1117,1249,1247,28,130,person
32414,14,person,15,0,12903,26,963,1115,1037,1315,74,200,person
32415,16,person,17,0,12903,16,1126,1130,1205,1315,79,185,person
32416,17,person,18,0,12903,17,1672,1148,1716,1322,44,174,person
32417,19,person,20,1,12903,16,1350,1117,1378,1253,28,136,person
32418,22,person,23,0,12903,27,373,1161,449,1402,76,241,person
32419,25,person,26,0,12903,20,283,1132,358,1318,75,186,person
32420,27,person,28,0,12903,19,225,1173,294,1417,69,244,person
32421,29,person,30,0,12903,17,7,904,55,972,48,68,person
32422,4,person,5,0,12905,30,1607,1203,1682,1409,75,206,person
32423,5,person,6,1,12905,15,1517,1235,1575,1329,58,94,person
32424,6,person,7,0,12905,26,1401,1184,1462,1409,61,225,person
32425,11,person,12,0,12905,27,317,1155,377,1380,60,225,person
32426,12,person,13,0,12905,31,766,1167,867,1392,101,225,person
32427,13,person,14,0,12905,32,512,1172,604,1382,92,210,person
32428,17,person,18,0,12905,33,954,1235,1005,1375,51,140,person
32429,18,person,19,0,12905,18,1073,1244,1111,1372,38,128,person
32430,44,chair,26,0,12908,32,612,513,740,681,128,168,chair
32431,45,chair,27,0,12908,33,429,513,554,671,125,158,chair
32432,46,chair,28,0,12908,33,313,509,437,663,124,154,chair
32433,47,chair,29,0,12908,33,872,535,1036,711,164,176,chair
32434,48,person,30,1,12908,28,711,401,784,524,73,123,person
32435,49,person,31,0,12908,36,954,390,1019,523,65,133,person
32436,50,person,32,1,12908,35,898,394,963,537,65,143,person
32437,51,person,33,1,12908,34,387,426,485,539,98,113,person
32438,52,person,34,1,12908,23,493,401,555,469,62,68,person
32439,53,person,35,1,12908,18,816,393,881,465,65,72,person
32440,54,person,36,0,12908,28,644,396,707,481,63,85,person
32441,55,person,37,1,12908,21,314,400,385,463,71,63,person
32442,56,person,38,1,12908,23,229,419,334,510,105,91,person
32443,57,person,39,1,12908,26,556,406,626,478,70,72,person
32444,58,person,40,1,12908,21,137,394,190,474,53,80,person
32445,9,bicycle,10,1,12910,39,1137,1276,1451,1598,314,322,bicycle
32446,10,bicycle,11,0,12910,48,1399,1233,1675,1517,276,284,bicycle
32447,1,person,2,0,12911,38,1070,322,1215,787,145,465,person
32448,3,person,4,0,12911,53,688,386,899,886,211,500,person
32449,5,person,6,1,12911,30,833,343,997,842,164,499,person
32450,2,mirror,3,0,12913,17,238,119,296,185,58,66,mirror
32451,7,chair,8,1,12913,15,466,238,503,365,37,127,chair
32452,8,chair,9,1,12913,23,425,250,486,411,61,161,chair
32453,9,chair,10,0,12913,19,325,251,432,433,107,182,chair
32454,10,chair,11,0,12913,34,177,260,301,449,124,189,chair
32455,7,bicycle,8,0,12919,58,446,784,573,927,127,143,bicycle
32456,8,bicycle,9,0,12919,51,607,773,702,940,95,167,bicycle
32457,9,bicycle,10,0,12919,52,670,797,771,940,101,143,bicycle
32458,10,bicycle,11,0,12919,37,956,780,1016,940,60,160,bicycle
32459,11,bicycle,12,0,12919,51,873,810,948,937,75,127,bicycle
32460,21,person,22,0,12919,20,1411,812,1439,899,28,87,person
32461,22,bicycle,23,0,12919,23,1317,830,1399,938,82,108,bicycle
32462,0,car,1,0,12921,46,267,1059,671,1227,404,168,car
32463,4,car,5,0,12921,53,1124,984,1321,1107,197,123,car
32464,6,truck,7,0,12921,23,802,1002,1035,1114,233,112,truck
32465,12,car,13,1,12921,19,76,1092,212,1185,136,93,car
32466,14,fire hydrant,15,0,12921,18,395,1245,458,1340,63,95,fire hydrant
32467,22,car,23,0,12921,18,1605,923,1797,1015,192,92,car
32468,23,person,24,0,12921,18,1807,936,1842,1017,35,81,person
32469,4,person,5,0,12923,32,513,531,679,839,166,308,person
32470,11,person,12,1,12923,16,382,543,466,683,84,140,person
32471,12,person,13,1,12923,18,694,556,784,718,90,162,person
32472,13,person,14,1,12923,21,828,560,907,703,79,143,person
32473,14,person,15,0,12923,23,951,558,1048,762,97,204,person
32474,15,person,16,1,12923,17,1030,560,1105,679,75,119,person
32475,16,person,17,1,12923,18,1125,569,1180,683,55,114,person
32476,31,person,32,1,12923,28,648,1030,778,1230,130,200,person
32477,32,person,33,1,12923,28,749,997,877,1188,128,191,person
32478,0,car,1,0,12924,41,1301,1052,1777,1258,476,206,car
32479,9,car,10,0,12924,28,111,1044,848,1468,737,424,car
32480,22,person,22,0,12924,18,1799,1047,1829,1182,30,135,person
32481,23,person,23,0,12924,19,1836,1020,1888,1177,52,157,person
32482,26,car,26,1,12924,27,788,1069,1157,1305,369,236,car
32483,28,car,28,1,12924,15,1984,1069,2197,1328,213,259,car
32484,46,door,46,0,12924,16,677,1065,781,1356,104,291,door
32485,5,vase,6,0,12925,27,917,762,1064,942,147,180,vase
32486,7,table,8,1,12925,81,247,842,1341,1650,1094,808,dining table
32487,8,chair,9,1,12925,60,269,719,637,957,368,238,chair
32488,9,chair,10,1,12925,35,397,1160,655,1618,258,458,chair
32489,10,chair,11,1,12925,26,891,1244,1063,1647,172,403,chair
32490,27,person,28,0,12926,20,811,993,848,1119,37,126,person
32491,28,person,29,0,12926,20,842,980,896,1146,54,166,person
32492,30,car,31,1,12926,17,398,986,568,1165,170,179,car
32493,13,door,7,0,12927,31,1,1,139,376,138,375,door
32494,14,chair,8,1,12927,27,120,221,230,337,110,116,chair
32495,15,chair,9,1,12927,16,171,256,249,315,78,59,chair
32496,16,chair,10,1,12927,15,56,394,190,480,134,86,chair
32497,17,table,11,1,12927,32,92,304,464,479,372,175,dining table
32498,18,chair,12,1,12927,21,428,364,529,480,101,116,chair
32499,2,person,3,0,12930,20,1158,768,1241,916,83,148,person
32500,6,car,7,0,12931,25,1176,1022,1387,1109,211,87,car
32501,9,car,10,1,12931,16,852,1004,1038,1097,186,93,car
32502,10,car,11,1,12931,15,940,1012,1176,1100,236,88,car
32503,16,car,17,0,12931,22,26,1019,278,1115,252,96,car
32504,6,person,7,1,12932,25,623,1049,739,1346,116,297,person
32505,7,person,8,0,12932,46,696,1066,858,1368,162,302,person
32506,8,person,9,0,12932,45,1189,1078,1298,1377,109,299,person
32507,13,bicycle,14,0,12932,40,1488,1143,1662,1273,174,130,bicycle
32508,17,window,18,0,12932,17,314,404,598,868,284,464,window
32509,2,car,3,0,12933,17,1274,905,1443,978,169,73,car
32510,21,person,22,1,12934,16,206,1000,239,1067,33,67,person
32511,3,person,4,0,12937,22,271,1066,308,1164,37,98,person
32512,14,person,15,0,12937,20,1687,1148,1733,1236,46,88,person
32513,18,bicycle,19,0,12937,29,1554,1154,1617,1200,63,46,bicycle
32514,5,door,6,0,12944,26,1036,726,1803,1434,767,708,door
32515,6,window,7,0,12944,18,1138,900,1626,1345,488,445,window
32516,0,car,1,0,12945,24,114,392,717,632,603,240,car
32517,32,table,33,0,12946,17,1815,833,1914,887,99,54,dining table
32518,5,person,6,0,12947,25,896,1140,953,1305,57,165,person
32519,6,car,7,0,12948,53,497,579,2054,1431,1557,852,car
32520,9,car,10,0,12953,17,519,1068,633,1145,114,77,car
32521,10,car,11,0,12953,21,360,1048,520,1153,160,105,car
32522,11,bench,12,0,12953,18,630,1172,1207,1247,577,75,bench
32523,9,bus,10,1,12954,26,227,890,678,1119,451,229,bus
32524,11,car,12,0,12954,30,412,1031,672,1144,260,113,car
32525,19,car,20,0,12954,20,802,1041,874,1107,72,66,car
32526,31,car,32,0,12954,24,1186,1045,1367,1185,181,140,car
32527,9,car,10,0,12956,24,198,706,381,782,183,76,car
32528,10,car,11,1,12956,15,2,710,213,815,211,105,car
32529,16,car,17,1,12956,21,753,688,913,768,160,80,car
32530,18,car,19,1,12956,37,899,681,1045,783,146,102,car
32531,20,person,21,1,12956,17,1036,681,1060,763,24,82,person
32532,27,car,28,0,12956,29,1198,681,1392,775,194,94,car
32533,29,truck,30,0,12956,26,1721,662,1866,745,145,83,truck
32534,30,truck,31,0,12956,24,1831,694,1983,764,152,70,truck
32535,6,person,7,0,12957,15,585,947,607,1026,22,79,person
32536,8,motorbikes,9,0,12957,16,4,966,299,1048,295,82,motorcycle
32537,0,table,1,0,12960,56,401,534,1548,1418,1147,884,dining table
32538,1,chair,2,0,12960,30,1143,653,1627,1329,484,676,chair
32539,6,chair,7,0,12963,49,961,592,1325,1079,364,487,chair
32540,7,table,8,0,12963,35,348,526,927,1015,579,489,dining table
32541,10,chair,11,0,12963,60,216,687,656,1199,440,512,chair
32542,11,chair,12,0,12963,24,1182,344,1329,546,147,202,chair
32543,12,chair,13,0,12963,20,911,361,1092,580,181,219,chair
32544,13,chair,14,0,12963,27,792,325,928,502,136,177,chair
32545,14,table,15,1,12963,32,928,328,1203,548,275,220,dining table
32546,15,chair,16,1,12963,28,668,485,926,894,258,409,chair
32547,16,chair,17,1,12963,29,273,523,603,821,330,298,chair
32548,17,chair,18,0,12963,21,1260,254,1371,384,111,130,chair
32549,19,chair,20,1,12963,15,1123,279,1228,399,105,120,chair
32550,20,chair,21,1,12963,15,985,262,1067,328,82,66,chair
32551,21,bicycle,22,0,12963,37,1505,141,1568,231,63,90,bicycle
32552,22,bicycle,23,0,12963,21,1409,137,1453,231,44,94,bicycle
32553,23,bicycle,24,0,12963,24,1379,145,1415,231,36,86,bicycle
32554,24,bicycle,25,0,12963,17,1329,151,1358,225,29,74,bicycle
32555,26,bicycle,27,0,12963,23,1277,155,1310,229,33,74,bicycle
32556,28,chair,29,1,12963,17,995,212,1058,286,63,74,chair
32557,29,chair,30,0,12963,21,829,206,909,300,80,94,chair
32558,30,chair,31,0,12963,16,460,210,516,273,56,63,chair
32559,31,chair,32,0,12963,22,559,202,630,275,71,73,chair
32560,8,sofa,9,0,12967,38,252,628,1089,1315,837,687,couch
32561,2,person,3,0,12974,37,278,1119,344,1284,66,165,person
32562,3,person,4,1,12974,21,685,1206,739,1307,54,101,person
32563,8,person,9,0,12974,29,216,1142,291,1344,75,202,person
32564,2,car,3,0,12975,17,760,1050,860,1114,100,64,car
32565,11,car,12,1,12975,15,2,1104,255,1274,253,170,car
32566,13,traffic light,14,0,12975,68,222,418,1783,1159,1561,741,traffic light
32567,2,person,3,1,12976,20,724,181,860,466,136,285,person
32568,12,person,13,1,12976,28,3,234,119,717,116,483,person
32569,14,person,15,1,12976,32,94,246,255,562,161,316,person
32570,16,person,17,1,12976,24,275,212,368,363,93,151,person
32571,17,person,18,1,12976,18,201,233,268,359,67,126,person
32572,21,person,21,0,12976,66,205,269,533,918,328,649,person
32573,23,person,23,1,12976,16,668,212,715,274,47,62,person
32574,34,person,33,1,12976,16,0,385,61,956,61,571,person
32575,38,person,37,1,12976,16,87,286,156,458,69,172,person
32576,41,umbrella,40,1,12976,16,605,169,765,208,160,39,umbrella
32577,43,umbrella,42,1,12976,21,433,109,804,180,371,71,umbrella
32578,47,umbrella,46,1,12976,18,202,13,737,118,535,105,umbrella
32579,48,umbrella,47,1,12976,33,84,46,767,148,683,102,umbrella
32580,15,person,16,0,12981,19,934,956,965,1058,31,102,person
32581,1,fire hydrant,2,0,12982,26,1468,1236,1613,1487,145,251,fire hydrant
32582,2,chair,3,0,12984,36,163,118,225,225,62,107,chair
32583,3,chair,4,0,12984,24,225,102,255,176,30,74,chair
32584,4,chair,5,1,12984,16,0,157,61,255,61,98,chair
32585,5,car,6,1,12986,20,226,171,256,211,30,40,car
32586,6,car,7,0,12986,39,98,178,199,215,101,37,car
32587,7,car,8,1,12986,15,0,175,37,206,37,31,car
32588,9,sofa,10,1,12990,17,2,233,89,350,87,117,couch
32589,18,desk,19,0,12993,29,118,225,1198,327,1080,102,desk
32590,27,person,28,1,12993,25,738,162,880,306,142,144,person
32591,28,person,29,1,12993,27,581,154,681,303,100,149,person
32592,29,person,30,1,12993,17,294,150,392,241,98,91,person
32593,51,chair,52,1,12993,29,654,352,855,443,201,91,chair
32594,52,chair,53,1,12993,23,897,366,1055,429,158,63,chair
32595,2,car,3,0,12994,22,607,305,643,323,36,18,car
32596,2,chair,3,0,12995,27,25,259,90,360,65,101,chair
32597,4,chair,5,0,12995,20,202,259,272,357,70,98,chair
32598,1,person,2,1,12999,32,195,201,219,256,24,55,person
32599,2,person,3,0,12999,26,0,201,18,255,18,54,person
32600,7,person,8,1,13002,26,126,59,148,114,22,55,person
32601,8,person,9,1,13002,20,105,59,128,122,23,63,person
32602,9,person,10,1,13002,31,43,71,92,134,49,63,person
32603,10,person,11,0,13002,31,10,97,50,172,40,75,person
32604,11,person,12,0,13002,38,117,112,241,143,124,31,person
32605,12,person,13,1,13002,21,308,91,341,158,33,67,person
32606,13,person,14,1,13002,23,324,87,353,142,29,55,person
32607,3,person,4,1,13005,25,613,125,703,410,90,285,person
32608,9,table,10,1,13006,23,151,130,215,181,64,51,dining table
32609,10,chair,11,0,13006,17,164,135,201,181,37,46,chair
32610,12,chair,13,0,13006,22,277,120,305,162,28,42,chair
32611,20,chair,21,1,13006,19,148,125,168,168,20,43,chair
32612,22,chair,23,1,13006,16,304,115,323,153,19,38,chair
32613,24,chair,25,1,13006,18,254,119,275,156,21,37,chair
32614,30,chair,31,1,13006,19,353,116,378,149,25,33,chair
32615,3,person,4,1,13008,28,117,86,157,139,40,53,person
32616,4,person,5,0,13008,39,175,50,228,205,53,155,person
32617,5,person,6,0,13008,37,219,40,265,205,46,165,person
32618,3,car,4,1,13009,17,32,184,91,215,59,31,car
32619,4,car,5,0,13009,25,59,180,162,226,103,46,car
32620,8,person,9,1,13010,18,241,116,314,195,73,79,person
32621,9,person,10,1,13010,26,131,144,228,204,97,60,person
32622,10,person,11,1,13010,32,62,90,134,250,72,160,person
32623,14,person,15,1,13010,21,17,86,60,135,43,49,person
32624,15,person,16,1,13010,16,61,83,86,135,25,52,person
32625,2,motorbike,3,0,13011,52,174,172,225,211,51,39,motorcycle
32626,3,car,4,0,13011,27,61,170,157,206,96,36,car
32627,4,car,5,1,13011,18,0,168,39,196,39,28,car
32628,0,table,1,0,13012,32,110,115,200,196,90,81,dining table
32629,9,table,10,0,13014,15,1904,713,2126,840,222,127,dining table
32630,10,person,11,0,13014,30,1686,565,1770,838,84,273,person
32631,7,person,8,1,13015,15,243,540,270,598,27,58,person
32632,9,person,10,1,13015,16,47,531,103,597,56,66,person
32633,9,person,10,0,13016,15,52,213,63,245,11,32,person
32634,17,person,18,0,13016,16,80,324,99,377,19,53,person
32635,45,person,46,0,13016,24,302,364,342,479,40,115,person
32636,46,person,47,1,13016,19,200,400,246,479,46,79,person
32637,51,person,52,1,13016,20,359,385,401,476,42,91,person
32638,53,person,54,1,13016,16,427,397,466,476,39,79,person
32639,8,chair,9,0,13019,26,118,344,168,461,50,117,chair
32640,3,person,4,1,13020,53,129,50,625,577,496,527,person
32641,8,bowl,9,0,13020,19,139,621,355,731,216,110,bowl
32642,3,boat,4,0,13023,22,149,0,247,174,98,174,boat
32643,0,person,1,1,13025,62,106,35,270,273,164,238,person
32644,19,chair,20,0,13025,29,0,170,71,266,71,96,chair
32645,7,person,8,0,13026,17,241,106,253,126,12,20,person
32646,4,truck,5,0,13028,27,145,245,244,283,99,38,truck
32647,9,person,10,0,13028,15,138,237,149,265,11,28,person
32648,9,person,10,0,13036,30,187,161,203,201,16,40,person
32649,0,bird,1,0,13037,44,134,82,277,253,143,171,bird
32650,0,sofa,1,0,13038,17,7,57,296,224,289,167,couch
32651,4,person,5,0,13039,42,66,119,286,514,220,395,person
32652,5,person,6,1,13039,27,174,92,282,338,108,246,person
32653,6,person,7,1,13039,17,3,140,44,322,41,182,person
32654,23,boat,24,0,13041,21,520,296,758,453,238,157,boat
32655,2,cake,3,0,13044,19,94,115,130,133,36,18,cake
32656,3,cake,4,0,13044,17,134,119,170,138,36,19,cake
32657,6,person,7,1,13047,37,299,40,370,224,71,184,person
32658,7,person,8,1,13047,38,255,57,319,224,64,167,person
32659,8,person,9,1,13047,33,223,77,277,224,54,147,person
32660,10,person,11,1,13047,18,199,92,231,189,32,97,person
32661,12,person,13,1,13047,36,76,76,150,224,74,148,person
32662,13,person,14,1,13047,52,125,38,217,223,92,185,person
32663,15,person,16,1,13047,47,0,17,98,224,98,207,person
32664,6,person,7,1,13048,31,45,122,125,385,80,263,person
32665,8,person,9,1,13048,22,98,265,199,372,101,107,person
32666,9,person,10,0,13048,23,239,128,290,291,51,163,person
32667,10,person,11,1,13048,22,311,160,353,282,42,122,person
32668,11,person,12,1,13048,20,431,163,473,254,42,91,person
32669,13,chair,14,0,13048,24,460,220,528,317,68,97,chair
32670,14,person,15,1,13048,24,522,168,573,320,51,152,person
32671,15,person,16,1,13048,18,487,314,555,386,68,72,person
32672,16,person,17,1,13048,15,337,215,372,269,35,54,person
32673,17,person,18,1,13048,15,379,231,411,299,32,68,person
32674,18,person,19,1,13048,24,334,246,384,322,50,76,person
32675,19,person,20,1,13048,17,408,234,458,291,50,57,person
32676,20,person,21,1,13048,19,442,289,484,377,42,88,person
32677,21,person,22,1,13048,20,384,273,446,369,62,96,person
32678,23,person,24,1,13048,20,287,250,328,334,41,84,person
32679,24,person,25,1,13048,33,224,290,316,437,92,147,person
32680,25,person,26,1,13048,35,307,301,393,447,86,146,person
32681,26,person,27,1,13048,24,360,318,483,448,123,130,person
32682,27,person,28,1,13048,16,462,197,599,446,137,249,person
32683,0,person,1,1,13051,36,60,43,105,198,45,155,person
32684,7,person,8,0,13051,37,203,82,239,157,36,75,person
32685,10,person,11,1,13051,32,287,55,336,180,49,125,person
32686,9,person,10,0,13052,15,667,540,679,585,12,45,person
32687,10,person,11,0,13052,16,652,535,667,585,15,50,person
32688,9,car,10,0,13056,20,40,161,90,184,50,23,car
32689,10,car,11,0,13056,26,92,154,137,178,45,24,car
32690,13,car,14,1,13056,17,136,152,166,173,30,21,car
32691,4,person,5,0,13057,83,159,47,265,298,106,251,person
32692,7,person,8,1,13057,87,286,20,402,304,116,284,person
32693,9,scissors,10,0,13057,21,228,138,250,221,22,83,scissors
32694,11,table,12,0,13058,35,10,258,115,354,105,96,dining table
32695,13,table,14,0,13058,20,225,308,331,382,106,74,dining table
32696,16,person,17,0,13058,32,263,136,320,264,57,128,person
32697,17,person,18,0,13058,39,315,130,373,272,58,142,person
32698,9,person,10,0,13062,48,167,99,228,211,61,112,person
32699,3,person,4,1,13066,18,189,201,225,230,36,29,person
32700,4,person,5,1,13066,21,234,195,269,225,35,30,person
32701,33,person,34,1,13066,24,282,193,313,227,31,34,person
32702,44,chair,45,1,13066,29,278,280,381,387,103,107,chair
32703,3,person,4,0,13069,79,236,49,549,368,313,319,person
32704,5,person,6,0,13069,92,45,19,335,357,290,338,person
32705,6,person,7,1,13069,26,13,1,60,95,47,94,person
32706,8,person,9,1,13069,23,351,1,392,85,41,84,person
32707,9,person,10,1,13069,19,393,0,424,91,31,91,person
32708,10,person,11,1,13069,15,424,1,467,71,43,70,person
32709,12,person,13,1,13069,17,477,0,516,90,39,90,person
32710,15,person,16,1,13070,25,162,104,230,345,68,241,person
32711,16,person,17,1,13070,31,81,106,190,390,109,284,person
32712,18,person,19,1,13070,15,276,142,308,203,32,61,person
32713,20,person,21,1,13070,21,343,141,401,269,58,128,person
32714,23,person,24,1,13070,17,483,142,614,291,131,149,person
32715,24,person,25,1,13070,37,386,138,541,529,155,391,person
32716,25,backpack,26,0,13070,29,441,204,608,454,167,250,backpack
32717,26,person,27,1,13070,20,546,126,619,251,73,125,person
32718,27,person,28,1,13070,52,599,44,759,532,160,488,person
32719,4,person,5,0,13072,41,376,51,468,331,92,280,person
32720,10,airplane,11,0,13077,37,680,694,917,758,237,64,airplane
32721,18,person,19,0,13079,18,135,189,148,216,13,27,person
32722,19,person,20,0,13079,19,174,180,183,207,9,27,person
32723,8,person,9,0,13081,28,178,107,215,214,37,107,person
32724,11,person,12,1,13081,20,389,122,421,171,32,49,person
32725,13,person,14,1,13081,22,414,113,461,203,47,90,person
32726,14,person,15,1,13081,26,426,142,478,268,52,126,person
32727,15,person,16,1,13081,18,327,118,377,181,50,63,person
32728,16,person,17,1,13081,24,388,162,439,274,51,112,person
32729,17,person,18,1,13081,19,296,169,334,263,38,94,person
32730,18,person,19,1,13081,33,299,162,367,286,68,124,person
32731,19,person,20,1,13081,30,332,183,438,318,106,135,person
32732,23,person,24,1,13081,31,182,142,250,266,68,124,person
32733,24,person,25,1,13081,24,235,191,337,318,102,127,person
32734,26,person,27,1,13081,26,70,169,169,317,99,148,person
32735,27,person,28,1,13081,16,6,216,137,317,131,101,person
32736,28,person,29,1,13081,24,52,121,87,211,35,90,person
32737,29,person,30,1,13081,18,35,130,58,211,23,81,person
32738,30,person,31,1,13081,18,15,127,39,206,24,79,person
32739,31,person,32,1,13081,21,148,113,167,185,19,72,person
32740,32,person,33,1,13081,15,164,119,178,182,14,63,person
32741,37,person,38,1,13081,17,78,116,96,170,18,54,person
32742,39,person,40,1,13081,16,4,126,19,205,15,79,person
32743,6,person,7,1,13082,23,24,13,98,126,74,113,person
32744,7,person,8,1,13082,24,125,26,176,156,51,130,person
32745,8,person,9,0,13082,35,183,75,242,310,59,235,person
32746,9,person,10,0,13082,58,138,113,209,354,71,241,person
32747,10,person,11,1,13082,38,246,51,296,220,50,169,person
32748,11,person,12,1,13082,30,299,36,360,205,61,169,person
32749,12,person,13,0,13082,39,368,24,422,219,54,195,person
32750,13,person,14,0,13082,40,314,116,375,358,61,242,person
32751,14,person,15,0,13082,61,236,119,317,347,81,228,person
32752,3,table,4,0,13085,27,275,208,399,329,124,121,dining table
32753,11,chair,12,1,13085,31,284,185,369,320,85,135,chair
32754,16,chair,17,0,13085,45,377,202,489,328,112,126,chair
32755,5,person,6,0,13088,16,184,160,195,186,11,26,person
32756,6,dog,7,0,13088,15,209,219,228,234,19,15,dog
32757,1,desk,2,0,13092,25,28,71,154,156,126,85,desk
32758,2,chair,3,1,13092,19,73,64,109,131,36,67,chair
32759,4,chair,5,1,13092,20,102,68,153,143,51,75,chair
32760,5,chair,6,1,13092,23,168,54,212,120,44,66,chair
32761,3,person,4,1,13094,34,145,63,223,173,78,110,person
32762,4,person,5,1,13094,38,63,67,155,172,92,105,person
32763,6,person,7,1,13094,17,69,123,113,172,44,49,person
32764,13,hat,13,0,13094,15,181,26,218,67,37,41,hat
32765,18,plate,18,0,13094,19,131,192,165,207,34,15,plate
32766,20,plate,20,0,13094,20,23,192,57,208,34,16,plate
32767,7,window,8,0,13096,15,848,420,1065,866,217,446,window
32768,14,chair,15,1,13096,20,355,704,613,860,258,156,chair
32769,16,chair,17,0,13096,24,683,707,896,976,213,269,chair
32770,21,chair,22,1,13096,19,1038,760,1230,1053,192,293,chair
32771,22,table,23,1,13096,35,0,863,447,1355,447,492,dining table
32772,24,chair,25,0,13096,42,213,834,624,1384,411,550,chair
32773,27,chair,28,1,13096,24,896,940,1118,1352,222,412,chair
32774,28,chair,29,1,13096,24,579,1038,1109,1449,530,411,chair
32775,31,person,32,1,13096,25,1943,521,2120,914,177,393,person
32776,9,person,10,1,13098,18,59,216,109,289,50,73,person
32777,13,person,14,1,13098,28,379,218,497,411,118,193,person
32778,15,person,16,1,13098,25,69,283,130,378,61,95,person
32779,16,person,17,1,13098,28,4,246,116,436,112,190,person
32780,17,person,18,1,13098,16,239,294,306,363,67,69,person
32781,5,umbrella,6,0,13099,19,367,325,486,421,119,96,umbrella
32782,8,person,9,1,13099,24,452,386,488,481,36,95,person
32783,10,car,11,1,13099,16,286,373,320,420,34,47,car
32784,12,person,13,0,13099,22,317,371,338,434,21,63,person
32785,13,person,14,0,13099,22,270,365,290,434,20,69,person
32786,14,person,15,0,13099,22,247,364,269,433,22,69,person
32787,16,car,17,1,13099,27,184,374,252,428,68,54,car
32788,18,person,19,0,13099,27,195,378,223,481,28,103,person
32789,19,person,20,1,13099,24,140,362,165,453,25,91,person
32790,20,person,21,1,13099,21,161,385,197,481,36,96,person
32791,22,person,23,0,13099,22,394,372,430,481,36,109,person
32792,23,person,24,0,13099,22,368,367,396,435,28,68,person
32793,25,person,26,0,13099,17,358,362,374,420,16,58,person
32794,28,person,29,0,13099,17,340,371,358,424,18,53,person
32795,31,person,32,1,13099,15,20,367,47,395,27,28,person
32796,8,table,9,0,13100,37,0,465,321,719,321,254,dining table
32797,11,window,12,0,13100,18,54,192,228,467,174,275,window
32798,7,sofa,8,0,13103,25,0,242,403,526,403,284,couch
32799,4,chair,5,0,13109,20,126,157,164,229,38,72,chair
32800,11,person,12,0,13112,30,230,105,250,163,20,58,person
32801,12,person,13,0,13112,15,168,108,177,128,9,20,person
32802,15,person,16,0,13112,19,91,113,101,136,10,23,person
32803,17,person,18,0,13112,20,119,110,133,140,14,30,person
32804,4,person,5,0,13114,27,107,202,143,323,36,121,person
32805,2,person,3,1,13116,55,5,29,97,165,92,136,person
32806,3,person,4,1,13116,45,9,81,120,227,111,146,person
32807,5,table,6,0,13120,15,134,135,285,223,151,88,dining table
32808,8,chair,9,0,13120,18,47,140,94,204,47,64,chair
32809,13,chair,14,0,13120,16,98,132,133,174,35,42,chair
32810,17,chair,18,0,13120,21,237,156,295,222,58,66,chair
32811,29,chair,30,1,13120,19,99,168,154,222,55,54,chair
32812,5,umbrella,6,1,13123,17,53,208,106,233,53,25,umbrella
32813,10,chair,11,1,13126,16,124,147,140,226,16,79,chair
32814,12,chair,13,1,13126,21,154,178,194,233,40,55,chair
32815,12,bowl,13,0,13127,17,255,568,557,733,302,165,bowl
32816,10,person,11,0,13131,22,33,99,75,126,42,27,person
32817,11,person,12,0,13131,19,20,102,66,131,46,29,person
32818,12,person,13,1,13131,17,103,57,115,86,12,29,person
32819,13,person,14,0,13131,18,179,58,192,99,13,41,person
32820,4,table,5,0,13132,15,262,198,334,294,72,96,dining table
32821,15,chair,16,0,13132,17,10,228,68,305,58,77,chair
32822,4,car,5,1,13133,15,223,69,267,83,44,14,car
32823,10,person,11,0,13133,17,213,85,232,140,19,55,person
32824,11,person,12,1,13133,22,271,139,327,180,56,41,person
32825,13,person,14,1,13133,22,204,136,247,173,43,37,person
32826,14,person,15,1,13133,21,52,148,80,180,28,32,person
32827,3,table,4,0,13134,33,856,535,2188,1531,1332,996,dining table
32828,4,chair,5,1,13134,20,1518,1128,2197,1641,679,513,chair
32829,5,chair,6,1,13134,24,182,407,590,839,408,432,chair
32830,7,chair,8,1,13134,17,1353,399,1728,556,375,157,chair
32831,10,chair,11,1,13134,16,1,525,293,996,292,471,chair
32832,39,chair,40,0,13134,85,178,623,751,1473,573,850,chair
32833,6,person,7,0,13137,25,80,147,105,179,25,32,person
32834,0,sofa,1,0,13138,17,32,89,268,179,236,90,couch
32835,4,vase,5,1,13138,19,4,84,20,164,16,80,vase
32836,5,vase,6,0,13138,18,13,100,33,172,20,72,vase
32837,8,table,9,0,13138,20,269,119,299,181,30,62,dining table
32838,3,person,4,1,13142,24,25,148,141,283,116,135,person
32839,0,person,1,1,13148,63,129,24,272,361,143,337,person
32840,1,person,2,1,13148,41,2,20,186,499,184,479,person
32841,9,bowl,10,0,13148,19,273,414,348,472,75,58,bowl
32842,0,bench,1,0,13151,26,79,201,140,237,61,36,bench
32843,2,person,3,0,13153,37,27,73,63,193,36,120,person
32844,16,person,17,0,13153,33,209,69,237,170,28,101,person
32845,17,person,18,0,13153,35,174,75,200,152,26,77,person
32846,18,person,19,1,13153,21,167,76,180,140,13,64,person
32847,14,person,15,1,13154,27,163,101,250,165,87,64,person
32848,15,person,16,1,13154,29,78,191,229,293,151,102,person
32849,4,bird,5,0,13156,20,239,287,342,392,103,105,bird
32850,5,bird,6,0,13156,15,911,276,958,340,47,64,bird
32851,4,sofa,5,0,13161,25,131,55,189,107,58,52,couch
32852,5,sofa,6,0,13161,27,54,60,121,126,67,66,couch
32853,6,sofa,7,0,13161,32,0,78,74,162,74,84,couch
32854,7,spoon,8,0,13163,17,233,131,296,235,63,104,spoon
32855,8,person,9,0,13163,64,186,18,261,240,75,222,person
32856,9,person,10,0,13163,63,51,24,177,208,126,184,person
32857,2,desk,3,0,13171,16,31,177,158,256,127,79,desk
32858,2,horse,3,0,13173,83,82,156,180,209,98,53,horse
32859,3,person,4,0,13173,34,132,142,153,193,21,51,person
32860,14,person,15,1,13176,15,56,300,81,337,25,37,person
32861,1,person,2,0,13181,18,237,144,267,276,30,132,person
32862,2,person,3,0,13181,17,208,151,241,277,33,126,person
32863,7,person,8,1,13181,39,0,57,351,529,351,472,person
32864,8,person,9,1,13181,59,411,9,799,523,388,514,person
32865,4,person,5,1,13182,47,156,0,321,157,165,157,person
32866,5,person,6,1,13184,28,157,118,279,178,122,60,person
32867,6,person,7,1,13184,36,7,120,145,210,138,90,person
32868,7,person,8,1,13184,27,32,159,149,251,117,92,person
32869,8,person,9,1,13184,15,326,120,365,181,39,61,person
32870,9,person,10,1,13184,28,359,158,479,219,120,61,person
32871,10,person,11,1,13184,35,179,135,363,245,184,110,person
32872,2,truck,3,0,13185,22,1128,1174,2000,1455,872,281,truck
32873,9,person,10,0,13185,27,892,1295,1025,1434,133,139,person
32874,12,person,13,0,13187,77,312,140,531,569,219,429,person
32875,13,person,14,0,13187,45,184,173,292,424,108,251,person
32876,15,chair,16,1,13187,23,0,387,104,566,104,179,chair
32877,16,chair,17,1,13187,21,31,322,148,398,117,76,chair
32878,17,person,18,1,13187,30,13,233,101,402,88,169,person
32879,4,window,5,0,13189,16,135,80,152,98,17,18,window
32880,7,door,8,0,13189,16,74,134,109,191,35,57,door
32881,10,person,11,0,13189,15,78,181,89,206,11,25,person
32882,11,person,12,0,13189,18,136,180,153,207,17,27,person
32883,7,car,8,0,13191,28,112,167,199,200,87,33,car
32884,8,car,9,1,13191,21,61,166,128,196,67,30,car
32885,12,person,13,0,13191,22,48,158,63,196,15,38,person
32886,13,person,14,0,13191,21,27,160,38,195,11,35,person
32887,14,person,15,0,13191,31,217,157,242,212,25,55,person
32888,4,car,5,1,13192,16,542,313,639,453,97,140,car
32889,5,car,6,1,13192,31,370,295,610,442,240,147,car
32890,6,car,7,1,13192,23,275,317,384,419,109,102,car
32891,7,car,8,1,13192,24,209,300,390,399,181,99,car
32892,9,car,10,1,13192,19,111,321,220,370,109,49,car
32893,10,car,11,1,13192,20,46,310,150,363,104,53,car
32894,10,person,11,1,13194,50,130,111,236,298,106,187,person
32895,0,table,1,0,13195,21,1,150,145,256,144,106,dining table
32896,4,chair,5,0,13195,16,46,196,122,254,76,58,chair
32897,5,chair,6,0,13195,19,116,177,169,255,53,78,chair
32898,18,chair,19,1,13195,15,128,136,160,162,32,26,chair
32899,2,flowerpot,3,0,13196,22,77,41,235,201,158,160,potted plant
32900,4,flowerpot,5,0,13196,17,0,185,107,239,107,54,potted plant
32901,2,shoe,3,0,13198,15,48,143,86,166,38,23,shoe
32902,4,boat,5,0,13199,77,126,162,559,448,433,286,boat
32903,6,truck,7,0,13200,35,30,275,199,394,169,119,truck
32904,38,person,39,0,13202,69,490,135,595,381,105,246,person
32905,1,table,2,0,13203,18,23,87,222,199,199,112,dining table
32906,11,desk,12,0,13204,17,35,181,185,255,150,74,desk
32907,14,chair,15,0,13204,26,178,183,248,254,70,71,chair
32908,15,desk,16,0,13204,17,169,120,243,168,74,48,desk
32909,17,chair,18,1,13204,16,125,114,154,155,29,41,chair
32910,15,clock,16,0,13207,35,299,158,352,359,53,201,clock
32911,5,bus,6,1,13211,15,551,54,599,133,48,79,bus
32912,6,bus,7,0,13211,30,151,68,329,180,178,112,bus
32913,7,bus,8,1,13211,25,246,158,557,284,311,126,bus
32914,9,bus,10,0,13211,36,65,241,458,367,393,126,bus
32915,8,car,9,1,13214,17,492,235,594,296,102,61,car
32916,9,person,10,0,13214,15,455,232,475,297,20,65,person
32917,10,person,11,0,13214,20,422,227,450,297,28,70,person
32918,13,car,14,0,13214,51,0,182,593,649,593,467,car
32919,4,boat,5,0,13223,19,76,118,233,163,157,45,boat
32920,9,person,10,0,13223,28,193,78,228,139,35,61,person
32921,5,person,6,0,13225,34,89,135,148,218,59,83,person
32922,6,person,7,0,13225,57,250,99,351,257,101,158,person
32923,7,person,8,0,13225,52,189,109,277,243,88,134,person
32924,8,person,9,0,13225,37,150,109,205,216,55,107,person
32925,9,person,10,0,13225,42,4,102,81,249,77,147,person
32926,10,person,11,0,13225,42,386,106,449,241,63,135,person
32927,11,person,12,0,13225,27,53,73,92,183,39,110,person
32928,12,person,13,1,13225,17,4,110,30,178,26,68,person
32929,18,person,19,1,13225,15,89,27,111,68,22,41,person
32930,20,person,21,1,13225,17,139,30,160,68,21,38,person
32931,22,person,23,1,13225,19,210,16,238,65,28,49,person
32932,23,person,24,1,13225,17,283,14,314,57,31,43,person
32933,24,person,25,1,13225,16,311,33,342,68,31,35,person
32934,25,person,26,1,13225,22,240,27,267,67,27,40,person
32935,27,person,28,1,13225,17,339,35,359,68,20,33,person
32936,29,person,30,1,13225,17,72,16,92,44,20,28,person
32937,31,person,32,1,13225,15,108,19,129,54,21,35,person
32938,32,person,33,1,13225,19,91,12,109,42,18,30,person
32939,6,person,7,0,13229,19,165,217,203,308,38,91,person
32940,10,person,11,0,13229,31,115,221,182,391,67,170,person
32941,11,person,12,0,13229,44,223,206,313,452,90,246,person
32942,17,door,18,0,13231,18,197,140,260,204,63,64,door
32943,8,person,9,0,13233,18,329,104,356,152,27,48,person
32944,24,person,21,0,13233,18,487,60,498,84,11,24,person
32945,26,bicycle,23,1,13233,16,503,69,514,85,11,16,bicycle
32946,27,person,24,0,13233,18,504,57,515,78,11,21,person
32947,28,bicycle,25,1,13233,21,519,68,532,83,13,15,bicycle
32948,29,person,26,0,13233,17,521,57,533,77,12,20,person
32949,0,chair,1,0,13237,28,108,159,171,247,63,88,chair
32950,16,chair,17,0,13237,16,224,127,251,172,27,45,chair
32951,42,chair,43,1,13237,39,184,138,225,197,41,59,chair
32952,43,chair,44,1,13237,38,45,142,80,211,35,69,chair
32953,44,chair,45,1,13237,28,24,137,52,198,28,61,chair
32954,45,chair,46,1,13237,25,5,132,30,187,25,55,chair
32955,8,person,9,0,13242,61,9,28,123,83,114,55,person
32956,9,person,10,1,13242,39,69,29,149,60,80,31,person
32957,10,person,11,0,13242,39,118,23,181,55,63,32,person
32958,11,person,12,1,13242,48,146,10,219,75,73,65,person
32959,1,boat,2,0,13245,77,0,1,316,392,316,391,boat
32960,11,car,12,1,13245,15,184,362,234,425,50,63,car
32961,12,car,13,0,13245,24,195,365,294,480,99,115,car
32962,2,person,3,0,13247,16,408,406,442,509,34,103,person
32963,3,person,4,0,13247,19,376,407,410,503,34,96,person
32964,6,person,7,0,13247,17,59,383,88,461,29,78,person
32965,11,person,12,1,13251,54,127,40,204,158,77,118,person
32966,11,car,12,1,13252,23,95,111,162,139,67,28,car
32967,12,car,13,0,13252,28,137,110,227,145,90,35,car
32968,17,clock,18,0,13253,15,274,3,317,67,43,64,clock
32969,0,person,1,0,13257,81,87,54,217,215,130,161,person
32970,3,chair,4,1,13257,23,94,123,164,189,70,66,chair
32971,7,car,8,0,13258,26,216,525,322,572,106,47,car
32972,12,car,13,0,13258,21,117,520,187,557,70,37,car
32973,13,car,14,0,13258,17,76,523,119,550,43,27,car
32974,20,person,21,0,13258,23,502,507,523,562,21,55,person
32975,21,person,22,0,13258,24,607,510,631,560,24,50,person
32976,2,person,3,1,13264,20,63,55,116,132,53,77,person
32977,8,person,9,1,13264,20,180,49,215,116,35,67,person
32978,9,person,10,1,13264,17,193,51,230,111,37,60,person
32979,10,person,11,0,13264,47,176,44,274,298,98,254,person
32980,7,airplane,8,0,13265,113,2,2,1793,423,1791,421,airplane
32981,7,person,8,0,13267,16,135,375,166,410,31,35,person
32982,8,person,9,0,13267,17,82,377,117,414,35,37,person
32983,9,person,10,1,13267,28,211,281,259,466,48,185,person
32984,10,person,11,1,13267,32,344,295,400,466,56,171,person
32985,11,person,12,0,13267,21,439,389,485,436,46,47,person
32986,12,person,13,0,13267,16,493,390,531,436,38,46,person
32987,19,person,20,0,13267,23,538,380,616,418,78,38,person
32988,7,car,8,0,13272,21,102,132,134,145,32,13,car
32989,48,chair,49,0,13275,22,102,168,136,206,34,38,chair
32990,49,chair,50,0,13275,20,19,196,68,254,49,58,chair
32991,50,chair,51,0,13275,18,44,153,69,176,25,23,chair
32992,10,person,11,1,13279,15,26,87,42,111,16,24,person
32993,3,table,4,0,13282,23,50,135,255,256,205,121,dining table
32994,30,chair,31,0,13282,17,21,89,48,123,27,34,chair
32995,34,person,35,0,13287,21,407,243,421,292,14,49,person
32996,47,person,48,1,13287,16,239,349,254,381,15,32,person
32997,48,person,49,0,13287,22,180,196,190,230,10,34,person
32998,49,person,50,0,13287,26,105,279,150,309,45,30,person
32999,50,person,51,0,13287,23,25,279,96,317,71,38,person
33000,51,person,52,1,13287,15,63,276,102,294,39,18,person
33001,52,person,53,0,13287,24,24,233,56,267,32,34,person
33002,53,person,54,0,13287,20,61,224,105,241,44,17,person
33003,54,person,55,0,13287,18,50,231,63,266,13,35,person
33004,55,person,56,0,13287,18,135,222,150,241,15,19,person
33005,56,person,57,0,13287,20,17,209,46,233,29,24,person
33006,57,person,58,0,13287,20,61,191,74,224,13,33,person
33007,58,person,59,0,13287,17,101,216,140,227,39,11,person
33008,59,person,60,0,13287,16,5,194,22,219,17,25,person
33009,60,person,61,0,13287,20,77,199,85,224,8,25,person
33010,61,person,62,0,13287,16,34,208,53,230,19,22,person
33011,62,person,63,0,13287,21,53,189,63,224,10,35,person
33012,64,person,65,0,13287,15,152,183,160,205,8,22,person
33013,65,person,66,0,13287,20,252,199,259,225,7,26,person
33014,2,boat,3,1,13292,23,99,101,253,279,154,178,boat
33015,4,boat,5,1,13292,32,253,3,520,283,267,280,boat
33016,5,boat,6,1,13292,24,467,172,698,287,231,115,boat
33017,1,book,2,0,13299,15,9,59,76,221,67,162,book
33018,7,person,8,0,13301,45,9,77,66,231,57,154,person
33019,8,person,9,0,13301,35,73,96,112,210,39,114,person
33020,9,person,10,0,13301,45,108,90,159,211,51,121,person
33021,10,person,11,0,13301,43,162,105,192,209,30,104,person
33022,11,person,12,0,13301,36,193,102,228,216,35,114,person
33023,12,person,13,0,13301,35,233,110,261,210,28,100,person
33024,13,person,14,0,13301,24,253,115,273,192,20,77,person
33025,14,person,15,0,13301,34,271,108,297,195,26,87,person
33026,15,person,16,0,13301,40,294,116,326,197,32,81,person
33027,16,person,17,0,13301,30,326,119,349,190,23,71,person
33028,17,person,18,0,13301,23,346,122,367,186,21,64,person
33029,18,person,19,0,13301,32,383,125,407,185,24,60,person
33030,22,person,21,1,13301,29,2,91,28,207,26,116,person
33031,15,sofa,16,1,13302,18,248,234,358,269,110,35,couch
33032,16,sofa,17,0,13302,27,262,255,431,353,169,98,couch
33033,22,chair,23,1,13302,22,247,287,312,447,65,160,chair
33034,5,sofa,6,0,13303,17,0,126,128,214,128,88,couch
33035,6,sofa,7,0,13303,22,168,130,288,215,120,85,couch
33036,21,chair,22,1,13304,16,2,263,212,424,210,161,chair
33037,25,person,26,0,13304,47,1019,345,1392,952,373,607,person
33038,29,person,30,0,13304,44,667,2,922,486,255,484,person
33039,31,person,32,1,13304,18,891,9,994,256,103,247,person
33040,39,person,40,0,13305,28,469,417,496,480,27,63,person
33041,40,person,41,0,13305,23,538,420,560,484,22,64,person
33042,41,person,42,0,13305,26,517,418,540,484,23,66,person
33043,45,person,46,0,13305,24,311,414,341,469,30,55,person
33044,46,person,47,0,13305,18,337,416,357,467,20,51,person
33045,48,person,49,0,13305,19,40,405,55,454,15,49,person
33046,49,person,50,0,13305,20,151,410,170,460,19,50,person
33047,51,dog,52,0,13305,22,435,463,455,474,20,11,dog
33048,6,person,7,1,13306,29,61,115,137,229,76,114,person
33049,7,person,8,1,13306,65,148,108,379,349,231,241,person
33050,1,person,2,1,13314,80,121,78,379,400,258,322,person
33051,3,person,4,0,13315,92,88,37,224,493,136,456,person
33052,4,person,5,1,13315,15,2,303,50,423,48,120,person
33053,5,person,6,1,13315,25,2,208,94,351,92,143,person
33054,6,person,7,1,13315,20,0,266,87,376,87,110,person
33055,8,person,9,1,13315,19,288,287,358,445,70,158,person
33056,9,person,10,1,13315,24,275,197,358,373,83,176,person
33057,0,person,1,1,13317,37,4,13,215,312,211,299,person
33058,9,chair,10,1,13318,28,499,209,597,327,98,118,chair
33059,10,chair,11,1,13318,19,543,220,599,340,56,120,chair
33060,11,table,12,1,13318,28,227,192,365,300,138,108,dining table
33061,12,vase,13,0,13318,22,336,290,397,386,61,96,vase
33062,13,vase,14,0,13318,19,381,294,428,374,47,80,vase
33063,15,chair,16,1,13318,28,417,212,502,348,85,136,chair
33064,2,table,3,0,13322,26,21,109,297,277,276,168,dining table
33065,7,cup,8,0,13322,19,89,172,131,205,42,33,cup
33066,8,cup,9,0,13322,15,242,138,273,159,31,21,cup
33067,11,cup,12,0,13322,19,61,112,92,134,31,22,cup
33068,14,person,15,1,13322,26,49,25,128,127,79,102,person
33069,16,person,17,1,13322,27,207,29,291,144,84,115,person
33070,17,person,18,1,13322,20,271,48,319,277,48,229,person
33071,18,person,19,1,13322,25,2,44,79,277,77,233,person
33072,13,chair,14,0,13323,17,14,107,33,165,19,58,chair
33073,26,desk,27,0,13323,17,85,115,221,251,136,136,desk
33074,1,person,2,0,13324,19,501,1341,580,1497,79,156,person
33075,2,person,3,0,13324,17,1513,1173,1560,1317,47,144,person
33076,6,airplane,7,0,13324,50,201,409,1287,708,1086,299,airplane
33077,7,person,8,0,13324,26,1080,1035,1127,1156,47,121,person
33078,8,person,9,0,13324,21,1601,1143,1644,1286,43,143,person
33079,9,person,10,0,13324,23,1657,1164,1721,1310,64,146,person
33080,10,person,11,1,13324,20,1641,1118,1690,1259,49,141,person
33081,11,person,12,1,13324,24,1721,1135,1765,1279,44,144,person
33082,12,person,13,0,13324,26,1733,1170,1797,1318,64,148,person
33083,13,person,14,0,13324,20,1785,1150,1870,1279,85,129,person
33084,15,person,16,0,13324,15,1869,1156,1916,1252,47,96,person
33085,16,person,17,1,13324,17,1904,1143,1943,1287,39,144,person
33086,17,person,18,0,13324,23,1870,1030,1917,1152,47,122,person
33087,18,person,19,0,13324,20,1912,1039,1951,1162,39,123,person
33088,19,person,20,0,13324,21,1996,1024,2035,1137,39,113,person
33089,20,person,21,0,13324,22,1956,1063,1996,1181,40,118,person
33090,21,person,22,1,13324,17,1174,1360,1220,1496,46,136,person
33091,10,person,11,0,13327,43,146,136,205,269,59,133,person
33092,11,person,12,0,13327,28,100,150,134,275,34,125,person
33093,1,chair,2,0,13330,15,618,523,878,856,260,333,chair
33094,12,pot,13,0,13330,16,1078,927,1127,1097,49,170,potted plant
33095,3,airplane,4,0,13331,70,3,17,199,134,196,117,airplane
33096,5,person,6,0,13331,40,143,76,172,155,29,79,person
33097,6,person,7,0,13331,45,89,73,115,151,26,78,person
33098,7,person,8,0,13331,44,51,69,79,150,28,81,person
33099,11,person,12,0,13334,25,144,263,214,306,70,43,person
33100,12,person,13,0,13334,34,47,284,123,403,76,119,person
33101,13,person,14,0,13334,24,186,355,247,410,61,55,person
33102,8,person,9,0,13335,34,129,275,169,462,40,187,person
33103,13,sofa,14,0,13338,15,908,532,1253,773,345,241,couch
33104,16,table,17,0,13338,24,5,478,225,660,220,182,dining table
33105,3,boat,4,0,13349,24,219,30,275,124,56,94,boat
33106,4,boat,5,0,13349,61,12,31,225,152,213,121,boat
33107,5,car,6,1,13349,16,146,98,189,129,43,31,car
33108,7,person,8,0,13349,22,123,93,135,133,12,40,person
33109,9,person,10,0,13349,21,134,96,145,133,11,37,person
33110,10,person,11,0,13349,23,91,97,101,132,10,35,person
33111,11,car,12,1,13349,17,44,90,92,125,48,35,car
33112,12,person,13,0,13349,21,65,92,76,130,11,38,person
33113,13,person,14,0,13349,18,41,96,50,132,9,36,person
33114,14,car,15,1,13349,17,67,75,120,104,53,29,car
33115,7,person,8,1,13350,25,204,203,286,283,82,80,person
33116,9,person,10,1,13350,27,46,168,164,264,118,96,person
33117,1,person,2,1,13351,51,442,118,558,449,116,331,person
33118,2,person,3,1,13351,52,347,110,449,448,102,338,person
33119,3,person,4,1,13351,20,298,123,350,185,52,62,person
33120,4,person,5,1,13351,40,256,102,334,294,78,192,person
33121,6,person,7,1,13351,24,292,140,367,304,75,164,person
33122,7,person,8,1,13351,16,164,130,245,221,81,91,person
33123,11,person,11,1,13351,22,140,136,176,296,36,160,person
33124,12,person,12,1,13351,24,133,137,152,240,19,103,person
33125,13,person,13,1,13351,25,54,134,86,284,32,150,person
33126,14,person,14,0,13351,56,61,132,117,293,56,161,person
33127,8,person,9,1,13352,20,238,144,262,179,24,35,person
33128,9,person,10,0,13352,43,262,224,336,324,74,100,person
33129,6,bus,7,0,13353,30,49,6,509,382,460,376,bus
33130,13,person,14,1,13353,16,24,246,48,312,24,66,person
33131,3,table,4,0,13357,21,92,169,333,299,241,130,dining table
33132,4,table,5,0,13357,36,292,134,434,267,142,133,dining table
33133,5,person,6,1,13357,27,138,41,177,134,39,93,person
33134,6,person,7,1,13357,17,102,60,120,108,18,48,person
33135,7,person,8,1,13357,19,33,77,89,139,56,62,person
33136,8,person,9,1,13357,39,0,1,122,298,122,297,person
33137,9,person,10,1,13357,40,94,86,183,299,89,213,person
33138,10,person,11,1,13357,32,177,74,258,195,81,121,person
33139,11,person,12,1,13357,21,241,109,278,178,37,69,person
33140,12,person,13,1,13357,22,183,38,223,116,40,78,person
33141,13,person,14,1,13357,35,235,43,299,171,64,128,person
33142,14,person,15,1,13357,24,286,88,350,166,64,78,person
33143,18,person,19,1,13357,21,420,63,445,135,25,72,person
33144,19,person,20,1,13357,18,324,56,357,127,33,71,person
33145,7,chair,8,0,13358,15,391,221,459,368,68,147,chair
33146,8,chair,9,0,13358,19,472,224,546,372,74,148,chair
33147,9,table,10,1,13358,30,559,268,646,364,87,96,dining table
33148,11,chair,12,1,13358,21,584,241,726,399,142,158,chair
33149,12,chair,13,1,13358,20,610,252,760,402,150,150,chair
33150,14,table,15,1,13358,26,281,270,367,319,86,49,dining table
33151,6,sofa,7,1,13363,19,795,770,1821,1248,1026,478,couch
33152,13,balls,14,0,13363,26,1012,942,1198,1022,186,80,sports ball
33153,21,table,22,1,13363,19,556,762,863,916,307,154,dining table
33154,4,bench,5,0,13366,20,191,166,318,239,127,73,bench
33155,4,person,5,1,13372,17,37,81,50,115,13,34,person
33156,5,person,6,1,13372,15,49,80,67,105,18,25,person
33157,6,person,7,0,13372,29,103,79,122,153,19,74,person
33158,23,person,24,1,13372,15,270,79,285,106,15,27,person
33159,24,person,25,1,13372,19,169,77,182,108,13,31,person
33160,3,person,4,0,13373,15,2,166,61,224,59,58,person
33161,10,person,11,0,13373,16,134,163,142,184,8,21,person
33162,11,person,12,0,13373,15,49,151,55,169,6,18,person
33163,3,table,4,0,13379,19,51,212,191,238,140,26,dining table
33164,4,tables,5,0,13379,32,45,184,255,208,210,24,dining table
33165,3,chair,4,0,13381,26,104,151,162,235,58,84,chair
33166,4,chair,5,0,13381,28,170,151,236,235,66,84,chair
33167,9,chair,9,1,13381,17,143,138,179,167,36,29,chair
33168,11,chair,11,1,13381,16,36,137,69,156,33,19,chair
33169,37,chair,37,0,13381,29,34,147,101,234,67,87,chair
33170,6,table,7,1,13382,15,159,185,248,261,89,76,dining table
33171,27,person,28,1,13385,30,522,144,597,437,75,293,person
33172,4,chair,5,0,13388,25,111,117,144,189,33,72,chair
33173,21,table,22,1,13388,19,51,125,131,154,80,29,dining table
33174,22,table,23,1,13388,20,0,140,115,208,115,68,dining table
33175,2,sofa,3,1,13391,16,171,154,243,186,72,32,couch
33176,3,chair,4,0,13391,27,188,166,249,255,61,89,chair
33177,20,person,21,1,13393,28,322,79,374,127,52,48,person
33178,8,person,9,1,13394,36,722,692,1644,2196,922,1504,person
33179,10,chair,11,1,13395,15,265,433,371,496,106,63,chair
33180,0,cake,1,0,13396,23,239,1,386,92,147,91,cake
33181,9,cake,10,0,13396,17,74,235,143,278,69,43,cake
33182,13,chair,14,1,13397,29,12,165,50,220,38,55,chair
33183,14,table,15,0,13397,24,22,164,90,224,68,60,dining table
33184,15,chair,16,0,13397,19,65,180,107,235,42,55,chair
33185,16,table,17,0,13397,22,115,140,160,184,45,44,dining table
33186,22,chair,23,1,13397,15,159,147,183,185,24,38,chair
33187,25,chair,26,0,13397,22,241,154,267,191,26,37,chair
33188,26,table,27,0,13397,17,234,190,325,219,91,29,dining table
33189,28,chair,29,1,13397,28,200,186,243,257,43,71,chair
33190,30,chair,31,1,13397,20,237,225,297,257,60,32,chair
33191,4,table,5,0,13398,29,0,69,399,290,399,221,dining table
33192,7,desk,8,0,13399,17,0,125,256,184,256,59,desk
33193,29,desk,30,0,13399,17,0,127,139,157,139,30,desk
33194,32,desk,33,1,13399,20,140,91,195,119,55,28,desk
33195,37,desk,38,1,13399,16,160,98,256,141,96,43,desk
33196,0,desk,1,0,13402,48,435,658,814,1126,379,468,desk
33197,1,desk,2,0,13402,47,780,606,1109,1121,329,515,desk
33198,2,desk,3,0,13402,43,1011,557,1301,1033,290,476,desk
33199,4,desk,5,1,13402,46,5,717,423,1124,418,407,desk
33200,10,desk,11,0,13405,32,88,160,112,233,24,73,desk
33201,13,chair,14,0,13405,44,145,150,167,197,22,47,chair
33202,8,car,9,0,13413,27,103,379,215,453,112,74,car
33203,10,car,11,0,13413,34,246,351,466,493,220,142,car
33204,25,chair,26,0,13417,20,48,181,130,255,82,74,chair
33205,26,chair,27,0,13417,16,209,178,256,256,47,78,chair
33206,32,chair,33,1,13417,16,146,116,186,172,40,56,chair
33207,43,table,44,0,13417,16,158,132,256,213,98,81,dining table
33208,47,person,48,1,13417,29,99,56,123,129,24,73,person
33209,8,table,9,0,13420,19,64,139,99,172,35,33,dining table
33210,9,chair,10,0,13420,22,48,130,75,170,27,40,chair
33211,10,chair,11,0,13420,24,91,135,119,170,28,35,chair
33212,3,window,4,0,13423,15,304,130,354,204,50,74,window
33213,4,window,5,0,13423,16,361,129,414,203,53,74,window
33214,5,door,6,0,13423,19,317,352,374,435,57,83,door
33215,12,person,13,0,13423,15,279,388,302,437,23,49,person
33216,16,person,17,1,13423,16,223,417,243,462,20,45,person
33217,7,car,8,1,13426,20,132,201,228,239,96,38,car
33218,9,car,10,0,13426,29,42,191,151,272,109,81,car
33219,12,car,13,1,13426,39,225,195,399,305,174,110,car
33220,13,car,14,1,13426,25,343,210,507,311,164,101,car
33221,6,person,7,0,13428,17,182,276,213,347,31,71,person
33222,4,person,5,0,13429,55,17,39,198,149,181,110,person
33223,4,person,5,0,13431,24,182,151,200,190,18,39,person
33224,5,person,6,0,13431,24,219,150,229,190,10,40,person
33225,6,boat,7,1,13431,28,180,156,219,189,39,33,boat
33226,5,person,6,1,13434,30,1005,243,1142,584,137,341,person
33227,6,person,7,0,13434,53,887,278,990,615,103,337,person
33228,7,person,8,0,13434,33,749,255,860,617,111,362,person
33229,8,person,9,0,13434,27,584,222,683,586,99,364,person
33230,9,person,10,0,13434,42,420,230,530,670,110,440,person
33231,12,person,13,0,13434,39,253,242,392,696,139,454,person
33232,13,person,14,0,13434,35,114,273,263,714,149,441,person
33233,14,person,15,1,13434,15,30,582,227,780,197,198,person
33234,15,person,16,1,13434,22,230,549,477,777,247,228,person
33235,17,person,18,1,13434,18,939,480,1087,704,148,224,person
33236,18,person,19,1,13434,15,985,571,1214,775,229,204,person
33237,9,truck,10,1,13437,19,174,158,220,180,46,22,truck
33238,5,truck,6,0,13438,20,244,142,310,183,66,41,truck
33239,4,person,5,0,13441,20,0,269,32,342,32,73,person
33240,5,horse,6,1,13441,56,165,225,292,427,127,202,horse
33241,6,horse,7,1,13441,28,114,237,193,428,79,191,horse
33242,7,person,8,1,13441,17,184,210,215,271,31,61,person
33243,8,person,9,0,13441,51,48,222,179,450,131,228,person
33244,6,car,7,0,13442,18,623,263,703,329,80,66,car
33245,10,truck,11,0,13442,26,393,214,479,292,86,78,truck
33246,11,car,12,0,13442,25,320,259,393,299,73,40,car
33247,12,person,13,0,13442,16,464,248,478,289,14,41,person
33248,18,car,19,0,13442,15,529,255,586,300,57,45,car
33249,1,door,2,0,13445,16,242,917,398,1088,156,171,door
33250,3,table,4,0,13449,16,101,188,198,285,97,97,dining table
33251,19,person,20,0,13449,48,84,133,136,262,52,129,person
33252,7,chair,8,0,13451,17,135,166,198,242,63,76,chair
33253,42,table,43,0,13451,19,143,120,255,200,112,80,dining table
33254,0,person,1,0,13453,52,112,81,132,148,20,67,person
33255,19,person,20,0,13453,15,66,96,79,125,13,29,person
33256,20,person,21,0,13453,15,79,96,91,126,12,30,person
33257,22,chair,23,1,13453,17,28,151,72,186,44,35,chair
33258,23,chair,24,1,13453,18,27,158,78,197,51,39,chair
33259,24,chair,25,0,13453,38,27,165,85,255,58,90,chair
33260,8,mirror,9,0,13454,38,70,36,120,118,50,82,mirror
33261,12,clock,13,0,13454,28,130,147,164,210,34,63,clock
33262,2,table,3,0,13455,17,0,107,55,162,55,55,dining table
33263,3,table,4,0,13455,16,62,94,101,132,39,38,dining table
33264,21,chair,22,0,13455,20,36,113,75,157,39,44,chair
33265,22,chair,23,1,13455,15,8,162,77,206,69,44,chair
33266,36,chair,37,0,13455,19,87,91,114,122,27,31,chair
33267,12,person,13,0,13456,15,116,238,127,266,11,28,person
33268,13,person,14,0,13456,17,137,234,153,266,16,32,person
33269,19,person,20,0,13456,19,149,238,156,266,7,28,person
33270,2,person,3,0,13461,40,117,62,158,219,41,157,person
33271,0,person,1,1,13462,44,178,107,668,863,490,756,person
33272,2,person,3,1,13462,26,22,146,234,436,212,290,person
33273,7,car,8,0,13465,15,173,215,200,236,27,21,car
33274,16,person,17,0,13465,29,95,208,110,270,15,62,person
33275,6,person,7,0,13469,59,142,41,288,539,146,498,person
33276,0,person,1,1,13471,37,170,40,500,332,330,292,person
33277,1,person,2,1,13471,31,0,33,117,332,117,299,person
33278,2,person,3,1,13471,21,60,170,127,286,67,116,person
33279,3,person,4,1,13471,26,112,160,183,322,71,162,person
33280,4,person,5,1,13471,45,169,39,318,298,149,259,person
33281,33,car,34,0,13472,18,556,725,627,797,71,72,car
33282,34,car,35,0,13472,15,563,598,627,651,64,53,car
33283,38,car,39,0,13472,19,1077,783,1193,836,116,53,car
33284,67,car,68,0,13472,20,598,363,626,374,28,11,car
33285,68,truck,69,0,13472,20,798,355,826,367,28,12,truck
33286,19,boat,20,0,13477,17,151,247,296,322,145,75,boat
33287,4,person,5,0,13478,25,397,155,436,232,39,77,person
33288,5,person,6,0,13478,18,368,150,386,233,18,83,person
33289,6,person,7,0,13478,22,158,221,215,309,57,88,person
33290,8,person,9,1,13478,24,82,201,155,335,73,134,person
33291,1,chair,2,0,13483,37,881,832,1322,1383,441,551,chair
33292,5,window,6,0,13483,17,1820,0,2197,1647,377,1647,window
33293,8,chair,9,1,13483,19,234,1285,1163,1650,929,365,chair
33294,9,chair,10,1,13483,17,1150,1298,1905,1650,755,352,chair
33295,10,chair,11,1,13483,41,1215,1034,1850,1592,635,558,chair
33296,11,chair,12,1,13483,21,1380,897,1814,1229,434,332,chair
33297,12,chair,13,1,13483,18,1333,865,1723,1258,390,393,chair
33298,13,chair,14,1,13483,38,1045,737,1400,1145,355,408,chair
33299,15,table,16,1,13483,63,2,720,934,1646,932,926,dining table
33300,3,cat,4,0,13484,21,200,273,238,314,38,41,cat
33301,10,bed,11,1,13486,18,728,556,1022,809,294,253,bed
33302,11,mirror,12,0,13486,50,575,98,798,413,223,315,mirror
33303,18,chair,19,0,13486,26,174,422,381,707,207,285,chair
33304,19,desk,20,0,13486,17,28,433,345,708,317,275,desk
33305,6,chair,7,1,13494,17,56,103,98,238,42,135,chair
33306,7,chair,8,1,13494,18,0,130,79,261,79,131,chair
33307,3,person,4,0,13496,15,268,53,279,78,11,25,person
33308,4,person,5,0,13496,15,319,529,330,570,11,41,person
33309,5,person,6,0,13496,21,301,541,320,573,19,32,person
33310,3,train,4,0,13497,27,49,80,599,391,550,311,train
33311,3,car,4,0,13500,35,24,136,124,195,100,59,car
33312,0,person,1,1,13501,70,85,39,333,499,248,460,person
33313,2,person,3,1,13501,17,26,108,75,147,49,39,person
33314,24,person,25,1,13501,16,292,317,332,447,40,130,person
33315,0,chair,1,0,13502,25,613,685,902,1058,289,373,chair
33316,5,table,6,0,13502,25,349,675,749,1057,400,382,dining table
33317,15,chair,16,1,13502,21,839,619,1017,911,178,292,chair
33318,33,chair,34,0,13502,84,164,671,429,1043,265,372,chair
33319,47,chair,48,1,13502,26,724,642,864,705,140,63,chair
33320,48,chair,49,1,13502,55,84,613,236,914,152,301,chair
33321,50,plate,51,0,13502,18,404,709,494,725,90,16,plate
33322,51,plate,52,1,13502,19,599,713,682,730,83,17,plate
33323,6,car,7,1,13514,20,127,131,187,165,60,34,car
33324,7,car,8,0,13514,22,78,140,133,182,55,42,car
33325,8,car,9,0,13514,21,131,168,199,211,68,43,car
33326,9,car,10,1,13514,17,276,208,349,250,73,42,car
33327,14,person,15,0,13514,21,58,172,68,207,10,35,person
33328,15,person,16,0,13514,23,71,172,83,206,12,34,person
33329,2,person,3,1,13518,43,133,80,226,234,93,154,person
33330,3,person,4,1,13518,39,150,139,280,266,130,127,person
33331,7,boat,8,0,13520,15,133,61,158,106,25,45,boat
33332,2,train,3,0,13521,41,0,47,467,767,467,720,train
33333,3,train,4,1,13521,42,368,224,701,636,333,412,train
33334,4,train,5,1,13521,31,629,281,808,570,179,289,train
33335,5,train,6,1,13521,24,744,317,877,536,133,219,train
33336,6,train,7,1,13521,23,817,337,926,516,109,179,train
33337,7,train,8,1,13521,15,871,357,956,503,85,146,train
33338,10,window,11,0,13521,17,115,148,307,391,192,243,window
33339,6,car,7,1,13523,18,183,11,217,22,34,11,car
33340,7,car,8,0,13523,15,259,22,285,34,26,12,car
33341,8,car,9,0,13523,16,306,28,336,40,30,12,car
33342,9,car,10,0,13523,15,342,42,365,54,23,12,car
33343,12,car,13,0,13523,17,401,262,442,281,41,19,car
33344,14,car,15,0,13523,16,471,217,500,236,29,19,car
33345,16,car,17,0,13523,18,428,271,461,291,33,20,car
33346,17,car,18,0,13523,18,466,256,512,280,46,24,car
33347,18,car,19,0,13523,15,203,29,231,42,28,13,car
33348,19,car,20,0,13523,17,156,40,188,52,32,12,car
33349,20,car,21,0,13523,15,303,264,342,282,39,18,car
33350,23,car,24,0,13523,15,25,69,57,87,32,18,car
33351,25,car,26,0,13523,15,73,61,104,82,31,21,car
33352,29,car,30,0,13523,15,109,51,138,65,29,14,car
33353,33,car,34,0,13523,15,173,30,201,42,28,12,car
33354,39,car,40,0,13523,17,491,97,519,115,28,18,car
33355,42,car,43,0,13523,19,117,7,141,18,24,11,car
33356,6,person,7,0,13526,30,194,206,228,341,34,135,person
33357,7,person,8,0,13526,17,52,261,66,300,14,39,person
33358,3,chair,4,1,13531,16,74,184,323,397,249,213,chair
33359,3,table,4,0,13533,15,948,533,1233,787,285,254,dining table
33360,8,table,9,0,13533,20,556,461,759,573,203,112,dining table
33361,3,chair,4,0,13540,20,623,1194,921,1600,298,406,chair
33362,8,table,9,0,13540,17,442,1167,1096,1594,654,427,dining table
33363,9,chair,10,0,13540,25,244,1161,516,1599,272,438,chair
33364,10,chair,11,0,13540,26,1055,1152,1355,1598,300,446,chair
33365,16,chair,17,1,13540,19,469,1113,599,1221,130,108,chair
33366,17,chair,18,1,13540,24,928,1124,1061,1240,133,116,chair
33367,38,plate,39,0,13540,19,893,1182,1005,1208,112,26,plate
33368,58,flowerpot,59,0,13540,17,1056,1170,1116,1226,60,56,potted plant
33369,7,truck,8,0,13542,19,107,809,233,918,126,109,truck
33370,8,truck,9,1,13542,17,260,815,373,920,113,105,truck
33371,2,airplane,3,0,13547,84,0,5,170,126,170,121,airplane
33372,8,person,9,0,13547,32,120,70,137,104,17,34,person
33373,4,chair,5,0,13548,32,107,73,225,254,118,181,chair
33374,6,desk,7,0,13548,15,58,115,230,221,172,106,desk
33375,4,person,5,0,13549,32,137,171,166,255,29,84,person
33376,5,person,6,0,13549,35,81,161,114,294,33,133,person
33377,20,person,21,1,13550,45,335,115,502,477,167,362,person
33378,3,person,4,1,13551,25,54,77,97,149,43,72,person
33379,4,person,5,1,13551,33,130,79,188,144,58,65,person
33380,5,person,6,1,13551,26,83,106,125,182,42,76,person
33381,6,person,7,1,13551,27,34,139,89,201,55,62,person
33382,7,person,8,1,13551,34,129,113,187,177,58,64,person
33383,8,person,9,1,13551,31,196,83,240,178,44,95,person
33384,9,person,10,1,13551,34,275,83,324,248,49,165,person
33385,10,person,11,1,13551,36,224,114,297,225,73,111,person
33386,11,chair,12,1,13551,26,263,118,315,247,52,129,chair
33387,12,chair,13,1,13551,20,19,158,45,216,26,58,chair
33388,13,table,14,0,13551,19,27,174,302,250,275,76,dining table
33389,16,cup,17,0,13551,17,125,196,154,217,29,21,cup
33390,17,cup,18,0,13551,19,219,186,253,208,34,22,cup
33391,19,cup,20,0,13551,16,86,180,115,196,29,16,cup
33392,20,mirror,21,1,13551,25,72,6,177,118,105,112,mirror
33393,6,table,7,1,13553,22,115,259,290,375,175,116,dining table
33394,9,chair,10,0,13553,24,116,205,235,413,119,208,chair
33395,2,person,3,0,13556,16,125,115,130,138,5,23,person
33396,11,umbrella,12,0,13558,23,51,19,106,128,55,109,umbrella
33397,12,umbrella,13,0,13558,21,304,17,358,126,54,109,umbrella
33398,13,umbrella,14,0,13558,15,459,11,499,132,40,121,umbrella
33399,7,window,8,1,13559,16,123,113,173,239,50,126,window
33400,13,car,14,0,13564,15,70,167,93,186,23,19,car
33401,0,desk,1,0,13570,38,74,146,206,216,132,70,desk
33402,8,chair,9,0,13575,15,557,489,639,588,82,99,chair
33403,9,chair,10,0,13575,20,656,502,756,597,100,95,chair
33404,14,chair,15,0,13575,16,45,485,128,595,83,110,chair
33405,15,person,16,0,13575,35,69,430,146,593,77,163,person
33406,16,person,17,1,13575,21,136,433,208,536,72,103,person
33407,17,person,18,1,13575,21,560,398,636,513,76,115,person
33408,18,person,19,1,13575,26,650,411,740,563,90,152,person
33409,23,person,24,1,13575,19,303,438,323,510,20,72,person
33410,24,person,25,0,13575,21,479,436,508,515,29,79,person
33411,25,person,26,1,13575,15,323,478,367,524,44,46,person
33412,27,person,28,0,13575,21,441,428,468,510,27,82,person
33413,28,person,29,0,13575,16,667,335,684,388,17,53,person
33414,29,person,30,0,13575,22,748,342,768,414,20,72,person
33415,34,person,35,0,13575,19,87,319,104,367,17,48,person
33416,37,person,38,0,13575,18,237,394,259,433,22,39,person
33417,38,person,39,1,13575,16,204,429,239,479,35,50,person
33418,44,person,45,1,13575,16,405,356,425,388,20,32,person
33419,46,person,47,1,13575,15,356,405,384,433,28,28,person
33420,48,person,49,0,13575,21,772,346,792,424,20,78,person
33421,49,person,50,0,13575,18,643,327,654,382,11,55,person
33422,50,person,51,1,13575,15,181,400,195,435,14,35,person
33423,52,chair,53,0,13575,19,18,345,38,372,20,27,chair
33424,53,table,54,1,13575,15,2,479,75,531,73,52,dining table
33425,12,person,13,1,13577,28,3,569,121,786,118,217,person
33426,14,person,15,0,13577,20,652,57,688,166,36,109,person
33427,16,person,17,0,13577,20,754,84,783,180,29,96,person
33428,17,person,18,0,13577,17,798,86,827,177,29,91,person
33429,18,person,19,0,13577,18,845,87,869,180,24,93,person
33430,20,person,21,0,13577,17,1560,125,1588,204,28,79,person
33431,22,chair,23,0,13577,26,1752,1277,1817,1385,65,108,chair
33432,23,chair,24,0,13577,28,1636,1272,1701,1375,65,103,chair
33433,24,chair,25,0,13577,22,1955,1120,2023,1211,68,91,chair
33434,25,chair,26,0,13577,20,1890,1102,1952,1182,62,80,chair
33435,34,car,35,0,13583,23,638,90,767,148,129,58,car
33436,6,person,7,0,13591,34,40,94,100,229,60,135,person
33437,4,car,5,1,13592,17,49,159,74,181,25,22,car
33438,8,person,9,0,13592,24,21,167,42,225,21,58,person
33439,9,person,10,0,13592,25,41,166,60,226,19,60,person
33440,10,person,11,0,13592,29,173,154,190,202,17,48,person
33441,11,person,12,0,13592,19,141,154,155,194,14,40,person
33442,16,person,17,0,13592,24,113,159,133,190,20,31,person
33443,20,person,21,0,13592,39,308,157,344,248,36,91,person
33444,21,person,22,1,13592,19,336,159,349,243,13,84,person
33445,15,pot,16,0,13594,21,133,138,214,232,81,94,potted plant
33446,6,person,7,1,13598,62,304,87,603,520,299,433,person
33447,7,person,8,1,13598,49,82,71,315,524,233,453,person
33448,3,person,4,0,13599,67,151,20,235,298,84,278,person
33449,4,person,5,0,13599,43,100,37,172,273,72,236,person
33450,5,person,6,1,13599,41,2,16,100,200,98,184,person
33451,6,person,7,1,13599,37,199,131,357,322,158,191,person
33452,7,person,8,1,13599,28,225,134,424,321,199,187,person
33453,8,person,9,1,13601,27,207,83,232,128,25,45,person
33454,9,person,10,0,13601,35,182,89,216,200,34,111,person
33455,11,table,12,0,13601,18,51,125,156,199,105,74,dining table
33456,22,person,23,0,13601,37,6,94,23,170,17,76,person
33457,23,person,24,0,13601,40,19,98,40,171,21,73,person
33458,24,person,25,0,13601,41,39,92,61,171,22,79,person
33459,7,chair,8,0,13606,22,22,77,77,161,55,84,chair
33460,8,sofa,9,0,13606,15,159,108,356,238,197,130,couch
33461,10,chair,11,1,13606,17,167,68,203,126,36,58,chair
33462,12,sofa,13,0,13606,16,0,138,126,248,126,110,couch
33463,13,chair,14,0,13610,15,78,458,225,640,147,182,chair
33464,14,chair,15,0,13610,16,142,447,264,607,122,160,chair
33465,16,person,17,1,13610,20,131,124,169,192,38,68,person
33466,26,person,27,1,13610,16,166,126,192,192,26,66,person
33467,2,person,3,1,13611,37,110,106,207,336,97,230,person
33468,3,person,4,1,13611,25,279,97,410,322,131,225,person
33469,18,window,19,1,13614,22,234,82,469,191,235,109,window
33470,3,car,4,0,13617,16,170,87,195,97,25,10,car
33471,5,car,6,1,13617,16,124,83,147,94,23,11,car
33472,6,car,7,0,13617,18,103,87,129,96,26,9,car
33473,7,car,8,1,13617,17,41,85,75,101,34,16,car
33474,20,person,21,0,13617,18,101,112,113,132,12,20,person
33475,21,umbrella,22,0,13617,20,77,88,112,119,35,31,umbrella
33476,24,person,25,0,13617,18,72,115,87,131,15,16,person
33477,26,person,27,0,13617,16,51,120,68,134,17,14,person
33478,16,bench,17,0,13618,18,294,174,338,199,44,25,bench
33479,3,person,4,1,13620,45,88,149,522,847,434,698,person
33480,4,person,5,1,13620,49,585,260,1176,631,591,371,person
33481,9,person,10,1,13625,70,17,151,296,240,279,89,person
33482,0,person,1,1,13627,58,166,10,445,333,279,323,person
33483,3,vase,4,0,13627,15,97,194,146,229,49,35,vase
33484,10,chair,11,0,13629,19,51,54,79,93,28,39,chair
33485,11,chair,12,0,13629,16,27,53,49,86,22,33,chair
33486,4,chair,5,0,13630,45,255,605,492,1014,237,409,chair
33487,38,pot,39,0,13630,15,809,419,832,475,23,56,potted plant
33488,47,desk,48,0,13630,41,2,611,309,969,307,358,desk
33489,48,chair,49,1,13630,28,0,795,316,1024,316,229,chair
33490,51,plate,52,1,13630,15,104,643,148,659,44,16,plate
33491,2,car,3,1,13632,15,812,282,892,339,80,57,car
33492,5,car,6,1,13632,15,681,296,754,329,73,33,car
33493,7,person,8,0,13633,23,59,299,74,372,15,73,person
33494,8,person,9,0,13633,22,159,301,183,369,24,68,person
33495,9,person,10,0,13633,24,411,322,448,370,37,48,person
33496,10,person,11,0,13633,23,461,294,482,367,21,73,person
33497,11,person,12,0,13633,22,373,289,396,341,23,52,person
33498,3,person,4,0,13634,29,61,120,87,210,26,90,person
33499,5,person,6,1,13634,17,137,121,159,183,22,62,person
33500,6,person,7,1,13634,20,170,110,193,170,23,60,person
33501,7,person,8,1,13634,15,185,123,207,174,22,51,person
33502,8,person,9,0,13634,22,203,108,224,178,21,70,person
33503,10,person,11,0,13634,37,227,107,266,197,39,90,person
33504,11,person,12,0,13634,31,266,110,302,191,36,81,person
33505,12,person,13,0,13634,16,384,120,404,186,20,66,person
33506,13,person,14,0,13634,22,372,121,388,193,16,72,person
33507,14,person,15,0,13634,28,342,117,372,217,30,100,person
33508,16,person,17,0,13634,30,398,131,428,235,30,104,person
33509,18,bicycle,19,0,13634,29,431,155,455,194,24,39,bicycle
33510,19,person,20,0,13634,47,457,110,536,336,79,226,person
33511,21,person,22,1,13634,17,462,126,494,208,32,82,person
33512,24,car,25,1,13634,21,113,165,241,269,128,104,car
33513,25,person,26,1,13634,16,147,123,180,168,33,45,person
33514,6,person,7,0,13636,41,75,29,97,121,22,92,person
33515,3,table,4,1,13637,30,131,773,1145,1647,1014,874,dining table
33516,10,bench,11,0,13638,37,0,252,200,385,200,133,bench
33517,4,car,5,1,13639,20,0,190,87,250,87,60,car
33518,9,table,10,1,13641,16,162,100,220,134,58,34,dining table
33519,13,chair,14,1,13641,17,213,93,243,147,30,54,chair
33520,16,chair,17,0,13641,18,102,89,126,136,24,47,chair
33521,17,table,18,1,13641,18,15,108,83,141,68,33,dining table
33522,27,table,28,1,13641,15,219,121,250,173,31,52,dining table
33523,30,chair,31,1,13641,18,76,92,90,132,14,40,chair
33524,24,chair,25,0,13647,20,61,177,207,255,146,78,chair
33525,5,car,6,0,13649,15,214,153,270,196,56,43,car
33526,9,table,10,0,13650,16,224,174,374,261,150,87,dining table
33527,10,sofa,11,1,13650,16,338,120,481,202,143,82,couch
33528,12,person,13,0,13650,25,327,117,407,189,80,72,person
33529,14,sofa,15,0,13650,36,8,128,498,333,490,205,couch
33530,15,person,16,1,13650,32,86,166,241,268,155,102,person
33531,16,person,17,1,13650,34,326,173,497,277,171,104,person
33532,6,clock,7,0,13652,15,1530,32,1691,215,161,183,clock
33533,12,chair,13,1,13652,45,1373,1172,1891,1527,518,355,chair
33534,4,table,5,1,13653,17,0,224,401,299,401,75,dining table
33535,45,chair,46,1,13653,17,50,203,122,267,72,64,chair
33536,2,boat,3,1,13655,33,0,9,160,247,160,238,boat
33537,7,vase,8,0,13657,19,358,93,383,239,25,146,vase
33538,4,boat,5,1,13659,27,0,0,639,479,639,479,boat
33539,6,person,7,1,13664,25,607,363,702,554,95,191,person
33540,11,person,12,1,13664,21,95,424,240,555,145,131,person
33541,13,person,14,1,13664,15,522,498,599,552,77,54,person
33542,5,car,6,1,13665,19,388,165,427,185,39,20,car
33543,6,car,7,0,13665,21,361,165,398,189,37,24,car
33544,6,table,7,0,13668,17,214,379,356,476,142,97,dining table
33545,12,table,13,0,13672,17,197,132,250,150,53,18,dining table
33546,16,chair,17,0,13672,16,151,154,193,193,42,39,chair
33547,8,person,9,0,13673,15,179,273,209,305,30,32,person
33548,14,chair,14,0,13675,21,107,137,150,186,43,49,chair
33549,5,table,6,0,13676,55,11,127,179,293,168,166,dining table
33550,11,chair,12,1,13676,15,110,108,158,144,48,36,chair
33551,12,chair,13,1,13676,23,164,115,217,189,53,74,chair
33552,14,chair,15,0,13676,28,111,173,226,333,115,160,chair
33553,3,person,4,1,13678,18,148,86,171,116,23,30,person
33554,4,person,5,1,13678,37,169,81,222,215,53,134,person
33555,5,person,6,1,13678,32,112,73,152,157,40,84,person
33556,6,person,7,1,13678,31,99,114,219,225,120,111,person
33557,9,car,10,0,13681,15,364,280,407,297,43,17,car
33558,4,sink,5,0,13683,17,255,301,591,479,336,178,sink
33559,7,person,8,0,13683,44,170,133,347,262,177,129,person
33560,8,person,9,0,13683,52,115,205,315,364,200,159,person
33561,9,person,10,0,13683,51,2,193,219,476,217,283,person
33562,3,chair,4,1,13684,36,40,47,314,229,274,182,chair
33563,13,bowl,11,0,13684,16,121,197,217,261,96,64,bowl
33564,16,plate,14,0,13684,29,274,307,461,387,187,80,plate
33565,19,plate,17,0,13684,28,63,284,225,352,162,68,plate
33566,22,plate,20,0,13684,19,4,241,102,300,98,59,plate
33567,7,bicycle,8,1,13685,28,270,172,300,240,30,68,bicycle
33568,9,car,10,0,13685,23,165,144,227,164,62,20,car
33569,10,car,11,0,13685,38,13,139,124,204,111,65,car
33570,10,person,11,1,13687,33,169,185,212,424,43,239,person
33571,11,person,12,1,13687,30,184,185,290,424,106,239,person
33572,17,person,18,1,13687,27,332,200,400,323,68,123,person
33573,19,person,20,1,13687,33,95,203,173,425,78,222,person
33574,22,person,23,1,13687,18,400,193,437,262,37,69,person
33575,23,person,24,1,13687,23,428,188,502,297,74,109,person
33576,26,table,27,0,13692,15,127,158,162,196,35,38,dining table
33577,0,chair,1,0,13694,37,93,131,145,209,52,78,chair
33578,2,chair,3,0,13694,29,166,123,209,186,43,63,chair
33579,7,desk,8,0,13694,17,35,129,207,213,172,84,desk
33580,4,car,4,0,13701,26,194,67,353,158,159,91,car
33581,5,car,5,0,13701,32,158,43,268,161,110,118,car
33582,6,car,6,0,13701,26,64,65,210,147,146,82,car
33583,9,car,9,0,13701,20,324,70,375,149,51,79,car
33584,10,car,10,0,13701,25,14,72,89,133,75,61,car
33585,11,car,11,0,13701,18,1,102,48,143,47,41,car
33586,2,person,3,1,13703,47,128,79,377,355,249,276,person
33587,5,car,6,0,13704,30,0,126,202,222,202,96,car
33588,8,car,9,0,13704,21,197,117,272,151,75,34,car
33589,9,car,10,1,13704,20,233,122,302,156,69,34,car
33590,10,car,11,0,13704,27,275,110,380,161,105,51,car
33591,3,car,4,0,13705,18,0,211,69,372,69,161,car
33592,4,car,5,1,13705,23,0,140,102,264,102,124,car
33593,5,car,6,1,13705,23,25,87,137,191,112,104,car
33594,6,car,7,1,13705,25,38,43,142,104,104,61,car
33595,7,car,8,1,13705,20,66,13,152,81,86,68,car
33596,8,car,9,1,13705,22,76,1,174,61,98,60,car
33597,11,car,12,1,13705,16,211,0,291,44,80,44,car
33598,12,car,13,1,13705,24,193,10,285,72,92,62,car
33599,13,car,14,1,13705,25,182,42,277,135,95,93,car
33600,14,car,15,1,13705,23,189,79,299,155,110,76,car
33601,15,car,16,1,13705,25,176,130,299,244,123,114,car
33602,16,car,17,1,13705,34,141,203,298,344,157,141,car
33603,17,car,18,0,13705,17,108,325,299,446,191,121,car
33604,18,person,19,0,13705,21,121,96,172,180,51,84,person
33605,3,person,4,1,13707,65,325,56,1274,1198,949,1142,person
33606,10,person,11,0,13708,62,128,77,308,288,180,211,person
33607,10,parking meter,11,0,13709,25,25,147,64,287,39,140,parking meter
33608,1,chair,2,1,13711,26,2,183,78,315,76,132,chair
33609,6,person,7,0,13713,18,196,70,208,99,12,29,person
33610,19,bicycle,20,0,13713,44,95,126,142,205,47,79,bicycle
33611,20,person,21,0,13713,41,100,77,142,192,42,115,person
33612,1,door,2,0,13718,59,15,40,180,297,165,257,door
33613,13,car,14,0,13719,16,2,256,28,269,26,13,car
33614,60,chair,61,0,13720,16,3,398,57,507,54,109,chair
33615,3,car,4,1,13722,20,209,154,256,179,47,25,car
33616,8,person,9,1,13727,30,192,163,242,244,50,81,person
33617,19,car,20,1,13728,17,208,155,256,182,48,27,car
33618,7,person,8,0,13730,17,0,136,11,203,11,67,person
33619,8,person,9,0,13730,31,11,141,37,206,26,65,person
33620,10,person,11,0,13730,18,101,152,121,181,20,29,person
33621,12,person,13,1,13730,28,270,127,317,218,47,91,person
33622,4,person,5,1,13732,15,176,400,261,457,85,57,person
33623,5,person,6,1,13732,30,35,412,197,501,162,89,person
33624,13,person,14,1,13732,21,215,309,272,424,57,115,person
33625,7,boat,8,0,13734,20,127,120,157,141,30,21,boat
33626,8,boat,9,0,13734,23,215,109,243,140,28,31,boat
33627,13,boat,14,0,13734,16,0,128,56,147,56,19,boat
33628,1,person,2,1,13738,63,201,23,400,267,199,244,person
33629,2,person,3,0,13740,35,89,165,113,237,24,72,person
33630,4,person,5,0,13740,53,116,160,144,247,28,87,person
33631,5,person,6,0,13740,40,159,163,182,254,23,91,person
33632,11,person,12,0,13744,53,17,119,80,265,63,146,person
33633,2,person,3,0,13746,16,100,136,109,165,9,29,person
33634,10,person,11,1,13747,18,1904,614,2025,818,121,204,person
33635,3,car,4,0,13748,27,99,251,223,305,124,54,car
33636,9,dog,10,0,13748,15,341,286,373,314,32,28,dog
33637,5,chair,6,0,13751,22,174,121,219,191,45,70,chair
33638,18,desk,19,0,13752,17,70,99,247,208,177,109,desk
33639,8,car,9,0,13753,15,412,133,446,157,34,24,car
33640,9,car,10,0,13753,31,309,107,407,188,98,81,car
33641,3,airplane,4,0,13756,19,280,233,351,285,71,52,airplane
33642,12,airplane,13,0,13756,19,199,229,255,275,56,46,airplane
33643,32,cup,31,0,13759,25,145,45,200,68,55,23,cup
33644,3,mirror,4,0,13762,74,45,0,190,255,145,255,mirror
33645,10,table,11,0,13769,27,165,148,236,218,71,70,dining table
33646,11,chair,12,0,13769,19,152,149,193,212,41,63,chair
33647,13,table,14,1,13769,22,212,166,286,256,74,90,dining table
33648,14,table,15,1,13769,15,25,142,82,166,57,24,dining table
33649,16,table,17,0,13769,22,17,202,161,299,144,97,dining table
33650,17,chair,18,0,13769,32,104,197,183,298,79,101,chair
33651,18,chair,19,1,13769,19,2,241,101,299,99,58,chair
33652,19,chair,20,1,13769,21,215,174,260,261,45,87,chair
33653,26,chair,27,1,13769,20,348,193,400,264,52,71,chair
33654,5,person,6,1,13770,25,247,392,299,459,52,67,person
33655,1,table,2,0,13773,23,2,178,85,255,83,77,dining table
33656,2,chair,3,0,13773,32,49,179,108,256,59,77,chair
33657,28,chair,29,1,13773,21,2,193,42,255,40,62,chair
33658,1,chair,2,0,13777,15,153,97,256,254,103,157,chair
33659,7,desk,8,0,13777,15,66,113,231,254,165,141,desk
33660,4,bottle,5,0,13781,15,31,189,51,197,20,8,bottle
33661,8,umbrella,9,0,13784,26,175,86,256,184,81,98,umbrella
33662,9,umbrella,10,0,13784,15,158,107,216,127,58,20,umbrella
33663,13,bench,14,0,13784,28,2,162,63,238,61,76,bench
33664,20,chair,21,1,13784,23,190,160,224,218,34,58,chair
33665,10,chair,8,0,13788,49,469,1219,1172,1648,703,429,chair
33666,11,chair,9,0,13788,48,1267,906,1784,1448,517,542,chair
33667,12,chair,10,0,13788,61,1734,789,2163,1241,429,452,chair
33668,13,chair,11,1,13788,26,1585,677,1881,794,296,117,chair
33669,14,chair,12,1,13788,17,1491,753,1680,819,189,66,chair
33670,15,chair,13,1,13788,31,1309,626,1513,784,204,158,chair
33671,16,chair,14,1,13788,23,1164,660,1309,859,145,199,chair
33672,17,chair,15,1,13788,22,702,607,867,742,165,135,chair
33673,18,chair,16,1,13788,26,870,661,1030,845,160,184,chair
33674,19,chair,17,1,13788,42,581,789,928,1266,347,477,chair
33675,20,chair,18,1,13788,22,946,724,1227,901,281,177,chair
33676,21,table,19,1,13788,19,934,614,1474,704,540,90,dining table
33677,22,table,20,1,13788,27,270,650,1000,1038,730,388,dining table
33678,23,table,21,0,13788,27,362,694,1270,1166,908,472,dining table
33679,24,table,22,1,13788,26,1228,657,1857,1057,629,400,dining table
33680,25,table,23,1,13788,28,1497,734,2198,1125,701,391,dining table
33681,26,table,24,1,13788,28,663,817,1762,1341,1099,524,dining table
33682,0,umbrella,1,1,13791,40,101,2,249,156,148,154,umbrella
33683,3,plate,4,0,13791,15,77,155,115,164,38,9,plate
33684,10,person,11,0,13792,23,303,345,342,421,39,76,person
33685,13,table,14,0,13792,28,3,430,194,607,191,177,dining table
33686,4,table,5,0,13794,17,49,418,419,599,370,181,dining table
33687,3,bench,4,0,13796,20,0,112,115,167,115,55,bench
33688,11,person,12,0,13796,32,39,96,80,164,41,68,person
33689,17,table,18,0,13796,19,9,134,34,171,25,37,dining table
33690,2,car,3,1,13798,15,15,179,89,238,74,59,car
33691,3,car,4,1,13798,16,21,173,126,220,105,47,car
33692,9,person,10,0,13799,20,203,551,234,672,31,121,person
33693,15,person,16,1,13799,15,530,519,548,542,18,23,person
33694,6,person,7,0,13800,30,46,121,91,221,45,100,person
33695,7,person,8,1,13800,24,131,128,160,235,29,107,person
33696,7,person,8,1,13802,26,62,62,150,148,88,86,person
33697,8,person,9,1,13802,31,149,84,238,157,89,73,person
33698,1,person,2,0,21749,15,152,334,161,366,9,32,person
33699,2,person,3,0,21749,15,141,332,151,361,10,29,person
33700,2,person,3,1,21751,31,2,27,161,263,159,236,person
33701,7,plant pot,7,0,21756,22,693,392,814,521,121,129,potted plant
33702,9,vase,9,1,21756,21,922,249,1021,461,99,212,vase
33703,13,window,13,0,21756,30,89,1,667,792,578,791,window
33704,16,vase,16,0,21756,24,0,724,157,945,157,221,vase
33705,0,bird,1,0,21760,44,134,82,277,253,143,171,bird
33706,1,airplane,2,0,21770,47,544,899,778,966,234,67,airplane
33707,1,elephant,2,1,21773,25,293,0,478,404,185,404,elephant
33708,2,elephant,3,0,21773,74,115,128,414,636,299,508,elephant
33709,2,person,3,0,21784,36,60,69,80,101,20,32,person
33710,3,person,4,0,21784,34,82,72,106,104,24,32,person
33711,3,person,4,0,21831,65,196,157,321,509,125,352,person
33712,1,elephant,2,0,21833,118,441,265,2023,1499,1582,1234,elephant
33713,1,person,2,0,21834,48,26,107,83,197,57,90,person
33714,1,person,2,1,21835,67,90,26,233,166,143,140,person
33715,3,table,4,0,21835,15,72,157,250,199,178,42,dining table
33716,3,person,4,1,21856,31,101,243,410,597,309,354,person
33717,2,person,3,0,21882,30,44,209,66,248,22,39,person
33718,2,bear,3,1,21894,61,20,16,192,199,172,183,bear
33719,22,person,23,1,218,17,1437,523,1468,563,31,40,person
33720,23,person,24,1,218,19,1845,253,1895,309,50,56,person
33721,24,person,25,1,218,19,1947,173,2010,245,63,72,person
33722,32,person,33,1,218,15,1685,1063,1712,1140,27,77,person
33723,52,person,53,1,218,44,2,1082,68,1317,66,235,person
33724,53,person,54,1,218,47,264,1080,377,1392,113,312,person
33725,56,person,57,1,218,51,1460,1074,1597,1461,137,387,person
33726,68,person,69,1,218,65,1306,1035,1441,1461,135,426,person
33727,79,person,80,0,218,50,673,1065,754,1305,81,240,person
33728,80,person,81,0,218,69,995,998,1107,1308,112,310,person
33729,96,person,97,0,218,76,883,984,992,1321,109,337,person
33730,98,person,99,1,218,42,912,925,1006,1071,94,146,person
33731,99,person,100,1,218,24,1134,822,1175,935,41,113,person
33732,100,person,101,0,218,49,1066,818,1160,1035,94,217,person
33733,101,person,102,0,218,42,991,787,1059,1003,68,216,person
33734,102,person,103,1,218,28,960,737,995,871,35,134,person
33735,104,person,105,0,218,61,802,931,898,1229,96,298,person
33736,105,person,106,0,218,42,883,713,940,877,57,164,person
33737,116,person,117,0,218,58,733,838,806,1039,73,201,person
33738,117,person,118,0,218,50,671,826,730,1038,59,212,person
33739,118,person,119,0,218,34,632,684,674,810,42,126,person
33740,119,person,120,0,218,45,582,676,635,808,53,132,person
33741,120,person,121,0,218,52,594,824,680,1059,86,235,person
33742,142,person,143,1,218,16,1056,685,1082,750,26,65,person
33743,2,person,3,0,14212,24,318,262,359,375,41,113,person
33744,3,person,4,0,14212,30,519,174,569,336,50,162,person
33745,4,person,5,0,14212,19,431,224,451,296,20,72,person
33746,5,person,6,1,14212,20,81,356,138,479,57,123,person
33747,6,person,7,1,14212,33,133,314,262,479,129,165,person
33748,7,person,8,1,14212,17,186,295,216,379,30,84,person
33749,8,person,9,1,14212,25,5,390,44,476,39,86,person
33750,11,person,12,0,14212,19,276,266,289,314,13,48,person
33751,12,person,13,0,14212,19,547,158,569,207,22,49,person
33752,13,person,14,0,14212,17,504,153,523,194,19,41,person
33753,15,person,16,0,14212,25,217,296,250,370,33,74,person
33754,8,person,9,0,14214,27,172,275,194,338,22,63,person
33755,9,person,10,0,14214,23,194,272,210,320,16,48,person
33756,10,person,11,0,14214,22,321,255,337,295,16,40,person
33757,11,person,12,0,14214,22,347,279,363,324,16,45,person
33758,14,person,15,0,14214,17,380,249,393,285,13,36,person
33759,15,person,16,0,14214,19,368,249,378,283,10,34,person
33760,16,person,17,0,14214,19,464,250,477,286,13,36,person
33761,17,person,18,0,14214,15,355,231,362,256,7,25,person
33762,18,person,19,0,14214,17,44,273,58,307,14,34,person
33763,26,person,27,0,14214,18,436,247,450,270,14,23,person
33764,4,airplane,5,0,14222,19,761,561,867,607,106,46,airplane
33765,22,airplane,23,0,14223,16,393,298,465,323,72,25,airplane
33766,26,airplane,27,0,14223,15,467,325,543,348,76,23,airplane
33767,9,person,10,0,14225,15,282,225,299,285,17,60,person
33768,12,person,13,1,14225,15,324,235,353,293,29,58,person
33769,15,person,16,1,14226,19,1404,589,1484,775,80,186,person
33770,12,table,13,1,14232,16,356,640,536,665,180,25,dining table
33771,14,chair,15,0,14233,16,704,1023,949,1310,245,287,chair
33772,15,chair,16,0,14233,25,325,1035,524,1339,199,304,chair
33773,17,pot,18,0,14233,16,1112,1174,1278,1327,166,153,potted plant
33774,16,table,17,0,14235,18,346,341,509,454,163,113,dining table
33775,17,bench,18,1,14235,16,302,382,390,451,88,69,bench
33776,18,bench,19,0,14235,19,473,377,547,461,74,84,bench
33777,4,car,5,1,14236,23,253,604,544,837,291,233,car
33778,5,car,6,1,14236,15,508,618,907,777,399,159,car
33779,7,chair,8,1,14236,15,571,710,687,896,116,186,chair
33780,8,person,9,0,14236,28,596,667,775,887,179,220,person
33781,9,person,10,0,14236,33,795,656,918,875,123,219,person
33782,7,bench,8,0,14237,23,37,192,235,242,198,50,bench
33783,4,table,5,0,14239,22,174,124,300,224,126,100,dining table
33784,18,sofa,19,0,14248,18,221,343,367,468,146,125,couch
33785,19,bench,20,1,14248,17,347,404,742,597,395,193,bench
33786,7,sofa,8,0,14249,18,469,436,1149,618,680,182,couch
33787,12,bench,13,0,14250,18,680,510,802,542,122,32,bench
33788,12,bench,13,0,14251,19,689,597,855,651,166,54,bench
33789,13,person,14,0,14251,16,757,571,777,621,20,50,person
33790,14,person,15,0,14251,16,782,576,796,619,14,43,person
33791,8,person,9,0,14252,78,106,53,235,273,129,220,person
33792,18,bed,19,0,14255,19,170,167,326,228,156,61,bed
33793,17,person,18,0,14257,17,189,242,204,264,15,22,person
33794,19,person,20,0,14257,18,271,136,280,166,9,30,person
33795,20,person,21,0,14257,17,249,131,257,161,8,30,person
33796,21,person,22,0,14257,17,313,146,319,176,6,30,person
33797,22,person,23,0,14257,18,303,139,315,166,12,27,person
33798,23,person,24,0,14257,16,343,147,352,176,9,29,person
33799,24,person,25,0,14257,15,195,169,201,196,6,27,person
33800,25,person,26,0,14257,16,352,113,360,140,8,27,person
33801,11,person,12,1,14258,16,18,285,55,335,37,50,person
33802,12,person,13,1,14258,22,67,285,106,340,39,55,person
33803,13,person,14,1,14258,15,127,304,164,349,37,45,person
33804,18,person,19,1,14258,20,144,251,168,294,24,43,person
33805,17,person,18,1,14259,16,139,210,157,262,18,52,person
33806,21,person,22,1,14259,17,335,205,360,233,25,28,person
33807,24,person,25,1,14259,18,215,236,239,257,24,21,person
33808,4,table,5,0,14262,23,29,101,106,123,77,22,dining table
33809,6,table,7,1,14262,25,126,102,196,120,70,18,dining table
33810,7,table,8,0,14262,38,170,111,263,143,93,32,dining table
33811,8,desk,9,0,14263,17,0,378,272,596,272,218,desk
33812,8,person,9,1,14265,26,278,202,328,262,50,60,person
33813,10,person,11,1,14265,15,154,220,188,246,34,26,person
33814,11,person,12,1,14265,15,115,231,146,257,31,26,person
33815,13,person,14,1,14265,25,338,188,376,236,38,48,person
33816,14,person,15,1,14265,15,360,185,385,221,25,36,person
33817,12,person,13,0,14266,17,103,667,117,721,14,54,person
33818,13,person,14,0,14266,16,164,666,187,719,23,53,person
33819,14,person,15,0,14266,18,260,668,286,719,26,51,person
33820,7,car,8,0,14268,20,46,393,92,417,46,24,car
33821,8,chair,9,1,14272,17,315,267,359,342,44,75,chair
33822,9,chair,10,0,14272,17,105,278,173,329,68,51,chair
33823,10,chair,11,0,14272,24,552,269,611,344,59,75,chair
33824,11,chair,12,0,14272,20,450,275,516,373,66,98,chair
33825,12,table,13,0,14272,18,514,316,562,354,48,38,dining table
33826,9,person,10,1,14273,18,86,126,123,171,37,45,person
33827,10,person,11,1,14273,31,115,132,184,202,69,70,person
33828,11,person,12,1,14273,17,158,111,185,156,27,45,person
33829,12,person,13,1,14273,23,128,117,154,170,26,53,person
33830,11,chair,12,0,14274,16,195,122,227,163,32,41,chair
33831,9,chair,10,0,14275,19,165,258,262,372,97,114,chair
33832,15,chair,16,0,14275,17,565,255,636,342,71,87,chair
33833,3,window,4,1,14276,20,33,116,164,173,131,57,window
33834,6,table,7,0,14276,15,139,197,313,233,174,36,dining table
33835,7,chair,8,0,14276,18,315,186,381,244,66,58,chair
33836,4,person,5,0,14279,35,176,164,214,258,38,94,person
33837,18,chair,19,0,14281,16,51,169,90,207,39,38,chair
33838,20,table,21,0,14281,20,266,156,336,218,70,62,dining table
33839,21,chair,22,0,14281,25,251,154,291,220,40,66,chair
33840,22,chair,23,0,14281,24,303,158,356,230,53,72,chair
33841,6,table,7,0,14283,17,2,180,125,275,123,95,dining table
33842,11,table,12,0,14285,22,81,181,161,245,80,64,dining table
33843,3,chair,4,0,14286,33,142,137,226,233,84,96,chair
33844,5,chair,6,1,14286,19,124,121,182,192,58,71,chair
33845,6,chair,7,1,14286,18,119,117,169,178,50,61,chair
33846,7,chair,8,1,14286,17,112,110,153,159,41,49,chair
33847,16,chair,17,0,14287,18,143,171,173,216,30,45,chair
33848,10,table,11,1,14289,20,254,160,329,224,75,64,dining table
33849,12,chair,13,0,14289,20,214,165,267,237,53,72,chair
33850,13,chair,14,0,14289,20,278,177,340,249,62,72,chair
33851,15,table,16,0,14289,20,177,210,224,262,47,52,dining table
33852,16,table,17,0,14289,21,155,250,217,299,62,49,dining table
33853,10,chair,11,1,14290,15,87,739,137,996,50,257,chair
33854,17,chair,18,0,14290,23,600,683,806,1084,206,401,chair
33855,18,chair,19,0,14290,24,844,694,1037,1090,193,396,chair
33856,19,chair,20,0,14290,21,287,723,546,1162,259,439,chair
33857,20,chair,21,1,14290,17,271,976,504,1198,233,222,chair
33858,21,chair,22,0,14290,24,1063,757,1332,1198,269,441,chair
33859,10,person,11,1,14291,17,659,695,751,766,92,71,person
33860,4,person,5,0,14294,35,365,199,427,409,62,210,person
33861,5,person,6,0,14294,29,437,212,509,391,72,179,person
33862,10,chair,11,1,14296,16,177,312,263,391,86,79,chair
33863,15,table,16,0,14296,17,421,274,519,383,98,109,dining table
33864,5,person,6,1,14299,38,10,43,125,299,115,256,person
33865,6,person,7,1,14299,69,117,6,278,299,161,293,person
33866,7,person,8,1,14299,66,249,61,409,299,160,238,person
33867,12,person,13,0,14299,23,396,69,417,131,21,62,person
33868,9,person,10,0,14300,20,144,155,162,221,18,66,person
33869,10,person,11,0,14300,25,188,151,204,222,16,71,person
33870,12,person,13,0,14300,28,225,137,259,221,34,84,person
33871,13,person,14,1,14300,18,255,152,266,219,11,67,person
33872,3,person,4,1,14301,49,22,122,144,359,122,237,person
33873,4,person,5,1,14301,33,118,161,174,359,56,198,person
33874,5,person,6,1,14301,51,161,134,258,359,97,225,person
33875,6,person,7,1,14301,52,287,85,449,359,162,274,person
33876,2,person,3,1,14302,28,31,108,135,229,104,121,person
33877,3,person,4,1,14302,24,131,115,181,292,50,177,person
33878,4,person,5,1,14302,30,0,155,132,351,132,196,person
33879,5,chair,6,0,14302,23,18,236,135,391,117,155,chair
33880,6,person,7,1,14302,22,247,176,291,297,44,121,person
33881,7,person,8,1,14302,26,188,118,263,297,75,179,person
33882,8,person,9,1,14302,26,388,177,466,311,78,134,person
33883,3,horse,4,1,14303,72,3,107,320,306,317,199,horse
33884,4,person,5,0,14303,57,139,45,233,271,94,226,person
33885,5,person,6,1,14303,40,27,147,119,306,92,159,person
33886,7,person,8,1,14303,17,28,149,66,204,38,55,person
33887,10,person,11,1,14303,26,239,148,340,306,101,158,person
33888,3,person,4,1,14304,25,261,176,359,306,98,130,person
33889,4,person,5,1,14304,39,198,139,302,306,104,167,person
33890,5,person,6,1,14304,19,144,187,211,306,67,119,person
33891,7,person,8,1,14304,22,111,206,182,306,71,100,person
33892,8,person,9,1,14304,26,58,190,126,296,68,106,person
33893,10,person,11,1,14304,21,21,220,128,306,107,86,person
33894,11,person,12,1,14304,16,0,180,32,306,32,126,person
33895,2,person,3,1,14305,42,353,82,478,638,125,556,person
33896,6,person,7,1,14305,21,245,164,279,289,34,125,person
33897,7,person,8,1,14305,19,148,170,192,270,44,100,person
33898,9,person,10,1,14305,32,179,196,263,523,84,327,person
33899,10,person,11,0,14305,45,240,147,368,456,128,309,person
33900,11,person,12,0,14305,37,55,172,236,639,181,467,person
33901,3,umbrella,4,0,14306,15,116,139,204,257,88,118,umbrella
33902,9,bus,10,0,14306,23,339,92,500,222,161,130,bus
33903,10,person,11,0,14306,64,300,146,372,355,72,209,person
33904,6,person,7,0,14307,43,116,118,170,299,54,181,person
33905,7,person,8,1,14307,32,62,114,116,260,54,146,person
33906,8,person,9,1,14307,32,15,112,66,305,51,193,person
33907,7,chair,8,0,14311,17,149,388,297,539,148,151,chair
33908,12,sofa,13,0,14313,24,3,311,100,398,97,87,couch
33909,15,table,16,0,14313,15,73,342,106,393,33,51,dining table
33910,2,person,3,0,14323,38,152,195,216,350,64,155,person
33911,3,person,4,1,14323,30,195,182,254,289,59,107,person
33912,4,person,5,1,14323,26,238,178,289,311,51,133,person
33913,5,person,6,0,14323,50,179,208,305,373,126,165,person
33914,6,person,7,1,14323,19,283,196,312,293,29,97,person
33915,7,person,8,1,14323,35,324,190,372,341,48,151,person
33916,8,person,9,0,14323,48,285,200,347,354,62,154,person
33917,9,person,10,0,14323,58,351,208,463,384,112,176,person
33918,4,flowerpot,5,0,14329,23,166,122,205,163,39,41,potted plant
33919,6,table,7,0,14329,16,20,90,102,160,82,70,dining table
33920,7,chair,8,0,14329,31,66,102,154,195,88,93,chair
33921,8,chair,9,1,14329,18,0,115,45,175,45,60,chair
33922,9,chair,10,1,14329,19,9,74,63,118,54,44,chair
33923,11,chair,12,1,14329,17,103,82,158,106,55,24,chair
33924,13,person,14,0,14334,69,208,129,411,596,203,467,person
33925,9,person,10,1,14335,18,181,290,276,476,95,186,person
33926,11,person,12,0,14335,50,202,263,469,897,267,634,person
33927,12,person,13,1,14335,16,374,299,487,435,113,136,person
33928,13,person,14,1,14335,16,570,313,688,473,118,160,person
33929,14,person,15,1,14335,26,686,253,835,501,149,248,person
33930,15,person,16,1,14335,28,854,279,996,691,142,412,person
33931,18,person,19,1,14335,48,978,168,1204,944,226,776,person
33932,2,person,3,0,14336,37,259,190,388,532,129,342,person
33933,3,person,4,1,14336,22,365,170,413,310,48,140,person
33934,4,person,5,0,14336,22,401,143,451,311,50,168,person
33935,5,person,6,1,14336,32,431,143,533,319,102,176,person
33936,6,person,7,1,14336,43,513,146,624,498,111,352,person
33937,22,car,23,1,14336,15,137,124,186,148,49,24,car
33938,9,table,10,1,14337,16,138,106,286,172,148,66,dining table
33939,15,flowerpot,16,0,14337,17,338,126,404,182,66,56,potted plant
33940,6,cat,7,1,14339,30,2,240,63,304,61,64,cat
33941,8,table,9,1,14339,18,220,211,298,374,78,163,dining table
33942,22,person,23,1,14340,22,34,193,98,279,64,86,person
33943,24,person,25,1,14340,17,316,152,340,216,24,64,person
33944,25,person,26,1,14340,15,346,175,392,242,46,67,person
33945,26,person,27,1,14340,17,304,199,362,248,58,49,person
33946,29,person,30,1,14340,28,198,146,253,316,55,170,person
33947,30,person,31,1,14340,15,366,190,414,243,48,53,person
33948,31,person,32,1,14340,19,398,194,431,292,33,98,person
33949,32,person,33,1,14340,25,254,201,310,321,56,120,person
33950,34,person,35,0,14340,56,415,137,531,477,116,340,person
33951,35,person,36,0,14340,57,97,157,218,479,121,322,person
33952,8,table,9,0,14341,18,133,104,208,170,75,66,dining table
33953,10,person,11,1,14341,26,90,46,117,121,27,75,person
33954,11,person,12,1,14341,18,108,47,121,91,13,44,person
33955,12,person,13,1,14341,22,124,58,152,114,28,56,person
33956,22,person,23,0,14341,52,222,43,268,178,46,135,person
33957,23,person,24,1,14341,25,234,59,248,123,14,64,person
33958,24,person,25,0,14341,41,263,55,290,165,27,110,person
33959,1,person,2,0,14342,46,51,70,192,499,141,429,person
33960,3,dog,4,1,14343,28,57,397,615,959,558,562,dog
33961,4,person,5,1,14351,43,179,69,236,141,57,72,person
33962,5,person,6,1,14351,32,148,17,177,61,29,44,person
33963,6,person,7,1,14351,20,118,89,144,121,26,32,person
33964,7,person,8,1,14351,21,82,68,125,117,43,49,person
33965,8,person,9,1,14351,37,54,86,142,159,88,73,person
33966,11,person,12,1,14351,17,182,1,204,32,22,31,person
33967,12,person,13,1,14351,19,195,0,223,27,28,27,person
33968,5,person,6,0,14352,22,1192,2,1228,143,36,141,person
33969,6,person,7,1,14352,16,1374,12,1416,82,42,70,person
33970,7,person,8,0,14352,24,970,0,1024,112,54,112,person
33971,4,person,5,1,14354,28,367,311,436,406,69,95,person
33972,5,person,6,1,14354,25,279,323,347,402,68,79,person
33973,6,person,7,1,14354,19,181,319,257,401,76,82,person
33974,11,person,12,0,14356,17,276,245,288,284,12,39,person
33975,12,person,13,0,14356,17,289,246,300,284,11,38,person
33976,13,person,14,0,14356,17,459,247,474,280,15,33,person
33977,14,person,15,0,14356,20,492,243,511,284,19,41,person
33978,13,person,14,1,14358,18,220,56,236,94,16,38,person
33979,14,person,15,1,14358,16,235,47,254,94,19,47,person
33980,15,person,16,1,14358,15,252,47,272,94,20,47,person
33981,16,person,17,1,14358,15,444,55,471,86,27,31,person
33982,18,person,19,0,14358,17,225,256,249,296,24,40,person
33983,19,person,20,0,14358,18,245,248,268,290,23,42,person
33984,20,person,21,0,14358,15,479,202,491,237,12,35,person
33985,12,person,13,0,14364,18,6,114,17,137,11,23,person
33986,16,person,17,0,14364,19,351,134,362,166,11,32,person
33987,8,person,9,0,14365,32,127,140,175,254,48,114,person
33988,9,person,10,0,14365,27,276,151,318,210,42,59,person
33989,34,hat,35,0,937,15,159,159,189,174,30,15,hat
33990,49,bed,50,1,937,23,53,208,290,290,237,82,bed
33991,3,person,4,1,14369,24,149,92,184,158,35,66,person
33992,4,person,5,1,14369,50,165,145,215,262,50,117,person
33993,7,person,8,1,14369,16,207,121,243,159,36,38,person
33994,8,person,9,1,14369,26,216,123,292,263,76,140,person
33995,13,plate,14,0,14371,18,92,132,150,172,58,40,plate
33996,15,spoon,16,0,14371,16,33,152,87,178,54,26,spoon
33997,22,fork,23,0,14371,15,162,152,200,195,38,43,fork
33998,23,fork,24,0,14371,17,167,143,209,190,42,47,fork
33999,24,plate,25,0,14371,22,182,108,284,173,102,65,plate
34000,6,chair,7,0,14372,22,118,157,208,314,90,157,chair
34001,7,chair,8,1,14372,18,71,106,130,189,59,83,chair
34002,8,chair,9,1,14372,23,2,118,72,201,70,83,chair
34003,9,table,10,1,14372,17,22,157,101,207,79,50,dining table
34004,13,person,14,1,14372,17,224,65,247,259,23,194,person
34005,3,person,4,1,14373,21,358,27,406,92,48,65,person
34006,4,person,5,0,14373,27,408,36,460,148,52,112,person
34007,3,bowl,4,0,14378,17,2,114,70,169,68,55,bowl
34008,7,bowl,8,0,14378,15,26,73,83,118,57,45,bowl
34009,5,spoon,6,0,14379,16,178,112,251,124,73,12,spoon
34010,9,spoon,10,0,14380,17,126,220,182,228,56,8,spoon
34011,0,table,1,0,14383,25,244,61,499,264,255,203,dining table
34012,2,table,3,0,14383,46,32,72,499,384,467,312,dining table
34013,12,bowl,13,0,14383,26,200,139,309,220,109,81,bowl
34014,29,person,30,1,14383,30,209,0,247,93,38,93,person
34015,20,chair,21,0,14385,18,256,82,274,122,18,40,chair
34016,13,spoon,14,0,14386,18,101,150,253,210,152,60,spoon
34017,14,spoon,15,1,14386,16,176,130,255,157,79,27,spoon
34018,15,person,16,1,14386,21,0,0,51,105,51,105,person
34019,16,person,17,1,14386,19,197,0,235,54,38,54,person
34020,19,person,20,1,14386,15,156,0,174,29,18,29,person
34021,20,person,21,1,14386,19,168,2,195,61,27,59,person
34022,2,table,3,1,14387,16,0,39,85,120,85,81,dining table
34023,0,table,1,0,14388,22,0,39,256,255,256,216,dining table
34024,12,fork,13,0,14388,21,108,149,125,199,17,50,fork
34025,19,cake,19,0,14388,15,132,153,166,179,34,26,cake
34026,27,chair,27,1,14388,29,0,0,81,96,81,96,chair
34027,32,cup,32,0,14388,17,166,109,212,139,46,30,cup
34028,33,plate,33,0,14388,22,158,121,213,148,55,27,plate
34029,34,cup,34,0,14388,15,86,40,111,54,25,14,cup
34030,35,plate,35,0,14388,21,80,43,116,60,36,17,plate
34031,2,plate,3,0,14390,16,185,137,245,167,60,30,plate
34032,5,plate,6,0,14390,16,145,129,194,156,49,27,plate
34033,16,vase,17,0,14390,16,69,47,111,101,42,54,vase
34034,18,person,19,1,14390,31,136,0,240,80,104,80,person
34035,19,person,20,1,14390,32,149,0,255,75,106,75,person
34036,0,table,1,0,14391,50,0,83,255,255,255,172,dining table
34037,14,bowl,15,0,14393,17,193,90,255,160,62,70,bowl
34038,0,table,1,0,14394,21,0,79,255,256,255,177,dining table
34039,5,bottle,6,0,14394,15,42,15,71,119,29,104,bottle
34040,8,bottle,9,0,14394,15,119,10,147,108,28,98,bottle
34041,21,cake,22,0,14395,15,583,146,638,171,55,25,cake
34042,9,spoon,10,0,14396,17,192,73,276,101,84,28,spoon
34043,12,fork,13,0,14396,29,314,6,352,92,38,86,fork
34044,32,spoon,33,0,14396,18,25,11,67,91,42,80,spoon
34045,5,bed,6,0,14399,42,18,14,189,219,171,205,bed
34046,15,car,16,0,14400,15,859,1240,963,1312,104,72,car
34047,4,truck,5,0,14401,31,76,127,249,212,173,85,truck
34048,13,truck,14,1,14401,18,280,151,342,192,62,41,truck
34049,9,car,10,0,14404,15,179,241,211,270,32,29,car
34050,13,car,14,0,14404,15,251,235,299,274,48,39,car
34051,5,car,6,0,14407,25,296,124,369,173,73,49,car
34052,4,person,5,0,14409,18,240,459,293,515,53,56,person
34053,6,person,7,0,14409,18,90,461,147,523,57,62,person
34054,7,person,8,0,14409,18,35,457,115,514,80,57,person
34055,2,person,3,0,14411,40,204,199,602,1171,398,972,person
34056,3,person,4,0,14411,46,600,340,931,1173,331,833,person
34057,4,person,5,0,14411,46,819,215,1222,1184,403,969,person
34058,6,person,7,1,14411,15,721,190,871,365,150,175,person
34059,7,person,8,1,14411,16,875,166,999,367,124,201,person
34060,13,table,14,1,14412,15,82,211,268,265,186,54,dining table
34061,20,car,21,0,14414,17,730,405,799,439,69,34,car
34062,14,car,15,0,14416,22,316,212,401,265,85,53,car
34063,18,bench,17,0,14418,18,88,139,119,158,31,19,bench
34064,9,car,10,0,14429,16,212,134,234,147,22,13,car
34065,2,person,3,0,21979,58,244,94,370,327,126,233,person
34066,12,person,13,0,14431,16,543,512,573,593,30,81,person
34067,13,person,14,0,14431,16,413,516,439,600,26,84,person
34068,14,bicycle,15,0,14431,34,276,548,384,615,108,67,bicycle
34069,15,person,16,0,14431,18,318,516,352,616,34,100,person
34070,16,person,17,0,14431,16,21,552,63,610,42,58,person
34071,9,person,10,1,14433,26,190,108,247,146,57,38,person
34072,10,chair,11,0,14433,19,166,179,249,252,83,73,chair
34073,8,table,9,0,14434,18,127,114,224,181,97,67,dining table
34074,9,chair,10,0,14434,30,155,107,190,190,35,83,chair
34075,13,door,14,1,14434,33,159,58,192,131,33,73,door
34076,14,chair,15,0,14434,42,210,104,250,181,40,77,chair
34077,21,chair,22,0,14434,40,112,107,149,168,37,61,chair
34078,4,window,5,0,14436,15,337,154,367,250,30,96,window
34079,15,table,16,0,14437,15,139,242,487,393,348,151,dining table
34080,26,chair,27,1,14437,16,414,226,475,274,61,48,chair
34081,30,chair,31,1,14437,16,47,306,193,392,146,86,chair
34082,20,person,21,0,14440,21,228,287,247,352,19,65,person
34083,21,person,22,0,14440,21,212,285,232,347,20,62,person
34084,8,person,9,0,14441,40,772,325,833,474,61,149,person
34085,9,person,10,0,14441,16,909,349,936,432,27,83,person
34086,26,sofa,27,1,14441,16,182,432,294,504,112,72,couch
34087,27,chair,28,0,14441,26,151,428,239,530,88,102,chair
34088,28,chair,29,0,14441,20,333,417,399,513,66,96,chair
34089,29,table,30,0,14441,21,465,567,721,764,256,197,dining table
34090,33,table,34,0,14441,61,992,567,1114,674,122,107,dining table
34091,7,table,8,0,14442,32,120,220,237,319,117,99,dining table
34092,3,flowerpot,4,0,14445,21,225,71,305,132,80,61,potted plant
34093,8,person,8,1,14446,25,26,500,125,587,99,87,person
34094,5,person,6,0,14450,19,138,360,156,416,18,56,person
34095,6,person,7,1,14450,25,547,348,569,452,22,104,person
34096,7,person,8,0,14450,23,561,370,581,461,20,91,person
34097,7,horse,8,0,14455,46,219,219,277,337,58,118,horse
34098,8,horse,9,0,14455,55,486,210,583,333,97,123,horse
34099,3,cow,4,1,14461,48,148,1,385,302,237,301,cow
34100,4,cow,5,1,14461,43,290,1,526,242,236,241,cow
34101,5,cow,6,1,14461,28,482,1,647,294,165,293,cow
34102,2,person,3,1,14463,45,216,48,383,288,167,240,person
34103,3,chair,4,1,14463,16,173,176,226,294,53,118,chair
34104,6,pots,7,0,14463,19,473,174,515,228,42,54,potted plant
34105,5,person,6,0,14464,23,154,180,228,261,74,81,person
34106,6,person,7,0,14464,43,7,114,136,275,129,161,person
34107,5,person,6,0,14467,74,22,24,221,475,199,451,person
34108,6,person,7,0,14467,43,84,246,167,455,83,209,person
34109,8,person,9,1,14468,50,35,80,136,268,101,188,person
34110,9,person,10,1,14468,54,159,43,240,269,81,226,person
34111,10,person,11,0,14468,52,217,43,306,268,89,225,person
34112,7,person,8,0,14469,51,65,0,187,319,122,319,person
34113,9,person,10,1,14470,31,3,3,181,175,178,172,person
34114,10,person,11,0,14470,44,271,306,478,600,207,294,person
34115,11,person,12,1,14470,37,566,2,797,293,231,291,person
34116,9,person,10,1,14471,23,221,0,283,125,62,125,person
34117,10,person,11,1,14471,37,242,0,354,150,112,150,person
34118,11,person,12,1,14471,55,325,107,512,383,187,276,person
34119,12,person,13,1,14471,17,364,0,447,120,83,120,person
34120,13,person,14,1,14471,30,415,1,500,169,85,168,person
34121,14,person,15,1,14471,18,451,1,512,128,61,127,person
34122,6,car,7,1,14474,48,94,125,495,266,401,141,car
34123,4,bed,5,0,14475,21,75,71,198,148,123,77,bed
34124,6,chair,7,0,14475,20,186,62,241,125,55,63,chair
34125,3,truck,4,0,14478,58,85,59,451,215,366,156,truck
34126,7,person,8,1,14480,18,271,295,288,329,17,34,person
34127,2,person,3,0,14482,53,449,145,617,462,168,317,person
34128,3,hat,4,0,14482,18,449,147,555,221,106,74,hat
34129,7,person,8,0,14482,41,274,225,455,404,181,179,person
34130,4,bench,5,0,14483,17,283,104,312,119,29,15,bench
34131,2,boat,3,0,21983,21,78,137,123,196,45,59,boat
34132,5,person,6,0,14490,24,107,140,119,179,12,39,person
34133,6,person,7,0,14490,31,119,134,135,167,16,33,person
34134,7,person,8,0,14490,24,141,146,150,183,9,37,person
34135,8,person,9,0,14490,21,256,150,271,176,15,26,person
34136,9,person,10,0,14490,22,64,139,75,167,11,28,person
34137,10,person,11,0,14490,18,207,167,219,190,12,23,person
34138,11,person,12,0,14490,20,31,140,43,177,12,37,person
34139,14,person,15,0,14496,16,176,101,204,123,28,22,person
34140,15,table,16,0,14496,27,249,166,348,255,99,89,dining table
34141,16,chair,17,0,14496,17,175,164,250,261,75,97,chair
34142,17,chair,18,1,14496,20,235,146,296,224,61,78,chair
34143,22,dog,23,0,14496,16,153,145,178,156,25,11,dog
34144,23,chair,24,0,14496,18,210,120,231,158,21,38,chair
34145,4,table,5,0,14505,15,191,188,224,201,33,13,dining table
34146,4,car,5,0,14512,16,555,264,619,289,64,25,car
34147,2,car,3,0,14519,24,226,130,289,167,63,37,car
34148,6,umbrella,7,0,14524,16,196,185,267,250,71,65,umbrella
34149,3,person,4,0,14535,20,410,340,431,405,21,65,person
34150,4,person,5,0,14535,17,460,335,484,395,24,60,person
34151,3,person,4,0,21986,27,135,105,161,145,26,40,person
34152,8,car,9,1,14536,25,345,224,433,275,88,51,car
34153,9,car,10,1,14536,21,420,219,511,281,91,62,car
34154,16,car,17,1,14540,15,481,278,537,303,56,25,car
34155,17,person,18,0,14540,21,459,257,482,307,23,50,person
34156,7,person,8,0,14542,15,82,359,99,389,17,30,person
34157,2,car,3,0,14545,36,277,359,445,415,168,56,car
34158,9,car,10,0,14545,20,96,358,182,383,86,25,car
34159,7,person,8,0,14547,36,506,294,581,408,75,114,person
34160,8,person,9,1,14547,18,733,306,781,360,48,54,person
34161,9,person,10,0,14548,16,360,116,368,137,8,21,person
34162,9,car,10,1,14550,16,75,162,117,185,42,23,car
34163,10,car,11,0,14550,20,64,176,120,221,56,45,car
34164,11,car,12,1,14550,23,138,165,193,215,55,50,car
34165,13,car,14,0,14550,22,205,171,261,213,56,42,car
34166,14,car,15,0,14550,24,265,168,320,209,55,41,car
34167,15,car,16,0,14550,23,319,168,383,206,64,38,car
34168,5,person,6,1,14551,29,656,241,815,540,159,299,person
34169,6,person,7,1,14551,25,2,214,106,545,104,331,person
34170,8,person,9,0,14551,58,154,168,510,430,356,262,person
34171,4,person,5,0,14552,33,688,189,759,401,71,212,person
34172,5,person,6,0,14552,45,537,188,607,431,70,243,person
34173,6,person,7,0,14552,51,174,194,266,516,92,322,person
34174,8,person,9,0,14552,31,324,174,485,345,161,171,person
34175,4,person,5,1,14553,27,99,1,134,43,35,42,person
34176,5,person,6,1,14553,53,31,8,92,111,61,103,person
34177,8,person,9,1,14553,37,73,10,128,101,55,91,person
34178,9,elephant,10,1,14553,44,20,84,174,200,154,116,elephant
34179,10,person,11,1,14553,17,27,161,53,200,26,39,person
34180,2,elephant,3,1,14554,86,16,138,233,269,217,131,elephant
34181,5,person,6,1,14554,23,11,205,65,269,54,64,person
34182,6,person,7,1,14554,19,88,205,121,269,33,64,person
34183,7,person,8,1,14554,21,113,195,150,269,37,74,person
34184,8,person,9,1,14554,20,185,196,216,269,31,73,person
34185,9,person,10,1,14554,16,210,209,227,269,17,60,person
34186,12,elephant,13,1,14554,49,239,165,350,269,111,104,elephant
34187,13,person,14,0,14554,21,258,127,290,172,32,45,person
34188,14,person,15,1,14554,20,242,205,267,269,25,64,person
34189,15,person,16,1,14554,15,256,205,276,269,20,64,person
34190,16,person,17,1,14554,18,270,194,314,269,44,75,person
34191,17,person,18,1,14554,19,303,188,350,269,47,81,person
34192,0,elephant,1,0,14555,64,11,140,262,363,251,223,elephant
34193,9,person,10,0,14555,23,93,32,138,120,45,88,person
34194,1,umbrella,2,0,14556,37,132,1,315,99,183,98,umbrella
34195,9,car,10,1,14556,20,275,190,364,260,89,70,car
34196,10,elephant,11,1,14556,17,0,203,359,337,359,134,elephant
34197,11,person,12,0,14556,53,2,111,99,311,97,200,person
34198,14,person,15,0,14556,38,108,67,210,218,102,151,person
34199,16,person,17,0,14556,57,114,58,271,259,157,201,person
34200,3,car,4,0,14558,17,283,199,313,208,30,9,car
34201,4,car,5,0,14558,16,134,201,165,211,31,10,car
34202,5,car,6,0,14558,16,86,205,108,212,22,7,car
34203,0,airplane,1,0,14559,44,58,161,1021,572,963,411,airplane
34204,8,person,9,0,14560,73,140,57,306,290,166,233,person
34205,15,chair,16,0,14560,20,2,105,45,162,43,57,chair
34206,9,person,10,1,14563,22,250,207,275,247,25,40,person
34207,10,chair,11,1,14563,17,265,225,285,278,20,53,chair
34208,5,person,6,1,14568,56,153,33,289,224,136,191,person
34209,6,person,7,1,14568,62,86,79,190,204,104,125,person
34210,7,person,8,1,14568,50,75,50,143,156,68,106,person
34211,8,person,9,1,14568,52,80,27,163,132,83,105,person
34212,9,person,10,1,14568,24,46,55,70,101,24,46,person
34213,1,clock,2,0,14569,17,153,85,218,148,65,63,clock
34214,2,person,3,1,14571,24,229,88,281,153,52,65,person
34215,3,person,4,1,14571,23,198,91,229,161,31,70,person
34216,4,person,5,1,14571,21,166,102,216,181,50,79,person
34217,5,person,6,1,14571,25,120,108,173,187,53,79,person
34218,6,person,7,1,14571,33,25,106,121,238,96,132,person
34219,7,person,8,1,14571,29,0,136,73,282,73,146,person
34220,8,person,9,1,14571,23,63,178,201,282,138,104,person
34221,9,person,10,1,14571,27,263,118,378,282,115,164,person
34222,10,table,11,0,14577,24,103,143,395,295,292,152,dining table
34223,6,airplane,7,0,14582,33,0,323,298,423,298,100,airplane
34224,9,car,10,1,14584,15,56,187,98,228,42,41,car
34225,11,car,12,1,14584,17,2,196,76,265,74,69,car
34226,13,car,13,0,14584,29,92,200,239,318,147,118,car
34227,2,person,3,1,14585,23,393,763,505,1177,112,414,person
34228,7,person,8,0,14585,24,636,804,760,987,124,183,person
34229,13,table,14,1,14585,16,1115,860,1771,1286,656,426,dining table
34230,9,person,10,0,14586,41,3,199,84,430,81,231,person
34231,5,person,6,0,14589,15,71,220,83,270,12,50,person
34232,9,person,10,1,14589,15,138,315,159,359,21,44,person
34233,3,toilet,4,0,21995,56,83,101,189,348,106,247,toilet
34234,2,train,3,0,14591,67,2,49,446,277,444,228,train
34235,2,train,3,0,21996,67,2,49,446,277,444,228,train
34236,2,person,3,1,14594,50,3,66,278,257,275,191,person
34237,13,person,14,1,14594,62,254,119,515,411,261,292,person
34238,14,person,15,1,14594,17,500,207,535,360,35,153,person
34239,17,person,18,0,14594,20,539,164,556,222,17,58,person
34240,15,chair,16,0,14597,15,564,208,610,262,46,54,chair
34241,16,chair,17,0,14597,15,528,203,567,248,39,45,chair
34242,4,truck,5,0,14601,24,495,276,594,325,99,49,truck
34243,7,person,8,0,14601,15,55,298,69,331,14,33,person
34244,2,truck,3,0,14602,30,38,148,140,169,102,21,truck
34245,5,window,6,0,939,55,205,143,425,403,220,260,window
34246,25,chair,26,1,939,22,382,281,435,394,53,113,chair
34247,26,chair,27,1,939,31,208,281,316,446,108,165,chair
34248,27,chair,28,0,939,50,220,293,361,519,141,226,chair
34249,36,chair,37,0,939,48,362,290,498,503,136,213,chair
34250,47,table,48,1,939,24,285,323,450,412,165,89,dining table
34251,5,window,6,0,14614,16,269,227,332,289,63,62,window
34252,6,person,6,1,14615,26,168,154,306,280,138,126,person
34253,7,chair,7,1,14615,18,91,204,217,298,126,94,chair
34254,5,person,6,0,14617,41,276,159,305,236,29,77,person
34255,6,person,7,0,14617,36,153,160,183,250,30,90,person
34256,7,person,8,0,14617,27,334,165,358,238,24,73,person
34257,8,person,9,0,14617,27,353,167,373,233,20,66,person
34258,9,person,10,0,14617,28,233,160,254,246,21,86,person
34259,10,person,11,0,14617,26,250,160,275,253,25,93,person
34260,11,person,12,0,14617,22,126,156,151,226,25,70,person
34261,12,person,13,0,14617,20,392,168,404,208,12,40,person
34262,1,chair,2,0,14619,15,216,328,341,513,125,185,chair
34263,6,car,7,0,14620,24,292,86,534,176,242,90,car
34264,10,car,11,1,14620,16,701,120,840,229,139,109,car
34265,11,car,12,1,14620,26,802,56,1024,255,222,199,car
34266,14,bicycle,15,1,14623,23,260,665,331,837,71,172,bicycle
34267,15,person,16,0,14623,40,249,551,349,805,100,254,person
34268,9,mirror,10,0,14625,15,182,51,217,135,35,84,mirror
34269,14,person,15,0,14626,18,108,99,116,128,8,29,person
34270,4,table,5,0,14627,28,99,118,176,167,77,49,dining table
34271,5,table,6,0,14627,16,6,111,88,138,82,27,dining table
34272,9,chair,10,1,14627,17,66,146,135,200,69,54,chair
34273,20,chair,21,0,14627,15,184,107,205,134,21,27,chair
34274,21,sofa,22,0,14627,22,201,111,252,139,51,28,couch
34275,4,person,5,0,14628,23,36,309,80,416,44,107,person
34276,5,person,6,0,14628,20,135,321,168,418,33,97,person
34277,6,person,7,0,14628,15,99,322,126,408,27,86,person
34278,8,person,9,0,14628,28,234,320,279,448,45,128,person
34279,9,person,10,0,14628,18,325,317,370,436,45,119,person
34280,10,person,11,0,14628,19,358,318,384,430,26,112,person
34281,11,person,12,0,14628,17,553,337,577,436,24,99,person
34282,12,person,13,0,14628,18,576,338,610,434,34,96,person
34283,15,car,16,1,14628,19,805,414,1023,692,218,278,car
34284,20,bicycle,21,0,14628,52,287,414,477,565,190,151,bicycle
34285,21,bicycle,22,0,14628,39,438,443,587,577,149,134,bicycle
34286,22,bicycle,23,0,14628,55,527,489,728,632,201,143,bicycle
34287,23,bicycle,24,0,14628,33,156,516,322,600,166,84,bicycle
34288,27,bicycle,28,0,14628,39,195,361,315,443,120,82,bicycle
34289,29,person,30,1,14628,17,652,337,708,433,56,96,person
34290,33,bicycle,34,1,14628,28,100,490,225,543,125,53,bicycle
34291,8,person,9,1,14629,17,266,44,303,89,37,45,person
34292,9,person,10,0,14629,25,379,72,415,139,36,67,person
34293,20,car,21,0,14631,15,304,148,342,184,38,36,car
34294,5,elephant,6,0,14639,48,189,62,256,182,67,120,elephant
34295,6,elephant,7,0,14639,32,103,77,147,155,44,78,elephant
34296,7,elephant,8,0,14639,35,49,84,83,140,34,56,elephant
34297,8,elephant,9,0,14639,21,26,90,52,135,26,45,elephant
34298,9,elephant,10,0,14639,18,0,92,25,130,25,38,elephant
34299,10,person,11,0,14639,27,211,21,246,69,35,48,person
34300,11,person,12,1,14639,26,198,16,218,65,20,49,person
34301,12,person,13,1,14639,33,226,12,265,87,39,75,person
34302,13,person,14,0,14639,21,106,43,126,77,20,34,person
34303,14,person,15,0,14639,18,124,49,146,85,22,36,person
34304,16,person,17,1,14639,15,65,62,78,83,13,21,person
34305,17,person,18,1,14639,16,65,75,81,90,16,15,person
34306,18,person,19,1,14639,20,49,64,64,93,15,29,person
34307,20,person,21,1,14639,16,29,67,41,91,12,24,person
34308,7,person,8,1,14640,37,246,205,365,444,119,239,person
34309,8,person,9,1,14640,25,19,251,117,447,98,196,person
34310,1,elephant,2,0,21999,82,98,1,389,218,291,217,elephant
34311,2,elephant,3,0,21999,39,181,137,275,215,94,78,elephant
34312,3,elephant,4,0,21999,46,19,127,118,213,99,86,elephant
34313,8,person,9,1,14641,36,176,39,240,131,64,92,person
34314,9,table,10,0,14641,39,57,111,222,228,165,117,dining table
34315,13,person,14,1,14641,39,241,81,396,203,155,122,person
34316,15,person,16,0,14641,47,144,134,416,294,272,160,person
34317,17,person,18,1,14641,26,2,83,69,186,67,103,person
34318,5,sofa,6,0,14642,26,2,156,230,329,228,173,couch
34319,11,sofa,12,0,14643,17,194,168,480,322,286,154,couch
34320,1,sink,2,0,14644,23,31,155,83,243,52,88,sink
34321,5,person,6,0,14644,37,77,110,98,171,21,61,person
34322,8,person,9,1,14644,23,110,123,124,158,14,35,person
34323,9,person,10,1,14644,20,98,125,113,158,15,33,person
34324,14,person,15,0,14644,20,184,114,198,154,14,40,person
34325,18,person,19,1,14644,27,150,141,219,201,69,60,person
34326,19,hair dryer,20,0,14644,16,212,107,248,142,36,35,hair drier
34327,14,chair,15,1,14647,16,2,313,127,505,125,192,chair
34328,3,motorbike,4,0,14650,43,4,326,169,433,165,107,motorcycle
34329,4,person,5,1,14650,21,137,311,164,381,27,70,person
34330,6,bench,7,0,14650,16,270,389,419,420,149,31,bench
34331,4,person,5,1,14652,24,155,144,181,186,26,42,person
34332,12,person,13,0,14654,40,270,161,319,292,49,131,person
34333,11,flowerpot,12,0,14656,17,61,286,222,343,161,57,potted plant
34334,10,person,11,0,14660,29,238,54,257,114,19,60,person
34335,11,person,12,1,14660,23,157,91,191,116,34,25,person
34336,12,person,13,1,14660,15,144,95,162,109,18,14,person
34337,13,person,14,1,14660,23,69,101,104,133,35,32,person
34338,14,person,15,1,14660,24,33,93,75,118,42,25,person
34339,5,person,6,0,14661,61,7,86,89,203,82,117,person
34340,6,person,7,1,14661,51,48,64,109,178,61,114,person
34341,10,person,11,1,14661,21,151,84,190,118,39,34,person
34342,12,person,13,1,14661,29,252,81,313,154,61,73,person
34343,7,person,8,0,14662,42,8,110,225,167,217,57,person
34344,21,person,22,1,14663,27,1024,390,1196,718,172,328,person
34345,22,person,23,1,14663,19,1125,380,1242,608,117,228,person
34346,26,person,27,1,14663,17,292,390,459,678,167,288,person
34347,27,person,28,1,14663,23,181,415,331,693,150,278,person
34348,5,person,6,0,14667,22,143,262,222,352,79,90,person
34349,6,backpack,7,0,14667,16,231,317,291,370,60,53,backpack
34350,5,table,6,0,14673,26,129,291,373,463,244,172,dining table
34351,5,plate,6,0,14683,34,242,326,526,416,284,90,plate
34352,9,table,10,0,14693,17,361,273,514,303,153,30,dining table
34353,10,bench,11,0,14693,16,355,283,510,302,155,19,bench
34354,3,backpack,4,0,14696,17,263,266,307,351,44,85,backpack
34355,2,person,3,0,14698,48,75,60,119,184,44,124,person
34356,6,bench,7,0,14699,15,267,286,403,321,136,35,bench
34357,15,bird,15,0,14701,20,476,328,554,360,78,32,bird
34358,16,bird,16,0,14701,15,219,317,254,339,35,22,bird
34359,19,bench,19,0,14701,16,348,265,423,286,75,21,bench
34360,12,bench,13,0,14703,28,67,181,141,268,74,87,bench
34361,13,bench,14,0,14703,16,146,163,171,191,25,28,bench
34362,1,umbrella,2,0,14704,34,2,14,222,199,220,185,umbrella
34363,9,bench,10,0,14704,23,11,199,146,299,135,100,bench
34364,10,bench,11,0,14704,16,147,211,222,299,75,88,bench
34365,7,table,8,0,14705,39,331,236,448,383,117,147,dining table
34366,10,chair,11,0,14705,26,462,231,581,382,119,151,chair
34367,6,table,7,0,14707,50,160,121,277,219,117,98,dining table
34368,7,chair,8,0,14707,30,125,112,178,202,53,90,chair
34369,8,chair,9,1,14707,20,245,141,300,222,55,81,chair
34370,15,chair,16,0,14708,21,332,231,443,378,111,147,chair
34371,17,chair,18,1,14708,18,2,295,128,417,126,122,chair
34372,9,person,10,0,14712,17,218,244,235,272,17,28,person
34373,11,person,12,0,14712,16,146,243,166,273,20,30,person
34374,8,boat,9,0,14713,15,285,471,385,519,100,48,boat
34375,9,person,10,1,14724,24,217,121,254,179,37,58,person
34376,10,person,11,0,14726,16,1031,872,1059,953,28,81,person
34377,11,person,12,0,14726,24,1058,863,1088,954,30,91,person
34378,3,person,4,0,14730,17,392,313,412,363,20,50,person
34379,12,car,13,1,14730,16,515,322,564,399,49,77,car
34380,15,car,16,1,14730,16,624,316,728,474,104,158,car
34381,16,car,17,1,14730,21,531,318,666,429,135,111,car
34382,4,bus,5,1,14732,15,168,81,196,95,28,14,bus
34383,11,bus,12,0,14732,17,88,82,124,111,36,29,bus
34384,7,car,8,0,14734,19,188,226,247,269,59,43,car
34385,9,car,10,1,14734,19,136,242,191,330,55,88,car
34386,10,car,11,1,14734,28,41,234,165,362,124,128,car
34387,11,car,12,1,14734,21,0,232,108,374,108,142,car
34388,3,car,4,1,14735,18,71,35,117,65,46,30,car
34389,4,car,5,1,14735,19,217,59,286,92,69,33,car
34390,5,car,6,1,14735,19,274,63,393,136,119,73,car
34391,6,car,7,1,14735,19,245,65,325,110,80,45,car
34392,7,car,8,1,14735,20,0,7,88,112,88,105,car
34393,13,car,14,1,14735,18,30,31,97,75,67,44,car
34394,15,car,16,0,14735,15,358,47,376,58,18,11,car
34395,6,car,7,0,14736,17,357,142,401,163,44,21,car
34396,5,person,6,0,14738,23,170,110,189,158,19,48,person
34397,2,person,3,1,14739,33,95,95,154,202,59,107,person
34398,7,table,8,0,14740,27,88,131,124,188,36,57,dining table
34399,8,chair,9,0,14740,20,112,128,142,181,30,53,chair
34400,17,chair,18,1,14740,16,81,128,105,177,24,49,chair
34401,18,chair,19,1,14740,24,235,153,274,205,39,52,chair
34402,9,person,10,0,14741,38,199,94,244,183,45,89,person
34403,10,person,11,0,14741,36,243,94,279,182,36,88,person
34404,12,person,13,1,14741,32,105,100,149,170,44,70,person
34405,13,person,14,1,14741,36,84,90,111,195,27,105,person
34406,14,person,15,1,14741,33,49,93,88,174,39,81,person
34407,16,person,17,1,14741,30,17,96,54,175,37,79,person
34408,17,person,18,1,14741,21,2,137,47,198,45,61,person
34409,18,person,19,1,14741,35,50,144,143,235,93,91,person
34410,19,table,20,0,14741,18,2,192,63,235,61,43,dining table
34411,20,person,21,1,14741,18,181,90,206,121,25,31,person
34412,7,person,8,1,14742,34,96,52,147,112,51,60,person
34413,8,person,9,1,14742,24,200,64,247,109,47,45,person
34414,11,person,12,1,14743,29,148,173,212,366,64,193,person
34415,12,person,13,1,14743,16,202,196,255,249,53,53,person
34416,13,person,14,1,14743,15,257,191,286,238,29,47,person
34417,14,person,15,1,14743,16,271,199,312,240,41,41,person
34418,3,person,4,1,14744,25,31,114,89,222,58,108,person
34419,5,person,6,1,14744,50,80,63,234,386,154,323,person
34420,6,person,7,1,14744,42,405,72,544,388,139,316,person
34421,4,person,5,1,14745,26,16,83,45,145,29,62,person
34422,5,person,6,1,14745,20,36,82,60,122,24,40,person
34423,6,person,7,1,14745,15,116,92,134,123,18,31,person
34424,7,person,8,1,14745,43,110,72,156,232,46,160,person
34425,5,person,6,1,14747,17,158,70,174,94,16,24,person
34426,9,table,10,0,14747,21,18,116,66,155,48,39,dining table
34427,13,chair,14,0,14747,15,45,124,78,162,33,38,chair
34428,1,truck,2,1,14751,44,174,0,599,391,425,391,truck
34429,5,mirror,6,0,14751,17,489,190,552,229,63,39,mirror
34430,5,person,6,0,14752,24,95,86,123,137,28,51,person
34431,14,person,15,0,14753,45,431,233,647,432,216,199,person
34432,14,car,15,0,14755,25,41,200,206,258,165,58,car
34433,3,dog,4,0,22009,30,191,135,264,236,73,101,dog
34434,1,table,2,0,14756,34,112,137,225,171,113,34,dining table
34435,8,person,9,0,14756,19,272,114,295,169,23,55,person
34436,9,person,10,1,14756,18,211,120,228,162,17,42,person
34437,15,person,16,1,14756,17,89,210,138,250,49,40,person
34438,18,person,19,1,14756,17,296,212,327,248,31,36,person
34439,19,person,20,1,14756,15,144,212,181,241,37,29,person
34440,21,person,22,1,14756,15,173,204,196,231,23,27,person
34441,7,person,8,1,14758,16,148,127,166,150,18,23,person
34442,2,horse,3,1,14761,45,45,100,240,346,195,246,horse
34443,3,door,4,0,14761,22,154,178,254,399,100,221,door
34444,4,person,5,0,14764,62,129,76,206,290,77,214,person
34445,5,person,6,0,14764,46,209,54,285,335,76,281,person
34446,2,horse,3,1,14766,37,239,47,437,213,198,166,horse
34447,5,bed,6,0,14767,24,115,152,285,311,170,159,bed
34448,8,bed,9,1,14767,18,317,157,412,335,95,178,bed
34449,13,sofa,14,0,14767,16,0,177,163,353,163,176,couch
34450,14,chair,15,1,14767,16,406,235,483,354,77,119,chair
34451,16,table,17,1,14767,17,98,269,263,353,165,84,dining table
34452,23,mirror,24,0,14767,20,271,26,379,134,108,108,mirror
34453,3,bed,4,0,14768,28,83,109,200,173,117,64,bed
34454,5,sofa,6,1,14768,18,0,97,92,236,92,139,couch
34455,14,table,15,0,14768,29,63,149,136,236,73,87,dining table
34456,28,person,29,0,14769,49,175,70,224,151,49,81,person
34457,29,person,30,1,14769,28,172,46,224,108,52,62,person
34458,3,person,4,1,14770,15,102,97,121,138,19,41,person
34459,4,car,5,1,14770,28,0,125,155,210,155,85,car
34460,7,car,8,1,14770,20,237,77,283,212,46,135,car
34461,9,person,10,0,14770,26,217,110,249,211,32,101,person
34462,8,person,9,1,14771,46,233,139,344,366,111,227,person
34463,9,person,10,1,14772,33,430,292,590,452,160,160,person
34464,5,chair,6,0,14774,15,373,168,411,210,38,42,chair
34465,13,person,14,0,14777,26,152,223,174,283,22,60,person
34466,14,car,15,0,14777,23,41,226,125,282,84,56,car
34467,26,car,27,0,14777,22,564,238,620,270,56,32,car
34468,9,train,10,0,14778,16,38,141,72,186,34,45,train
34469,7,person,8,0,14779,35,184,66,220,178,36,112,person
34470,8,person,9,1,14779,31,112,71,153,203,41,132,person
34471,9,person,10,1,14779,34,93,61,140,210,47,149,person
34472,10,person,11,0,14779,38,43,48,120,224,77,176,person
34473,11,person,12,0,14779,47,209,47,290,224,81,177,person
34474,8,car,9,1,14780,16,262,285,314,318,52,33,car
34475,9,car,10,1,14780,18,283,290,339,323,56,33,car
34476,5,person,6,1,14781,23,372,73,454,242,82,169,person
34477,7,person,8,0,14781,21,333,101,387,230,54,129,person
34478,8,person,9,1,14781,22,486,117,542,300,56,183,person
34479,10,person,11,1,14781,23,428,96,473,207,45,111,person
34480,11,person,12,1,14781,17,465,117,495,199,30,82,person
34481,12,person,13,1,14781,19,327,87,367,205,40,118,person
34482,13,person,14,0,14781,19,214,71,245,171,31,100,person
34483,14,person,15,1,14781,20,238,71,290,186,52,115,person
34484,15,person,16,0,14781,20,13,71,62,165,49,94,person
34485,16,person,17,0,14781,28,54,41,112,199,58,158,person
34486,18,person,19,1,14781,31,16,133,162,372,146,239,person
34487,19,person,20,1,14781,19,220,154,312,297,92,143,person
34488,20,person,21,1,14781,28,372,206,465,387,93,181,person
34489,22,person,23,1,14781,41,40,172,277,472,237,300,person
34490,46,person,47,1,14781,67,250,252,522,472,272,220,person
34491,4,person,5,1,14782,38,70,114,133,279,63,165,person
34492,5,person,6,1,14782,19,2,122,54,279,52,157,person
34493,6,person,7,0,14782,45,234,110,288,278,54,168,person
34494,7,person,8,1,14782,38,282,108,335,263,53,155,person
34495,8,person,9,1,14782,31,315,100,384,279,69,179,person
34496,9,backpack,10,0,14782,22,333,126,384,213,51,87,backpack
34497,10,person,11,1,14782,15,264,109,282,164,18,55,person
34498,11,person,12,0,14782,22,164,117,185,180,21,63,person
34499,12,person,13,0,14782,23,143,118,162,185,19,67,person
34500,13,person,14,1,14782,26,117,116,147,196,30,80,person
34501,14,person,15,1,14782,24,23,115,64,253,41,138,person
34502,6,sofa,7,0,14783,24,57,125,256,210,199,85,couch
34503,7,person,8,0,14783,33,95,88,153,222,58,134,person
34504,9,person,10,0,14783,38,176,82,240,220,64,138,person
34505,14,person,15,1,14783,17,344,50,365,90,21,40,person
34506,15,person,16,0,14783,30,384,55,423,163,39,108,person
34507,16,person,17,0,14783,41,288,42,328,167,40,125,person
34508,19,person,20,1,14783,18,190,47,210,115,20,68,person
34509,20,person,21,0,14783,28,34,55,61,149,27,94,person
34510,21,person,22,0,14783,24,4,58,28,154,24,96,person
34511,4,desk,5,0,14784,16,83,221,211,371,128,150,desk
34512,8,person,9,0,14784,36,35,172,103,384,68,212,person
34513,9,person,10,0,14784,29,185,196,249,384,64,188,person
34514,10,backpack,11,0,14784,16,217,222,267,292,50,70,backpack
34515,11,person,12,0,14785,16,150,107,172,152,22,45,person
34516,13,person,14,1,14785,15,56,102,86,136,30,34,person
34517,15,person,16,1,14785,32,0,132,65,231,65,99,person
34518,16,person,17,1,14785,21,41,128,90,177,49,49,person
34519,17,person,18,1,14785,26,94,128,153,221,59,93,person
34520,18,person,19,0,14785,44,29,164,168,325,139,161,person
34521,19,person,20,1,14785,27,128,155,248,266,120,111,person
34522,21,table,22,0,14785,25,79,216,236,374,157,158,dining table
34523,25,chair,26,0,14785,22,4,222,113,371,109,149,chair
34524,10,person,11,1,14786,23,454,448,665,578,211,130,person
34525,19,table,20,0,14786,20,693,677,1352,1053,659,376,dining table
34526,21,table,22,0,14786,23,219,795,1166,1193,947,398,dining table
34527,22,chair,23,0,14786,20,405,758,675,1189,270,431,chair
34528,23,chair,24,1,14786,22,676,791,1006,1193,330,402,chair
34529,54,window,55,0,14786,20,2,99,308,650,306,551,window
34530,59,chair,60,1,14786,28,131,593,224,749,93,156,chair
34531,60,table,61,1,14786,39,1,743,425,1182,424,439,dining table
34532,61,chair,62,1,14786,42,184,597,350,769,166,172,chair
34533,62,chair,63,1,14786,36,351,618,537,810,186,192,chair
34534,3,person,4,1,14787,31,113,3,236,166,123,163,person
34535,5,person,6,1,14787,35,19,108,179,320,160,212,person
34536,6,chair,7,1,14787,18,142,160,221,249,79,89,chair
34537,8,person,9,1,14787,34,202,98,369,240,167,142,person
34538,10,person,11,1,14787,30,318,64,451,191,133,127,person
34539,12,person,13,1,14787,37,351,11,470,153,119,142,person
34540,13,person,14,1,14787,25,499,62,607,161,108,99,person
34541,14,person,15,1,14787,22,594,81,700,231,106,150,person
34542,17,chair,18,1,14787,16,646,279,718,468,72,189,chair
34543,18,person,19,1,14787,35,527,103,685,288,158,185,person
34544,19,person,20,1,14787,28,442,159,656,371,214,212,person
34545,20,person,21,1,14787,42,316,197,683,478,367,281,person
34546,7,person,8,1,14788,17,406,167,456,227,50,60,person
34547,9,person,10,1,14788,21,224,145,297,244,73,99,person
34548,12,person,13,1,14788,20,162,158,234,239,72,81,person
34549,13,person,14,1,14788,15,107,165,167,233,60,68,person
34550,14,person,15,1,14788,26,58,159,176,262,118,103,person
34551,20,person,21,1,14788,21,2,201,154,347,152,146,person
34552,22,person,23,1,14788,41,247,209,494,420,247,211,person
34553,24,backpack,25,0,14788,28,56,342,372,474,316,132,backpack
34554,4,person,5,1,14789,32,4,52,174,216,170,164,person
34555,5,person,6,1,14789,42,140,51,385,287,245,236,person
34556,6,person,7,1,14789,49,439,109,717,375,278,266,person
34557,5,chair,6,0,14791,27,8,57,77,138,69,81,chair
34558,6,table,7,0,14791,30,68,102,128,179,60,77,dining table
34559,7,chair,8,1,14791,31,139,67,215,160,76,93,chair
34560,8,chair,9,0,14791,33,173,79,269,204,96,125,chair
34561,3,chair,4,0,14792,34,4,70,133,184,129,114,chair
34562,12,chair,13,1,14794,16,888,768,1277,958,389,190,chair
34563,10,sofa,11,0,14795,21,115,141,222,222,107,81,couch
34564,11,sofa,12,0,14795,21,284,141,370,246,86,105,couch
34565,7,chair,8,0,14796,30,983,676,1599,1193,616,517,chair
34566,8,sofa,9,1,14796,31,2,555,515,891,513,336,couch
34567,9,chair,10,1,14796,35,2,725,693,1200,691,475,chair
34568,11,table,12,0,14797,15,181,120,270,176,89,56,dining table
34569,12,chair,13,0,14797,19,176,108,205,163,29,55,chair
34570,13,chair,14,0,14797,20,205,114,240,170,35,56,chair
34571,14,chair,15,0,14797,17,242,113,283,174,41,61,chair
34572,9,chair,10,0,14798,19,165,125,200,181,35,56,chair
34573,6,chair,7,1,14799,24,46,113,110,177,64,64,chair
34574,7,chair,8,1,14799,18,0,128,103,198,103,70,chair
34575,8,table,9,1,14799,20,110,146,175,198,65,52,dining table
34576,9,chair,10,1,14799,24,149,142,287,200,138,58,chair
34577,1,table,2,1,14800,27,61,114,246,264,185,150,dining table
34578,4,person,5,1,14800,59,173,1,351,264,178,263,person
34579,5,person,6,1,14800,57,101,0,219,139,118,139,person
34580,6,person,7,1,14800,23,0,0,44,264,44,264,person
34581,4,person,5,1,14802,20,78,309,104,358,26,49,person
34582,5,person,6,0,14802,16,176,298,185,327,9,29,person
34583,7,person,8,0,14802,18,57,319,72,344,15,25,person
34584,6,person,7,0,14804,24,115,265,136,322,21,57,person
34585,7,person,8,0,14804,22,133,269,152,322,19,53,person
34586,2,person,3,0,14807,51,176,105,247,274,71,169,person
34587,3,person,4,0,14807,50,300,71,368,318,68,247,person
34588,1,person,2,1,22011,35,88,80,192,409,104,329,person
34589,2,person,3,0,22011,80,88,92,292,436,204,344,person
34590,4,person,5,0,14808,25,186,83,234,248,48,165,person
34591,24,person,25,0,14809,15,727,473,751,548,24,75,person
34592,25,person,26,1,14809,17,795,542,828,575,33,33,person
34593,27,person,28,0,14809,18,399,566,434,647,35,81,person
34594,28,person,29,0,14809,15,802,381,821,427,19,46,person
34595,29,person,30,0,14809,19,725,385,750,446,25,61,person
34596,30,person,31,0,14809,17,651,350,672,412,21,62,person
34597,56,person,57,0,14809,16,702,378,720,441,18,63,person
34598,57,person,58,0,14809,17,180,96,195,148,15,52,person
34599,4,person,5,0,14810,72,95,115,504,633,409,518,person
34600,19,person,20,0,14811,16,159,122,169,151,10,29,person
34601,20,person,21,0,14811,18,125,134,134,162,9,28,person
34602,21,person,22,0,14811,18,184,132,192,163,8,31,person
34603,30,person,31,0,14811,18,147,104,158,130,11,26,person
34604,4,person,5,0,14813,40,137,9,198,133,61,124,person
34605,5,person,6,1,14813,35,58,37,161,202,103,165,person
34606,6,person,7,1,14814,40,16,90,61,207,45,117,person
34607,7,person,8,1,14814,32,74,98,101,207,27,109,person
34608,8,person,9,1,14814,30,106,116,157,208,51,92,person
34609,9,person,10,1,14814,30,102,117,133,200,31,83,person
34610,10,person,11,1,14814,34,158,88,192,207,34,119,person
34611,11,person,12,1,14814,29,144,97,176,206,32,109,person
34612,12,person,13,1,14814,32,215,88,249,207,34,119,person
34613,13,person,14,1,14814,31,169,87,240,207,71,120,person
34614,14,person,15,1,14814,22,254,103,299,208,45,105,person
34615,15,person,16,1,14814,22,238,142,274,207,36,65,person
34616,3,person,4,1,14815,72,0,47,413,399,413,352,person
34617,4,person,5,1,14815,28,249,18,486,329,237,311,person
34618,2,person,3,1,14816,35,65,115,146,219,81,104,person
34619,3,person,4,1,14816,29,118,99,200,298,82,199,person
34620,4,person,5,1,14816,35,0,120,103,297,103,177,person
34621,2,person,3,1,14817,16,352,112,410,154,58,42,person
34622,3,person,4,0,14817,32,172,116,230,289,58,173,person
34623,4,person,5,0,14817,46,105,102,163,272,58,170,person
34624,5,person,6,0,14817,43,16,113,61,251,45,138,person
34625,7,person,8,0,14823,18,157,339,173,386,16,47,person
34626,8,person,9,0,14823,19,183,340,199,389,16,49,person
34627,9,person,10,0,14823,18,285,343,301,396,16,53,person
34628,11,person,12,0,14823,19,300,345,317,397,17,52,person
34629,12,person,13,0,14823,18,317,350,339,403,22,53,person
34630,13,person,14,0,14823,19,99,336,118,376,19,40,person
34631,14,bicycle,15,0,14823,19,100,355,119,377,19,22,bicycle
34632,15,person,16,0,14823,22,47,336,62,377,15,41,person
34633,1,boat,2,0,14826,16,80,160,183,191,103,31,boat
34634,16,person,17,0,14826,16,560,123,576,172,16,49,person
34635,17,person,18,0,14826,17,601,133,621,174,20,41,person
34636,4,person,5,0,14830,34,251,59,280,171,29,112,person
34637,3,bird,4,0,14832,21,250,228,278,261,28,33,bird
34638,6,boat,7,0,14833,26,14,218,360,246,346,28,boat
34639,7,person,8,0,14833,37,42,159,148,234,106,75,person
34640,8,person,9,0,14833,27,130,156,207,239,77,83,person
34641,9,person,10,1,14833,30,159,134,233,213,74,79,person
34642,10,person,11,1,14833,24,205,149,287,232,82,83,person
34643,11,person,12,1,14833,39,273,108,363,231,90,123,person
34644,7,bus,8,0,14835,32,0,185,290,246,290,61,bus
34645,8,bird,9,0,14836,18,31,289,69,329,38,40,bird
34646,3,truck,4,0,14840,41,201,169,428,433,227,264,truck
34647,19,car,20,0,941,21,5,126,36,147,31,21,car
34648,20,car,21,1,941,20,38,120,64,138,26,18,car
34649,21,car,22,1,941,16,76,118,97,131,21,13,car
34650,22,car,23,0,941,20,85,124,113,139,28,15,car
34651,23,car,24,1,941,22,52,123,83,148,31,25,car
34652,24,car,25,1,941,18,39,136,68,151,29,15,car
34653,25,car,26,1,941,25,29,143,66,165,37,22,car
34654,26,car,27,1,941,21,5,151,40,177,35,26,car
34655,27,car,28,1,941,16,0,163,29,187,29,24,car
34656,29,car,30,1,941,18,1,204,35,254,34,50,car
34657,30,car,31,1,941,24,0,249,61,310,61,61,car
34658,31,car,32,1,941,15,96,115,122,124,26,9,car
34659,9,person,10,0,14856,24,279,195,301,240,22,45,person
34660,10,bench,11,0,14857,24,228,214,388,269,160,55,bench
34661,11,bench,12,0,14857,17,71,220,290,299,219,79,bench
34662,2,car,3,0,14861,20,344,155,435,186,91,31,car
34663,3,car,4,0,14861,15,415,148,502,174,87,26,car
34664,4,truck,5,1,14861,15,463,123,549,169,86,46,truck
34665,5,truck,6,0,14861,24,230,133,332,195,102,62,truck
34666,5,truck,6,0,14862,29,523,155,659,272,136,117,truck
34667,6,truck,7,0,14862,25,429,187,544,272,115,85,truck
34668,7,truck,8,1,14862,29,338,172,506,277,168,105,truck
34669,8,truck,9,1,14862,26,253,180,368,276,115,96,truck
34670,9,truck,10,1,14862,27,172,181,291,276,119,95,truck
34671,10,truck,11,1,14862,23,125,184,225,278,100,94,truck
34672,1,truck,2,0,14863,39,2,298,376,396,374,98,truck
34673,2,truck,3,1,14863,15,491,340,544,373,53,33,truck
34674,9,truck,10,1,14863,19,544,339,684,374,140,35,truck
34675,10,truck,11,0,14863,21,609,348,716,376,107,28,truck
34676,11,truck,12,1,14863,16,702,347,752,374,50,27,truck
34677,4,truck,5,0,14864,31,226,402,567,633,341,231,truck
34678,2,truck,3,0,14865,55,111,146,486,362,375,216,truck
34679,3,person,4,0,14865,26,423,237,467,358,44,121,person
34680,4,person,5,0,14865,39,454,232,508,358,54,126,person
34681,6,truck,7,1,14865,25,575,244,799,325,224,81,truck
34682,5,car,6,0,14866,20,64,162,98,175,34,13,car
34683,6,truck,7,1,14866,25,28,156,72,174,44,18,truck
34684,14,person,15,0,14867,16,317,282,333,324,16,42,person
34685,8,chair,9,0,14868,22,122,129,184,211,62,82,chair
34686,9,chair,10,0,14868,25,185,130,244,209,59,79,chair
34687,10,chair,11,1,14868,16,238,129,263,197,25,68,chair
34688,11,chair,12,1,14868,16,257,128,274,193,17,65,chair
34689,13,chair,14,1,14869,29,143,99,210,185,67,86,chair
34690,14,table,15,0,14869,26,82,112,148,179,66,67,dining table
34691,8,table,9,0,14870,33,219,221,376,362,157,141,dining table
34692,9,chair,10,0,14870,33,149,196,235,358,86,162,chair
34693,10,chair,11,0,14870,31,357,194,442,358,85,164,chair
34694,4,chair,5,0,14876,36,228,133,370,263,142,130,chair
34695,5,chair,6,1,14876,19,273,104,368,171,95,67,chair
34696,2,door,3,0,14879,18,93,34,241,447,148,413,door
34697,15,chair,16,0,14881,24,252,224,322,353,70,129,chair
34698,17,table,18,0,14881,18,47,357,176,476,129,119,dining table
34699,8,flowerpot,9,0,14888,15,22,151,54,193,32,42,potted plant
34700,7,bench,8,0,14891,21,187,417,287,555,100,138,bench
34701,10,person,11,0,14891,29,209,281,245,382,36,101,person
34702,11,person,12,0,14891,29,140,266,177,380,37,114,person
34703,12,person,13,1,14891,16,131,232,164,286,33,54,person
34704,13,person,14,0,14891,21,188,220,216,297,28,77,person
34705,14,person,15,0,14891,16,246,188,264,255,18,67,person
34706,15,person,16,0,14891,19,289,173,308,237,19,64,person
34707,3,person,4,1,14897,37,59,21,112,115,53,94,person
34708,4,person,5,1,14897,31,21,67,105,179,84,112,person
34709,5,person,6,1,14897,27,94,73,162,164,68,91,person
34710,6,person,7,1,14897,26,147,59,195,125,48,66,person
34711,7,person,8,1,14897,28,228,11,299,122,71,111,person
34712,8,person,9,1,14897,32,289,8,355,122,66,114,person
34713,12,person,13,1,14898,29,15,181,46,280,31,99,person
34714,13,person,14,1,14898,23,97,212,140,284,43,72,person
34715,14,person,15,0,14898,28,145,203,182,278,37,75,person
34716,16,person,17,1,14898,19,348,201,383,252,35,51,person
34717,17,person,18,1,14898,17,301,187,319,243,18,56,person
34718,18,person,19,0,14898,22,262,171,283,242,21,71,person
34719,7,sink,8,0,14901,15,181,368,315,433,134,65,sink
34720,9,sink,10,0,14901,15,447,346,549,433,102,87,sink
34721,8,person,9,1,14902,43,506,123,753,774,247,651,person
34722,7,sink,8,0,14904,19,391,580,573,649,182,69,sink
34723,2,umbrella,3,1,14907,20,0,0,132,184,132,184,umbrella
34724,5,table,6,0,14907,17,2,177,77,265,75,88,dining table
34725,10,chair,11,1,14907,17,234,204,298,292,64,88,chair
34726,11,chair,12,1,14907,18,40,200,101,267,61,67,chair
34727,10,person,11,1,14908,16,0,207,23,356,23,149,person
34728,17,person,18,1,14908,18,225,232,247,268,22,36,person
34729,21,bench,22,0,14908,15,542,282,639,337,97,55,bench
34730,22,person,23,0,14908,32,551,266,594,333,43,67,person
34731,23,person,24,0,14908,33,585,264,637,336,52,72,person
34732,31,person,32,0,14908,76,15,198,90,403,75,205,person
34733,32,person,33,0,14908,51,88,219,159,403,71,184,person
34734,13,bench,14,0,14911,15,199,525,362,599,163,74,bench
34735,14,bench,15,0,14911,20,484,520,603,573,119,53,bench
34736,5,boat,6,0,14917,18,157,67,340,356,183,289,boat
34737,6,boat,7,0,14917,23,326,100,494,352,168,252,boat
34738,8,boat,9,0,14917,17,672,99,798,330,126,231,boat
34739,28,boat,29,0,14920,18,180,290,255,448,75,158,boat
34740,32,window,33,0,14921,15,366,295,427,357,61,62,window
34741,13,bench,14,0,14922,15,77,166,108,194,31,28,bench
34742,8,bed,9,0,14937,16,23,105,179,151,156,46,bed
34743,2,car,3,0,14938,22,217,155,314,209,97,54,car
34744,3,car,4,0,14938,22,312,172,407,208,95,36,car
34745,4,truck,5,1,14938,20,147,138,260,204,113,66,truck
34746,5,bicycle,6,0,14938,24,277,135,298,152,21,17,bicycle
34747,2,car,3,0,14939,15,311,221,338,237,27,16,car
34748,14,bench,15,0,14939,16,443,283,524,316,81,33,bench
34749,15,bench,16,0,14939,24,268,303,441,374,173,71,bench
34750,31,car,32,1,238,65,1144,488,1544,708,400,220,car
34751,32,car,33,1,238,35,1369,493,1615,742,246,249,car
34752,42,car,43,1,238,29,738,522,884,609,146,87,car
34753,46,car,47,1,238,17,787,527,884,625,97,98,car
34754,52,car,52,1,238,22,913,567,985,627,72,60,car
34755,53,car,53,1,238,32,954,509,1105,637,151,128,car
34756,56,car,56,1,238,17,1021,566,1107,660,86,94,car
34757,62,car,62,1,238,26,682,533,755,601,73,68,car
34758,64,car,64,1,238,21,628,534,677,583,49,49,car
34759,65,car,65,1,238,23,581,518,675,580,94,62,car
34760,68,car,68,1,238,18,577,526,621,568,44,42,car
34761,72,car,72,0,238,26,493,531,546,573,53,42,car
34762,78,car,78,0,238,21,433,532,485,574,52,42,car
34763,85,car,85,1,238,15,280,531,333,610,53,79,car
34764,89,car,89,0,238,24,0,528,129,657,129,129,car
34765,0,person,1,0,241,51,150,214,538,653,388,439,person
34766,15,person,16,1,241,35,581,341,634,408,53,67,person
34767,17,person,18,1,241,33,662,297,737,433,75,136,person
34768,18,door,19,1,241,17,684,295,712,379,28,84,door
34769,24,door,25,1,241,16,6,307,49,388,43,81,door
34770,47,table,48,0,241,16,38,417,123,441,85,24,dining table
34771,48,person,49,1,241,23,1,346,60,445,59,99,person
34772,50,person,51,1,241,15,80,360,102,383,22,23,person
34773,53,person,54,1,241,21,59,360,91,418,32,58,person
34774,55,chair,56,1,241,25,57,422,145,502,88,80,chair
34775,56,person,57,1,241,32,119,357,165,500,46,143,person
34776,57,person,58,1,241,24,155,353,201,459,46,106,person
34777,58,chair,59,1,241,38,72,500,187,652,115,152,chair
34778,62,person,63,1,241,100,524,136,1000,653,476,517,person
34779,17,person,18,0,260,29,430,281,449,336,19,55,person
34780,18,person,19,1,260,25,407,317,435,369,28,52,person
34781,19,person,20,1,260,28,387,283,416,328,29,45,person
34782,20,person,21,0,260,36,355,212,372,255,17,43,person
34783,21,person,22,0,260,35,303,307,326,356,23,49,person
34784,22,person,23,0,260,44,261,244,286,291,25,47,person
34785,23,person,24,0,260,33,284,239,300,288,16,49,person
34786,24,person,25,0,260,31,300,242,319,288,19,46,person
34787,25,person,26,0,260,32,217,242,237,288,20,46,person
34788,26,person,27,0,260,30,192,248,215,296,23,48,person
34789,27,person,28,0,260,32,242,215,262,262,20,47,person
34790,28,person,29,0,260,33,232,161,254,210,22,49,person
34791,29,person,30,0,260,28,251,160,271,206,20,46,person
34792,30,person,31,0,260,35,263,129,285,172,22,43,person
34793,31,person,32,0,260,30,407,66,424,112,17,46,person
34794,32,person,33,0,260,35,388,65,405,114,17,49,person
34795,33,person,34,0,260,32,298,42,315,82,17,40,person
34796,34,person,35,0,260,31,325,39,341,80,16,41,person
34797,35,person,36,0,260,34,345,34,363,76,18,42,person
34798,36,person,37,0,260,26,228,71,243,110,15,39,person
34799,37,person,38,0,260,24,222,11,237,45,15,34,person
34800,38,person,39,0,260,29,241,12,258,48,17,36,person
34801,39,person,40,0,260,30,54,48,85,97,31,49,person
34802,40,person,41,0,260,37,6,47,45,115,39,68,person
34803,41,person,42,1,260,24,31,118,64,187,33,69,person
34804,44,person,45,0,260,38,140,283,164,334,24,51,person
34805,46,person,47,1,260,20,348,0,360,24,12,24,person
34806,9,person,10,1,261,28,95,107,285,234,190,127,person
34807,10,person,11,0,261,69,569,215,651,406,82,191,person
34808,1,person,2,1,272,88,201,204,437,393,236,189,person
34809,2,person,3,1,272,36,202,198,278,298,76,100,person
34810,3,person,4,1,272,27,264,173,323,265,59,92,person
34811,4,person,5,1,272,25,341,180,387,273,46,93,person
34812,6,person,7,1,272,30,368,226,420,340,52,114,person
34813,7,person,8,1,272,19,490,332,570,392,80,60,person
34814,8,person,9,0,272,23,478,304,537,392,59,88,person
34815,9,person,10,1,272,36,486,248,561,354,75,106,person
34816,10,person,11,1,272,32,517,213,581,311,64,98,person
34817,11,person,12,1,272,19,567,202,613,272,46,70,person
34818,12,person,13,1,272,34,415,271,487,362,72,91,person
34819,13,person,14,1,272,25,454,237,500,332,46,95,person
34820,14,person,15,1,272,39,420,183,509,293,89,110,person
34821,15,person,16,1,272,27,421,139,479,229,58,90,person
34822,16,person,17,1,272,24,386,154,425,235,39,81,person
34823,17,person,18,1,272,26,287,133,350,216,63,83,person
34824,18,person,19,1,272,30,325,101,376,202,51,101,person
34825,19,person,20,1,272,37,363,88,431,198,68,110,person
34826,20,person,21,1,272,26,431,90,493,184,62,94,person
34827,21,person,22,1,272,20,496,136,544,224,48,88,person
34828,22,person,23,1,272,25,222,145,293,238,71,93,person
34829,23,person,24,1,272,30,218,88,289,186,71,98,person
34830,24,person,25,1,272,24,193,262,261,361,68,99,person
34831,25,person,26,1,272,36,116,231,205,379,89,148,person
34832,26,person,27,1,272,37,145,164,225,300,80,136,person
34833,27,person,28,1,272,27,136,131,196,221,60,90,person
34834,28,person,29,1,272,16,159,100,199,148,40,48,person
34835,29,person,30,1,272,34,52,205,135,347,83,142,person
34836,30,person,31,1,272,27,2,169,69,340,67,171,person
34837,31,person,32,1,272,37,2,122,73,238,71,116,person
34838,32,person,33,1,272,25,96,169,147,272,51,103,person
34839,33,person,34,1,272,32,75,106,154,219,79,113,person
34840,34,person,35,1,272,22,69,69,119,161,50,92,person
34841,35,person,36,1,272,29,140,59,205,152,65,93,person
34842,36,person,37,1,272,26,219,40,277,141,58,101,person
34843,37,person,38,1,272,40,361,43,436,156,75,113,person
34844,38,person,39,1,272,23,285,74,361,144,76,70,person
34845,39,person,40,1,272,23,434,58,486,147,52,89,person
34846,40,person,41,1,272,28,483,90,535,195,52,105,person
34847,41,person,42,1,272,24,508,158,575,235,67,77,person
34848,42,person,43,1,272,26,576,158,632,254,56,96,person
34849,43,person,44,1,272,21,571,110,614,194,43,84,person
34850,44,person,45,1,272,37,419,18,502,134,83,116,person
34851,45,person,46,1,272,30,499,16,573,110,74,94,person
34852,46,person,47,1,272,23,546,48,606,139,60,91,person
34853,47,person,48,1,272,17,294,45,356,105,62,60,person
34854,48,person,49,1,272,22,107,51,149,138,42,87,person
34855,49,person,50,1,272,23,77,0,130,72,53,72,person
34856,50,person,51,1,272,35,142,33,224,148,82,115,person
34857,51,person,52,1,272,18,164,5,218,96,54,91,person
34858,52,person,53,1,272,29,245,10,303,106,58,96,person
34859,53,person,54,1,272,19,22,97,74,179,52,82,person
34860,54,person,55,0,272,22,28,48,72,124,44,76,person
34861,55,person,56,1,272,24,38,13,85,109,47,96,person
34862,56,person,57,1,272,21,291,15,341,93,50,78,person
34863,57,person,58,1,272,23,469,142,505,240,36,98,person
34864,58,person,59,1,272,25,561,307,629,392,68,85,person
34865,59,person,60,1,272,15,594,345,634,393,40,48,person
34866,60,person,61,1,272,23,595,80,633,206,38,126,person
34867,61,person,62,1,272,25,401,0,458,88,57,88,person
34868,62,person,63,1,272,19,492,0,544,76,52,76,person
34869,63,person,64,1,272,24,48,290,114,393,66,103,person
34870,64,person,65,1,272,16,94,341,163,393,69,52,person
34871,65,person,66,1,272,20,0,315,53,392,53,77,person
34872,67,person,68,1,272,20,437,318,484,392,47,74,person
34873,13,person,14,0,273,133,923,244,1173,1194,250,950,person
34874,14,person,15,0,273,135,668,175,937,1232,269,1057,person
34875,27,person,28,0,273,143,379,197,686,1276,307,1079,person
34876,6,umbrella,7,0,25227,30,1,433,294,519,293,86,umbrella
34877,2,person,3,0,25229,36,688,604,723,702,35,98,person
34878,3,person,4,0,25229,26,673,549,703,624,30,75,person
34879,4,person,5,1,25233,26,478,451,523,547,45,96,person
34880,5,person,6,0,25233,20,462,448,477,495,15,47,person
34881,6,person,7,0,25233,26,519,452,547,525,28,73,person
34882,7,person,8,0,25233,19,446,451,459,495,13,44,person
34883,8,person,9,1,25233,16,441,450,451,493,10,43,person
34884,7,person,8,1,25234,18,149,313,167,377,18,64,person
34885,8,person,9,1,25234,22,144,309,163,375,19,66,person
34886,9,person,10,1,25234,21,124,321,145,375,21,54,person
34887,10,person,11,0,25234,33,99,299,135,372,36,73,person
34888,11,person,12,1,25234,31,33,319,60,399,27,80,person
34889,12,person,13,1,25234,17,13,352,38,411,25,59,person
34890,12,person,13,0,25238,16,341,292,353,342,12,50,person
34891,3,truck,4,1,25239,18,149,741,282,810,133,69,truck
34892,5,bird,6,0,25239,25,590,399,727,504,137,105,bird
34893,9,person,10,0,25241,24,62,613,93,727,31,114,person
34894,10,person,11,0,25241,30,89,626,126,726,37,100,person
34895,11,person,12,1,25241,25,359,650,403,767,44,117,person
34896,2,train,3,0,295,64,232,117,786,609,554,492,train
34897,7,person,8,1,295,48,898,215,999,665,101,450,person
34898,19,person,20,1,295,67,835,244,934,557,99,313,person
34899,31,person,32,0,295,66,763,242,848,484,85,242,person
34900,7,person,8,0,296,39,1733,739,1863,1052,130,313,person
34901,8,person,9,0,296,40,1640,714,1745,1037,105,323,person
34902,9,person,10,0,296,30,1361,750,1427,1010,66,260,person
34903,11,suitcase,12,0,296,22,1156,854,1220,1011,64,157,suitcase
34904,12,suitcase,13,1,296,16,1139,844,1184,1007,45,163,suitcase
34905,15,person,16,1,296,22,1066,744,1104,826,38,82,person
34906,16,person,17,0,296,51,943,744,1041,1011,98,267,person
34907,23,backpack,24,0,296,19,958,796,1026,904,68,108,backpack
34908,24,person,25,0,296,46,870,745,982,1023,112,278,person
34909,25,person,26,0,296,49,774,745,886,1043,112,298,person
34910,34,person,35,1,296,37,727,741,787,989,60,248,person
34911,35,person,36,1,296,38,633,753,698,1048,65,295,person
34912,36,person,37,0,296,55,657,756,772,1058,115,302,person
34913,37,person,38,0,296,40,574,751,666,1072,92,321,person
34914,38,person,39,0,296,55,459,741,578,1095,119,354,person
34915,47,person,48,0,296,62,361,781,492,1109,131,328,person
34916,57,person,58,1,296,27,283,781,361,1046,78,265,person
34917,58,suitcase,59,0,296,28,250,919,365,1178,115,259,suitcase
34918,60,person,61,0,296,54,75,751,245,1189,170,438,person
34919,61,person,62,1,296,45,13,754,123,1173,110,419,person
34920,66,person,67,1,296,29,1082,752,1162,978,80,226,person
34921,1,person,2,0,297,51,506,46,851,479,345,433,person
34922,7,person,8,1,297,72,6,136,412,478,406,342,person
34923,3,person,4,1,300,35,259,176,298,329,39,153,person
34924,4,person,5,0,300,140,215,82,472,477,257,395,person
34925,14,person,15,0,300,78,77,27,214,435,137,408,person
34926,2,person,3,1,24694,91,79,451,476,1601,397,1150,person
34927,4,person,5,1,24694,22,547,1185,684,1366,137,181,person
34928,5,person,6,1,24694,16,601,1004,635,1060,34,56,person
34929,4,car,5,0,24695,33,851,527,1056,598,205,71,car
34930,5,person,6,0,24699,20,223,867,237,912,14,45,person
34931,6,person,7,0,24699,18,207,869,220,912,13,43,person
34932,7,person,8,0,24699,17,185,871,198,916,13,45,person
34933,3,person,4,1,24707,30,287,317,473,495,186,178,person
34934,7,person,8,0,24709,96,674,31,781,298,107,267,person
34935,1,person,2,0,303,81,643,151,836,283,193,132,person
34936,22,bench,22,1,979,20,573,691,845,765,272,74,bench
34937,23,person,23,1,979,17,683,574,710,648,27,74,person
34938,24,person,24,1,979,23,644,591,684,696,40,105,person
34939,26,person,26,1,979,21,743,655,820,763,77,108,person
34940,27,person,27,1,979,30,680,606,761,765,81,159,person
34941,28,person,28,0,979,27,919,602,976,730,57,128,person
34942,29,person,29,0,979,23,963,603,1005,739,42,136,person
34943,30,person,30,0,979,22,370,567,398,672,28,105,person
34944,31,person,31,0,979,22,343,561,370,657,27,96,person
34945,32,person,32,0,979,18,409,549,422,593,13,44,person
34946,33,person,33,0,979,15,452,561,468,614,16,53,person
34947,34,person,34,0,979,19,530,558,546,604,16,46,person
34948,35,chair,35,0,979,18,197,603,232,641,35,38,chair
34949,36,person,36,0,979,18,195,582,228,636,33,54,person
34950,37,chair,37,0,979,15,237,603,259,641,22,38,chair
34951,40,person,40,1,979,18,333,567,347,639,14,72,person
34952,41,person,41,0,979,16,493,556,508,593,15,37,person
34953,7,car,8,1,1000,17,299,217,350,251,51,34,car
34954,7,car,8,0,1002,16,458,155,479,163,21,8,car
34955,12,car,13,0,1002,15,483,166,508,177,25,11,car
34956,7,person,8,0,1004,27,302,271,332,333,30,62,person
34957,9,person,10,0,1004,37,425,244,475,359,50,115,person
34958,8,car,9,0,1005,15,69,203,103,222,34,19,car
34959,12,car,13,0,1005,17,164,207,209,224,45,17,car
34960,10,truck,11,0,1007,16,566,665,652,736,86,71,truck
34961,17,person,18,0,1010,15,40,275,49,302,9,27,person
34962,18,person,19,0,1010,21,170,283,185,347,15,64,person
34963,5,car,6,0,1011,19,348,120,419,163,71,43,car
34964,11,car,12,0,1013,15,396,112,448,154,52,42,car
34965,14,door,15,0,1015,19,433,277,589,413,156,136,door
34966,16,door,17,0,1015,16,0,297,49,453,49,156,door
34967,11,car,12,0,1016,22,422,127,527,183,105,56,car
34968,7,truck,8,1,1018,18,11,167,75,228,64,61,truck
34969,18,car,19,1,1018,18,180,342,239,393,59,51,car
34970,23,car,24,1,1018,15,88,368,151,395,63,27,car
34971,24,car,25,1,1018,22,200,359,268,395,68,36,car
34972,28,car,29,1,1018,15,1,265,23,311,22,46,car
34973,29,car,30,1,1018,17,1,252,29,292,28,40,car
34974,7,truck,8,1,1020,16,166,126,197,153,31,27,truck
34975,6,car,7,0,1021,23,0,412,210,489,210,77,car
34976,7,person,8,0,1021,17,32,401,72,492,40,91,person
34977,10,car,11,0,1021,24,377,423,590,494,213,71,car
34978,15,car,16,0,1021,18,656,403,772,491,116,88,car
34979,22,car,23,0,1021,18,933,426,982,455,49,29,car
34980,23,car,24,0,1021,15,981,431,1030,455,49,24,car
34981,24,car,25,0,1021,25,834,424,926,494,92,70,car
34982,29,car,30,0,1021,22,1125,439,1234,477,109,38,car
34983,34,traffic light,35,0,1021,16,274,1,332,513,58,512,traffic light
34984,3,airplane,4,0,1024,40,3,213,401,374,398,161,airplane
34985,4,airplane,5,0,1024,37,516,255,764,363,248,108,airplane
34986,5,airplane,6,0,1024,33,781,278,930,359,149,81,airplane
34987,6,airplane,7,0,1024,34,930,291,1064,356,134,65,airplane
34988,10,person,11,1,1024,15,0,381,42,553,42,172,person
34989,13,person,14,0,1024,27,902,356,981,522,79,166,person
34990,4,airplane,5,0,1025,71,397,379,1384,968,987,589,airplane
34991,10,car,11,0,1025,17,1795,820,1927,870,132,50,car
34992,0,car,1,0,1026,15,1446,638,1731,716,285,78,car
34993,4,airplane,5,0,1026,107,3,343,1403,750,1400,407,airplane
34994,5,car,6,1,1026,18,607,643,748,722,141,79,car
34995,6,car,7,1,1026,18,361,643,476,697,115,54,car
34996,7,car,8,0,1026,17,240,655,330,701,90,46,car
34997,15,person,16,1,1026,17,425,650,458,720,33,70,person
34998,23,window,24,0,1026,16,1169,507,1350,579,181,72,window
34999,3,airplane,4,0,1027,70,230,344,1973,1000,1743,656,airplane
35000,4,person,5,0,1027,59,358,651,645,1311,287,660,person
35001,5,car,6,1,1027,15,0,706,128,821,128,115,car
35002,19,person,20,0,1027,16,2072,649,2113,745,41,96,person
35003,2,airplane,3,1,1028,36,356,470,594,588,238,118,airplane
35004,3,airplane,4,0,1028,59,498,456,948,594,450,138,airplane
35005,6,airplane,7,1,1028,111,555,67,1748,673,1193,606,airplane
35006,10,car,11,1,1028,16,1341,540,1429,585,88,45,car
35007,12,person,13,0,1028,67,15,427,134,784,119,357,person
35008,2,airplane,3,0,1029,84,18,63,394,191,376,128,airplane
35009,3,airplane,4,0,1029,72,353,182,604,277,251,95,airplane
35010,2,truck,3,0,1030,18,61,75,112,97,51,22,truck
35011,3,truck,4,1,1030,15,127,73,213,98,86,25,truck
35012,4,airplane,5,0,1030,70,18,88,277,160,259,72,airplane
35013,1,airplane,2,0,1031,60,111,99,439,198,328,99,airplane
35014,2,airplane,3,1,1031,15,0,484,151,564,151,80,airplane
35015,3,airplane,4,1,1031,35,85,333,594,541,509,208,airplane
35016,4,airplane,5,1,1031,25,507,296,798,559,291,263,airplane
35017,7,truck,8,0,1031,22,146,463,284,570,138,107,truck
35018,3,person,4,0,1,20,341,175,354,214,13,39,person
35019,5,person,6,0,1,21,236,188,262,218,26,30,person
35020,6,airplane,7,0,1,72,68,57,426,169,358,112,airplane
35021,13,airplane,14,0,2,63,87,110,512,210,425,100,airplane
35022,4,airplane,5,0,3,34,237,155,459,233,222,78,airplane
35023,3,airplane,4,0,1033,97,14,124,749,378,735,254,airplane
35024,3,airplane,4,0,1034,83,14,137,750,404,736,267,airplane
35025,7,airplane,8,0,1035,52,410,661,1383,913,973,252,airplane
35026,3,airplane,4,0,1036,48,203,92,384,145,181,53,airplane
35027,10,airplane,11,0,1037,65,135,217,959,493,824,276,airplane
35028,2,airplane,3,0,1038,71,1,364,1530,835,1529,471,airplane
35029,3,person,4,0,1038,36,633,546,749,836,116,290,person
35030,14,airplane,15,0,22589,19,1,434,84,467,83,33,airplane
35031,15,airplane,16,0,22589,90,160,442,498,570,338,128,airplane
35032,6,person,7,1,22590,26,586,376,655,522,69,146,person
35033,7,person,8,0,22590,38,620,349,698,520,78,171,person
35034,8,person,9,0,22590,41,827,346,903,513,76,167,person
35035,3,airplane,4,1,22591,25,588,289,723,357,135,68,airplane
35036,4,airplane,5,1,22591,66,681,274,1007,382,326,108,airplane
35037,5,airplane,6,0,22591,132,20,161,1008,524,988,363,airplane
35038,1,airplane,2,0,22592,122,126,139,1023,630,897,491,airplane
35039,2,airplane,3,1,22592,26,449,161,738,280,289,119,airplane
35040,1,airplane,2,0,22593,107,34,277,998,611,964,334,airplane
35041,1,person,2,1,22594,31,1,489,169,767,168,278,person
35042,2,person,3,1,22594,95,53,37,543,767,490,730,person
35043,3,person,4,1,22594,65,571,20,1006,767,435,747,person
35044,4,umbrella,5,1,22594,57,499,176,1023,412,524,236,umbrella
35045,10,person,11,0,22595,17,104,434,112,455,8,21,person
35046,12,person,13,0,22595,17,407,434,414,453,7,19,person
35047,13,car,14,0,22595,18,753,437,772,452,19,15,car
35048,15,airplane,16,0,22595,186,74,201,927,483,853,282,airplane
35049,7,airplane,8,0,22596,67,193,124,691,310,498,186,airplane
35050,6,car,7,0,22597,21,1002,149,1022,157,20,8,car
35051,9,airplane,10,0,22597,171,42,152,979,415,937,263,airplane
35052,2,airplane,3,0,22598,159,46,106,663,392,617,286,airplane
35053,3,car,4,0,22598,16,388,392,469,461,81,69,car
35054,12,person,13,0,22598,38,41,303,63,346,22,43,person
35055,3,airplane,4,0,22599,109,92,245,943,627,851,382,airplane
35056,2,airplane,3,0,22600,82,1,203,948,473,947,270,airplane
35057,3,airplane,4,1,22600,18,562,266,816,335,254,69,airplane
35058,8,airplane,9,0,22600,19,1,248,80,271,79,23,airplane
35059,9,person,10,0,22600,29,46,276,65,318,19,42,person
35060,10,person,11,0,22600,21,31,276,45,318,14,42,person
35061,11,person,12,0,22600,27,14,274,29,319,15,45,person
35062,2,person,3,1,22601,25,96,348,253,516,157,168,person
35063,3,person,4,1,22601,52,227,258,380,525,153,267,person
35064,4,person,5,0,22601,66,387,403,620,823,233,420,person
35065,3,airplane,4,0,22602,92,163,360,1746,835,1583,475,airplane
35066,1,airplane,2,0,22603,183,144,51,842,249,698,198,airplane
35067,4,car,5,0,22603,15,800,407,822,413,22,6,car
35068,5,car,6,0,22603,16,699,406,722,414,23,8,car
35069,6,car,7,0,22603,16,894,406,915,414,21,8,car
35070,8,car,9,0,22603,17,583,407,604,415,21,8,car
35071,13,car,14,0,22603,16,157,411,180,419,23,8,car
35072,0,airplane,1,0,1069,35,241,865,849,1128,608,263,airplane
35073,1,airplane,2,0,1069,19,934,940,1335,1105,401,165,airplane
35074,7,truck,8,1,1069,19,90,1097,245,1146,155,49,truck
35075,10,car,11,0,1069,16,624,1105,673,1122,49,17,car
35076,24,car,25,0,1069,15,1108,1103,1159,1126,51,23,car
35077,27,truck,28,0,1069,20,1180,1091,1231,1115,51,24,truck
35078,44,truck,45,1,1069,16,2125,1105,2200,1168,75,63,truck
35079,0,airplane,1,0,1070,28,634,431,948,589,314,158,airplane
35080,8,car,9,0,1070,18,796,592,873,621,77,29,car
35081,9,truck,10,0,1070,17,1017,588,1103,628,86,40,truck
35082,0,truck,1,0,1071,33,1137,1017,1343,1097,206,80,truck
35083,1,truck,2,0,1071,18,1493,1015,1600,1115,107,100,truck
35084,7,car,8,0,1071,15,1014,1054,1113,1095,99,41,car
35085,1,airplane,2,1,1072,18,1021,581,1598,941,577,360,airplane
35086,2,airplane,3,1,1072,18,933,770,1400,963,467,193,airplane
35087,6,car,7,0,1072,15,758,941,834,995,76,54,car
35088,1,truck,2,0,1073,21,829,652,1000,714,171,62,truck
35089,2,airplane,3,0,1073,18,1261,447,1575,579,314,132,airplane
35090,3,truck,4,0,1073,36,150,849,312,1097,162,248,truck
35091,4,car,5,0,1073,23,302,864,470,994,168,130,car
35092,5,airplane,6,1,1073,35,179,360,1137,732,958,372,airplane
35093,11,car,12,0,1073,16,213,772,354,842,141,70,car
35094,12,car,13,0,1073,15,1484,716,1599,779,115,63,car
35095,17,car,18,1,1073,20,1482,835,1596,927,114,92,car
35096,18,person,19,0,1073,20,1505,807,1574,894,69,87,person
35097,7,airplane,8,0,1074,63,258,837,1310,1213,1052,376,airplane
35098,2,airplane,3,0,1075,62,669,682,1338,948,669,266,airplane
35099,6,airplane,7,1,1075,15,1454,840,1599,942,145,102,airplane
35100,7,car,8,0,1075,15,1358,906,1423,936,65,30,car
35101,0,airplane,1,0,1076,53,167,748,1056,981,889,233,airplane
35102,1,airplane,2,0,1076,134,1014,751,1511,908,497,157,airplane
35103,0,airplane,1,0,1077,46,195,431,659,591,464,160,airplane
35104,7,car,8,1,1077,15,119,572,161,594,42,22,car
35105,9,car,10,0,1077,31,215,595,340,637,125,42,car
35106,1,airplane,2,1,1078,20,51,994,258,1035,207,41,airplane
35107,2,airplane,3,0,1078,24,100,1004,186,1050,86,46,airplane
35108,9,car,10,0,1078,17,313,1018,344,1038,31,20,car
35109,6,car,6,0,1079,17,759,849,902,931,143,82,car
35110,8,car,8,0,1079,19,840,790,968,847,128,57,car
35111,12,car,12,0,1079,20,490,790,602,857,112,67,car
35112,13,car,13,0,1079,16,382,725,450,765,68,40,car
35113,17,car,17,0,1079,16,1392,810,1458,880,66,70,car
35114,18,person,18,0,1079,19,1457,787,1492,880,35,93,person
35115,27,truck,27,0,1079,20,1163,635,1209,659,46,24,truck
35116,28,car,28,0,1079,22,261,667,312,689,51,22,car
35117,29,person,29,0,1079,18,394,719,415,752,21,33,person
35118,1,airplane,2,0,1080,54,7,406,1803,790,1796,384,airplane
35119,7,airplane,7,1,1080,23,831,375,1250,585,419,210,airplane
35120,9,airplane,9,1,1080,18,1920,548,2049,672,129,124,airplane
35121,14,truck,15,1,1082,33,181,1040,473,1194,292,154,truck
35122,3,car,4,0,1084,17,41,562,190,605,149,43,car
35123,4,person,5,0,1085,26,458,797,501,902,43,105,person
35124,5,car,6,1,1086,18,430,1362,639,1502,209,140,car
35125,6,car,7,1,1086,19,626,1394,792,1488,166,94,car
35126,7,car,8,0,1086,20,846,1389,1036,1467,190,78,car
35127,10,car,11,0,1086,17,1362,1373,1482,1435,120,62,car
35128,14,truck,15,1,1086,22,1556,1360,1697,1421,141,61,truck
35129,36,person,37,0,1086,22,379,1362,425,1511,46,149,person
35130,37,person,38,0,1086,18,1183,1365,1207,1445,24,80,person
35131,6,car,7,0,1087,23,1012,791,1133,851,121,60,car
35132,7,car,8,0,1087,18,1203,780,1293,837,90,57,car
35133,8,car,9,0,1087,20,1291,795,1353,835,62,40,car
35134,9,car,10,0,1087,16,1343,794,1401,830,58,36,car
35135,18,person,19,0,1087,17,774,773,799,853,25,80,person
35136,5,person,6,0,1088,15,970,1048,1033,1137,63,89,person
35137,2,person,3,0,1090,16,600,710,644,772,44,62,person
35138,7,bus,8,0,1090,20,1650,689,1767,734,117,45,bus
35139,4,person,5,0,1091,19,1415,767,1474,1006,59,239,person
35140,5,person,6,0,1091,17,1504,758,1597,985,93,227,person
35141,4,person,5,0,5,70,169,239,320,676,151,437,person
35142,6,motorbike,6,0,1234,16,839,1447,886,1537,47,90,motorcycle
35143,7,motorbike,7,0,1234,17,690,1438,735,1536,45,98,motorcycle
35144,11,motorbike,11,0,1234,53,520,1463,632,1703,112,240,motorcycle
35145,14,person,14,0,1234,24,738,1476,785,1536,47,60,person
35146,15,person,15,1,1234,17,732,1440,748,1508,16,68,person
35147,10,flowerpot,11,0,1235,17,1334,1232,1510,1392,176,160,potted plant
35148,0,person,1,0,1236,77,945,718,1068,1101,123,383,person
35149,1,person,1,0,1237,39,410,859,545,1258,135,399,person
35150,14,chair,14,1,1237,16,1067,1185,1208,1449,141,264,chair
35151,15,chair,15,1,1237,25,1097,1238,1281,1534,184,296,chair
35152,20,chair,20,1,1237,19,1401,1236,1579,1303,178,67,chair
35153,22,table,22,0,1237,24,1309,1285,1770,1534,461,249,dining table
35154,23,chair,23,1,1237,30,1665,1356,1910,1506,245,150,chair
35155,24,chair,24,1,1237,18,1257,1273,1408,1532,151,259,chair
35156,25,chair,25,1,1237,21,1339,1375,1629,1536,290,161,chair
35157,28,person,28,0,1237,27,726,869,760,975,34,106,person
35158,29,person,29,0,1237,29,665,868,704,980,39,112,person
35159,30,person,30,0,1237,33,623,873,666,1012,43,139,person
35160,37,car,37,1,1237,22,2,907,274,1535,272,628,car
35161,39,person,39,1,1237,18,396,852,443,974,47,122,person
35162,41,person,41,1,1237,19,511,857,538,928,27,71,person
35163,69,person,69,0,1237,209,742,830,995,1425,253,595,person
35164,70,person,70,1,1237,34,758,883,818,988,60,105,person
35165,71,person,71,0,1237,50,588,891,613,976,25,85,person
35166,72,car,72,1,1237,23,534,883,571,943,37,60,car
35167,3,person,4,0,1238,30,578,1435,649,1655,71,220,person
35168,5,bicycle,6,0,1238,24,506,1509,580,1585,74,76,bicycle
35169,6,bicycle,7,0,1238,37,690,1525,759,1632,69,107,bicycle
35170,6,person,7,0,1239,18,665,1403,733,1582,68,179,person
35171,12,person,13,0,1241,18,442,978,484,1140,42,162,person
35172,16,person,17,1,1241,16,469,969,522,1137,53,168,person
35173,25,person,26,0,1246,19,1354,694,1388,790,34,96,person
35174,26,person,27,1,1246,15,1301,682,1327,780,26,98,person
35175,28,motorbike,29,1,1246,20,1578,748,1656,896,78,148,motorcycle
35176,10,car,11,0,1247,15,977,1618,1045,1670,68,52,car
35177,11,person,12,0,1247,29,907,1688,986,1855,79,167,person
35178,7,table,8,0,1249,15,64,158,107,187,43,29,dining table
35179,8,chair,9,0,1249,17,50,158,81,195,31,37,chair
35180,24,chair,25,1,1249,17,59,151,84,164,25,13,chair
35181,3,motorbike,4,0,1250,20,262,221,289,271,27,50,motorcycle
35182,4,motorbike,5,0,1252,39,37,1326,485,2138,448,812,motorcycle
35183,1,truck,2,1,1255,22,119,85,222,159,103,74,truck
35184,6,person,7,0,1255,27,218,107,237,159,19,52,person
35185,10,person,11,0,1257,26,659,367,697,473,38,106,person
35186,11,person,12,0,1257,22,475,374,509,499,34,125,person
35187,12,person,13,0,1257,35,424,391,470,514,46,123,person
35188,13,person,14,0,1257,34,355,373,406,504,51,131,person
35189,14,person,15,1,1257,21,404,382,437,492,33,110,person
35190,15,person,16,0,1257,22,514,378,544,467,30,89,person
35191,16,person,17,0,1257,20,600,368,622,446,22,78,person
35192,17,person,18,0,1257,21,638,359,660,448,22,89,person
35193,8,table,9,1,1258,20,184,278,299,399,115,121,dining table
35194,9,chair,10,1,1258,18,256,289,299,399,43,110,chair
35195,11,table,12,1,1258,17,151,268,237,327,86,59,dining table
35196,6,person,7,0,1259,21,264,240,284,295,20,55,person
35197,1,motorbike,2,0,1260,56,955,626,1150,875,195,249,motorcycle
35198,3,motorbike,3,0,1260,63,580,549,706,813,126,264,motorcycle
35199,4,motorbike,4,1,1260,61,664,550,778,714,114,164,motorcycle
35200,5,motorbike,5,0,1260,19,839,552,886,614,47,62,motorcycle
35201,6,motorbike,6,0,1260,15,899,528,923,562,24,34,motorcycle
35202,7,motorbike,7,1,1260,15,991,541,1008,576,17,35,motorcycle
35203,11,person,10,0,1260,21,780,511,805,569,25,58,person
35204,71,flowerpot,66,0,1260,15,442,709,485,756,43,47,potted plant
35205,3,bicycle,4,0,1263,42,199,513,326,671,127,158,bicycle
35206,4,car,5,0,1267,16,166,380,193,405,27,25,car
35207,15,person,16,0,1267,21,281,379,303,467,22,88,person
35208,4,car,5,0,1269,15,142,229,165,253,23,24,car
35209,1,person,2,1,1272,16,241,362,266,448,25,86,person
35210,5,person,6,0,1273,17,322,297,346,368,24,71,person
35211,6,person,7,0,1273,17,302,293,320,363,18,70,person
35212,7,person,8,0,1273,24,281,296,306,366,25,70,person
35213,8,person,9,0,1273,22,264,299,281,367,17,68,person
35214,9,person,10,0,1273,21,240,299,265,366,25,67,person
35215,11,person,12,0,1273,21,341,298,358,361,17,63,person
35216,8,person,9,1,1275,23,0,93,218,520,218,427,person
35217,9,person,10,1,1275,18,441,434,502,524,61,90,person
35218,4,person,5,1,1279,16,379,200,413,343,34,143,person
35219,5,person,6,0,1279,17,328,210,349,257,21,47,person
35220,7,door,8,0,1280,21,416,734,663,1013,247,279,door
35221,7,person,8,0,1286,23,967,1024,1071,1383,104,359,person
35222,7,table,8,0,1288,15,160,247,238,285,78,38,dining table
35223,8,table,9,1,1288,19,193,309,299,442,106,133,dining table
35224,17,person,18,0,1288,17,148,200,160,235,12,35,person
35225,7,person,8,0,1293,17,201,218,211,246,10,28,person
35226,8,person,9,0,1293,15,178,216,184,244,6,28,person
35227,4,person,5,0,1300,24,156,250,183,338,27,88,person
35228,4,motorbike,5,0,1301,26,321,555,390,656,69,101,motorcycle
35229,9,motorbike,10,0,1302,33,199,526,262,568,63,42,motorcycle
35230,8,person,9,0,1303,18,103,295,124,345,21,50,person
35231,9,person,10,0,1303,20,138,260,152,295,14,35,person
35232,10,person,11,1,1303,27,129,341,172,425,43,84,person
35233,11,person,12,1,1303,36,19,305,69,425,50,120,person
35234,4,car,5,1,1305,17,358,256,407,298,49,42,car
35235,5,umbrella,6,0,1305,19,337,198,468,292,131,94,umbrella
35236,7,person,8,0,1305,18,427,257,454,348,27,91,person
35237,8,bicycle,9,0,1305,46,361,296,451,373,90,77,bicycle
35238,13,person,14,0,1305,15,309,246,321,280,12,34,person
35239,14,person,15,0,1305,18,271,253,286,299,15,46,person
35240,15,umbrella,16,0,1305,19,539,216,639,296,100,80,umbrella
35241,5,person,6,0,1307,18,195,137,204,169,9,32,person
35242,4,person,5,0,1308,31,128,158,175,278,47,120,person
35243,5,truck,6,0,1311,25,386,560,581,725,195,165,truck
35244,12,person,13,0,22614,17,349,592,360,618,11,26,person
35245,13,person,14,0,22614,15,388,594,395,610,7,16,person
35246,7,person,8,0,22618,56,564,583,659,944,95,361,person
35247,8,backpack,9,0,22618,33,594,631,679,802,85,171,backpack
35248,9,person,10,0,22618,76,449,619,557,958,108,339,person
35249,11,person,12,1,22618,50,103,606,204,883,101,277,person
35250,12,person,13,0,22618,30,467,591,533,652,66,61,person
35251,13,person,14,0,22618,35,541,580,586,764,45,184,person
35252,15,person,16,0,22618,29,362,619,383,696,21,77,person
35253,16,person,17,0,22618,40,384,592,417,693,33,101,person
35254,17,person,18,0,22618,43,425,600,452,698,27,98,person
35255,19,person,19,0,22618,32,339,588,361,667,22,79,person
35256,20,person,20,1,22618,24,327,584,344,664,17,80,person
35257,21,person,21,1,22618,20,367,589,376,618,9,29,person
35258,22,person,22,1,22618,18,404,590,419,615,15,25,person
35259,23,person,23,1,22618,34,416,587,430,647,14,60,person
35260,24,person,24,1,22618,41,416,586,460,641,44,55,person
35261,25,person,25,1,22618,42,445,587,463,675,18,88,person
35262,4,plant pot,5,0,22619,20,39,1274,169,1493,130,219,potted plant
35263,6,plant pot,7,0,22619,22,400,1076,587,1258,187,182,potted plant
35264,6,person,7,0,22620,98,329,292,549,870,220,578,person
35265,9,car,10,1,22621,19,545,706,602,763,57,57,car
35266,10,car,11,0,22621,24,486,729,579,791,93,62,car
35267,7,bicycle,8,0,22623,51,458,803,546,914,88,111,bicycle
35268,11,person,12,1,22623,23,658,747,677,817,19,70,person
35269,12,person,13,0,22623,22,673,758,689,829,16,71,person
35270,13,person,14,0,22623,25,686,747,710,831,24,84,person
35271,9,car,10,1,22624,19,330,586,357,611,27,25,car
35272,10,person,11,1,1318,49,566,971,1184,1534,618,563,person
35273,11,person,12,0,1318,45,727,979,1289,1532,562,553,person
35274,12,person,13,0,1318,15,1573,1257,1597,1328,24,71,person
35275,13,person,14,0,1318,15,1420,1205,1453,1274,33,69,person
35276,15,person,16,0,1318,16,1773,1238,1795,1307,22,69,person
35277,16,person,17,0,1318,20,1608,1142,1633,1216,25,74,person
35278,17,person,18,0,1318,16,1278,1289,1296,1355,18,66,person
35279,18,person,19,0,1318,16,1851,1024,1877,1076,26,52,person
35280,19,person,20,0,1320,31,969,936,1026,1096,57,160,person
35281,20,person,21,0,1320,33,1037,864,1120,1012,83,148,person
35282,21,person,22,0,1320,19,1785,570,1831,663,46,93,person
35283,24,person,25,0,1322,20,574,577,605,694,31,117,person
35284,25,person,26,0,1322,22,490,597,537,682,47,85,person
35285,26,person,27,1,1322,18,523,612,575,680,52,68,person
35286,27,person,28,0,1322,16,737,569,764,666,27,97,person
35287,28,person,29,1,1322,15,101,676,151,788,50,112,person
35288,30,person,31,0,1322,17,1406,553,1441,598,35,45,person
35289,9,person,10,0,1323,31,425,440,490,531,65,91,person
35290,10,person,11,0,1323,29,507,476,570,559,63,83,person
35291,11,person,12,0,1323,26,325,290,375,374,50,84,person
35292,12,person,13,0,1323,21,344,237,378,321,34,84,person
35293,27,person,28,0,1324,26,821,1224,859,1348,38,124,person
35294,28,person,29,0,1324,19,909,1219,946,1337,37,118,person
35295,29,person,30,1,1324,16,898,1175,942,1239,44,64,person
35296,30,person,31,0,1324,17,695,903,718,959,23,56,person
35297,5,person,6,0,1325,20,59,683,115,838,56,155,person
35298,6,person,7,0,1325,25,116,729,160,884,44,155,person
35299,5,person,6,0,1326,40,349,328,539,757,190,429,person
35300,10,person,11,0,1327,18,406,546,424,614,18,68,person
35301,11,person,12,0,1327,19,368,563,398,643,30,80,person
35302,12,person,13,0,1327,20,308,601,336,689,28,88,person
35303,5,person,6,0,1328,17,286,137,303,161,17,24,person
35304,7,person,8,0,1328,15,246,135,264,159,18,24,person
35305,22,person,23,1,22626,85,407,332,742,768,335,436,person
35306,5,car,6,0,1404,23,1620,949,1807,1009,187,60,car
35307,5,car,6,0,1405,24,76,477,210,532,134,55,car
35308,38,flowerpot,39,0,1406,15,2039,1071,2085,1115,46,44,potted plant
35309,4,car,5,1,1408,22,787,1641,1114,1941,327,300,car
35310,5,car,6,1,1408,30,554,1621,909,1857,355,236,car
35311,6,car,7,1,1408,22,421,1605,688,1797,267,192,car
35312,7,car,8,1,1408,20,265,1570,547,1764,282,194,car
35313,8,car,9,1,1408,23,29,1561,298,1720,269,159,car
35314,94,person,95,0,1415,29,928,937,973,1040,45,103,person
35315,95,motorbike,96,0,1415,27,1327,931,1399,993,72,62,motorcycle
35316,96,motorbike,97,0,1415,27,1257,920,1334,996,77,76,motorcycle
35317,98,motorbike,99,0,1415,19,1155,928,1201,999,46,71,motorcycle
35318,105,motorbike,106,1,1415,20,139,972,275,1022,136,50,motorcycle
35319,106,bicycle,107,1,1415,20,270,968,349,1014,79,46,bicycle
35320,5,car,6,1,1421,15,394,566,509,666,115,100,car
35321,6,car,7,0,1421,29,77,567,395,734,318,167,car
35322,8,car,9,1,1423,17,142,730,268,817,126,87,car
35323,10,car,11,1,1423,16,264,726,388,798,124,72,car
35324,12,truck,13,1,1423,17,396,712,549,780,153,68,truck
35325,17,motorbikes,18,1,1423,21,460,783,637,851,177,68,motorcycle
35326,4,car,5,1,1425,25,123,1271,551,1527,428,256,car
35327,6,car,7,0,1425,36,684,1324,1421,1529,737,205,car
35328,8,car,9,1,1425,23,1611,1216,2199,1586,588,370,car
35329,11,car,12,1,1425,20,2,1264,204,1538,202,274,car
35330,29,window,30,0,1425,16,422,658,493,747,71,89,window
35331,135,door,136,0,1425,19,901,1328,1081,1486,180,158,door
35332,136,door,137,0,1425,20,1054,1329,1202,1487,148,158,door
35333,154,window,155,0,1425,15,1989,1245,2193,1363,204,118,window
35334,155,door,156,0,1425,19,1942,1234,2200,1520,258,286,door
35335,10,car,11,1,1426,23,33,396,152,462,119,66,car
35336,11,car,12,1,1426,27,65,393,184,467,119,74,car
35337,13,car,14,0,1426,53,271,391,619,516,348,125,car
35338,54,bed,55,0,1426,18,161,413,314,442,153,29,bed
35339,5,person,6,0,1430,23,574,476,624,578,50,102,person
35340,5,car,6,1,1431,20,1225,1834,1535,2046,310,212,car
35341,7,car,8,0,1431,21,669,1845,1230,2046,561,201,car
35342,8,car,9,1,1431,28,428,1859,866,2045,438,186,car
35343,13,car,14,0,1432,20,1776,1130,2200,1366,424,236,car
35344,22,person,23,0,1432,24,1217,1126,1282,1254,65,128,person
35345,23,person,24,0,1432,24,1263,1124,1326,1269,63,145,person
35346,85,person,86,0,1432,29,994,1111,1053,1237,59,126,person
35347,86,person,87,0,1432,24,1043,1120,1082,1237,39,117,person
35348,11,person,12,1,1437,27,683,454,739,547,56,93,person
35349,13,person,14,0,1437,32,248,437,280,539,32,102,person
35350,14,person,15,0,1437,28,209,429,236,544,27,115,person
35351,8,motorbike,9,1,1438,29,315,415,484,478,169,63,motorcycle
35352,9,motorbike,10,1,1438,30,304,414,431,470,127,56,motorcycle
35353,28,person,29,0,1438,18,158,382,173,419,15,37,person
35354,29,person,30,1,1438,22,47,400,68,462,21,62,person
35355,11,car,12,0,1439,27,199,285,381,348,182,63,car
35356,24,fire hydrant,25,0,1439,16,127,300,142,327,15,27,fire hydrant
35357,9,car,10,1,1445,18,289,449,347,490,58,41,car
35358,10,car,11,0,1445,21,235,457,310,496,75,39,car
35359,5,person,6,0,1448,15,174,31,183,49,9,18,person
35360,4,motorbike,5,0,1453,35,193,528,287,603,94,75,motorcycle
35361,5,motorbike,6,1,1453,18,271,529,316,585,45,56,motorcycle
35362,6,car,7,1,1453,16,315,528,479,639,164,111,car
35363,9,boat,10,0,1456,17,493,495,614,528,121,33,boat
35364,9,car,10,1,1458,15,500,292,549,330,49,38,car
35365,10,car,11,0,1458,30,214,278,317,322,103,44,car
35366,11,car,12,0,1458,25,125,275,189,305,64,30,car
35367,12,car,13,0,1458,20,86,266,143,294,57,28,car
35368,5,car,6,0,1460,31,557,392,731,471,174,79,car
35369,6,car,7,0,1460,27,380,386,531,452,151,66,car
35370,37,door,38,0,1460,16,660,395,692,452,32,57,door
35371,41,door,42,0,1460,15,678,395,709,450,31,55,door
35372,3,car,4,1,1461,16,301,412,368,471,67,59,car
35373,11,car,12,1,1462,19,184,255,247,306,63,51,car
35374,6,person,7,0,1464,22,124,250,144,294,20,44,person
35375,7,person,8,1,1464,17,115,252,128,293,13,41,person
35376,3,car,4,0,1465,21,79,442,226,509,147,67,car
35377,9,window,10,0,1465,18,128,175,250,294,122,119,window
35378,3,car,4,0,1466,18,0,536,86,591,86,55,car
35379,4,car,5,1,1466,23,60,536,148,575,88,39,car
35380,5,car,6,1,1466,19,118,515,214,567,96,52,car
35381,6,car,7,1,1466,21,182,513,258,556,76,43,car
35382,4,car,5,0,1467,22,358,319,468,367,110,48,car
35383,6,car,7,0,1467,23,615,316,685,345,70,29,car
35384,7,car,8,0,1467,19,680,315,731,343,51,28,car
35385,9,car,10,0,1469,15,337,1327,522,1456,185,129,car
35386,10,car,11,0,1469,17,604,1365,761,1450,157,85,car
35387,12,car,13,0,1469,18,824,1368,997,1491,173,123,car
35388,79,fire hydrant,80,0,1469,15,172,1383,204,1454,32,71,fire hydrant
35389,9,person,10,0,1470,19,191,448,208,494,17,46,person
35390,11,person,12,0,24792,32,802,561,816,605,14,44,person
35391,12,person,13,0,24792,30,776,560,790,604,14,44,person
35392,13,person,14,0,24792,25,760,560,772,602,12,42,person
35393,14,person,15,0,24792,30,747,563,760,603,13,40,person
35394,15,person,16,0,24792,30,732,563,752,604,20,41,person
35395,16,person,17,0,24792,15,731,563,741,594,10,31,person
35396,17,person,18,0,24792,26,899,556,914,601,15,45,person
35397,18,person,19,0,24792,25,928,568,938,600,10,32,person
35398,19,person,20,0,24792,24,957,563,971,601,14,38,person
35399,20,person,21,0,24792,25,944,574,960,600,16,26,person
35400,21,bench,22,0,24792,20,682,567,723,589,41,22,bench
35401,22,bench,23,0,24792,21,323,567,362,590,39,23,bench
35402,8,umbrella,8,0,24794,40,760,280,879,416,119,136,umbrella
35403,18,door,19,0,24796,16,485,372,514,397,29,25,door
35404,19,person,20,0,24796,16,495,365,513,406,18,41,person
35405,20,person,21,1,24796,17,512,366,529,407,17,41,person
35406,22,car,23,1,24796,27,181,371,292,411,111,40,car
35407,23,car,24,0,24796,24,16,365,154,412,138,47,car
35408,4,car,5,0,24798,29,1834,1491,2175,1725,341,234,car
35409,5,car,6,0,24798,30,1463,1553,1894,1814,431,261,car
35410,6,car,7,0,24798,22,832,1605,1537,1884,705,279,car
35411,3,car,4,0,24799,24,72,423,232,511,160,88,car
35412,12,car,13,0,1511,21,712,480,784,537,72,57,car
35413,24,car,25,1,1511,24,2,467,140,665,138,198,car
35414,0,car,1,0,1516,16,2,697,114,761,112,64,car
35415,25,person,24,0,1519,29,607,506,648,608,41,102,person
35416,26,person,25,0,1519,42,402,522,446,636,44,114,person
35417,27,person,26,0,1519,24,251,515,286,608,35,93,person
35418,28,person,27,0,1519,35,39,492,90,605,51,113,person
35419,29,person,28,1,1519,30,0,473,39,568,39,95,person
35420,30,person,29,0,1519,22,693,490,721,567,28,77,person
35421,15,boat,16,0,1521,90,570,294,1320,684,750,390,boat
35422,24,person,25,1,1521,33,1016,380,1084,484,68,104,person
35423,25,person,26,1,1521,42,920,391,1007,495,87,104,person
35424,26,person,27,1,1521,33,651,231,715,309,64,78,person
35425,27,person,28,1,1521,29,585,231,632,320,47,89,person
35426,28,person,29,1,1521,25,477,242,493,307,16,65,person
35427,29,person,30,0,1521,27,484,241,509,308,25,67,person
35428,30,person,31,0,1521,23,441,249,459,297,18,48,person
35429,5,person,6,1,22639,21,214,589,269,645,55,56,person
35430,7,person,8,0,22639,77,1528,950,1634,1282,106,332,person
35431,8,person,9,0,22639,72,1801,997,1954,1306,153,309,person
35432,10,person,11,0,22639,70,2083,934,2199,1308,116,374,person
35433,11,person,12,0,22639,36,1181,967,1236,1133,55,166,person
35434,12,person,13,1,22639,33,1221,960,1253,1061,32,101,person
35435,13,person,14,1,22639,21,1008,942,1036,1038,28,96,person
35436,14,person,15,0,22639,39,975,910,1013,1038,38,128,person
35437,15,person,16,0,22639,33,952,910,989,1038,37,128,person
35438,16,person,17,0,22639,50,729,928,806,1121,77,193,person
35439,23,person,24,1,22639,25,202,938,258,996,56,58,person
35440,24,person,25,1,22639,20,188,922,216,994,28,72,person
35441,25,person,26,0,22639,64,159,862,218,996,59,134,person
35442,26,person,27,1,22639,31,89,921,130,991,41,70,person
35443,27,person,28,1,22639,23,111,933,160,995,49,62,person
35444,5,person,6,1,1532,20,350,429,391,479,41,50,person
35445,11,person,12,1,1532,17,554,419,590,479,36,60,person
35446,12,person,13,1,1532,16,538,423,563,479,25,56,person
35447,17,person,18,1,1532,20,176,429,227,479,51,50,person
35448,8,person,9,0,1534,16,285,305,299,343,14,38,person
35449,9,person,10,0,1534,17,269,302,281,340,12,38,person
35450,13,person,14,0,1535,24,70,316,90,367,20,51,person
35451,14,person,15,0,1535,22,314,318,326,361,12,43,person
35452,15,person,16,0,1535,21,298,317,311,362,13,45,person
35453,8,person,9,1,1537,16,146,586,178,625,32,39,person
35454,1,window,2,0,22650,30,857,104,1021,345,164,241,window
35455,2,window,3,0,22650,35,636,112,792,349,156,237,window
35456,3,window,4,0,22650,26,368,103,572,342,204,239,window
35457,4,window,5,0,22650,28,161,129,313,356,152,227,window
35458,5,window,6,0,22650,18,0,135,111,354,111,219,window
35459,6,window,7,0,22650,16,868,416,1024,711,156,295,window
35460,7,window,8,0,22650,18,640,422,809,693,169,271,window
35461,5,person,6,0,8,118,321,11,975,648,654,637,person
35462,1,person,2,0,9,65,157,173,394,431,237,258,person
35463,3,person,4,0,1540,22,222,12,245,49,23,37,person
35464,4,person,5,0,1540,37,219,113,263,173,44,60,person
35465,5,person,6,0,1540,26,150,58,192,100,42,42,person
35466,6,person,7,0,1540,25,61,28,95,66,34,38,person
35467,1,person,2,0,1541,72,183,192,551,480,368,288,person
35468,2,person,3,0,1541,49,460,1,661,239,201,238,person
35469,3,person,4,0,1541,32,227,1,349,184,122,183,person
35470,3,person,4,0,1542,51,141,29,205,153,64,124,person
35471,4,person,5,1,1542,25,48,38,107,66,59,28,person
35472,5,person,6,1,1542,23,73,58,106,104,33,46,person
35473,6,person,7,1,1542,18,0,59,54,105,54,46,person
35474,8,person,9,1,1542,50,0,64,121,239,121,175,person
35475,9,person,10,1,1542,39,149,129,259,239,110,110,person
35476,2,person,3,1,1543,50,47,24,107,155,60,131,person
35477,3,person,4,1,1543,49,138,52,207,204,69,152,person
35478,24,bus,25,0,1544,16,668,125,785,199,117,74,bus
35479,3,person,4,0,1546,41,138,128,497,438,359,310,person
35480,4,person,5,1,1546,37,419,3,690,409,271,406,person
35481,5,person,6,0,1546,56,654,117,1062,621,408,504,person
35482,6,person,7,1,1546,29,903,3,1174,780,271,777,person
35483,7,person,8,1,1546,43,3,528,608,781,605,253,person
35484,8,dog,9,0,1546,37,382,220,650,433,268,213,dog
35485,9,person,10,1,1547,33,226,3,267,79,41,76,person
35486,10,person,11,0,1547,43,63,75,127,181,64,106,person
35487,11,person,12,0,1547,36,175,80,233,164,58,84,person
35488,12,person,13,0,1547,49,216,72,314,221,98,149,person
35489,1,person,2,0,1548,29,0,56,66,154,66,98,person
35490,2,person,3,1,1548,32,182,18,233,112,51,94,person
35491,3,person,4,1,1548,36,216,44,285,132,69,88,person
35492,4,person,5,1,22656,72,1201,572,1454,1190,253,618,person
35493,6,person,7,1,22656,51,1053,615,1230,1060,177,445,person
35494,10,person,11,0,22657,37,394,416,498,536,104,120,person
35495,11,person,12,1,22657,37,464,281,535,472,71,191,person
35496,12,person,13,1,22657,36,543,273,594,504,51,231,person
35497,13,person,14,0,22657,63,491,301,592,589,101,288,person
35498,14,person,15,1,22657,30,615,323,662,544,47,221,person
35499,15,person,16,0,22657,37,635,324,711,596,76,272,person
35500,4,person,5,1,22658,25,469,137,486,211,17,74,person
35501,5,person,6,0,22658,30,477,137,513,224,36,87,person
35502,1,person,2,0,22660,79,1,124,355,352,354,228,person
35503,2,person,3,0,22660,66,195,54,451,243,256,189,person
35504,3,person,4,1,22660,70,321,1,640,268,319,267,person
35505,4,person,5,1,22660,15,90,445,222,479,132,34,person
35506,1,person,2,1,22661,51,572,1,900,583,328,582,person
35507,2,person,3,1,22661,82,1,0,358,348,357,348,person
35508,1,person,2,1,10,28,371,37,428,347,57,310,person
35509,2,person,3,1,10,57,306,8,424,347,118,339,person
35510,3,person,4,1,10,52,203,98,336,347,133,249,person
35511,4,person,5,1,10,55,183,118,289,346,106,228,person
35512,5,person,6,1,10,43,206,129,252,347,46,218,person
35513,6,person,7,1,10,33,200,155,221,346,21,191,person
35514,11,person,12,1,10,54,84,91,212,347,128,256,person
35515,12,person,13,1,10,24,76,115,118,259,42,144,person
35516,13,person,14,1,10,37,0,105,66,262,66,157,person
35517,14,person,15,1,10,41,0,115,96,346,96,231,person
35518,5,window,6,0,11,35,272,157,497,416,225,259,window
35519,7,person,8,0,11,99,305,243,498,855,193,612,person
35520,6,person,7,0,12,162,43,109,271,627,228,518,person
35521,14,person,15,1,12,124,180,70,329,451,149,381,person
35522,24,plate,25,1,12,36,357,347,482,388,125,41,plate
35523,26,person,27,1,12,21,310,151,374,352,64,201,person
35524,28,person,29,1,12,60,331,79,494,351,163,272,person
35525,35,person,36,1,12,49,519,49,615,228,96,179,person
35526,41,person,42,1,12,33,570,58,650,161,80,103,person
35527,42,person,43,1,12,21,609,152,650,337,41,185,person
35528,43,person,44,0,12,107,397,99,643,626,246,527,person
35529,50,person,51,1,12,25,451,220,523,322,72,102,person
35530,7,window,8,0,13,16,503,378,772,682,269,304,window
35531,16,person,17,0,13,86,245,416,504,1087,259,671,person
35532,18,person,19,0,13,65,1234,447,1595,1117,361,670,person
35533,2,person,3,0,14,48,240,617,367,821,127,204,person
35534,10,person,11,0,14,59,364,646,538,885,174,239,person
35535,19,person,20,1,14,38,483,631,634,742,151,111,person
35536,20,person,21,0,14,62,538,502,698,758,160,256,person
35537,27,person,28,0,14,26,729,568,802,708,73,140,person
35538,28,person,29,0,14,57,815,586,960,875,145,289,person
35539,36,person,37,1,14,25,1050,554,1128,652,78,98,person
35540,37,person,38,0,14,63,1035,597,1175,829,140,232,person
35541,47,person,48,1,14,40,1122,547,1264,663,142,116,person
35542,49,person,50,1,14,41,1146,590,1274,761,128,171,person
35543,9,person,10,0,1594,30,38,172,69,262,31,90,person
35544,10,person,11,0,1594,28,63,173,97,290,34,117,person
35545,11,person,12,0,1594,38,384,137,441,296,57,159,person
35546,4,person,5,1,22664,37,3,1,327,486,324,485,person
35547,5,person,6,1,22664,15,699,0,770,84,71,84,person
35548,6,person,7,1,22664,79,250,107,986,675,736,568,person
35549,7,backpack,8,0,22664,31,407,40,871,250,464,210,backpack
35550,1,person,2,1,22665,79,32,2,682,1024,650,1022,person
35551,2,person,3,1,22665,86,3,99,656,855,653,756,person
35552,5,table,6,1,22666,30,296,477,548,616,252,139,dining table
35553,7,person,8,1,22666,110,456,202,743,679,287,477,person
35554,8,person,9,1,22666,87,338,181,548,679,210,498,person
35555,9,person,10,1,22666,92,115,213,315,679,200,466,person
35556,2,person,3,0,22667,80,862,332,948,599,86,267,person
35557,3,person,4,0,22667,80,788,327,876,598,88,271,person
35558,4,person,5,0,22667,92,708,325,800,597,92,272,person
35559,5,person,6,0,22667,110,605,324,713,597,108,273,person
35560,6,person,7,0,22667,89,512,305,625,599,113,294,person
35561,7,person,8,0,22667,106,447,299,567,602,120,303,person
35562,8,person,9,0,22667,75,370,310,460,606,90,296,person
35563,9,person,10,1,22667,88,294,303,383,607,89,304,person
35564,10,person,11,0,22667,88,229,325,317,611,88,286,person
35565,11,person,12,0,22667,71,160,327,244,616,84,289,person
35566,12,person,13,0,22667,104,73,317,181,611,108,294,person
35567,1,person,2,1,22668,31,604,158,640,403,36,245,person
35568,3,person,4,1,22668,42,594,158,630,383,36,225,person
35569,4,person,5,0,22668,58,539,145,609,404,70,259,person
35570,6,person,7,1,22668,47,532,174,564,378,32,204,person
35571,7,person,8,1,22668,59,471,154,543,394,72,240,person
35572,8,person,9,0,22668,69,385,112,495,448,110,336,person
35573,11,person,12,1,22668,43,363,166,401,379,38,213,person
35574,12,person,13,0,22668,57,319,164,388,379,69,215,person
35575,13,person,14,1,22668,19,312,163,339,206,27,43,person
35576,14,person,15,1,22668,37,307,168,331,365,24,197,person
35577,15,person,16,0,22668,45,261,161,328,381,67,220,person
35578,16,person,17,1,22668,42,245,168,278,365,33,197,person
35579,17,person,18,0,22668,50,205,162,267,375,62,213,person
35580,18,person,19,0,22668,62,117,118,222,443,105,325,person
35581,21,car,22,1,22668,22,1,162,77,295,76,133,car
35582,22,car,23,1,22668,18,67,223,125,296,58,73,car
35583,7,person,8,1,22669,98,484,50,763,685,279,635,person
35584,8,person,9,1,22669,95,0,46,337,684,337,638,person
35585,9,person,10,1,22669,23,474,305,504,467,30,162,person
35586,10,person,11,1,22669,43,437,279,481,458,44,179,person
35587,11,person,12,1,22669,42,385,254,452,469,67,215,person
35588,12,person,13,1,22669,42,348,273,406,474,58,201,person
35589,13,person,14,1,22669,40,299,279,364,482,65,203,person
35590,14,person,15,1,22669,19,269,250,312,333,43,83,person
35591,4,person,5,1,22670,18,684,111,724,179,40,68,person
35592,5,person,6,1,22670,94,772,108,964,624,192,516,person
35593,6,person,7,1,22670,95,340,116,492,679,152,563,person
35594,7,person,8,1,22670,143,1,18,403,679,402,661,person
35595,8,person,9,1,22670,16,0,178,40,250,40,72,person
35596,10,bottle,11,1,22670,21,1,602,27,679,26,77,bottle
35597,13,person,14,1,22670,137,431,3,910,679,479,676,person
35598,14,person,15,1,22670,122,65,83,510,679,445,596,person
35599,4,person,5,0,22671,47,20,202,82,369,62,167,person
35600,5,person,6,0,22671,51,73,202,148,429,75,227,person
35601,6,person,7,1,22671,29,258,203,317,309,59,106,person
35602,7,person,8,1,22671,59,197,256,409,526,212,270,person
35603,8,person,9,0,22671,67,240,294,410,574,170,280,person
35604,9,person,10,0,22671,53,386,203,467,387,81,184,person
35605,11,person,12,0,22671,71,420,294,594,532,174,238,person
35606,12,person,13,0,22671,38,574,212,635,395,61,183,person
35607,13,person,14,0,22671,44,740,215,815,434,75,219,person
35608,14,person,15,0,22671,59,834,203,924,447,90,244,person
35609,15,person,16,0,22671,54,902,199,990,452,88,253,person
35610,16,person,17,0,22671,41,942,211,1023,478,81,267,person
35611,4,person,5,0,22672,46,825,260,942,565,117,305,person
35612,5,person,6,1,22672,53,684,129,812,712,128,583,person
35613,6,person,7,1,22672,46,593,145,744,713,151,568,person
35614,7,person,8,1,22672,57,453,82,648,711,195,629,person
35615,8,person,9,1,22672,67,168,5,561,712,393,707,person
35616,2,person,3,1,22673,22,206,185,281,337,75,152,person
35617,3,person,4,0,22673,51,312,132,409,335,97,203,person
35618,4,person,5,1,22673,35,380,201,455,330,75,129,person
35619,5,person,6,1,22673,35,538,148,649,248,111,100,person
35620,6,person,7,0,22673,33,758,160,885,284,127,124,person
35621,1,person,2,0,22674,50,89,326,300,840,211,514,person
35622,2,person,3,0,22674,55,411,225,653,740,242,515,person
35623,3,person,4,0,22674,49,833,168,1002,687,169,519,person
35624,4,person,5,0,22674,56,1171,126,1361,748,190,622,person
35625,5,person,6,0,22674,79,1347,152,1535,856,188,704,person
35626,6,person,7,1,22674,65,1489,429,1750,1017,261,588,person
35627,7,backpack,8,0,22674,17,1533,330,1701,619,168,289,backpack
35628,8,backpack,9,0,22674,25,1438,143,1597,435,159,292,backpack
35629,9,backpack,10,0,22674,19,1226,131,1368,397,142,266,backpack
35630,10,backpack,11,0,22674,19,918,171,1054,406,136,235,backpack
35631,12,backpack,13,0,22674,16,256,350,359,563,103,213,backpack
35632,4,person,5,1,22675,18,695,121,737,187,42,66,person
35633,5,person,6,0,22675,115,665,75,895,561,230,486,person
35634,6,person,7,1,22675,84,481,117,615,573,134,456,person
35635,7,person,8,0,22675,118,254,98,560,716,306,618,person
35636,8,backpack,9,0,22675,38,781,128,885,285,104,157,backpack
35637,9,backpack,10,0,22675,33,321,188,383,384,62,196,backpack
35638,0,airplane,1,1,1601,20,570,692,1215,911,645,219,airplane
35639,1,airplane,2,0,1601,55,2,668,487,927,485,259,airplane
35640,2,car,3,0,1601,17,387,884,451,917,64,33,car
35641,3,car,4,0,1601,19,455,885,521,911,66,26,car
35642,4,car,5,0,1601,15,514,873,575,903,61,30,car
35643,5,airplane,6,1,1601,35,1020,762,1536,890,516,128,airplane
35644,7,truck,8,1,1601,16,1544,847,1599,904,55,57,truck
35645,3,airplane,4,1,1602,15,940,800,1430,894,490,94,airplane
35646,4,airplane,5,1,1603,18,386,232,599,401,213,169,airplane
35647,1,airplane,2,1,1604,29,556,560,1798,981,1242,421,airplane
35648,3,truck,4,0,1604,28,569,1007,1479,1259,910,252,truck
35649,1,airplane,2,0,1605,77,284,407,1603,979,1319,572,airplane
35650,7,person,8,0,1605,21,1298,800,1342,903,44,103,person
35651,11,airplane,12,0,1606,27,0,157,116,206,116,49,airplane
35652,0,airplane,1,0,1607,53,804,472,1596,896,792,424,airplane
35653,5,car,6,0,1607,15,301,769,385,802,84,33,car
35654,8,car,9,1,1607,15,567,777,647,816,80,39,car
35655,4,airplane,5,1,1608,38,62,59,436,206,374,147,airplane
35656,5,airplane,6,1,1608,46,0,147,512,347,512,200,airplane
35657,2,airplane,3,1,1609,64,62,192,622,398,560,206,airplane
35658,5,airplane,6,0,1609,15,462,274,534,295,72,21,airplane
35659,5,airplane,6,0,1610,40,308,241,586,399,278,158,airplane
35660,10,person,11,0,1610,17,679,363,697,408,18,45,person
35661,11,person,12,0,1610,16,663,361,681,408,18,47,person
35662,0,airplane,1,1,1611,34,18,483,1805,872,1787,389,airplane
35663,1,airplane,2,1,1611,15,1554,516,1904,658,350,142,airplane
35664,6,truck,7,1,1611,35,738,882,1271,1175,533,293,truck
35665,7,truck,8,1,1611,31,1015,934,1415,1213,400,279,truck
35666,8,truck,9,0,1611,44,1319,904,1831,1279,512,375,truck
35667,9,truck,10,1,1611,38,1743,880,2046,1446,303,566,truck
35668,10,truck,11,1,1611,18,0,1189,375,1533,375,344,truck
35669,0,airplane,1,0,1612,17,270,956,340,977,70,21,airplane
35670,1,airplane,2,0,1612,18,419,957,474,972,55,15,airplane
35671,3,airplane,4,0,1612,17,514,939,587,970,73,31,airplane
35672,8,airplane,9,0,1612,24,1110,921,1225,957,115,36,airplane
35673,11,truck,12,1,1612,23,1973,1300,2199,1519,226,219,truck
35674,13,car,14,1,1612,19,1970,1091,2082,1170,112,79,car
35675,16,car,17,0,1612,38,1429,1414,1580,1604,151,190,car
35676,23,person,24,0,1612,34,792,1208,837,1309,45,101,person
35677,24,car,25,1,1612,30,786,1181,864,1266,78,85,car
35678,26,car,27,0,1612,48,677,1328,931,1431,254,103,car
35679,30,airplane,31,0,1612,136,339,733,2048,1408,1709,675,airplane
35680,31,person,32,1,1612,18,1501,1213,1540,1255,39,42,person
35681,34,car,35,0,1612,32,581,1269,753,1351,172,82,car
35682,44,airplane,45,0,1612,17,1550,924,1631,948,81,24,airplane
35683,49,door,50,0,1612,20,1614,1014,1702,1174,88,160,door
35684,7,airplane,8,1,1613,28,16,330,692,539,676,209,airplane
35685,8,airplane,9,1,1613,24,497,395,1022,661,525,266,airplane
35686,9,airplane,10,1,1613,25,208,424,1023,767,815,343,airplane
35687,0,car,1,0,1614,48,400,974,674,1056,274,82,car
35688,1,airplane,2,1,1614,16,692,687,1341,891,649,204,airplane
35689,3,airplane,4,1,1614,16,1275,787,1570,908,295,121,airplane
35690,1,airplane,2,1,1615,46,0,65,354,243,354,178,airplane
35691,4,person,5,0,1615,37,358,161,403,264,45,103,person
35692,5,door,6,0,1615,15,133,97,151,147,18,50,door
35693,4,airplane,5,0,1616,31,542,824,802,993,260,169,airplane
35694,0,airplane,1,0,1617,30,407,794,987,1032,580,238,airplane
35695,1,airplane,2,0,1617,18,1104,863,1590,1005,486,142,airplane
35696,11,truck,12,0,1617,21,862,960,1000,1035,138,75,truck
35697,12,car,13,0,1617,15,169,975,259,1022,90,47,car
35698,2,car,3,0,1618,38,87,1428,295,1573,208,145,car
35699,4,truck,5,0,1618,19,1499,1483,1972,1651,473,168,truck
35700,5,airplane,6,1,1618,21,1507,845,2199,1165,692,320,airplane
35701,10,truck,11,0,1618,28,1794,1252,2050,1386,256,134,truck
35702,12,car,13,0,1618,29,1236,1467,1481,1624,245,157,car
35703,22,airplane,23,0,1618,29,1036,943,1299,1081,263,138,airplane
35704,27,airplane,28,0,1618,34,242,941,626,1071,384,130,airplane
35705,0,airplane,1,0,1619,91,5,281,1603,1185,1598,904,airplane
35706,2,person,3,0,1619,27,1042,949,1109,1136,67,187,person
35707,3,car,4,0,1619,20,175,576,238,603,63,27,car
35708,1,person,2,0,1620,29,940,718,1037,1014,97,296,person
35709,9,truck,10,1,1620,19,936,387,1599,761,663,374,truck
35710,13,person,14,1,1620,26,1321,824,1493,1068,172,244,person
35711,15,person,16,1,1620,16,111,439,135,518,24,79,person
35712,0,truck,1,0,1621,46,326,761,829,935,503,174,truck
35713,1,person,2,0,1621,31,1156,989,1331,1380,175,391,person
35714,15,airplane,16,1,1621,27,700,538,934,640,234,102,airplane
35715,0,car,1,0,1622,22,903,1014,1071,1121,168,107,car
35716,1,car,2,0,1622,28,682,861,851,925,169,64,car
35717,3,airplane,4,1,1622,38,162,479,741,919,579,440,airplane
35718,10,car,11,0,1623,16,957,609,1015,630,58,21,car
35719,14,car,15,0,1623,15,438,625,476,648,38,23,car
35720,15,car,16,0,1623,18,396,627,438,647,42,20,car
35721,16,car,17,0,1623,15,355,628,393,649,38,21,car
35722,17,car,18,0,1623,16,317,628,354,651,37,23,car
35723,19,car,20,0,1623,17,491,604,567,635,76,31,car
35724,2,airplane,3,1,1624,20,542,648,1381,1024,839,376,airplane
35725,4,truck,5,0,1625,16,1473,538,1598,589,125,51,truck
35726,5,airplane,6,0,1625,57,4,329,1348,647,1344,318,airplane
35727,1,truck,2,1,1626,38,5,1002,853,1443,848,441,truck
35728,4,airplane,5,1,1626,43,523,668,1638,947,1115,279,airplane
35729,6,car,7,0,1626,21,920,912,1010,985,90,73,car
35730,7,airplane,8,0,1626,26,1513,775,1969,947,456,172,airplane
35731,19,person,20,0,1626,22,1341,981,1392,1085,51,104,person
35732,25,truck,26,1,1626,17,183,860,364,920,181,60,truck
35733,0,airplane,1,0,1627,64,422,727,1421,1328,999,601,airplane
35734,20,person,21,0,1627,16,185,1246,224,1304,39,58,person
35735,21,car,22,1,1627,17,1,1235,174,1321,173,86,car
35736,0,airplane,1,1,1628,108,2,561,1597,1357,1595,796,airplane
35737,2,person,3,0,1628,54,588,1216,673,1389,85,173,person
35738,4,person,4,1,1628,21,852,1032,938,1126,86,94,person
35739,11,airplane,10,1,1628,20,106,767,340,888,234,121,airplane
35740,13,truck,12,1,1628,24,165,882,268,917,103,35,truck
35741,16,airplane,15,1,1628,20,0,797,64,884,64,87,airplane
35742,3,airplane,4,0,1629,42,2,121,309,243,307,122,airplane
35743,5,airplane,6,0,1629,27,270,144,436,203,166,59,airplane
35744,8,truck,9,0,1629,17,106,235,173,286,67,51,truck
35745,2,airplane,3,1,1630,35,1317,1071,2194,1376,877,305,airplane
35746,3,airplane,4,1,1630,55,3,1275,1636,1648,1633,373,airplane
35747,4,truck,5,1,1630,17,1549,1409,1721,1601,172,192,truck
35748,6,person,7,0,1630,24,1875,1474,1928,1626,53,152,person
35749,9,airplane,10,1,1630,34,525,1124,1297,1321,772,197,airplane
35750,0,airplane,1,1,1631,19,298,229,1083,600,785,371,airplane
35751,7,car,8,0,1631,24,235,665,486,824,251,159,car
35752,8,car,9,1,1631,19,649,587,831,696,182,109,car
35753,9,car,10,0,1631,17,790,674,898,772,108,98,car
35754,14,truck,15,1,1631,17,725,452,987,564,262,112,truck
35755,0,airplane,1,0,1632,24,341,757,893,929,552,172,airplane
35756,5,airplane,5,1,20240,107,305,472,1718,1448,1413,976,airplane
35757,6,truck,6,1,20240,25,534,946,650,1088,116,142,truck
35758,7,person,7,0,20240,22,1239,1033,1286,1166,47,133,person
35759,9,car,9,0,20240,31,126,965,273,1045,147,80,car
35760,3,person,4,1,2031,60,177,222,950,1627,773,1405,person
35761,4,car,5,1,2031,20,1899,861,2197,1064,298,203,car
35762,4,car,5,1,2032,15,0,797,163,1201,163,404,car
35763,13,car,14,0,2033,20,1313,909,1568,1062,255,153,car
35764,3,car,4,1,2034,25,1680,693,2197,990,517,297,car
35765,4,person,5,0,2067,24,45,174,64,242,19,68,person
35766,4,window,5,0,2204,18,92,0,128,87,36,87,window
35767,9,person,10,0,2205,23,253,117,287,208,34,91,person
35768,5,window,6,0,2207,17,307,0,337,86,30,86,window
35769,4,person,5,1,2209,16,386,389,448,452,62,63,person
35770,5,person,6,1,2209,18,366,392,401,450,35,58,person
35771,6,person,7,1,2209,15,343,402,379,452,36,50,person
35772,9,person,10,1,2209,15,305,402,343,452,38,50,person
35773,10,person,11,1,2209,16,271,401,306,453,35,52,person
35774,14,person,15,1,2209,16,206,406,232,452,26,46,person
35775,15,person,16,1,2209,17,167,403,219,458,52,55,person
35776,16,person,17,1,2209,16,154,408,178,456,24,48,person
35777,17,person,18,1,2209,19,125,404,155,457,30,53,person
35778,18,person,19,1,2209,16,99,407,130,458,31,51,person
35779,19,person,20,1,2209,17,68,397,100,460,32,63,person
35780,3,person,4,1,2213,39,77,6,134,141,57,135,person
35781,4,person,5,1,2213,19,43,61,75,125,32,64,person
35782,5,person,6,1,2213,29,13,62,71,148,58,86,person
35783,2,window,3,0,2214,16,724,2,926,550,202,548,window
35784,4,window,5,0,2214,15,1145,117,1356,849,211,732,window
35785,8,person,9,1,2214,15,1542,638,1608,724,66,86,person
35786,9,person,10,1,2214,15,1615,666,1704,765,89,99,person
35787,3,car,4,1,24829,16,1,362,42,395,41,33,car
35788,17,car,18,1,24830,26,658,842,817,923,159,81,car
35789,18,car,19,1,24830,29,475,911,685,981,210,70,car
35790,19,car,20,1,24830,30,423,950,621,1021,198,71,car
35791,20,car,21,1,24830,26,379,993,625,1079,246,86,car
35792,21,car,22,1,24830,15,777,841,919,898,142,57,car
35793,23,car,24,0,24830,24,1268,673,1416,735,148,62,car
35794,24,motorbike,25,1,24830,15,1374,655,1431,693,57,38,motorcycle
35795,25,car,26,0,24830,20,1396,647,1519,697,123,50,car
35796,26,car,27,1,24830,18,1469,635,1565,689,96,54,car
35797,27,car,28,0,24830,16,1541,613,1657,655,116,42,car
35798,28,car,29,1,24830,17,1594,598,1689,647,95,49,car
35799,14,person,15,1,2217,21,948,417,1048,637,100,220,person
35800,9,chair,10,1,2218,21,42,133,219,317,177,184,chair
35801,11,chair,12,1,2218,26,13,235,281,477,268,242,chair
35802,3,table,4,0,2220,16,229,126,276,185,47,59,dining table
35803,5,bench,6,0,2220,17,206,145,235,182,29,37,bench
35804,4,chair,5,0,2221,57,0,199,287,479,287,280,chair
35805,11,sofa,12,0,2222,30,98,198,293,348,195,150,couch
35806,17,chair,18,0,2222,30,339,217,436,306,97,89,chair
35807,18,chair,19,1,2222,31,348,295,560,359,212,64,chair
35808,13,chair,14,0,2223,18,624,178,694,294,70,116,chair
35809,14,table,15,0,2223,23,572,239,640,311,68,72,dining table
35810,7,chair,8,1,2225,32,76,35,160,139,84,104,chair
35811,8,chair,9,1,2225,17,195,48,298,133,103,85,chair
35812,9,chair,10,0,2225,36,2,88,123,246,121,158,chair
35813,10,chair,11,0,2225,35,167,88,299,277,132,189,chair
35814,11,table,12,0,2225,54,85,57,236,217,151,160,dining table
35815,6,table,7,0,2226,16,326,688,835,959,509,271,dining table
35816,8,chair,9,1,2226,25,797,687,976,959,179,272,chair
35817,9,chair,10,1,2226,15,497,798,863,958,366,160,chair
35818,10,chair,11,1,2226,31,158,668,420,878,262,210,chair
35819,11,chair,12,1,2226,40,174,712,485,959,311,247,chair
35820,5,chair,6,1,2229,74,1366,401,2046,1533,680,1132,chair
35821,6,chair,7,1,2229,30,0,530,1207,1533,1207,1003,chair
35822,18,flowerpot,19,0,2230,15,496,461,569,538,73,77,potted plant
35823,22,sofa,23,0,2230,31,2,386,436,910,434,524,couch
35824,4,chair,5,0,2231,72,287,202,909,604,622,402,chair
35825,5,chair,6,0,2231,74,88,121,589,702,501,581,chair
35826,10,chair,11,1,2232,23,851,364,1019,523,168,159,chair
35827,12,chair,13,0,2232,38,666,395,894,686,228,291,chair
35828,13,chair,14,1,2232,20,885,463,1022,765,137,302,chair
35829,13,chair,14,1,2233,34,311,1276,615,2091,304,815,chair
35830,14,chair,15,1,2233,45,764,1335,1318,2196,554,861,chair
35831,15,chair,16,1,2233,39,367,1565,982,2197,615,632,chair
35832,31,bench,32,0,2234,75,225,260,392,437,167,177,bench
35833,32,dog,33,0,2234,68,277,529,408,767,131,238,dog
35834,10,chair,11,1,2235,18,919,391,1022,720,103,329,chair
35835,8,chair,9,1,2237,27,1653,860,2044,1354,391,494,chair
35836,9,chair,10,0,2237,37,1186,896,1753,1464,567,568,chair
35837,3,umbrella,4,0,2238,42,126,42,645,405,519,363,umbrella
35838,13,table,14,1,2238,29,255,377,534,651,279,274,dining table
35839,15,chair,16,1,2238,23,448,335,556,476,108,141,chair
35840,16,chair,17,1,2238,37,635,328,761,539,126,211,chair
35841,17,chair,18,0,2238,37,504,374,675,638,171,264,chair
35842,18,chair,19,0,2238,46,187,446,418,741,231,295,chair
35843,5,window,6,0,2239,27,27,0,201,204,174,204,window
35844,8,chair,9,0,2239,67,43,93,182,275,139,182,chair
35845,5,chair,6,0,2240,67,1242,638,2149,1649,907,1011,chair
35846,9,flowerpot,10,0,2240,28,986,757,1273,1072,287,315,potted plant
35847,10,chair,11,1,2240,36,0,513,584,1565,584,1052,chair
35848,9,chair,10,1,2242,17,53,80,125,112,72,32,chair
35849,10,table,11,1,2242,19,49,102,126,130,77,28,dining table
35850,11,chair,12,1,2242,39,37,132,159,225,122,93,chair
35851,5,chair,6,1,2243,44,198,95,282,217,84,122,chair
35852,6,chair,7,1,2243,40,0,91,144,235,144,144,chair
35853,6,chair,7,1,2244,27,557,361,666,462,109,101,chair
35854,8,chair,9,0,2244,49,489,380,645,549,156,169,chair
35855,9,chair,10,0,2244,41,664,403,835,577,171,174,chair
35856,10,table,11,1,2244,19,576,391,752,537,176,146,dining table
35857,11,chair,12,0,2244,65,308,416,527,677,219,261,chair
35858,13,chair,14,0,2244,68,84,472,408,767,324,295,chair
35859,15,door,16,0,2244,24,378,85,505,517,127,432,door
35860,9,chair,10,0,2245,68,1134,649,1629,1332,495,683,chair
35861,10,chair,11,0,2245,66,450,619,933,1253,483,634,chair
35862,13,chair,14,0,2246,93,3,807,811,1787,808,980,chair
35863,12,table,13,1,2247,22,158,88,210,130,52,42,dining table
35864,14,chair,15,0,2247,18,133,84,166,132,33,48,chair
35865,15,chair,16,0,2247,22,202,85,235,133,33,48,chair
35866,16,chair,17,0,2247,20,170,88,200,138,30,50,chair
35867,28,table,29,1,2248,25,114,374,563,638,449,264,dining table
35868,31,chair,32,1,2248,23,49,352,221,557,172,205,chair
35869,32,chair,33,0,2248,40,100,507,416,767,316,260,chair
35870,5,person,6,0,24840,15,139,484,152,513,13,29,person
35871,3,person,4,1,24841,19,741,722,833,1013,92,291,person
35872,4,person,5,0,24841,28,845,724,943,1010,98,286,person
35873,11,sofa,12,0,24842,79,1,403,1024,739,1023,336,couch
35874,24,chair,25,1,24842,22,246,574,538,767,292,193,chair
35875,25,chair,26,1,24842,20,540,567,825,767,285,200,chair
35876,4,umbrella,5,0,24843,52,1347,82,2197,1172,850,1090,umbrella
35877,5,umbrella,6,0,24843,41,1,0,1122,1375,1121,1375,umbrella
35878,19,chair,20,0,24843,15,1839,597,1912,675,73,78,chair
35879,8,person,9,0,2315,24,458,1170,532,1414,74,244,person
35880,9,person,10,0,2315,19,544,1188,624,1408,80,220,person
35881,15,car,16,0,2315,22,0,1203,338,1331,338,128,car
35882,16,person,17,1,2315,15,608,1165,662,1272,54,107,person
35883,20,car,21,1,2315,21,1390,1163,1893,1392,503,229,car
35884,21,car,22,1,2315,19,1777,1162,2200,1584,423,422,car
35885,56,person,57,1,2315,26,1029,1137,1076,1250,47,113,person
35886,62,door,63,0,2315,17,188,1212,271,1306,83,94,door
35887,69,bench,70,0,2315,91,909,1248,1056,1367,147,119,bench
35888,71,door,72,0,2315,21,1661,1178,1805,1361,144,183,door
35889,5,car,6,0,2320,26,21,258,91,295,70,37,car
35890,24,traffic light,25,0,2320,32,28,134,158,290,130,156,traffic light
35891,5,person,6,0,2355,19,443,568,459,612,16,44,person
35892,6,person,7,0,2355,17,479,569,495,611,16,42,person
35893,7,person,8,0,2355,18,494,568,512,612,18,44,person
35894,10,person,11,1,2356,23,375,541,408,637,33,96,person
35895,11,person,12,0,2356,22,305,525,328,582,23,57,person
35896,12,person,13,0,2356,19,256,521,276,579,20,58,person
35897,13,person,14,1,2356,19,352,575,384,638,32,63,person
35898,14,person,15,1,2356,17,441,532,477,638,36,106,person
35899,7,bicycle,8,0,2359,31,146,287,175,305,29,18,bicycle
35900,3,car,4,0,2438,24,111,171,153,203,42,32,car
35901,5,person,6,0,22783,34,1,350,78,500,77,150,person
35902,11,sheep,12,0,22785,24,519,623,533,639,14,16,sheep
35903,12,sheep,13,0,22785,25,551,624,569,638,18,14,sheep
35904,13,sheep,14,0,22785,16,545,624,554,634,9,10,sheep
35905,14,sheep,15,0,22785,23,604,602,617,610,13,8,sheep
35906,15,sheep,16,0,22785,19,662,595,673,604,11,9,sheep
35907,16,sheep,17,0,22785,16,586,602,594,611,8,9,sheep
35908,18,sheep,19,0,22785,19,192,596,203,606,11,10,sheep
35909,19,sheep,20,0,22785,20,210,596,223,605,13,9,sheep
35910,20,sheep,21,0,22785,20,247,587,255,595,8,8,sheep
35911,21,sheep,22,0,22785,19,270,587,279,595,9,8,sheep
35912,22,sheep,23,0,22785,18,263,585,275,593,12,8,sheep
35913,23,sheep,24,0,22785,17,398,579,406,588,8,9,sheep
35914,24,sheep,25,0,22785,19,383,575,397,584,14,9,sheep
35915,9,car,10,1,22792,16,583,492,810,552,227,60,car
35916,9,pot,10,0,2445,16,302,448,427,609,125,161,potted plant
35917,11,door,12,0,2446,35,105,202,230,326,125,124,door
35918,1,door,2,0,22797,27,0,1,950,750,950,749,door
35919,4,person,5,1,22798,15,425,588,442,605,17,17,person
35920,8,table,9,0,22799,15,74,465,233,539,159,74,dining table
35921,9,bench,10,0,22799,25,35,458,107,538,72,80,bench
35922,10,chair,11,0,22799,18,107,463,145,547,38,84,chair
35923,11,chair,12,1,22799,19,139,469,195,556,56,87,chair
35924,13,chair,14,1,22799,15,232,460,282,504,50,44,chair
35925,4,cow,5,0,2451,30,86,168,131,238,45,70,cow
35926,5,cow,6,0,2451,24,7,114,39,166,32,52,cow
35927,6,cow,7,0,2451,36,56,231,116,314,60,83,cow
35928,7,cow,8,1,2451,21,2,244,73,321,71,77,cow
35929,8,cow,9,1,2451,18,2,263,46,323,44,60,cow
35930,8,cow,9,0,2453,28,63,172,112,206,49,34,cow
35931,9,cow,10,0,2453,16,144,185,167,200,23,15,cow
35932,10,cow,11,0,2453,15,178,192,201,200,23,8,cow
35933,11,cow,12,1,2453,15,229,174,256,201,27,27,cow
35934,4,cow,5,0,2455,32,197,268,265,387,68,119,cow
35935,7,horse,8,0,2457,25,47,834,140,968,93,134,horse
35936,8,horse,9,0,2457,35,491,847,617,980,126,133,horse
35937,9,horse,10,0,2457,25,980,854,1053,983,73,129,horse
35938,7,door,8,1,37,30,719,812,792,1002,73,190,door
35939,23,window,24,0,37,17,887,853,996,1008,109,155,window
35940,26,person,27,1,37,17,917,947,976,1023,59,76,person
35941,27,person,28,1,37,18,790,971,847,1023,57,52,person
35942,28,person,29,1,37,23,751,930,792,1022,41,92,person
35943,30,person,31,1,37,21,666,951,706,1022,40,71,person
35944,31,person,32,1,37,21,596,955,636,1024,40,69,person
35945,32,person,33,1,37,19,532,953,570,1022,38,69,person
35946,33,person,34,1,37,25,395,959,458,1024,63,65,person
35947,38,person,39,1,37,24,328,957,388,1024,60,67,person
35948,43,person,44,1,37,17,287,982,325,1024,38,42,person
35949,44,person,45,1,37,23,218,958,283,1024,65,66,person
35950,45,person,46,1,37,16,203,958,222,1020,19,62,person
35951,47,person,48,1,37,19,189,971,215,1024,26,53,person
35952,48,person,49,1,37,15,153,974,209,1024,56,50,person
35953,51,person,52,1,37,37,99,942,150,1018,51,76,person
35954,52,person,53,1,37,18,49,966,98,1024,49,58,person
35955,53,person,54,1,37,19,22,969,76,1023,54,54,person
35956,54,person,55,1,37,25,1,946,56,1024,55,78,person
35957,12,person,13,0,38,18,486,459,499,504,13,45,person
35958,13,person,14,0,38,19,337,452,354,497,17,45,person
35959,14,person,15,1,38,20,613,446,630,496,17,50,person
35960,15,person,16,0,38,30,582,444,606,496,24,52,person
35961,16,person,17,1,38,17,273,439,283,480,10,41,person
35962,17,person,18,0,38,23,262,441,278,488,16,47,person
35963,18,bicycle,19,0,38,32,170,456,203,480,33,24,bicycle
35964,21,person,22,0,38,20,27,434,40,475,13,41,person
35965,10,person,11,1,2503,16,176,635,203,679,27,44,person
35966,11,person,12,1,2503,15,180,614,209,666,29,52,person
35967,16,car,17,1,2504,15,355,237,399,261,44,24,car
35968,19,person,20,1,2504,15,196,230,220,266,24,36,person
35969,20,person,21,1,2504,15,216,234,243,267,27,33,person
35970,2,truck,3,0,2505,21,358,300,438,343,80,43,truck
35971,8,person,9,0,2505,16,445,302,454,341,9,39,person
35972,9,person,10,0,2505,18,549,308,564,341,15,33,person
35973,13,person,14,0,2505,16,139,298,154,334,15,36,person
35974,10,car,8,1,2511,15,593,1302,690,1365,97,63,car
35975,11,car,9,0,2511,16,884,1296,986,1368,102,72,car
35976,15,car,13,1,2511,18,963,1280,1086,1355,123,75,car
35977,19,car,17,0,2511,23,123,1314,343,1404,220,90,car
35978,84,person,82,0,2511,23,627,1293,672,1387,45,94,person
35979,7,person,8,0,3036,30,608,201,671,421,63,220,person
35980,8,person,9,0,3036,50,209,226,442,541,233,315,person
35981,2,person,3,0,3037,37,96,107,122,166,26,59,person
35982,3,person,4,0,3037,17,60,113,69,133,9,20,person
35983,17,person,18,0,3038,25,209,95,232,171,23,76,person
35984,18,person,19,0,3038,49,227,108,285,251,58,143,person
35985,8,person,9,0,3039,34,292,197,340,308,48,111,person
35986,5,person,6,0,3041,21,15,67,28,114,13,47,person
35987,13,person,14,0,3042,53,51,144,113,286,62,142,person
35988,3,person,4,0,3043,21,133,67,153,108,20,41,person
35989,4,person,5,0,3043,51,197,56,259,213,62,157,person
35990,3,person,4,1,3046,81,17,46,121,298,104,252,person
35991,5,hat,6,0,3046,23,35,46,77,82,42,36,hat
35992,0,person,1,1,3068,42,200,69,352,264,152,195,person
35993,1,person,2,1,3068,31,137,136,214,263,77,127,person
35994,2,person,3,1,3068,29,79,146,168,264,89,118,person
35995,3,person,4,1,3068,26,280,66,308,151,28,85,person
35996,10,person,11,0,3069,37,73,55,114,191,41,136,person
35997,11,person,12,1,3069,43,99,55,186,239,87,184,person
35998,12,person,13,1,3069,28,161,148,220,241,59,93,person
35999,15,person,16,1,3069,32,170,62,202,148,32,86,person
36000,16,person,17,1,3069,31,200,61,238,182,38,121,person
36001,17,person,18,0,3069,40,215,61,259,197,44,136,person
36002,20,person,21,0,3069,34,254,70,288,184,34,114,person
36003,2,umbrella,3,0,3070,17,57,240,161,339,104,99,umbrella
36004,3,umbrella,4,1,3070,18,154,261,379,316,225,55,umbrella
36005,4,person,5,1,3070,15,130,275,156,335,26,60,person
36006,7,umbrella,8,0,3070,19,170,291,355,376,185,85,umbrella
36007,10,person,11,1,3070,26,0,454,50,695,50,241,person
36008,18,person,19,0,3070,27,768,239,809,365,41,126,person
36009,19,person,20,0,3070,31,850,279,887,396,37,117,person
36010,20,umbrella,21,0,3070,24,922,281,1096,448,174,167,umbrella
36011,21,person,22,1,3070,28,1050,309,1099,423,49,114,person
36012,22,person,23,1,3070,16,1088,371,1131,429,43,58,person
36013,23,person,24,0,3070,32,639,305,679,434,40,129,person
36014,29,person,30,0,3070,31,363,368,412,473,49,105,person
36015,30,person,31,0,3070,42,294,358,368,539,74,181,person
36016,33,person,34,1,3070,38,628,496,741,660,113,164,person
36017,34,person,35,1,3070,33,677,532,756,744,79,212,person
36018,35,person,36,1,3070,31,772,571,901,783,129,212,person
36019,36,person,37,1,3070,22,745,640,797,782,52,142,person
36020,37,person,38,1,3070,31,622,589,747,783,125,194,person
36021,39,person,40,1,3070,20,466,297,496,414,30,117,person
36022,40,person,41,1,3070,23,481,296,513,421,32,125,person
36023,41,person,42,0,3070,28,497,305,561,432,64,127,person
36024,42,person,43,0,3070,24,544,301,588,431,44,130,person
36025,7,umbrella,8,0,3071,16,421,197,536,283,115,86,umbrella
36026,8,umbrella,9,0,3071,22,282,187,427,322,145,135,umbrella
36027,12,umbrella,13,0,3071,21,2,126,162,361,160,235,umbrella
36028,13,person,14,0,3071,28,292,238,345,329,53,91,person
36029,13,person,14,0,3072,28,211,174,271,214,60,40,person
36030,15,person,16,0,3072,29,291,108,312,180,21,72,person
36031,16,bicycle,17,0,3072,46,315,150,379,209,64,59,bicycle
36032,17,person,18,0,3072,29,329,123,378,193,49,70,person
36033,5,car,6,0,3073,29,62,260,135,290,73,30,car
36034,7,car,8,1,3073,38,187,298,271,330,84,32,car
36035,9,person,10,0,3073,40,302,283,317,318,15,35,person
36036,31,person,32,1,3075,24,204,214,246,285,42,71,person
36037,12,person,13,1,3076,17,496,252,552,339,56,87,person
36038,25,person,26,0,3076,31,727,260,778,398,51,138,person
36039,35,person,36,0,3076,18,781,263,807,335,26,72,person
36040,27,person,28,1,24851,17,1,334,34,425,33,91,person
36041,28,bench,29,1,24851,16,0,422,31,473,31,51,bench
36042,31,dog,32,1,24851,52,534,461,696,636,162,175,dog
36043,32,person,33,1,24851,39,656,315,799,636,143,321,person
36044,33,person,34,1,24851,24,710,311,751,426,41,115,person
36045,34,person,35,1,24851,39,633,310,681,485,48,175,person
36046,35,person,36,1,24851,48,563,311,667,460,104,149,person
36047,36,person,37,1,24851,24,574,377,627,475,53,98,person
36048,37,person,38,1,24851,37,491,317,530,442,39,125,person
36049,38,person,39,1,24851,26,471,346,498,448,27,102,person
36050,39,person,40,0,24851,36,446,306,487,452,41,146,person
36051,40,person,41,0,24851,45,317,321,388,507,71,186,person
36052,41,person,42,1,24851,31,361,312,392,422,31,110,person
36053,42,person,43,0,24851,34,273,373,318,501,45,128,person
36054,43,person,44,1,24851,50,294,297,349,498,55,201,person
36055,46,person,47,1,24851,16,531,320,549,435,18,115,person
36056,48,person,49,1,24851,25,436,320,462,445,26,125,person
36057,50,person,51,1,24851,39,419,308,443,414,24,106,person
36058,51,person,52,0,24851,43,390,311,420,411,30,100,person
36059,52,person,53,1,24851,29,407,310,423,412,16,102,person
36060,53,person,54,1,24851,29,244,309,264,376,20,67,person
36061,54,person,55,1,24851,30,211,304,247,375,36,71,person
36062,55,person,56,1,24851,18,175,308,191,373,16,65,person
36063,56,person,57,0,24851,30,111,316,135,381,24,65,person
36064,57,person,58,0,24851,20,86,309,99,362,13,53,person
36065,58,person,59,0,24851,22,70,305,86,362,16,57,person
36066,9,person,10,1,24852,26,240,276,261,330,21,54,person
36067,10,person,11,1,24852,23,203,245,221,288,18,43,person
36068,11,person,12,0,24852,29,204,273,227,307,23,34,person
36069,12,person,13,1,24852,21,229,244,247,283,18,39,person
36070,14,person,15,1,24852,18,249,246,265,272,16,26,person
36071,15,person,16,1,24852,18,257,249,275,279,18,30,person
36072,17,person,18,1,24852,17,315,259,331,298,16,39,person
36073,18,person,19,1,24852,22,334,261,358,296,24,35,person
36074,25,person,26,1,24852,15,472,323,494,353,22,30,person
36075,26,person,27,1,24852,25,472,247,498,301,26,54,person
36076,31,person,32,0,24852,46,365,246,412,381,47,135,person
36077,32,person,33,0,24852,47,288,251,329,377,41,126,person
36078,33,person,34,0,24852,51,253,255,290,381,37,126,person
36079,34,person,35,0,24852,36,125,243,173,359,48,116,person
36080,35,person,36,0,24852,39,63,243,100,355,37,112,person
36081,36,person,37,0,24852,58,70,303,113,414,43,111,person
36082,38,person,39,1,24852,19,3,343,21,454,18,111,person
36083,39,person,40,1,24852,18,0,268,23,484,23,216,person
36084,40,person,41,1,24852,23,0,500,30,620,30,120,person
36085,43,person,44,1,24852,25,742,277,775,334,33,57,person
36086,44,person,45,1,24852,33,681,280,720,365,39,85,person
36087,45,person,46,0,24852,66,559,286,622,474,63,188,person
36088,46,person,47,0,24852,62,611,276,685,498,74,222,person
36089,49,person,50,0,24852,67,691,276,750,509,59,233,person
36090,51,person,52,1,24852,71,392,291,520,630,128,339,person
36091,11,person,12,0,3156,17,22,341,45,374,23,33,person
36092,2,umbrella,3,0,22860,15,703,259,742,361,39,102,umbrella
36093,17,person,18,0,22861,26,1183,842,1208,920,25,78,person
36094,18,person,19,0,22861,26,1246,836,1274,915,28,79,person
36095,19,person,20,0,22861,36,1271,823,1300,913,29,90,person
36096,20,person,21,1,22861,25,1299,822,1323,910,24,88,person
36097,21,person,22,0,22861,23,1315,836,1353,908,38,72,person
36098,22,person,23,0,22861,22,800,896,860,917,60,21,person
36099,50,table,51,0,22861,17,160,939,255,980,95,41,dining table
36100,5,person,6,0,22867,38,515,754,582,884,67,130,person
36101,6,person,7,1,22867,17,554,743,573,791,19,48,person
36102,7,person,8,0,22867,19,575,749,593,801,18,52,person
36103,8,person,9,1,22867,23,486,753,515,813,29,60,person
36104,9,person,10,1,22867,15,479,741,507,791,28,50,person
36105,10,person,11,0,22867,26,424,744,490,809,66,65,person
36106,11,person,12,0,22867,41,156,753,213,888,57,135,person
36107,12,person,13,0,22867,29,78,802,140,888,62,86,person
36108,13,person,14,0,22867,22,607,788,658,803,51,15,person
36109,14,person,15,1,22867,17,79,782,99,809,20,27,person
36110,15,person,16,1,22867,15,56,786,81,806,25,20,person
36111,17,person,18,1,22867,15,35,772,49,798,14,26,person
36112,19,person,20,1,22867,16,147,775,162,802,15,27,person
36113,20,person,21,1,22867,16,540,777,556,805,16,28,person
36114,17,motorbike,18,0,22869,59,504,424,542,466,38,42,motorcycle
36115,7,person,8,1,4284,21,923,271,984,381,61,110,person
36116,8,person,9,0,4284,24,553,247,603,362,50,115,person
36117,12,person,13,0,4284,41,932,283,1029,507,97,224,person
36118,13,person,14,1,4284,55,668,189,853,534,185,345,person
36119,14,person,15,1,4284,24,669,262,697,399,28,137,person
36120,16,person,17,0,4284,31,610,264,662,458,52,194,person
36121,18,bicycle,19,1,4284,49,168,434,446,945,278,511,bicycle
36122,19,bicycle,20,1,4284,62,401,466,618,918,217,452,bicycle
36123,20,bicycle,21,1,4284,70,818,441,1133,839,315,398,bicycle
36124,1,bicycle,2,0,4285,156,173,167,790,876,617,709,bicycle
36125,0,bicycle,1,0,4286,47,92,73,297,203,205,130,bicycle
36126,5,bicycle,6,0,4287,53,69,102,148,184,79,82,bicycle
36127,6,bicycle,7,0,4287,56,140,107,212,198,72,91,bicycle
36128,10,person,11,1,4288,20,1157,458,1236,678,79,220,person
36129,16,person,17,1,4288,16,1024,447,1058,511,34,64,person
36130,17,person,18,0,4288,23,746,460,806,560,60,100,person
36131,18,person,19,0,4288,16,595,449,615,496,20,47,person
36132,19,person,20,1,4288,15,99,470,133,553,34,83,person
36133,25,bicycle,26,0,4288,50,1319,526,1428,715,109,189,bicycle
36134,1,bird,2,0,4289,33,978,294,1192,603,214,309,bird
36135,6,bicycle,7,0,4289,46,52,384,497,1352,445,968,bicycle
36136,8,bicycle,9,1,4289,49,501,510,1439,981,938,471,bicycle
36137,9,bicycle,10,1,4289,55,461,581,1469,1186,1008,605,bicycle
36138,12,bird,13,0,4289,36,823,914,1408,1219,585,305,bird
36139,7,bicycle,8,0,4290,66,465,1086,863,1546,398,460,bicycle
36140,8,bicycle,9,0,4290,64,806,1043,1327,1546,521,503,bicycle
36141,10,bicycle,11,1,4290,29,1179,1117,1469,1491,290,374,bicycle
36142,7,bicycle,8,0,4291,61,88,20,203,159,115,139,bicycle
36143,0,bicycle,1,0,20424,94,57,21,248,265,191,244,bicycle
36144,3,bicycle,4,0,20425,107,607,180,1145,959,538,779,bicycle
36145,9,table,10,0,4303,18,372,336,417,405,45,69,dining table
36146,10,table,11,0,4303,22,340,350,390,430,50,80,dining table
36147,12,table,13,0,4303,16,328,326,359,368,31,42,dining table
36148,15,chair,16,1,4303,17,288,374,335,449,47,75,chair
36149,23,person,24,0,4303,24,502,251,526,328,24,77,person
36150,24,person,25,0,4303,29,539,244,577,358,38,114,person
36151,25,person,26,1,4303,23,573,261,592,326,19,65,person
36152,7,car,8,1,4304,18,519,244,598,355,79,111,car
36153,37,person,38,0,4305,17,227,415,246,457,19,42,person
36154,8,umbrella,9,0,4306,33,145,354,529,516,384,162,umbrella
36155,9,umbrella,10,0,4306,21,29,329,328,385,299,56,umbrella
36156,20,table,21,0,4306,18,229,551,314,669,85,118,dining table
36157,26,chair,27,1,4306,24,209,529,276,639,67,110,chair
36158,29,person,30,1,4306,15,155,418,180,480,25,62,person
36159,30,umbrella,31,1,4306,17,20,389,144,420,124,31,umbrella
36160,33,car,34,1,4306,15,0,445,109,543,109,98,car
36161,1,table,2,0,4307,19,104,121,200,194,96,73,dining table
36162,15,chair,16,1,4307,19,198,113,220,135,22,22,chair
36163,16,chair,17,1,4307,16,216,113,236,138,20,25,chair
36164,17,chair,18,0,4307,16,248,119,271,148,23,29,chair
36165,19,table,20,0,4307,15,53,109,89,140,36,31,dining table
36166,20,chair,21,0,4307,15,78,109,102,139,24,30,chair
36167,7,person,8,1,4308,20,125,149,157,187,32,38,person
36168,8,chair,9,1,4308,16,157,164,177,189,20,25,chair
36169,14,person,15,0,4308,18,107,150,128,187,21,37,person
36170,16,person,17,1,4308,19,83,147,106,177,23,30,person
36171,4,boat,5,1,48,28,0,305,146,599,146,294,boat
36172,11,person,12,1,48,15,266,524,296,537,30,13,person
36173,14,person,15,1,48,17,318,487,339,503,21,16,person
36174,15,person,16,1,48,16,339,479,351,510,12,31,person
36175,16,person,17,1,48,17,351,482,375,498,24,16,person
36176,17,person,18,1,48,22,380,479,397,497,17,18,person
36177,18,person,19,0,48,111,87,124,307,359,220,235,person
36178,3,boat,4,0,49,86,268,573,1600,1065,1332,492,boat
36179,4,person,5,1,49,128,456,140,1582,1064,1126,924,person
36180,2,person,3,0,50,80,161,55,244,268,83,213,person
36181,3,person,4,0,50,62,238,131,285,270,47,139,person
36182,4,person,5,0,50,60,115,100,172,263,57,163,person
36183,5,boat,6,1,50,33,0,86,450,300,450,214,boat
36184,6,person,7,1,4337,45,419,251,757,597,338,346,person
36185,7,person,8,1,4337,38,233,254,757,620,524,366,person
36186,8,chair,9,1,4337,17,179,292,306,504,127,212,chair
36187,1,boat,2,1,4338,22,0,394,2046,1533,2046,1139,boat
36188,4,chair,5,1,4339,30,199,534,405,803,206,269,chair
36189,5,chair,6,0,4339,32,795,444,1028,730,233,286,chair
36190,6,chair,7,1,4339,18,1069,449,1173,718,104,269,chair
36191,8,person,9,1,4339,36,982,324,1092,656,110,332,person
36192,9,person,10,0,4339,66,566,183,691,675,125,492,person
36193,10,person,11,0,4339,42,454,226,563,681,109,455,person
36194,5,table,6,0,4340,28,65,87,222,187,157,100,dining table
36195,6,person,7,0,4341,22,385,571,479,777,94,206,person
36196,10,person,11,0,4342,58,158,99,208,213,50,114,person
36197,11,person,12,0,4342,47,230,102,268,213,38,111,person
36198,4,chair,5,0,4344,16,285,993,346,1079,61,86,chair
36199,2,boat,3,1,20431,31,0,18,1023,765,1023,747,boat
36200,1,boat,2,0,22906,72,0,1,624,501,624,500,boat
36201,5,person,6,1,22907,17,352,311,431,412,79,101,person
36202,10,boat,11,0,22908,23,570,266,609,323,39,57,boat
36203,11,boat,12,0,22908,48,486,239,594,355,108,116,boat
36204,1,boat,2,0,22909,78,70,254,701,525,631,271,boat
36205,3,person,4,1,22909,52,493,150,614,354,121,204,person
36206,6,boat,7,0,22910,61,407,301,1023,682,616,381,boat
36207,7,person,8,0,22910,39,437,307,474,422,37,115,person
36208,2,boat,3,0,22911,37,0,30,639,479,639,449,boat
36209,3,person,4,1,22911,28,469,356,570,479,101,123,person
36210,4,person,5,1,22911,15,388,372,454,477,66,105,person
36211,1,boat,2,1,22912,61,0,6,1349,1648,1349,1642,boat
36212,3,person,4,1,22912,47,1395,4,2201,1650,806,1646,person
36213,4,person,5,1,22912,56,1161,493,1694,1646,533,1153,person
36214,1,boat,2,0,22913,22,1,56,893,766,892,710,boat
36215,2,person,3,0,22913,19,758,558,795,634,37,76,person
36216,3,person,4,0,22913,20,763,632,795,719,32,87,person
36217,4,person,5,0,22913,27,745,664,788,767,43,103,person
36218,5,person,6,1,22913,28,758,535,792,624,34,89,person
36219,6,person,7,1,22913,26,735,510,767,596,32,86,person
36220,7,person,8,0,22913,35,744,455,785,546,41,91,person
36221,8,person,9,0,22913,27,776,448,808,535,32,87,person
36222,9,person,10,1,22913,18,780,430,809,464,29,34,person
36223,10,person,11,0,22913,37,558,563,603,650,45,87,person
36224,11,person,12,0,22913,18,594,568,623,622,29,54,person
36225,12,person,13,0,22913,32,606,510,639,595,33,85,person
36226,13,person,14,1,22913,29,624,494,656,581,32,87,person
36227,14,person,15,1,22913,21,632,463,659,513,27,50,person
36228,15,person,16,1,22913,25,650,446,669,533,19,87,person
36229,16,person,17,0,22913,22,650,423,677,479,27,56,person
36230,17,person,18,0,22913,20,662,398,688,467,26,69,person
36231,18,person,19,1,22913,23,674,364,698,439,24,75,person
36232,19,person,20,0,22913,19,681,338,703,384,22,46,person
36233,21,person,22,0,22913,21,769,404,795,463,26,59,person
36234,22,person,23,0,22913,17,789,388,819,433,30,45,person
36235,24,person,25,0,22913,26,501,551,540,639,39,88,person
36236,25,person,26,1,22913,23,498,507,536,558,38,51,person
36237,26,person,27,1,22913,16,505,484,526,523,21,39,person
36238,27,person,28,1,22913,31,513,452,544,534,31,82,person
36239,28,person,29,0,22913,21,528,436,551,516,23,80,person
36240,29,person,30,0,22913,18,537,424,558,495,21,71,person
36241,30,person,31,0,22913,16,522,405,547,444,25,39,person
36242,31,person,32,0,22913,33,550,402,580,483,30,81,person
36243,32,person,33,0,22913,30,574,353,602,427,28,74,person
36244,33,person,34,0,22913,26,585,337,610,412,25,75,person
36245,34,person,35,1,22913,21,593,329,614,395,21,66,person
36246,35,person,36,1,22913,15,598,316,615,348,17,32,person
36247,36,person,37,0,22913,26,638,332,664,398,26,66,person
36248,37,person,38,0,22913,26,719,272,747,345,28,73,person
36249,38,person,39,0,22913,28,705,264,732,334,27,70,person
36250,39,person,40,0,22913,19,676,275,703,341,27,66,person
36251,41,person,42,1,22913,25,434,542,470,581,36,39,person
36252,42,person,43,1,22913,21,437,558,473,616,36,58,person
36253,43,person,44,0,22913,37,461,528,503,616,42,88,person
36254,44,person,45,1,22913,20,387,481,416,558,29,77,person
36255,45,person,46,1,22913,29,390,455,426,538,36,83,person
36256,46,person,47,0,22913,29,407,440,440,526,33,86,person
36257,47,person,48,0,22913,27,423,429,458,509,35,80,person
36258,48,person,49,1,22913,24,431,398,466,490,35,92,person
36259,49,person,50,1,22913,15,443,390,466,454,23,64,person
36260,50,person,51,0,22913,18,452,373,477,445,25,72,person
36261,51,person,52,0,22913,34,463,356,496,430,33,74,person
36262,52,person,53,1,22913,23,481,346,506,414,25,68,person
36263,53,person,54,1,22913,26,495,327,520,402,25,75,person
36264,54,person,55,1,22913,20,507,327,531,395,24,68,person
36265,55,person,56,1,22913,23,523,316,543,383,20,67,person
36266,56,person,57,1,22913,23,543,307,557,376,14,69,person
36267,57,person,58,1,22913,19,550,294,563,360,13,66,person
36268,59,person,60,0,22913,33,463,266,486,330,23,64,person
36269,60,person,61,1,22913,19,667,264,686,327,19,63,person
36270,61,person,62,0,22913,22,645,271,669,339,24,68,person
36271,62,person,63,0,22913,25,624,272,645,331,21,59,person
36272,63,person,64,0,22913,24,611,260,630,323,19,63,person
36273,64,person,65,0,22913,23,592,258,617,314,25,56,person
36274,65,person,66,0,22913,28,573,253,595,312,22,59,person
36275,66,person,67,1,22913,25,547,242,568,307,21,65,person
36276,67,person,68,0,22913,27,514,238,538,300,24,62,person
36277,68,person,69,0,22913,24,496,232,519,294,23,62,person
36278,69,person,70,0,22913,24,425,283,445,341,20,58,person
36279,70,person,71,0,22913,23,408,284,429,351,21,67,person
36280,71,person,72,1,22913,18,388,296,409,345,21,49,person
36281,72,person,73,1,22913,20,388,316,416,370,28,54,person
36282,74,person,75,1,22913,32,366,323,397,399,31,76,person
36283,75,person,76,1,22913,25,336,339,367,410,31,71,person
36284,76,person,77,1,22913,16,311,400,336,423,25,23,person
36285,77,person,78,1,22913,26,311,374,338,415,27,41,person
36286,78,person,79,0,22913,36,352,354,378,425,26,71,person
36287,81,person,82,1,22913,20,253,459,285,500,32,41,person
36288,82,person,83,1,22913,23,281,445,317,510,36,65,person
36289,83,person,84,0,22913,28,242,436,273,483,31,47,person
36290,84,person,85,0,22913,30,214,216,238,267,24,51,person
36291,86,person,87,1,22913,19,239,255,258,281,19,26,person
36292,87,person,88,1,22913,27,217,254,241,294,24,40,person
36293,88,person,89,1,22913,18,200,275,227,312,27,37,person
36294,90,person,91,1,22913,26,189,230,209,278,20,48,person
36295,91,person,92,1,22913,29,175,237,204,300,29,63,person
36296,92,person,93,1,22913,19,172,213,189,238,17,25,person
36297,93,person,94,1,22913,22,159,221,178,261,19,40,person
36298,94,person,95,1,22913,20,178,288,200,324,22,36,person
36299,95,person,96,1,22913,36,144,270,167,332,23,62,person
36300,96,person,97,1,22913,25,127,270,151,324,24,54,person
36301,97,person,98,1,22913,19,136,239,151,275,15,36,person
36302,98,person,99,1,22913,25,151,213,165,262,14,49,person
36303,1,boat,2,0,22914,61,55,1,758,454,703,453,boat
36304,5,boat,6,0,4347,25,77,605,704,1215,627,610,boat
36305,10,chair,11,0,4347,19,825,947,909,1055,84,108,chair
36306,9,boat,10,1,4350,18,12,149,320,242,308,93,boat
36307,5,person,6,0,4351,20,561,232,572,270,11,38,person
36308,9,person,10,1,4352,32,763,409,1165,762,402,353,person
36309,12,door,13,0,4352,16,365,275,598,551,233,276,door
36310,6,boat,7,0,4353,24,704,805,1221,907,517,102,boat
36311,1,boat,2,0,22915,17,2,1206,313,1454,311,248,boat
36312,9,boat,10,0,22918,21,214,801,533,912,319,111,boat
36313,7,car,8,0,22919,15,753,371,785,390,32,19,car
36314,9,person,10,0,22920,19,799,436,813,474,14,38,person
36315,10,person,11,0,22920,26,788,435,801,474,13,39,person
36316,11,person,12,0,22920,28,770,435,785,475,15,40,person
36317,12,person,13,0,22920,22,759,439,772,475,13,36,person
36318,13,person,14,0,22920,23,741,439,755,476,14,37,person
36319,1,boat,2,0,22922,18,176,249,422,293,246,44,boat
36320,3,boat,4,0,22923,35,31,417,606,529,575,112,boat
36321,9,person,10,0,22925,56,579,414,731,922,152,508,person
36322,7,boat,8,0,22928,16,665,426,774,480,109,54,boat
36323,0,window,1,0,4460,16,47,48,247,237,200,189,window
36324,1,window,2,0,4462,19,190,31,586,585,396,554,window
36325,3,window,4,0,4463,21,57,3,202,217,145,214,window
36326,3,window,4,0,4464,23,47,44,437,323,390,279,window
36327,1,window,2,0,4465,21,110,5,428,310,318,305,window
36328,1,window,2,0,4468,36,56,10,402,277,346,267,window
36329,2,window,3,0,4469,18,85,112,208,358,123,246,window
36330,1,window,2,0,4470,26,43,1,361,370,318,369,window
36331,1,window,2,0,4471,15,54,1,385,228,331,227,window
36332,2,window,3,0,4473,17,46,114,161,265,115,151,window
36333,4,window,5,0,4473,17,65,23,138,112,73,89,window
36334,3,window,4,0,4474,21,2,171,394,462,392,291,window
36335,5,window,6,0,4475,18,158,144,485,463,327,319,window
36336,2,window,3,0,4476,40,97,95,758,617,661,522,window
36337,1,window,2,0,4478,32,36,16,272,215,236,199,window
36338,1,window,2,0,4480,17,13,13,319,388,306,375,window
36339,3,truck,4,1,4530,29,203,148,288,201,85,53,truck
36340,6,car,7,0,4530,29,11,184,67,206,56,22,car
36341,15,person,16,0,4531,29,841,652,905,791,64,139,person
36342,2,car,3,0,4534,26,39,164,94,197,55,33,car
36343,5,boat,6,0,56,41,404,289,710,374,306,85,boat
36344,4,person,5,0,57,51,277,257,322,357,45,100,person
36345,5,person,6,0,57,56,170,280,204,403,34,123,person
36346,6,person,7,0,57,88,355,27,438,146,83,119,person
36347,7,person,8,0,57,42,312,138,350,206,38,68,person
36348,8,person,9,0,57,49,267,129,317,247,50,118,person
36349,9,person,10,1,57,15,266,223,277,254,11,31,person
36350,10,person,11,0,57,40,230,253,264,329,34,76,person
36351,11,person,12,0,57,63,223,168,274,288,51,120,person
36352,12,person,13,0,57,36,211,377,245,459,34,82,person
36353,13,person,14,0,57,47,212,422,266,513,54,91,person
36354,14,person,15,0,57,39,65,443,105,524,40,81,person
36355,10,truck,11,0,58,39,354,106,597,371,243,265,truck
36356,16,mirror,17,0,58,27,388,197,410,260,22,63,mirror
36357,17,mirror,18,0,58,15,580,188,598,254,18,66,mirror
36358,19,person,20,0,58,32,410,42,448,110,38,68,person
36359,25,person,26,0,58,54,376,49,419,113,43,64,person
36360,31,person,32,0,58,69,322,47,388,117,66,70,person
36361,40,person,41,0,58,51,277,63,352,118,75,55,person
36362,47,person,48,0,58,57,228,86,310,138,82,52,person
36363,54,person,55,0,58,51,190,127,280,176,90,49,person
36364,61,person,62,0,58,52,153,182,248,228,95,46,person
36365,68,person,69,0,58,56,116,247,211,293,95,46,person
36366,76,person,77,0,58,63,82,325,191,372,109,47,person
36367,7,boat,8,0,555,35,2,190,146,256,144,66,boat
36368,16,person,9,0,4559,19,262,726,281,816,19,90,person
36369,17,person,10,0,4559,21,209,717,244,804,35,87,person
36370,18,person,11,1,4559,15,236,726,260,797,24,71,person
36371,19,person,12,0,4559,20,713,792,745,867,32,75,person
36372,22,person,15,1,4559,17,752,800,784,871,32,71,person
36373,23,person,16,1,4559,19,967,814,998,887,31,73,person
36374,24,person,17,0,4559,20,1284,846,1315,907,31,61,person
36375,25,person,18,1,4559,15,1781,877,1803,938,22,61,person
36376,26,person,19,1,4559,19,2040,847,2060,895,20,48,person
36377,27,person,20,0,4559,18,2143,828,2168,871,25,43,person
36378,28,person,21,0,4559,16,1521,864,1541,917,20,53,person
36379,29,person,22,0,4559,21,1418,852,1440,924,22,72,person
36380,30,person,23,1,4559,16,113,747,143,805,30,58,person
36381,31,person,24,0,4559,23,457,780,483,849,26,69,person
36382,7,car,8,1,4561,22,0,956,1758,1164,1758,208,car
36383,0,car,1,0,4567,24,1497,921,2017,1179,520,258,car
36384,2,person,3,0,4567,37,961,862,1243,1317,282,455,person
36385,15,door,16,0,4567,19,1576,932,1673,1106,97,174,door
36386,18,door,19,0,4567,16,1532,937,1635,1099,103,162,door
36387,10,person,8,0,4572,22,1322,1146,1360,1241,38,95,person
36388,11,person,9,0,4572,25,1369,1153,1406,1241,37,88,person
36389,12,car,10,0,4572,31,698,1164,829,1251,131,87,car
36390,14,car,12,1,4572,20,852,1158,969,1261,117,103,car
36391,16,car,14,1,4572,27,892,1188,1056,1326,164,138,car
36392,0,person,1,0,4583,33,1693,678,1912,1644,219,966,person
36393,7,car,8,1,22954,30,914,595,1023,741,109,146,car
36394,13,car,14,0,22954,30,658,606,696,633,38,27,car
36395,1,person,2,1,22955,21,6,1286,177,1645,171,359,person
36396,3,person,4,0,22955,74,776,527,998,799,222,272,person
36397,4,person,5,1,22955,20,849,1100,946,1293,97,193,person
36398,5,person,6,1,22955,28,746,986,833,1237,87,251,person
36399,6,person,7,0,22955,19,630,938,710,1066,80,128,person
36400,7,person,8,1,22955,43,366,802,477,1047,111,245,person
36401,8,person,9,1,22955,21,266,731,342,865,76,134,person
36402,9,person,10,1,22955,26,67,664,193,876,126,212,person
36403,10,person,11,1,22955,17,4,596,110,692,106,96,person
36404,1,person,2,0,22956,50,566,531,646,793,80,262,person
36405,2,person,3,0,22956,17,389,558,401,600,12,42,person
36406,3,person,4,0,22956,17,375,559,390,601,15,42,person
36407,9,person,10,0,22958,26,905,228,932,304,27,76,person
36408,3,person,4,1,22960,23,648,316,682,358,34,42,person
36409,4,person,5,0,22960,46,661,320,719,508,58,188,person
36410,7,person,8,0,22961,166,430,65,699,682,269,617,person
36411,4,person,5,0,22962,41,145,69,216,260,71,191,person
36412,8,table,9,0,22963,50,280,565,1024,811,744,246,dining table
36413,9,dog,10,0,22963,71,250,333,818,624,568,291,dog
36414,10,chair,11,0,22963,29,223,483,653,812,430,329,chair
36415,11,bench,12,0,22963,27,1,489,200,595,199,106,bench
36416,12,bench,13,1,22963,17,594,474,751,548,157,74,bench
36417,13,bench,14,0,22963,38,754,472,926,545,172,73,bench
36418,14,car,15,0,22964,15,178,467,192,472,14,5,car
36419,8,door,9,0,4594,15,146,172,187,241,41,69,door
36420,13,person,14,0,4594,20,163,221,179,256,16,35,person
36421,2,car,3,0,4595,15,102,237,144,254,42,17,car
36422,3,car,4,0,4595,20,68,237,105,254,37,17,car
36423,4,car,5,1,4595,16,38,238,68,253,30,15,car
36424,5,car,6,1,4595,15,2,233,40,253,38,20,car
36425,22,traffic light,23,0,4595,25,122,154,214,253,92,99,traffic light
36426,2,person,3,0,4596,22,76,198,85,234,9,36,person
36427,3,person,4,0,4596,28,87,199,100,232,13,33,person
36428,5,car,6,1,4596,22,184,202,256,244,72,42,car
36429,3,person,4,0,4597,21,151,198,162,233,11,35,person
36430,8,car,9,1,4597,16,163,201,256,256,93,55,car
36431,10,car,11,1,4597,21,2,206,109,255,107,49,car
36432,4,car,5,1,4598,17,33,200,74,217,41,17,car
36433,7,car,8,1,4598,23,37,204,99,234,62,30,car
36434,8,car,9,1,4598,17,184,204,256,256,72,52,car
36435,9,car,10,1,4598,19,43,208,195,256,152,48,car
36436,3,person,4,1,4600,36,162,165,206,255,44,90,person
36437,4,person,5,0,4600,24,203,174,220,223,17,49,person
36438,5,person,6,0,4600,27,76,177,94,222,18,45,person
36439,6,person,7,0,4600,26,57,176,74,225,17,49,person
36440,7,person,8,0,4600,17,36,172,46,203,10,31,person
36441,8,person,9,0,4600,31,2,173,21,219,19,46,person
36442,2,car,3,1,4601,17,0,216,154,256,154,40,car
36443,18,window,19,0,4601,15,0,152,51,234,51,82,window
36444,0,person,1,0,4602,21,151,189,170,226,19,37,person
36445,2,person,3,0,4602,22,37,193,50,226,13,33,person
36446,7,bicycle,8,0,4602,36,69,205,100,223,31,18,bicycle
36447,8,person,9,0,4602,24,189,186,199,226,10,40,person
36448,15,door,16,0,4605,15,109,181,136,255,27,74,door
36449,8,car,9,0,4606,37,35,187,191,243,156,56,car
36450,22,door,23,0,4606,15,59,189,100,239,41,50,door
36451,2,person,3,0,4607,28,204,212,214,248,10,36,person
36452,3,person,4,0,4607,18,216,211,224,246,8,35,person
36453,4,person,5,0,4607,20,172,210,182,247,10,37,person
36454,5,person,6,0,4607,16,152,215,158,245,6,30,person
36455,6,person,7,0,4607,19,88,213,96,235,8,22,person
36456,7,person,8,0,4607,25,56,210,68,239,12,29,person
36457,8,person,9,0,4607,18,68,214,76,240,8,26,person
36458,9,person,10,0,4607,22,128,216,136,239,8,23,person
36459,10,person,11,0,4607,16,21,212,27,238,6,26,person
36460,14,traffic light,15,0,4607,17,226,142,238,251,12,109,traffic light
36461,8,window,9,0,4613,17,200,67,237,142,37,75,window
36462,6,car,7,1,4616,16,0,172,59,202,59,30,car
36463,7,car,8,1,4616,27,179,169,256,201,77,32,car
36464,3,person,4,1,4621,29,2,173,23,249,21,76,person
36465,5,person,6,0,4621,50,74,152,114,241,40,89,person
36466,5,person,6,0,4622,30,224,175,241,206,17,31,person
36467,6,person,7,0,4622,22,241,184,249,204,8,20,person
36468,6,person,7,0,4623,26,209,154,225,202,16,48,person
36469,8,car,9,1,4623,21,2,170,95,256,93,86,car
36470,10,flowerpot,11,0,4623,27,218,184,249,215,31,31,potted plant
36471,11,person,12,1,4623,15,3,143,14,169,11,26,person
36472,12,person,13,1,4623,19,6,135,17,169,11,34,person
36473,12,bicycle,13,0,4627,29,98,165,118,189,20,24,bicycle
36474,13,person,14,0,4627,21,85,147,96,178,11,31,person
36475,14,person,15,0,4627,17,92,146,103,172,11,26,person
36476,15,person,16,0,4627,23,143,143,154,177,11,34,person
36477,16,person,17,0,4627,19,195,144,203,181,8,37,person
36478,17,person,18,1,4627,21,246,145,256,191,10,46,person
36479,18,person,19,0,4627,21,214,145,226,182,12,37,person
36480,21,car,22,1,4627,25,0,152,72,196,72,44,car
36481,0,person,1,0,4628,35,224,149,244,194,20,45,person
36482,6,car,7,1,4628,15,189,157,256,193,67,36,car
36483,2,clock,3,0,4629,16,21,52,41,72,20,20,clock
36484,5,window,6,0,4629,16,124,99,137,114,13,15,window
36485,1,person,2,0,4630,35,84,187,106,227,22,40,person
36486,4,car,5,0,4630,37,141,197,252,241,111,44,car
36487,7,person,8,0,4631,21,11,186,22,236,11,50,person
36488,8,person,9,0,4631,21,26,191,41,234,15,43,person
36489,9,person,10,0,4631,27,43,188,59,232,16,44,person
36490,10,person,11,0,4631,29,58,185,80,230,22,45,person
36491,11,person,12,0,4631,22,79,187,92,228,13,41,person
36492,12,person,13,0,4631,22,111,190,127,224,16,34,person
36493,25,person,26,0,4631,17,91,190,103,226,12,36,person
36494,3,person,4,1,4634,20,163,166,178,195,15,29,person
36495,9,car,10,1,4634,31,119,170,256,232,137,62,car
36496,0,person,1,0,4636,19,81,177,88,205,7,28,person
36497,1,person,2,0,4636,20,37,179,46,202,9,23,person
36498,31,bicycle,32,0,4636,78,144,208,219,253,75,45,bicycle
36499,32,person,33,0,4636,51,160,178,202,246,42,68,person
36500,25,person,26,1,4637,15,154,227,165,255,11,28,person
36501,0,car,1,0,4638,29,63,137,212,190,149,53,car
36502,0,person,1,0,4639,30,156,151,169,194,13,43,person
36503,3,person,4,1,4640,15,195,131,205,149,10,18,person
36504,16,car,17,0,4640,34,49,143,166,184,117,41,car
36505,17,car,18,1,4640,24,165,144,256,178,91,34,car
36506,6,car,7,0,4641,21,198,192,250,216,52,24,car
36507,0,person,1,0,4643,18,137,130,144,157,7,27,person
36508,1,person,2,0,4643,18,152,132,159,156,7,24,person
36509,2,person,3,0,4643,17,162,130,168,154,6,24,person
36510,3,person,4,0,4643,19,179,132,187,156,8,24,person
36511,4,person,5,0,4643,24,244,125,253,155,9,30,person
36512,5,person,6,1,4643,15,239,128,247,156,8,28,person
36513,6,person,7,0,4643,21,194,133,203,157,9,24,person
36514,7,car,8,1,4643,17,210,136,240,155,30,19,car
36515,8,car,9,0,4643,28,38,134,98,160,60,26,car
36516,9,traffic light,10,0,4643,21,154,39,178,155,24,116,traffic light
36517,2,window,3,0,4648,25,55,60,210,169,155,109,window
36518,5,window,6,0,4648,16,62,0,204,36,142,36,window
36519,3,car,4,1,4650,25,124,220,251,256,127,36,car
36520,4,car,5,0,4650,32,30,218,103,250,73,32,car
36521,5,car,6,1,4650,20,2,214,32,240,30,26,car
36522,12,car,13,0,4652,21,20,220,119,256,99,36,car
36523,13,car,14,1,4652,21,126,215,178,256,52,41,car
36524,14,car,15,1,4652,23,197,205,250,254,53,49,car
36525,15,flowerpot,16,0,4655,23,152,223,175,253,23,30,potted plant
36526,9,person,10,0,4656,19,94,162,103,197,9,35,person
36527,18,car,19,0,4656,27,97,169,208,204,111,35,car
36528,2,person,3,0,4657,16,35,204,44,225,9,21,person
36529,5,car,6,1,4657,29,27,218,98,246,71,28,car
36530,7,car,8,1,4657,15,55,201,106,227,51,26,car
36531,9,truck,10,0,4657,21,191,200,243,234,52,34,truck
36532,10,car,11,0,4657,29,128,208,170,232,42,24,car
36533,3,car,4,0,4659,36,137,201,235,243,98,42,car
36534,5,person,6,0,4659,23,87,198,97,231,10,33,person
36535,1,car,2,1,4660,17,201,191,256,226,55,35,car
36536,3,car,4,0,4660,29,109,188,185,226,76,38,car
36537,2,person,3,0,4661,26,221,172,234,216,13,44,person
36538,3,person,4,0,4661,27,233,171,249,214,16,43,person
36539,5,fire hydrant,6,0,4661,19,129,197,144,233,15,36,fire hydrant
36540,0,car,1,0,4663,16,165,189,245,223,80,34,car
36541,8,person,9,1,4665,18,214,177,224,202,10,25,person
36542,9,person,10,0,4665,23,201,174,212,214,11,40,person
36543,18,person,19,0,4665,22,185,181,195,216,10,35,person
36544,19,car,20,0,4665,33,0,180,154,234,154,54,car
36545,20,car,21,1,4665,22,207,195,256,235,49,40,car
36546,2,person,3,0,4667,23,184,188,196,231,12,43,person
36547,14,car,15,0,4667,30,0,189,187,256,187,67,car
36548,5,car,6,0,4669,23,31,166,92,216,61,50,car
36549,6,car,7,0,4669,24,106,169,175,211,69,42,car
36550,7,car,8,1,4669,24,174,169,222,204,48,35,car
36551,0,car,1,1,4670,24,228,157,256,212,28,55,car
36552,1,car,2,0,4670,29,157,156,229,211,72,55,car
36553,2,car,3,0,4670,23,70,157,158,235,88,78,car
36554,3,car,4,0,4670,33,10,149,80,201,70,52,car
36555,8,person,9,1,4672,19,0,183,10,232,10,49,person
36556,2,person,3,1,4673,18,14,208,29,230,15,22,person
36557,3,person,4,1,4673,23,27,209,48,230,21,21,person
36558,4,person,5,1,4673,17,58,208,75,235,17,27,person
36559,9,person,10,1,4673,18,75,209,96,236,21,27,person
36560,10,person,11,1,4673,19,234,209,256,232,22,23,person
36561,12,person,13,1,4673,21,186,209,206,237,20,28,person
36562,13,person,14,1,4673,24,164,208,183,237,19,29,person
36563,15,person,16,1,4673,15,141,207,157,230,16,23,person
36564,16,person,17,1,4673,17,126,208,142,229,16,21,person
36565,17,person,18,1,4673,18,103,214,117,234,14,20,person
36566,27,door,28,1,4673,23,28,162,80,212,52,50,door
36567,28,person,29,1,4673,15,54,192,70,209,16,17,person
36568,29,door,30,1,4673,18,240,170,254,215,14,45,door
36569,32,door,33,0,4673,18,217,169,236,214,19,45,door
36570,3,car,4,0,4674,23,8,213,112,256,104,43,car
36571,4,car,5,1,4674,18,111,225,237,256,126,31,car
36572,6,person,7,1,4674,21,97,207,111,234,14,27,person
36573,3,person,4,0,4675,22,40,188,56,236,16,48,person
36574,4,person,5,0,4675,16,138,191,151,227,13,36,person
36575,18,person,19,1,4676,16,167,240,177,255,10,15,person
36576,19,person,20,1,4676,15,121,237,129,255,8,18,person
36577,5,bus,6,0,4677,24,111,145,171,180,60,35,bus
36578,9,person,10,0,4677,17,171,208,176,223,5,15,person
36579,10,person,11,0,4677,16,137,228,143,245,6,17,person
36580,11,person,12,0,4677,16,144,228,149,245,5,17,person
36581,12,person,13,0,4677,15,151,227,156,245,5,18,person
36582,5,car,6,1,4678,16,20,220,107,256,87,36,car
36583,13,person,14,0,4678,18,134,225,144,245,10,20,person
36584,14,person,15,0,4678,15,180,225,186,247,6,22,person
36585,0,person,1,0,4681,37,4,152,24,232,20,80,person
36586,1,person,2,0,4681,43,26,160,57,240,31,80,person
36587,1,person,2,0,4682,34,156,203,177,256,21,53,person
36588,2,person,3,1,4682,30,169,196,195,256,26,60,person
36589,3,person,4,0,4682,31,202,200,220,256,18,56,person
36590,4,person,5,0,4682,36,217,200,240,256,23,56,person
36591,5,person,6,1,4682,21,235,194,247,236,12,42,person
36592,7,car,8,1,4686,17,171,197,256,241,85,44,car
36593,3,motorbike,4,0,4687,65,105,151,173,203,68,52,motorcycle
36594,4,motorbike,5,1,4687,48,123,148,185,193,62,45,motorcycle
36595,5,door,6,0,4687,46,124,81,225,186,101,105,door
36596,2,person,3,0,4689,20,147,130,158,158,11,28,person
36597,8,car,9,0,4690,25,0,164,66,188,66,24,car
36598,5,person,6,0,4691,31,86,156,100,198,14,42,person
36599,6,person,7,0,4691,33,100,155,118,197,18,42,person
36600,27,car,28,1,4691,29,77,153,205,197,128,44,car
36601,8,truck,9,1,4692,19,5,180,66,208,61,28,truck
36602,11,car,12,1,4692,23,87,202,156,235,69,33,car
36603,12,car,13,0,4692,31,2,203,90,240,88,37,car
36604,17,person,18,0,4692,17,212,190,221,219,9,29,person
36605,18,person,19,0,4692,19,200,188,210,218,10,30,person
36606,20,person,21,1,4692,16,148,190,157,215,9,25,person
36607,7,car,8,1,4693,31,2,196,63,236,61,40,car
36608,8,car,9,1,4693,30,74,202,155,233,81,31,car
36609,9,car,10,1,4693,32,143,200,249,240,106,40,car
36610,2,bicycle,3,0,4694,32,125,186,150,203,25,17,bicycle
36611,3,bicycle,4,1,4694,16,146,187,158,203,12,16,bicycle
36612,4,car,5,1,4695,18,198,157,256,201,58,44,car
36613,5,car,6,0,4695,29,12,164,132,215,120,51,car
36614,0,person,1,0,4697,25,125,210,141,256,16,46,person
36615,1,person,2,0,4697,33,108,203,118,247,10,44,person
36616,3,person,4,1,4697,19,147,203,157,239,10,36,person
36617,4,person,5,1,4697,15,138,200,151,236,13,36,person
36618,32,person,31,0,4697,31,37,211,62,246,25,35,person
36619,33,bicycle,32,0,4697,43,22,226,74,255,52,29,bicycle
36620,14,window,15,1,4701,16,169,38,209,74,40,36,window
36621,8,car,9,1,4705,21,127,217,256,256,129,39,car
36622,13,person,14,0,4710,17,247,136,251,155,4,19,person
36623,2,car,3,0,4712,33,3,158,109,208,106,50,car
36624,3,car,4,1,4712,19,77,161,157,200,80,39,car
36625,4,car,5,1,4712,20,130,159,213,189,83,30,car
36626,5,car,6,1,4712,15,181,157,228,183,47,26,car
36627,6,car,7,1,4712,17,220,154,255,177,35,23,car
36628,4,window,5,0,4716,16,51,121,75,175,24,54,window
36629,5,window,6,0,4716,18,87,120,112,175,25,55,window
36630,6,window,7,0,4716,16,124,120,148,174,24,54,window
36631,7,window,8,0,4716,16,52,35,74,88,22,53,window
36632,8,window,9,0,4716,18,87,34,111,87,24,53,window
36633,9,window,10,0,4716,17,124,30,147,85,23,55,window
36634,3,car,4,0,4717,15,111,154,137,176,26,22,car
36635,4,car,5,0,4717,17,144,157,173,177,29,20,car
36636,9,car,10,0,4717,30,2,153,88,198,86,45,car
36637,2,person,3,0,4718,23,137,141,151,174,14,33,person
36638,3,person,4,0,4718,18,75,147,84,173,9,26,person
36639,4,person,5,0,4718,24,89,140,100,171,11,31,person
36640,5,person,6,0,4718,20,99,140,108,169,9,29,person
36641,13,car,14,1,4718,15,61,195,256,256,195,61,car
36642,14,car,15,1,4718,29,156,148,256,196,100,48,car
36643,2,bicycle,3,0,4719,37,32,183,61,207,29,24,bicycle
36644,3,bicycle,4,0,4719,33,202,178,241,204,39,26,bicycle
36645,4,person,5,0,4719,21,210,163,221,204,11,41,person
36646,7,person,8,1,4719,20,76,167,88,204,12,37,person
36647,0,person,1,1,4720,17,0,190,7,243,7,53,person
36648,0,person,1,1,4721,25,123,183,142,223,19,40,person
36649,1,person,2,0,4721,29,207,177,225,231,18,54,person
36650,4,clock,5,0,4722,25,57,121,82,150,25,29,clock
36651,5,car,6,0,4723,35,97,145,244,192,147,47,car
36652,6,car,7,1,4723,22,0,133,63,193,63,60,car
36653,4,person,5,0,4724,25,3,198,15,248,12,50,person
36654,2,person,3,0,4726,17,232,140,239,161,7,21,person
36655,21,car,22,0,4726,31,73,149,156,177,83,28,car
36656,22,car,23,1,4726,17,0,148,57,180,57,32,car
36657,23,car,24,0,4726,17,193,174,256,245,63,71,car
36658,1,car,2,1,4728,18,0,167,50,199,50,32,car
36659,2,car,3,1,4728,23,48,167,117,204,69,37,car
36660,3,car,4,0,4728,27,109,165,188,205,79,40,car
36661,3,person,4,0,4734,17,60,151,70,170,10,19,person
36662,4,person,5,0,4734,20,128,153,144,173,16,20,person
36663,10,flowerpot,11,1,4734,16,0,160,46,200,46,40,potted plant
36664,16,flowerpot,17,0,4734,17,192,163,252,201,60,38,potted plant
36665,7,car,8,1,4737,22,188,131,256,168,68,37,car
36666,8,car,9,1,4737,17,2,131,68,160,66,29,car
36667,27,car,28,0,4737,49,2,122,189,221,187,99,car
36668,30,door,31,0,4737,15,61,126,105,185,44,59,door
36669,5,person,6,0,4740,17,88,203,99,245,11,42,person
36670,12,person,13,0,4744,16,99,192,104,209,5,17,person
36671,4,person,5,0,4745,24,167,166,180,208,13,42,person
36672,12,door,13,0,4745,16,41,124,54,222,13,98,door
36673,2,person,3,1,4746,17,228,164,237,183,9,19,person
36674,10,person,11,0,4747,15,142,171,150,192,8,21,person
36675,11,person,12,0,4747,18,162,174,170,194,8,20,person
36676,12,person,13,0,4747,15,152,172,157,191,5,19,person
36677,14,person,15,0,4747,21,106,180,117,210,11,30,person
36678,15,person,16,0,4747,20,121,180,131,209,10,29,person
36679,16,person,17,0,4747,25,203,176,215,213,12,37,person
36680,17,person,18,0,4747,19,197,176,205,212,8,36,person
36681,18,person,19,0,4747,24,225,176,236,213,11,37,person
36682,23,window,24,1,4747,32,118,7,178,50,60,43,window
36683,7,person,8,1,4749,15,129,184,138,198,9,14,person
36684,6,car,7,1,4751,18,0,184,28,243,28,59,car
36685,8,car,9,1,4751,15,74,182,99,214,25,32,car
36686,9,car,10,0,4751,32,10,172,75,217,65,45,car
36687,12,person,13,0,4755,30,105,189,124,234,19,45,person
36688,2,person,3,0,4756,18,235,200,246,231,11,31,person
36689,5,car,6,1,4759,17,27,190,74,226,47,36,car
36690,6,car,7,0,4759,26,73,166,148,223,75,57,car
36691,1,person,2,0,4761,31,36,190,58,237,22,47,person
36692,2,person,3,0,4761,25,89,187,97,217,8,30,person
36693,3,person,4,0,4761,30,187,191,200,231,13,40,person
36694,4,person,5,0,4761,34,199,193,216,231,17,38,person
36695,1,person,2,0,4762,15,19,204,27,232,8,28,person
36696,3,person,4,0,4762,17,28,205,37,228,9,23,person
36697,4,person,5,1,4762,17,35,204,42,231,7,27,person
36698,5,person,6,0,4762,15,42,206,49,231,7,25,person
36699,6,person,7,0,4762,19,51,204,60,231,9,27,person
36700,9,car,10,1,4762,19,119,201,164,228,45,27,car
36701,10,bus,11,1,4762,20,168,174,256,213,88,39,bus
36702,11,car,12,1,4762,33,143,196,218,241,75,45,car
36703,12,car,13,1,4762,23,204,200,256,242,52,42,car
36704,14,traffic light,15,0,4762,19,56,183,75,231,19,48,traffic light
36705,2,car,3,0,4764,33,130,167,242,202,112,35,car
36706,4,car,5,1,4764,17,0,168,49,200,49,32,car
36707,6,person,7,1,4766,15,127,234,135,256,8,22,person
36708,7,person,8,0,4766,18,88,233,97,256,9,23,person
36709,8,person,9,0,4766,17,61,236,68,256,7,20,person
36710,9,person,10,0,4766,16,37,236,47,256,10,20,person
36711,11,person,12,0,4766,18,112,232,121,256,9,24,person
36712,12,person,13,0,4766,19,72,237,78,256,6,19,person
36713,7,person,8,0,4767,17,76,216,85,243,9,27,person
36714,10,car,11,0,4767,32,83,217,133,249,50,32,car
36715,11,truck,12,1,4767,24,121,207,164,239,43,32,truck
36716,13,car,13,1,4767,15,197,214,209,230,12,16,car
36717,14,car,14,1,4767,18,198,209,222,227,24,18,car
36718,15,car,15,1,4767,15,222,212,235,224,13,12,car
36719,2,person,3,0,4768,28,128,225,141,256,13,31,person
36720,4,person,5,0,4768,16,74,222,80,243,6,21,person
36721,5,person,6,0,4768,22,56,222,68,256,12,34,person
36722,7,person,8,0,4768,18,15,215,20,240,5,25,person
36723,0,person,1,0,4769,30,43,140,60,185,17,45,person
36724,1,person,2,0,4769,24,33,144,43,184,10,40,person
36725,2,bicycle,3,0,4769,34,182,160,213,180,31,20,bicycle
36726,4,car,5,1,4769,17,0,157,36,190,36,33,car
36727,5,car,6,0,4769,31,63,151,151,186,88,35,car
36728,11,door,12,0,4769,16,152,67,183,155,31,88,door
36729,16,car,17,1,4770,25,0,216,47,256,47,40,car
36730,4,person,5,0,4772,16,165,209,173,236,8,27,person
36731,5,person,6,0,4772,18,82,210,92,233,10,23,person
36732,7,person,8,0,4772,17,128,212,134,233,6,21,person
36733,7,person,8,0,4773,19,5,143,13,171,8,28,person
36734,8,person,9,1,4773,18,113,141,127,171,14,30,person
36735,13,person,14,0,4773,20,181,146,189,174,8,28,person
36736,5,boat,6,0,4774,18,95,187,226,219,131,32,boat
36737,1,person,1,0,4777,15,168,191,176,221,8,30,person
36738,2,person,2,0,4777,25,22,196,32,230,10,34,person
36739,3,person,3,0,4777,18,107,197,118,222,11,25,person
36740,4,person,4,0,4777,20,57,197,64,228,7,31,person
36741,5,person,5,0,4777,17,63,198,70,227,7,29,person
36742,6,person,6,0,4777,18,149,193,159,220,10,27,person
36743,10,traffic light,10,0,4777,33,165,17,256,66,91,49,traffic light
36744,41,person,41,0,4777,23,119,199,135,221,16,22,person
36745,42,bicycle,42,0,4777,18,119,211,134,225,15,14,bicycle
36746,1,person,2,0,4778,17,95,159,102,178,7,19,person
36747,0,car,1,0,4779,27,0,156,188,237,188,81,car
36748,1,person,2,0,4780,15,44,120,52,145,8,25,person
36749,2,person,3,1,4780,17,55,123,65,146,10,23,person
36750,3,car,4,1,4780,26,0,138,75,167,75,29,car
36751,5,car,6,0,4780,32,111,125,210,162,99,37,car
36752,8,person,9,1,4780,20,189,120,199,137,10,17,person
36753,9,car,10,1,4780,17,212,123,256,156,44,33,car
36754,30,person,31,0,4780,19,100,118,106,144,6,26,person
36755,4,car,5,0,4781,16,183,214,228,230,45,16,car
36756,5,car,6,0,4781,15,225,214,251,229,26,15,car
36757,7,person,8,0,4785,21,18,139,30,169,12,30,person
36758,8,person,9,0,4785,24,79,136,96,168,17,32,person
36759,25,car,26,0,4785,30,88,141,214,197,126,56,car
36760,2,person,3,0,4790,39,75,42,111,102,36,60,person
36761,3,person,4,0,4792,16,149,151,157,174,8,23,person
36762,3,car,4,0,4794,21,84,197,185,228,101,31,car
36763,4,car,5,0,4794,15,0,189,77,223,77,34,car
36764,6,car,7,1,4795,17,87,234,179,256,92,22,car
36765,5,umbrella,6,0,4797,19,80,184,132,235,52,51,umbrella
36766,9,person,10,0,4797,28,166,202,196,254,30,52,person
36767,14,person,15,1,4797,21,134,233,163,254,29,21,person
36768,15,person,16,1,4797,23,136,206,151,243,15,37,person
36769,9,car,10,1,4799,21,0,133,73,176,73,43,car
36770,11,car,12,1,4799,22,158,134,256,179,98,45,car
36771,1,person,2,0,4800,32,85,197,102,249,17,52,person
36772,8,window,9,1,4801,15,97,1,140,68,43,67,window
36773,2,person,3,0,4804,27,239,210,248,246,9,36,person
36774,3,person,4,0,4804,28,213,212,223,250,10,38,person
36775,4,person,5,0,4804,29,196,213,208,253,12,40,person
36776,5,person,6,1,4804,19,153,210,164,234,11,24,person
36777,10,car,11,1,4804,21,27,213,178,255,151,42,car
36778,1,person,2,0,4806,19,101,192,109,217,8,25,person
36779,3,person,4,0,4806,19,233,199,256,225,23,26,person
36780,5,person,6,0,4806,19,223,194,238,215,15,21,person
36781,6,person,7,0,4806,19,211,196,226,213,15,17,person
36782,7,person,8,0,4806,16,125,191,130,206,5,15,person
36783,9,person,10,0,4806,17,30,197,44,217,14,20,person
36784,11,bus,12,1,4806,17,197,192,237,203,40,11,bus
36785,15,clock,16,0,4806,15,120,64,135,78,15,14,clock
36786,8,door,9,1,4807,15,36,212,73,255,37,43,door
36787,2,car,3,0,4809,16,24,212,61,232,37,20,car
36788,5,person,6,0,4809,28,0,210,21,256,21,46,person
36789,6,person,7,0,4809,39,73,206,95,256,22,50,person
36790,7,person,8,0,4809,27,143,212,162,256,19,44,person
36791,8,person,9,0,4809,30,166,213,188,256,22,43,person
36792,18,traffic light,19,0,4809,15,226,133,239,254,13,121,traffic light
36793,23,person,24,1,4809,16,159,206,184,239,25,33,person
36794,3,car,4,0,4810,38,90,183,216,243,126,60,car
36795,2,car,3,0,4812,23,65,143,117,160,52,17,car
36796,1,car,2,0,4813,24,76,194,197,240,121,46,car
36797,1,car,2,1,4815,24,47,200,120,255,73,55,car
36798,2,car,3,0,4815,27,94,195,198,254,104,59,car
36799,16,person,17,1,4816,19,0,188,12,233,12,45,person
36800,17,car,18,0,4816,35,112,187,223,230,111,43,car
36801,15,window,16,0,4817,16,175,72,195,143,20,71,window
36802,6,car,7,0,4818,19,23,219,44,234,21,15,car
36803,6,person,7,0,22965,15,74,558,85,590,11,32,person
36804,7,truck,8,1,22966,16,716,329,775,419,59,90,truck
36805,12,person,13,0,22966,43,52,397,90,502,38,105,person
36806,13,person,14,0,22966,23,147,393,165,429,18,36,person
36807,14,person,15,0,22966,25,468,383,491,436,23,53,person
36808,15,person,16,1,22966,21,520,382,538,433,18,51,person
36809,16,person,17,0,22966,21,590,377,603,420,13,43,person
36810,17,person,18,0,22966,23,639,382,650,416,11,34,person
36811,18,person,19,0,22966,16,658,376,667,414,9,38,person
36812,19,person,20,0,22966,18,669,379,678,412,9,33,person
36813,20,car,21,1,22966,28,81,394,140,439,59,45,car
36814,22,car,23,1,22966,41,1,408,99,472,98,64,car
36815,24,traffic light,25,0,22966,40,488,313,524,449,36,136,traffic light
36816,28,traffic light,29,0,22966,38,1,13,177,108,176,95,traffic light
36817,12,person,13,0,22973,34,407,383,452,509,45,126,person
36818,13,person,14,0,22973,24,567,455,615,518,48,63,person
36819,14,person,15,0,22973,29,470,443,536,514,66,71,person
36820,15,person,16,1,22973,26,452,456,524,516,72,60,person
36821,19,person,20,1,22973,18,943,649,1023,705,80,56,person
36822,6,person,7,0,22974,33,403,720,471,926,68,206,person
36823,7,person,8,0,22974,27,309,723,356,841,47,118,person
36824,8,person,9,0,22974,21,128,727,162,836,34,109,person
36825,9,person,10,1,22974,28,395,710,430,858,35,148,person
36826,10,person,11,0,22974,28,722,739,770,812,48,73,person
36827,11,bench,12,0,22974,20,769,772,817,807,48,35,bench
36828,22,person,23,0,22975,48,787,631,850,806,63,175,person
36829,28,person,29,0,22975,28,690,601,717,680,27,79,person
36830,29,person,30,0,22975,23,643,596,661,648,18,52,person
36831,31,person,32,0,22975,19,571,599,589,659,18,60,person
36832,32,person,33,0,22975,20,591,617,611,673,20,56,person
36833,33,person,34,0,22975,21,273,611,290,671,17,60,person
36834,34,person,35,0,22975,48,150,624,203,750,53,126,person
36835,35,person,36,0,22975,38,114,629,157,757,43,128,person
36836,41,person,42,0,22975,18,904,610,926,679,22,69,person
36837,42,person,43,0,22975,25,0,625,29,747,29,122,person
36838,43,person,44,0,22975,38,33,618,74,742,41,124,person
36839,44,person,45,0,22975,25,64,618,92,735,28,117,person
36840,13,car,14,0,22978,20,758,433,809,482,51,49,car
36841,14,car,15,1,22978,17,845,440,957,489,112,49,car
36842,20,car,21,1,22978,16,820,465,1024,597,204,132,car
36843,21,person,22,1,22978,53,807,430,851,573,44,143,person
36844,23,person,24,0,22978,66,489,429,564,588,75,159,person
36845,27,person,28,0,22978,33,386,419,407,483,21,64,person
36846,28,person,29,0,22978,19,751,429,760,459,9,30,person
36847,29,person,30,0,22978,17,743,432,752,461,9,29,person
36848,30,person,31,0,22978,20,453,417,467,456,14,39,person
36849,31,person,32,0,22978,18,413,414,425,451,12,37,person
36850,35,person,36,0,22978,33,148,409,167,471,19,62,person
36851,36,person,37,0,22978,33,161,415,184,472,23,57,person
36852,37,person,38,0,22978,21,733,423,743,455,10,32,person
36853,5,car,6,1,22979,22,1,642,162,730,161,88,car
36854,6,car,7,1,22979,26,219,640,408,719,189,79,car
36855,7,car,8,1,22979,15,436,617,571,674,135,57,car
36856,8,car,9,1,22979,20,373,629,572,694,199,65,car
36857,9,car,10,1,22979,23,571,625,677,690,106,65,car
36858,12,car,13,1,22979,16,207,685,721,767,514,82,car
36859,2,traffic light,3,0,22980,38,957,239,1017,682,60,443,traffic light
36860,3,traffic light,4,0,22980,25,756,469,833,584,77,115,traffic light
36861,6,traffic light,7,0,22980,32,98,462,143,595,45,133,traffic light
36862,11,car,12,1,22980,32,440,533,874,682,434,149,car
36863,28,bus,29,1,4848,19,315,608,973,866,658,258,bus
36864,29,bus,30,1,4848,16,512,610,1204,853,692,243,bus
36865,30,bus,31,1,4848,17,690,602,1378,837,688,235,bus
36866,31,bus,32,1,4848,16,206,541,691,630,485,89,bus
36867,32,bus,33,1,4848,17,479,532,984,617,505,85,bus
36868,33,bus,34,1,4848,15,653,533,1159,608,506,75,bus
36869,35,bus,36,1,4848,18,1006,584,1681,799,675,215,bus
36870,36,bus,37,1,4848,19,992,522,1503,598,511,76,bus
36871,37,bus,38,1,4848,16,1190,583,1862,787,672,204,bus
36872,40,bus,41,1,4848,18,1310,576,1916,770,606,194,bus
36873,46,bus,47,1,4848,18,1578,502,1915,573,337,71,bus
36874,6,bus,7,1,4850,19,0,331,210,594,210,263,bus
36875,7,bus,8,0,4850,23,219,330,448,592,229,262,bus
36876,8,bus,9,0,4850,22,468,330,694,587,226,257,bus
36877,6,bus,7,1,4851,23,448,201,542,323,94,122,bus
36878,8,bus,9,1,4851,29,350,177,455,327,105,150,bus
36879,9,bus,10,0,4851,31,0,158,356,335,356,177,bus
36880,5,bus,6,1,4852,40,82,343,468,620,386,277,bus
36881,6,bus,7,1,4852,32,405,374,609,632,204,258,bus
36882,7,bus,8,0,4852,36,601,236,980,641,379,405,bus
36883,2,bus,3,1,4853,19,0,247,161,324,161,77,bus
36884,3,bus,4,1,4853,28,155,237,233,339,78,102,bus
36885,4,bus,5,1,4853,25,229,233,336,342,107,109,bus
36886,5,bus,6,1,4853,22,331,229,529,357,198,128,bus
36887,8,bus,9,1,4854,20,169,196,258,321,89,125,bus
36888,9,bus,10,1,4854,29,249,170,429,341,180,171,bus
36889,10,bus,11,0,4854,49,376,133,751,382,375,249,bus
36890,9,person,10,0,4855,15,352,826,420,1008,68,182,person
36891,10,bus,11,1,4855,18,379,686,827,988,448,302,bus
36892,11,bus,12,1,4855,32,813,625,1653,1031,840,406,bus
36893,12,bus,13,1,4855,20,1639,568,2200,1060,561,492,bus
36894,28,mirror,29,0,4855,16,955,721,985,786,30,65,mirror
36895,36,mirror,37,0,4855,15,352,735,394,798,42,63,mirror
36896,37,mirror,38,0,4855,15,439,724,464,809,25,85,mirror
36897,46,mirror,47,0,4855,19,774,692,828,787,54,95,mirror
36898,58,mirror,59,0,4855,21,1811,613,1847,758,36,145,mirror
36899,59,mirror,60,0,4855,19,1592,640,1659,753,67,113,mirror
36900,1,bus,2,1,4857,27,0,393,434,1369,434,976,bus
36901,2,bus,3,0,4857,71,368,91,1943,1535,1575,1444,bus
36902,5,window,6,0,4857,15,1291,842,1486,1097,195,255,window
36903,11,window,12,0,4857,15,1611,500,1740,725,129,225,window
36904,12,window,13,0,4857,17,1457,415,1620,675,163,260,window
36905,13,window,14,0,4857,17,1253,307,1466,607,213,300,window
36906,14,window,15,0,4857,20,1010,173,1257,522,247,349,window
36907,15,window,16,0,4857,19,429,151,962,520,533,369,window
36908,17,bus,18,1,4857,23,1919,751,2160,1224,241,473,bus
36909,21,mirror,22,0,4857,16,937,707,1045,934,108,227,mirror
36910,5,bus,6,1,4858,17,1504,517,1597,658,93,141,bus
36911,8,bus,9,1,4858,46,1044,442,1526,861,482,419,bus
36912,9,bus,10,1,4858,35,739,431,1055,823,316,392,bus
36913,10,bus,11,1,4858,39,377,375,723,750,346,375,bus
36914,11,bus,12,1,4858,32,41,377,401,734,360,357,bus
36915,1,bus,2,0,4859,32,2,804,345,1155,343,351,bus
36916,3,bus,4,0,4859,46,390,731,982,1192,592,461,bus
36917,4,bus,5,0,4859,47,972,592,2173,1244,1201,652,bus
36918,8,window,9,0,4859,17,1794,642,2131,829,337,187,window
36919,10,window,11,0,4859,16,649,768,956,903,307,135,window
36920,11,window,12,0,4859,15,61,831,315,934,254,103,window
36921,7,bus,8,1,4885,16,176,199,595,431,419,232,bus
36922,12,person,13,1,4885,25,651,315,695,553,44,238,person
36923,13,person,14,0,4885,33,666,299,754,588,88,289,person
36924,15,person,16,1,4885,15,92,327,182,431,90,104,person
36925,16,person,17,0,4885,34,243,326,328,635,85,309,person
36926,17,person,18,1,4885,28,326,327,415,649,89,322,person
36927,18,person,19,0,4885,37,373,342,489,669,116,327,person
36928,22,bench,23,0,4885,29,842,493,978,668,136,175,bench
36929,25,window,26,0,4885,16,176,210,356,308,180,98,window
36930,7,bench,8,0,4886,19,107,136,194,159,87,23,bench
36931,7,person,8,0,4887,38,986,494,1115,1011,129,517,person
36932,8,backpack,9,0,4887,21,1089,599,1198,764,109,165,backpack
36933,11,person,12,0,4887,30,815,500,910,757,95,257,person
36934,12,person,13,0,4887,31,744,522,823,755,79,233,person
36935,14,person,15,1,4887,20,707,519,749,619,42,100,person
36936,15,bus,16,1,4887,32,622,481,754,595,132,114,bus
36937,16,bus,17,0,4887,34,0,379,425,724,425,345,bus
36938,17,person,18,1,4887,17,0,634,106,1020,106,386,person
36939,18,person,19,0,4887,29,434,529,507,769,73,240,person
36940,19,person,20,1,4887,18,535,570,579,701,44,131,person
36941,20,person,21,1,4887,15,595,554,640,722,45,168,person
36942,21,person,22,0,4887,38,615,552,691,758,76,206,person
36943,22,person,23,0,4887,27,685,555,741,754,56,199,person
36944,2,bench,3,0,4890,26,65,144,286,199,221,55,bench
36945,3,person,4,0,4890,40,123,90,177,190,54,100,person
36946,4,person,5,0,4890,31,84,97,126,189,42,92,person
36947,5,backpack,6,0,4890,15,177,94,216,156,39,62,backpack
36948,27,bench,28,0,4891,15,245,726,629,883,384,157,bench
36949,6,bus,7,0,4897,19,7,223,114,330,107,107,bus
36950,10,person,11,0,4897,16,153,269,163,310,10,41,person
36951,11,person,12,0,4897,22,162,271,175,311,13,40,person
36952,12,person,13,0,4897,24,322,278,338,333,16,55,person
36953,13,person,14,0,4897,27,355,281,375,339,20,58,person
36954,14,person,15,0,4897,22,376,283,397,345,21,62,person
36955,8,person,9,0,4898,18,405,294,441,343,36,49,person
36956,11,person,12,0,4898,21,621,265,648,348,27,83,person
36957,13,bus,14,0,4898,19,145,268,245,347,100,79,bus
36958,15,person,16,0,4898,17,368,292,386,341,18,49,person
36959,16,person,17,1,4898,15,380,286,394,338,14,52,person
36960,5,bus,6,0,4899,38,0,144,245,241,245,97,bus
36961,6,bus,7,1,4899,21,240,149,308,236,68,87,bus
36962,7,bus,8,1,4899,21,304,159,402,228,98,69,bus
36963,4,bus,5,0,4900,19,606,324,861,451,255,127,bus
36964,5,bus,6,0,4900,23,115,358,582,562,467,204,bus
36965,12,car,13,1,4901,23,1246,972,2197,1649,951,677,car
36966,13,bus,14,1,4901,28,0,1029,422,1214,422,185,bus
36967,16,person,17,1,4901,38,171,1128,295,1436,124,308,person
36968,20,person,21,1,4901,31,510,1112,639,1513,129,401,person
36969,21,person,22,1,4901,23,763,1099,857,1379,94,280,person
36970,22,suitcase,23,0,4901,20,723,1238,841,1388,118,150,suitcase
36971,23,suitcase,24,0,4901,22,378,1348,539,1537,161,189,suitcase
36972,24,person,25,0,4901,29,1294,1068,1396,1324,102,256,person
36973,26,person,27,0,4901,25,1242,1047,1296,1233,54,186,person
36974,27,person,28,0,4901,15,1191,1124,1250,1229,59,105,person
36975,28,person,29,0,4901,16,1434,1041,1491,1212,57,171,person
36976,29,person,30,0,4901,17,1379,1079,1444,1198,65,119,person
36977,30,person,31,0,4901,19,1491,1049,1534,1176,43,127,person
36978,31,person,32,0,4901,23,1581,1027,1632,1179,51,152,person
36979,32,person,33,0,4901,20,1553,1021,1602,1168,49,147,person
36980,33,person,34,0,4901,19,727,1076,766,1224,39,148,person
36981,3,bus,4,0,4902,28,63,159,165,231,102,72,bus
36982,4,bus,5,0,4902,20,151,155,269,227,118,72,bus
36983,4,car,5,1,4933,25,0,955,554,1390,554,435,car
36984,7,chair,8,0,4933,21,807,1015,948,1211,141,196,chair
36985,8,chair,9,0,4933,16,1003,1041,1169,1208,166,167,chair
36986,42,chair,12,1,4935,17,1687,756,1891,1037,204,281,chair
36987,43,chair,13,0,4935,15,432,820,640,1164,208,344,chair
36988,71,table,36,1,4935,15,937,831,1319,1154,382,323,dining table
36989,0,motorbike,1,0,4936,62,840,547,1760,1172,920,625,motorcycle
36990,2,motorbike,2,1,4936,100,199,555,765,997,566,442,motorcycle
36991,3,motorbike,3,1,4936,131,568,554,1127,1041,559,487,motorcycle
36992,4,person,4,1,4936,48,250,509,419,747,169,238,person
36993,1,car,2,0,4940,24,565,298,1020,674,455,376,car
36994,11,person,12,1,4940,32,665,336,801,567,136,231,person
36995,0,person,1,0,4941,101,27,339,157,687,130,348,person
36996,1,person,2,0,4941,93,368,302,484,704,116,402,person
36997,3,person,4,0,4941,102,484,318,593,667,109,349,person
36998,4,hat,5,0,4941,16,519,318,581,344,62,26,hat
36999,5,person,6,1,4941,52,720,375,793,556,73,181,person
37000,6,person,7,0,4941,75,777,460,919,675,142,215,person
37001,9,person,10,1,4941,62,885,427,1034,645,149,218,person
37002,14,window,15,0,4943,15,68,422,337,521,269,99,window
37003,3,bench,3,1,4944,20,415,433,611,510,196,77,bench
37004,10,person,11,0,4945,73,649,942,848,1648,199,706,person
37005,2,car,3,0,24877,43,42,474,686,867,644,393,car
37006,0,window,1,0,73,88,58,2,999,240,941,238,window
37007,2,sofa,3,1,73,54,233,228,419,450,186,222,couch
37008,3,person,4,0,73,76,1,46,274,450,273,404,person
37009,11,fork,12,0,73,25,218,218,273,338,55,120,fork
37010,12,table,13,1,73,60,85,344,807,450,722,106,dining table
37011,13,bowl,14,0,73,21,590,338,724,376,134,38,bowl
37012,14,fork,15,0,73,26,604,202,644,352,40,150,fork
37013,15,plate,16,0,73,21,403,341,596,374,193,33,plate
37014,16,plate,17,0,73,21,207,345,385,375,178,30,plate
37015,19,fork,20,0,73,17,454,271,514,337,60,66,fork
37016,20,person,21,1,73,105,303,22,620,450,317,428,person
37017,31,person,32,1,73,111,517,42,844,416,327,374,person
37018,42,person,43,0,73,101,587,36,999,450,412,414,person
37019,2,person,3,1,74,33,436,1,543,130,107,129,person
37020,3,person,4,1,74,29,541,1,622,115,81,114,person
37021,4,person,5,1,74,23,185,231,277,295,92,64,person
37022,5,person,6,1,74,37,171,7,239,135,68,128,person
37023,6,person,7,1,74,59,0,11,33,466,33,455,person
37024,12,person,13,1,74,100,20,3,279,466,259,463,person
37025,13,person,14,1,74,127,1,33,301,466,300,433,person
37026,21,person,22,1,74,103,310,128,531,467,221,339,person
37027,36,person,37,1,74,80,524,110,700,467,176,357,person
37028,8,bench,9,0,75,36,273,1244,527,1467,254,223,bench
37029,9,person,10,0,75,25,364,1207,508,1380,144,173,person
37030,14,person,15,0,75,113,497,700,1064,2120,567,1420,person
37031,12,bicycle,13,0,4984,44,499,334,566,423,67,89,bicycle
37032,16,person,17,0,4984,26,74,275,139,444,65,169,person
37033,17,person,18,0,4984,17,209,289,232,352,23,63,person
37034,20,person,21,0,4984,19,254,280,273,336,19,56,person
37035,12,person,13,0,4986,65,132,100,227,313,95,213,person
37036,13,person,14,0,4986,33,116,94,169,293,53,199,person
37037,18,backpack,19,0,4986,15,200,149,233,203,33,54,backpack
37038,10,person,11,0,4987,18,533,343,552,369,19,26,person
37039,5,car,6,0,4988,21,308,234,439,292,131,58,car
37040,10,vase,11,0,4994,17,832,397,891,471,59,74,vase
37041,15,bird,16,0,4994,20,767,697,809,741,42,44,bird
37042,16,person,17,0,4994,18,304,506,324,556,20,50,person
37043,17,person,18,0,4994,17,287,511,303,558,16,47,person
37044,18,person,19,0,4994,19,179,537,210,572,31,35,person
37045,60,person,61,0,4994,22,761,522,793,553,32,31,person
37046,9,person,10,0,4995,18,144,155,154,178,10,23,person
37047,10,person,11,0,4995,15,257,160,267,183,10,23,person
37048,5,person,6,0,4997,34,8,306,41,402,33,96,person
37049,6,person,7,0,4997,29,179,312,220,416,41,104,person
37050,7,person,8,0,4997,24,162,306,196,407,34,101,person
37051,8,person,9,0,4997,25,131,307,158,400,27,93,person
37052,9,person,10,0,4997,22,114,314,135,406,21,92,person
37053,10,person,11,0,4997,20,93,314,113,386,20,72,person
37054,11,person,12,0,4997,17,56,315,71,377,15,62,person
37055,12,person,13,0,4997,17,79,314,95,376,16,62,person
37056,10,person,11,0,4998,27,363,185,389,245,26,60,person
37057,11,person,12,0,4998,39,219,190,267,317,48,127,person
37058,12,person,13,0,4998,39,174,193,215,311,41,118,person
37059,4,person,5,0,5001,16,434,251,443,274,9,23,person
37060,5,person,6,0,23013,101,493,348,591,647,98,299,person
37061,9,car,10,0,23017,15,346,524,383,547,37,23,car
37062,11,person,12,0,23017,18,233,497,250,537,17,40,person
37063,15,person,16,1,23017,16,284,493,301,533,17,40,person
37064,24,person,25,0,23017,21,409,522,424,547,15,25,person
37065,25,person,26,0,23017,15,424,526,430,547,6,21,person
37066,26,person,27,0,23017,19,434,522,445,549,11,27,person
37067,27,person,28,0,23017,16,465,507,471,529,6,22,person
37068,28,person,29,0,23017,16,457,507,464,529,7,22,person
37069,8,backpack,9,0,23020,21,883,429,1023,678,140,249,backpack
37070,13,person,14,1,23020,73,449,241,670,677,221,436,person
37071,14,person,15,1,23020,101,135,252,432,677,297,425,person
37072,16,person,17,1,23020,32,0,163,57,676,57,513,person
37073,17,person,18,1,23020,102,1,90,271,625,270,535,person
37074,5,chair,4,0,23021,22,361,491,400,523,39,32,chair
37075,8,table,7,0,23021,22,123,494,186,530,63,36,dining table
37076,9,bench,8,0,23021,19,165,506,200,527,35,21,bench
37077,7,person,8,0,5014,20,125,152,143,192,18,40,person
37078,27,boat,28,1,5015,34,3,1255,636,1651,633,396,boat
37079,28,window,29,0,5015,18,1277,1145,1337,1237,60,92,window
37080,29,window,30,0,5015,17,1602,1145,1666,1238,64,93,window
37081,23,boat,24,1,5018,20,899,1270,1195,1320,296,50,boat
37082,58,person,59,1,5018,16,1295,1326,1321,1355,26,29,person
37083,14,boat,15,0,5021,17,111,138,181,224,70,86,boat
37084,16,person,17,0,5021,19,166,82,175,102,9,20,person
37085,18,person,19,0,5021,16,180,79,186,101,6,22,person
37086,15,person,15,0,5023,17,1077,862,1119,919,42,57,person
37087,17,person,17,0,5023,22,1652,842,1681,914,29,72,person
37088,20,car,20,0,5023,15,597,873,916,931,319,58,car
37089,21,car,21,0,5023,25,620,869,708,936,88,67,car
37090,22,car,22,0,5023,28,755,866,850,932,95,66,car
37091,23,car,23,0,5023,35,909,868,1029,931,120,63,car
37092,29,car,29,0,5023,21,1477,826,1636,880,159,54,car
37093,31,car,31,1,5023,16,1108,828,1177,881,69,53,car
37094,9,boat,10,1,24891,15,533,446,640,516,107,70,boat
37095,11,person,12,1,24891,15,363,416,375,443,12,27,person
37096,6,car,7,0,5056,24,237,215,334,250,97,35,car
37097,7,car,8,0,5056,18,178,212,236,252,58,40,car
37098,8,car,9,0,5056,16,320,212,375,233,55,21,car
37099,9,car,10,0,5056,25,375,212,489,246,114,34,car
37100,16,car,17,0,5056,16,96,211,156,255,60,44,car
37101,17,car,18,1,5056,20,30,209,105,242,75,33,car
37102,10,car,11,0,5057,24,38,191,146,227,108,36,car
37103,12,car,13,0,5057,30,145,181,274,233,129,52,car
37104,14,car,15,1,5057,17,295,194,360,245,65,51,car
37105,12,car,13,1,5058,22,205,23,399,149,194,126,car
37106,13,car,14,0,5058,49,6,24,398,248,392,224,car
37107,6,car,7,0,5059,15,152,189,179,201,27,12,car
37108,7,car,8,0,5059,17,263,192,292,213,29,21,car
37109,8,car,9,0,5059,15,300,195,329,215,29,20,car
37110,10,car,11,0,5059,15,338,194,364,217,26,23,car
37111,11,car,12,0,5059,16,381,193,411,219,30,26,car
37112,12,car,13,0,5059,15,419,194,443,209,24,15,car
37113,8,chair,9,0,5060,18,610,601,691,718,81,117,chair
37114,21,person,22,1,5060,15,1221,496,1313,563,92,67,person
37115,22,car,23,1,5060,26,730,510,1245,682,515,172,car
37116,24,car,25,1,5060,22,569,515,730,658,161,143,car
37117,25,car,26,1,5060,23,310,469,631,602,321,133,car
37118,26,car,27,1,5060,30,223,526,610,744,387,218,car
37119,27,car,28,1,5060,39,2,555,528,842,526,287,car
37120,32,person,33,1,5060,17,699,528,793,685,94,157,person
37121,33,car,34,1,5060,32,594,555,1324,893,730,338,car
37122,34,car,35,1,5060,30,590,563,1597,1198,1007,635,car
37123,35,car,36,1,5060,21,0,579,270,863,270,284,car
37124,36,car,37,1,5060,20,0,755,327,1198,327,443,car
37125,2,car,3,0,5061,28,574,1045,1259,1299,685,254,car
37126,12,car,13,0,5061,34,9,1011,575,1291,566,280,car
37127,16,car,17,1,5061,21,1241,939,1444,1126,203,187,car
37128,18,car,19,1,5061,17,1536,910,2044,1092,508,182,car
37129,19,car,20,1,5061,22,1393,993,2046,1345,653,352,car
37130,45,door,46,0,5061,15,983,1056,1144,1228,161,172,door
37131,63,door,64,0,5061,16,312,1025,411,1214,99,189,door
37132,4,car,5,1,5062,22,0,401,253,563,253,162,car
37133,5,car,6,1,5062,27,948,400,1228,612,280,212,car
37134,6,car,7,0,5062,42,167,365,1032,808,865,443,car
37135,9,person,10,1,5062,25,917,393,966,511,49,118,person
37136,17,door,18,0,5062,18,256,385,422,677,166,292,door
37137,19,window,20,0,5062,16,287,392,401,462,114,70,window
37138,10,car,11,1,5063,15,98,123,134,142,36,19,car
37139,11,car,12,0,5063,21,129,124,169,146,40,22,car
37140,17,car,18,1,5063,15,287,126,320,148,33,22,car
37141,19,car,20,0,5063,18,234,134,279,174,45,40,car
37142,20,car,21,0,5063,24,173,131,222,170,49,39,car
37143,21,car,22,0,5063,26,66,130,125,166,59,36,car
37144,22,car,23,1,5063,22,18,129,81,163,63,34,car
37145,23,car,24,1,5063,17,0,129,38,160,38,31,car
37146,25,car,26,1,5063,20,192,180,320,214,128,34,car
37147,8,car,9,1,5064,21,946,487,1216,638,270,151,car
37148,9,car,10,1,5064,25,1139,492,1531,634,392,142,car
37149,11,car,12,0,5064,26,1181,522,1559,832,378,310,car
37150,12,car,13,0,5064,29,587,499,1004,760,417,261,car
37151,13,car,14,1,5064,28,273,485,673,680,400,195,car
37152,14,car,15,1,5064,31,40,466,389,636,349,170,car
37153,49,door,50,0,5064,16,531,492,603,635,72,143,door
37154,4,person,5,1,5086,25,605,298,639,409,34,111,person
37155,3,person,4,1,5088,21,147,251,194,292,47,41,person
37156,2,boat,3,0,5116,27,167,187,519,269,352,82,boat
37157,9,boat,10,0,5117,15,413,91,468,138,55,47,boat
37158,13,person,14,0,5117,16,391,157,405,191,14,34,person
37159,15,car,16,0,5118,51,102,113,303,197,201,84,car
37160,3,car,4,1,5119,29,216,267,569,454,353,187,car
37161,9,car,10,1,5120,37,45,157,272,267,227,110,car
37162,10,car,11,0,5120,40,182,161,395,279,213,118,car
37163,20,window,21,0,5120,19,198,175,286,206,88,31,window
37164,26,door,27,0,5120,19,292,169,343,247,51,78,door
37165,4,car,5,0,5121,37,97,272,530,464,433,192,car
37166,5,car,6,1,5121,25,439,253,647,351,208,98,car
37167,10,door,11,0,5121,16,356,320,450,420,94,100,door
37168,3,car,4,1,5122,34,124,97,284,225,160,128,car
37169,3,car,4,0,5123,32,102,108,230,207,128,99,car
37170,3,car,4,0,5124,34,52,95,286,181,234,86,car
37171,2,car,3,1,5125,30,956,281,1561,585,605,304,car
37172,3,car,4,1,5125,28,580,272,1174,626,594,354,car
37173,4,car,5,0,5125,29,193,318,692,658,499,340,car
37174,3,car,4,0,5126,43,46,100,192,173,146,73,car
37175,5,car,6,0,5127,27,398,554,629,729,231,175,car
37176,6,bicycle,7,0,5127,16,1307,597,1372,699,65,102,bicycle
37177,7,bicycle,8,0,5127,22,1132,586,1181,683,49,97,bicycle
37178,3,bicycle,4,1,5133,27,386,583,550,841,164,258,bicycle
37179,10,bench,11,0,5133,25,1108,609,1375,782,267,173,bench
37180,12,car,13,0,5133,45,513,553,1152,1109,639,556,car
37181,7,car,8,0,5134,33,143,110,240,170,97,60,car
37182,9,car,10,0,5137,33,68,215,332,320,264,105,car
37183,5,car,6,1,5138,27,0,229,406,359,406,130,car
37184,6,car,7,1,5138,20,81,423,445,570,364,147,car
37185,4,car,5,0,5139,36,64,100,200,189,136,89,car
37186,7,car,8,0,5140,34,423,732,1699,1350,1276,618,car
37187,13,door,14,0,5140,16,1051,777,1353,1202,302,425,door
37188,13,bird,14,0,5142,15,1136,57,1230,160,94,103,bird
37189,7,person,8,0,562,27,24,247,37,288,13,41,person
37190,8,person,9,0,562,28,139,247,153,279,14,32,person
37191,9,bicycle,10,0,562,55,131,261,164,287,33,26,bicycle
37192,10,person,11,0,562,18,75,263,89,282,14,19,person
37193,12,person,13,0,562,15,85,231,93,252,8,21,person
37194,13,person,14,0,562,15,92,236,98,252,6,16,person
37195,14,person,15,0,562,18,73,229,82,252,9,23,person
37196,15,person,16,0,562,23,56,229,65,254,9,25,person
37197,16,person,17,0,562,18,46,235,54,254,8,19,person
37198,3,car,4,0,5216,16,123,254,162,269,39,15,car
37199,5,window,6,0,93,20,346,312,388,441,42,129,window
37200,6,window,7,0,93,20,201,320,244,446,43,126,window
37201,9,person,10,0,93,15,264,686,284,737,20,51,person
37202,10,person,11,1,93,16,191,696,217,738,26,42,person
37203,11,person,12,1,93,36,288,659,407,800,119,141,person
37204,12,person,13,1,93,28,406,640,533,800,127,160,person
37205,14,person,15,1,93,19,195,702,249,788,54,86,person
37206,15,person,16,1,93,21,193,711,308,800,115,89,person
37207,16,person,17,1,93,22,148,701,194,800,46,99,person
37208,17,person,18,1,93,21,58,709,161,800,103,91,person
37209,18,person,19,1,93,20,0,674,44,800,44,126,person
37210,13,door,14,0,563,16,1761,1160,1796,1252,35,92,door
37211,0,person,1,0,5225,27,523,767,710,1071,187,304,person
37212,15,pot,16,0,5242,17,94,541,140,581,46,40,potted plant
37213,21,person,22,0,5242,19,457,518,482,601,25,83,person
37214,0,person,1,1,5245,25,404,536,557,767,153,231,person
37215,11,person,9,0,5245,28,266,608,285,669,19,61,person
37216,12,person,10,1,5245,16,123,607,133,636,10,29,person
37217,13,person,11,1,5245,18,140,606,151,635,11,29,person
37218,14,person,12,1,5245,15,147,608,157,636,10,28,person
37219,15,person,13,1,5245,15,167,604,179,636,12,32,person
37220,1,person,2,0,5249,31,547,597,785,1095,238,498,person
37221,11,person,12,1,5249,66,848,595,1060,1083,212,488,person
37222,12,person,13,1,5249,61,1044,625,1216,1073,172,448,person
37223,25,chair,26,0,5249,19,1314,788,1366,867,52,79,chair
37224,26,chair,27,0,5249,21,1255,792,1299,858,44,66,chair
37225,27,person,28,0,5249,32,1207,738,1246,849,39,111,person
37226,6,person,6,0,5252,46,787,545,875,853,88,308,person
37227,7,person,7,0,5252,58,852,516,954,852,102,336,person
37228,13,person,14,0,5258,15,277,943,306,993,29,50,person
37229,14,person,15,0,5258,17,304,941,330,994,26,53,person
37230,15,person,16,0,5258,16,329,923,352,990,23,67,person
37231,17,person,18,0,5258,22,394,914,425,990,31,76,person
37232,18,person,19,0,5258,18,427,912,449,991,22,79,person
37233,19,person,20,1,5258,16,445,914,464,989,19,75,person
37234,20,person,21,0,5258,21,476,911,508,991,32,80,person
37235,21,person,22,0,5258,21,513,915,542,989,29,74,person
37236,22,person,23,0,5258,18,537,912,569,988,32,76,person
37237,23,person,24,0,5258,20,590,917,614,988,24,71,person
37238,24,person,25,0,5258,19,657,920,675,987,18,67,person
37239,25,person,26,0,5258,19,617,914,636,988,19,74,person
37240,52,person,53,0,5258,16,902,939,915,980,13,41,person
37241,54,person,55,0,5258,17,861,938,881,982,20,44,person
37242,55,person,56,0,5258,16,832,947,856,984,24,37,person
37243,72,person,73,0,5258,17,1047,914,1062,977,15,63,person
37244,0,person,1,0,5262,23,1688,1335,2004,1647,316,312,person
37245,44,car,42,1,5262,15,1956,1421,2029,1514,73,93,car
37246,25,person,18,1,5263,17,319,603,478,745,159,142,person
37247,26,person,19,0,5263,15,275,483,389,627,114,144,person
37248,27,person,20,1,5263,35,604,561,736,661,132,100,person
37249,28,person,21,1,5263,34,580,568,655,666,75,98,person
37250,29,person,22,1,5263,30,514,598,614,688,100,90,person
37251,30,person,23,0,5263,41,760,467,838,603,78,136,person
37252,31,person,24,0,5263,35,736,413,784,532,48,119,person
37253,32,person,25,0,5263,38,727,340,775,436,48,96,person
37254,33,person,26,0,5263,26,779,371,814,496,35,125,person
37255,34,person,27,0,5263,36,838,422,889,546,51,124,person
37256,9,person,10,0,5264,18,22,227,29,254,7,27,person
37257,10,person,11,0,5264,19,8,230,14,254,6,24,person
37258,6,door,7,0,5267,42,647,852,871,1187,224,335,door
37259,7,door,8,0,5267,45,861,842,1108,1190,247,348,door
37260,1,bench,1,0,5268,16,0,1134,181,1332,181,198,bench
37261,24,person,24,1,5268,42,562,997,624,1285,62,288,person
37262,25,person,25,0,5268,37,515,1004,597,1301,82,297,person
37263,27,person,27,0,5268,20,1175,973,1216,1152,41,179,person
37264,28,person,28,0,5268,17,983,1013,1024,1095,41,82,person
37265,0,motorbike,1,0,5269,46,159,987,839,1421,680,434,motorcycle
37266,1,person,2,1,5269,19,366,878,567,1175,201,297,person
37267,6,car,7,0,5272,38,627,905,820,973,193,68,car
37268,7,car,8,0,5272,25,1153,901,1344,979,191,78,car
37269,8,car,9,1,5272,19,1280,902,1421,973,141,71,car
37270,9,car,10,1,5272,21,1370,901,1507,971,137,70,car
37271,10,person,11,0,5272,18,1561,875,1594,947,33,72,person
37272,14,car,15,1,5274,20,0,1291,813,1534,813,243,car
37273,27,person,28,0,5276,18,807,691,823,721,16,30,person
37274,0,person,1,0,5278,35,1468,1014,1833,1750,365,736,person
37275,1,car,2,1,5278,36,1382,1201,2108,1750,726,549,car
37276,0,car,1,0,23049,33,728,567,926,722,198,155,car
37277,16,car,17,1,23049,30,824,545,956,595,132,50,car
37278,24,person,25,0,23049,22,557,544,576,590,19,46,person
37279,25,person,26,0,23049,28,689,540,723,625,34,85,person
37280,28,bench,29,0,23049,18,892,582,935,626,43,44,bench
37281,29,bench,30,0,23049,30,933,604,1000,668,67,64,bench
37282,12,person,13,1,23050,19,206,520,219,562,13,42,person
37283,13,person,14,0,23050,17,471,527,477,553,6,26,person
37284,14,person,15,0,23050,18,920,546,926,567,6,21,person
37285,15,person,16,0,23050,19,949,547,956,570,7,23,person
37286,9,person,10,0,23051,15,12,622,19,641,7,19,person
37287,0,person,1,1,23055,83,67,177,628,683,561,506,person
37288,7,window,8,0,5310,16,98,106,143,143,45,37,window
37289,4,car,5,0,5312,16,84,280,122,296,38,16,car
37290,5,car,6,0,5312,23,22,276,78,299,56,23,car
37291,5,person,6,1,5313,23,33,318,55,334,22,16,person
37292,7,person,8,1,5317,23,128,398,213,568,85,170,person
37293,8,person,9,1,5317,24,197,363,275,570,78,207,person
37294,9,person,10,1,5317,16,249,372,295,486,46,114,person
37295,10,person,11,1,5317,20,303,422,382,570,79,148,person
37296,11,person,11,0,5321,29,204,1102,336,1354,132,252,person
37297,6,person,7,1,97,44,206,73,311,234,105,161,person
37298,7,chair,8,0,97,21,11,136,46,175,35,39,chair
37299,8,person,9,1,98,60,133,176,526,480,393,304,person
37300,10,person,11,0,99,49,136,204,177,364,41,160,person
37301,13,person,14,1,100,68,305,75,516,412,211,337,person
37302,0,person,1,1,5367,24,103,135,147,200,44,65,person
37303,17,car,18,1,5370,17,2,680,200,846,198,166,car
37304,18,car,19,1,5370,15,1191,655,1421,753,230,98,car
37305,20,car,21,0,5370,29,969,720,1449,885,480,165,car
37306,17,car,18,0,5371,27,1878,825,2174,922,296,97,car
37307,4,car,5,0,23070,76,414,332,1016,570,602,238,car
37308,6,person,7,0,23071,122,88,160,585,1023,497,863,person
37309,7,person,8,1,23071,45,315,414,515,748,200,334,person
37310,13,table,14,0,23075,24,814,586,882,648,68,62,dining table
37311,16,chair,17,0,23075,23,677,613,725,664,48,51,chair
37312,17,sofa,18,0,23075,49,556,566,662,646,106,80,couch
37313,18,person,19,1,23075,24,567,568,616,615,49,47,person
37314,19,chair,20,0,23075,23,563,613,602,659,39,46,chair
37315,12,door,13,0,5441,19,832,1117,1111,1433,279,316,door
37316,3,person,4,1,5447,17,0,34,26,76,26,42,person
37317,2,person,3,1,5448,19,0,26,73,213,73,187,person
37318,3,person,4,1,5448,18,290,0,385,107,95,107,person
37319,7,bird,6,0,5455,18,173,220,231,274,58,54,bird
37320,10,bird,9,0,5455,21,39,269,142,374,103,105,bird
37321,15,bird,14,0,5455,28,273,328,388,442,115,114,bird
37322,16,bird,15,0,5455,15,367,361,402,418,35,57,bird
37323,19,bird,18,0,5455,48,234,292,342,369,108,77,bird
37324,20,bird,19,0,5455,27,486,421,513,468,27,47,bird
37325,21,bird,20,0,5455,28,180,295,211,344,31,49,bird
37326,22,bird,21,0,5455,26,383,295,401,350,18,55,bird
37327,23,bird,22,0,5455,30,470,177,502,236,32,59,bird
37328,9,bird,10,0,5456,21,166,217,211,275,45,58,bird
37329,10,bird,11,0,5456,36,482,245,553,462,71,217,bird
37330,11,bird,12,0,5456,23,584,317,699,440,115,123,bird
37331,13,bird,14,0,5456,19,239,200,266,234,27,34,bird
37332,14,bird,15,0,5456,16,216,194,236,233,20,39,bird
37333,15,bird,16,0,5456,15,26,204,59,238,33,34,bird
37334,0,bowl,1,0,5459,16,147,116,211,160,64,44,bowl
37335,1,pot,2,0,5459,22,18,28,59,86,41,58,potted plant
37336,6,person,7,1,5459,64,168,0,299,219,131,219,person
37337,8,sheep,9,0,5461,34,394,913,648,1173,254,260,sheep
37338,9,sheep,10,0,5461,33,663,939,894,1198,231,259,sheep
37339,10,sheep,11,0,5461,23,881,913,1060,1186,179,273,sheep
37340,4,window,5,0,564,20,108,165,125,182,17,17,window
37341,14,person,15,0,5567,17,306,449,327,482,21,33,person
37342,15,person,16,0,5567,19,285,444,313,477,28,33,person
37343,16,window,17,0,5574,16,101,71,120,106,19,35,window
37344,10,person,10,1,24900,39,397,829,503,1024,106,195,person
37345,11,person,11,1,24900,24,554,873,646,1022,92,149,person
37346,12,person,12,1,24900,29,626,861,718,1022,92,161,person
37347,13,person,13,1,24900,16,718,878,767,1024,49,146,person
37348,14,person,14,0,24900,31,361,741,388,819,27,78,person
37349,15,person,15,0,24900,23,340,734,364,813,24,79,person
37350,16,person,16,0,24900,30,290,740,318,810,28,70,person
37351,17,person,17,0,24900,25,258,739,286,831,28,92,person
37352,18,person,18,0,24900,30,228,711,261,807,33,96,person
37353,19,person,19,0,24900,34,203,720,238,802,35,82,person
37354,20,person,20,0,24900,17,290,688,304,714,14,26,person
37355,21,person,21,0,24900,16,412,716,422,747,10,31,person
37356,22,person,22,1,24900,30,463,757,504,866,41,109,person
37357,23,person,23,0,24900,47,495,767,532,872,37,105,person
37358,24,person,24,0,24900,36,526,768,557,869,31,101,person
37359,25,person,25,0,24900,48,556,774,590,877,34,103,person
37360,26,person,26,0,24900,46,578,782,614,883,36,101,person
37361,27,person,27,1,24900,37,601,766,630,875,29,109,person
37362,28,person,28,1,24900,32,617,784,643,875,26,91,person
37363,29,backpack,29,0,24900,16,470,771,495,804,25,33,backpack
37364,31,person,31,1,24900,30,641,783,665,870,24,87,person
37365,32,person,32,1,24900,16,650,771,665,826,15,55,person
37366,33,person,33,1,24900,37,679,784,721,898,42,114,person
37367,34,person,34,0,24900,38,708,790,738,891,30,101,person
37368,36,person,36,1,24900,22,549,750,574,776,25,26,person
37369,43,table,43,0,24900,16,1,800,49,843,48,43,dining table
37370,44,chair,44,0,24900,22,3,815,47,867,44,52,chair
37371,45,person,45,0,24900,20,462,706,472,734,10,28,person
37372,46,person,46,0,24900,19,456,706,463,732,7,26,person
37373,47,person,47,0,24900,18,227,667,237,692,10,25,person
37374,48,person,48,0,24900,19,220,666,230,691,10,25,person
37375,49,person,49,0,24900,15,266,640,273,657,7,17,person
37376,50,person,50,0,24900,38,160,693,180,749,20,56,person
37377,51,person,51,1,24900,17,139,692,155,721,16,29,person
37378,52,person,52,0,24900,26,184,681,195,712,11,31,person
37379,53,person,53,0,24900,33,118,673,131,708,13,35,person
37380,56,person,56,0,24900,15,191,659,199,680,8,21,person
37381,58,person,58,0,24900,17,153,677,161,708,8,31,person
37382,60,person,60,0,24900,18,137,625,146,644,9,19,person
37383,62,person,62,1,24900,16,97,664,108,685,11,21,person
37384,64,person,64,1,24900,16,67,652,78,676,11,24,person
37385,70,person,70,1,24900,15,18,643,28,659,10,16,person
37386,71,person,71,0,24900,19,12,609,20,629,8,20,person
37387,94,clock,94,0,24900,16,648,436,687,477,39,41,clock
37388,96,person,96,0,24900,16,245,631,254,639,9,8,person
37389,5,door,6,0,24902,41,483,470,684,655,201,185,door
37390,18,person,18,0,24904,31,231,511,267,608,36,97,person
37391,11,person,12,0,24907,30,397,647,429,754,32,107,person
37392,12,person,13,0,24907,31,649,641,677,730,28,89,person
37393,13,person,14,0,24907,33,680,631,720,731,40,100,person
37394,14,table,15,0,24907,18,762,663,831,714,69,51,dining table
37395,15,person,16,0,24907,27,887,612,914,703,27,91,person
37396,16,person,17,0,24907,25,859,634,892,700,33,66,person
37397,17,person,18,1,24907,23,809,621,839,697,30,76,person
37398,18,person,19,0,24907,29,297,644,333,767,36,123,person
37399,19,person,20,0,24907,38,252,656,301,767,49,111,person
37400,20,person,21,0,24907,29,369,663,395,733,26,70,person
37401,21,clock,22,0,24907,16,734,373,777,416,43,43,clock
37402,22,person,23,1,24907,27,12,656,81,767,69,111,person
37403,23,person,24,0,24907,25,133,650,173,767,40,117,person
37404,24,person,25,0,24907,24,103,657,138,767,35,110,person
37405,25,person,26,0,24907,28,228,678,255,763,27,85,person
37406,26,person,27,0,24907,27,176,686,212,764,36,78,person
37407,28,person,29,0,24907,18,495,654,510,704,15,50,person
37408,7,bus,8,0,24908,16,315,816,419,854,104,38,bus
37409,20,car,21,1,24908,43,901,813,967,841,66,28,car
37410,24,person,25,0,24908,22,910,815,927,860,17,45,person
37411,25,person,26,0,24908,23,926,814,941,861,15,47,person
37412,2,bird,3,0,24912,19,770,114,783,136,13,22,bird
37413,3,bird,4,0,24912,19,716,46,736,67,20,21,bird
37414,5,car,6,0,24914,22,0,760,179,937,179,177,car
37415,6,car,7,1,24914,27,97,712,238,861,141,149,car
37416,7,car,8,1,24914,22,213,718,324,812,111,94,car
37417,8,car,9,1,24914,31,265,722,422,848,157,126,car
37418,9,car,10,0,24914,29,289,761,481,932,192,171,car
37419,10,car,11,1,24914,25,456,741,588,868,132,127,car
37420,11,car,12,1,24914,18,626,720,767,818,141,98,car
37421,12,car,13,0,24914,25,520,753,767,921,247,168,car
37422,4,car,5,1,24915,18,942,1855,1195,2048,253,193,car
37423,6,car,7,0,24915,19,191,1863,388,2013,197,150,car
37424,7,car,8,1,24915,17,2,1861,193,2019,191,158,car
37425,9,person,10,0,24918,22,26,867,58,941,32,74,person
37426,4,window,5,0,5698,15,159,191,313,429,154,238,window
37427,5,window,6,0,5698,15,382,221,472,425,90,204,window
37428,9,car,10,0,6189,19,2000,979,2104,1056,104,77,car
37429,17,person,18,0,6189,54,655,963,803,1238,148,275,person
37430,8,bicycle,9,0,6192,38,65,263,111,304,46,41,bicycle
37431,9,window,10,0,6194,20,109,37,206,79,97,42,window
37432,7,person,8,1,6197,15,79,466,98,497,19,31,person
37433,8,person,9,1,6197,16,99,455,112,481,13,26,person
37434,9,person,10,0,6197,36,114,433,149,533,35,100,person
37435,11,person,12,0,6201,15,294,259,306,290,12,31,person
37436,14,car,15,0,6205,15,363,718,399,743,36,25,car
37437,2,airplane,3,0,20563,16,51,329,256,400,205,71,airplane
37438,2,car,3,1,6218,15,0,852,257,1052,257,200,car
37439,21,person,22,1,6218,18,557,816,598,902,41,86,person
37440,3,truck,4,1,6220,38,53,911,683,1375,630,464,truck
37441,6,person,7,0,6220,21,938,1011,1011,1278,73,267,person
37442,8,car,9,0,6220,33,1092,1054,1802,1338,710,284,car
37443,9,car,10,1,6220,28,1689,1044,2195,1324,506,280,car
37444,3,car,4,0,6221,31,506,894,1022,1268,516,374,car
37445,4,car,5,1,6221,21,1822,888,2197,1172,375,284,car
37446,10,person,11,0,6221,27,1675,884,1809,1153,134,269,person
37447,11,person,12,0,6223,38,530,471,603,689,73,218,person
37448,3,bench,4,0,6225,20,822,1031,991,1185,169,154,bench
37449,2,car,3,1,6227,16,2,309,121,491,119,182,car
37450,3,truck,4,0,6227,38,176,288,400,486,224,198,truck
37451,4,car,5,1,6227,24,840,303,1023,461,183,158,car
37452,7,person,8,0,6228,27,1102,524,1161,755,59,231,person
37453,10,bicycle,11,0,6228,39,214,608,334,789,120,181,bicycle
37454,11,bicycle,12,0,6228,29,341,597,410,781,69,184,bicycle
37455,12,bicycle,13,1,6228,26,753,578,883,727,130,149,bicycle
37456,13,bicycle,14,1,6228,33,834,578,1003,736,169,158,bicycle
37457,16,bicycle,17,0,6228,34,986,593,1040,720,54,127,bicycle
37458,7,bench,8,0,6371,20,730,1131,956,1342,226,211,bench
37459,9,person,10,0,23189,31,130,458,146,498,16,40,person
37460,10,person,11,0,23189,23,150,456,165,499,15,43,person
37461,11,person,12,0,23189,21,207,457,220,499,13,42,person
37462,12,person,13,0,23189,30,221,459,244,500,23,41,person
37463,2,bench,3,0,23191,18,130,761,272,843,142,82,bench
37464,3,bench,4,0,23191,22,328,755,469,830,141,75,bench
37465,4,person,5,0,23191,39,750,659,837,827,87,168,person
37466,5,person,6,1,23191,19,737,674,774,756,37,82,person
37467,6,person,7,0,23191,55,667,600,784,838,117,238,person
37468,7,person,8,1,23191,21,638,704,678,832,40,128,person
37469,8,person,9,0,23191,53,573,603,643,850,70,247,person
37470,9,person,10,1,23191,23,520,745,578,836,58,91,person
37471,10,person,11,0,23191,55,478,593,552,856,74,263,person
37472,11,person,12,1,23191,15,541,704,569,763,28,59,person
37473,12,person,13,1,23191,55,384,696,496,839,112,143,person
37474,14,bench,15,1,23191,16,791,726,854,820,63,94,bench
37475,22,bench,23,0,23191,16,2,778,81,851,79,73,bench
37476,15,person,16,0,23192,18,2,386,21,440,19,54,person
37477,24,vase,25,0,6385,17,504,521,523,569,19,48,vase
37478,28,car,26,0,6390,25,2138,1290,2200,1323,62,33,car
37479,29,car,27,0,6390,18,1972,1290,2088,1325,116,35,car
37480,37,window,35,0,6390,19,1343,636,1461,917,118,281,window
37481,44,person,42,1,6390,15,1394,1160,1466,1245,72,85,person
37482,6,car,7,0,6393,24,494,1277,798,1464,304,187,car
37483,0,car,1,0,6396,48,295,593,592,680,297,87,car
37484,75,door,76,0,6396,16,377,601,447,663,70,62,door
37485,78,door,79,0,6396,16,425,601,493,665,68,64,door
37486,3,car,4,0,6397,17,634,463,677,482,43,19,car
37487,32,person,33,0,6399,32,1037,1109,1086,1251,49,142,person
37488,33,person,34,0,6399,27,1263,1172,1311,1305,48,133,person
37489,34,person,35,0,6399,29,1371,1172,1416,1331,45,159,person
37490,35,person,36,0,6399,19,1646,1187,1674,1290,28,103,person
37491,36,person,37,0,6399,24,1823,1213,1855,1299,32,86,person
37492,37,person,38,0,6399,34,1964,1197,2022,1349,58,152,person
37493,38,person,39,0,6399,30,2034,1214,2083,1355,49,141,person
37494,39,person,40,0,6399,36,2110,1227,2180,1396,70,169,person
37495,40,person,41,0,6399,24,2075,1210,2113,1326,38,116,person
37496,37,person,38,0,6400,18,512,307,524,335,12,28,person
37497,3,person,4,0,6403,17,97,412,126,479,29,67,person
37498,4,person,5,0,6403,18,38,414,79,480,41,66,person
37499,6,person,7,1,6403,16,835,378,859,460,24,82,person
37500,2,clock,3,0,23194,17,380,410,453,478,73,68,clock
37501,3,car,4,1,23195,28,0,404,88,565,88,161,car
37502,4,car,5,1,23195,58,117,404,280,555,163,151,car
37503,5,car,6,1,23195,55,405,398,672,498,267,100,car
37504,6,car,7,1,23195,17,553,399,673,457,120,58,car
37505,7,car,8,1,23195,21,567,395,683,455,116,60,car
37506,9,car,10,1,23195,20,732,399,766,446,34,47,car
37507,11,car,12,1,23195,19,760,396,800,471,40,75,car
37508,13,person,14,0,23195,29,674,378,703,483,29,105,person
37509,14,person,15,0,23195,54,695,368,745,503,50,135,person
37510,15,person,16,1,23195,15,637,376,649,398,12,22,person
37511,16,person,17,1,23195,31,447,415,491,587,44,172,person
37512,17,person,18,0,23195,49,485,385,546,599,61,214,person
37513,18,person,19,0,23195,52,353,381,414,547,61,166,person
37514,19,person,20,1,23195,39,151,399,277,600,126,201,person
37515,8,traffic light,9,0,23196,35,814,308,881,553,67,245,traffic light
37516,29,person,30,0,23196,38,52,509,84,575,32,66,person
37517,30,bicycle,31,0,23196,36,57,546,87,593,30,47,bicycle
37518,31,person,32,0,23196,28,256,522,287,569,31,47,person
37519,33,person,34,0,23196,27,479,516,496,575,17,59,person
37520,35,person,36,0,23196,21,726,522,747,571,21,49,person
37521,36,person,37,1,23196,22,721,519,731,571,10,52,person
37522,37,person,38,0,23196,27,860,522,881,580,21,58,person
37523,38,car,39,0,23196,15,906,544,947,572,41,28,car
37524,8,person,8,0,23197,34,965,1258,1023,1420,58,162,person
37525,9,person,9,0,23197,32,1062,1269,1110,1418,48,149,person
37526,10,person,10,0,23197,18,1165,1297,1221,1388,56,91,person
37527,11,person,11,0,23197,25,535,1273,613,1422,78,149,person
37528,13,person,13,0,23197,24,243,1276,300,1423,57,147,person
37529,15,person,15,0,23197,19,65,1266,106,1423,41,157,person
37530,16,person,16,0,23197,25,22,1277,75,1424,53,147,person
37531,17,person,17,0,23197,25,163,1276,245,1424,82,148,person
37532,7,car,8,0,23200,20,939,592,1024,680,85,88,car
37533,4,person,5,1,23201,19,385,461,409,521,24,60,person
37534,8,car,9,0,23201,38,394,463,626,550,232,87,car
37535,39,person,40,0,6422,21,252,270,264,318,12,48,person
37536,40,person,41,0,6422,18,239,265,251,320,12,55,person
37537,41,person,42,1,6422,15,377,266,393,319,16,53,person
37538,42,person,43,0,6422,19,370,269,388,318,18,49,person
37539,2,umbrella,3,1,6427,15,1843,1439,2187,1578,344,139,umbrella
37540,12,window,13,0,6427,15,625,1234,850,1489,225,255,window
37541,3,car,4,0,6431,26,71,140,148,184,77,44,car
37542,9,door,10,0,23204,41,372,394,699,681,327,287,door
37543,11,table,12,0,23205,17,433,656,531,767,98,111,dining table
37544,12,chair,13,1,23205,26,426,646,481,743,55,97,chair
37545,13,chair,14,0,23205,31,460,675,544,775,84,100,chair
37546,15,chair,16,0,23205,23,314,634,383,721,69,87,chair
37547,17,table,18,1,23205,17,491,582,607,683,116,101,dining table
37548,18,chair,19,1,23205,21,483,593,534,668,51,75,chair
37549,20,chair,21,1,23205,25,621,618,674,718,53,100,chair
37550,22,chair,23,0,23205,27,601,699,680,813,79,114,chair
37551,23,table,24,1,23205,19,382,555,479,643,97,88,dining table
37552,24,chair,25,1,23205,15,455,567,489,637,34,70,chair
37553,27,chair,28,0,23205,23,378,554,415,621,37,67,chair
37554,29,chair,30,1,23205,21,37,615,104,713,67,98,chair
37555,31,umbrella,32,0,23205,44,2,465,204,764,202,299,umbrella
37556,11,table,12,0,23207,20,334,565,398,611,64,46,dining table
37557,12,chair,13,0,23207,23,311,559,345,616,34,57,chair
37558,13,chair,14,0,23207,20,387,557,433,611,46,54,chair
37559,14,bench,15,0,23207,19,283,550,332,590,49,40,bench
37560,16,chair,17,1,23207,15,383,537,396,557,13,20,chair
37561,17,table,18,0,23207,22,136,571,194,589,58,18,dining table
37562,18,chair,19,0,23207,20,79,565,114,617,35,52,chair
37563,19,chair,20,0,23207,29,112,568,160,619,48,51,chair
37564,21,chair,22,1,23207,21,190,561,218,609,28,48,chair
37565,27,table,28,0,23207,19,502,537,536,563,34,26,dining table
37566,28,chair,29,0,23207,19,486,535,513,566,27,31,chair
37567,29,chair,30,1,23207,23,535,532,556,564,21,32,chair
37568,30,chair,31,0,23207,30,551,540,584,579,33,39,chair
37569,32,chair,33,0,23207,25,601,538,634,578,33,40,chair
37570,33,chair,34,1,23207,15,633,535,649,573,16,38,chair
37571,34,person,35,1,23207,18,566,523,586,549,20,26,person
37572,35,person,36,1,23207,19,572,508,586,540,14,32,person
37573,36,person,37,1,23207,22,626,499,643,546,17,47,person
37574,38,person,39,0,23207,42,852,498,877,571,25,73,person
37575,39,chair,40,0,23207,36,935,552,1005,622,70,70,chair
37576,42,person,43,0,23207,25,197,499,210,535,13,36,person
37577,51,chair,52,0,23207,17,437,516,454,535,17,19,chair
37578,52,chair,53,0,23207,15,416,517,431,535,15,18,chair
37579,2,person,3,1,23208,33,605,403,725,529,120,126,person
37580,3,person,4,1,23208,21,690,400,736,499,46,99,person
37581,4,person,5,1,23208,19,671,403,699,467,28,64,person
37582,6,person,7,1,23208,27,346,376,488,529,142,153,person
37583,7,person,8,1,23208,40,0,329,142,530,142,201,person
37584,8,person,9,1,23208,32,184,399,246,530,62,131,person
37585,9,person,10,1,23208,28,234,384,268,530,34,146,person
37586,10,person,11,1,23208,32,113,390,152,507,39,117,person
37587,11,backpack,12,0,23208,18,133,399,164,446,31,47,backpack
37588,12,person,13,1,23208,35,151,388,182,475,31,87,person
37589,19,person,20,1,23208,22,362,393,392,460,30,67,person
37590,23,person,24,1,23208,15,614,189,636,212,22,23,person
37591,24,person,25,1,23208,18,734,129,769,159,35,30,person
37592,25,person,26,1,23208,15,571,211,594,233,23,22,person
37593,27,person,28,1,23208,16,606,404,630,461,24,57,person
37594,28,person,29,1,23208,19,606,390,629,431,23,41,person
37595,9,person,10,0,23211,41,597,556,638,685,41,129,person
37596,10,person,11,0,23211,27,537,561,561,635,24,74,person
37597,11,person,12,0,23211,23,440,592,475,635,35,43,person
37598,12,person,13,0,23211,34,406,550,438,648,32,98,person
37599,13,person,14,1,23211,26,394,564,413,643,19,79,person
37600,14,person,15,0,23211,30,360,563,390,645,30,82,person
37601,15,person,16,0,23211,24,342,564,360,614,18,50,person
37602,16,person,17,0,23211,26,324,564,338,613,14,49,person
37603,17,person,18,0,23211,24,309,564,323,615,14,51,person
37604,4,person,5,0,23212,36,424,401,472,617,48,216,person
37605,5,person,6,0,23212,34,316,425,365,554,49,129,person
37606,6,person,7,0,23212,31,247,412,298,554,51,142,person
37607,9,person,10,0,23212,31,164,423,188,502,24,79,person
37608,13,person,14,0,23212,21,558,436,587,480,29,44,person
37609,14,person,15,0,23212,16,542,441,560,475,18,34,person
37610,2,car,3,0,6449,17,642,375,697,409,55,34,car
37611,14,car,15,1,128,23,610,113,648,143,38,30,car
37612,15,car,16,0,128,21,565,114,599,142,34,28,car
37613,16,car,17,1,128,24,518,110,553,142,35,32,car
37614,22,car,23,1,128,28,329,113,385,143,56,30,car
37615,23,car,24,1,128,20,276,109,314,136,38,27,car
37616,25,car,26,0,128,15,51,105,64,114,13,9,car
37617,32,person,33,0,128,50,451,103,490,169,39,66,person
37618,33,bicycle,34,0,128,60,438,133,498,175,60,42,bicycle
37619,34,person,35,0,128,43,302,103,338,166,36,63,person
37620,35,bicycle,36,0,128,56,293,137,337,184,44,47,bicycle
37621,38,traffic light,39,0,128,30,171,17,251,134,80,117,traffic light
37622,5,car,6,1,129,42,0,76,328,308,328,232,car
37623,11,person,12,0,129,53,373,99,446,314,73,215,person
37624,12,umbrella,13,0,129,20,350,74,481,138,131,64,umbrella
37625,6,car,7,1,130,16,600,150,661,189,61,39,car
37626,10,traffic light,11,0,130,71,57,1,616,150,559,149,traffic light
37627,14,car,15,1,130,22,6,144,53,175,47,31,car
37628,16,car,17,1,130,21,1,153,38,181,37,28,car
37629,17,car,18,1,130,27,77,141,124,174,47,33,car
37630,28,car,29,0,130,18,256,139,283,155,27,16,car
37631,29,car,30,0,130,22,214,144,240,163,26,19,car
37632,30,car,31,1,130,16,240,137,261,155,21,18,car
37633,31,car,32,1,130,23,115,143,186,193,71,50,car
37634,33,car,34,0,130,35,244,154,299,189,55,35,car
37635,34,car,35,0,130,16,337,139,363,158,26,19,car
37636,38,truck,39,0,130,32,364,115,423,179,59,64,truck
37637,40,car,41,0,130,47,0,186,331,366,331,180,car
37638,44,door,45,0,130,15,154,197,272,319,118,122,door
37639,49,door,50,0,130,20,80,197,188,328,108,131,door
37640,56,person,57,0,130,39,427,152,455,232,28,80,person
37641,8,car,9,1,131,18,274,198,407,235,133,37,car
37642,9,car,10,1,131,16,373,190,484,233,111,43,car
37643,18,traffic light,19,0,131,32,400,75,445,297,45,222,traffic light
37644,24,car,25,0,131,32,601,203,704,249,103,46,car
37645,30,car,31,1,131,16,776,211,800,253,24,42,car
37646,39,car,40,1,131,27,786,197,832,217,46,20,car
37647,40,car,41,1,131,16,815,212,829,248,14,36,car
37648,41,person,42,0,131,48,753,179,781,268,28,89,person
37649,43,person,44,0,131,44,797,191,821,261,24,70,person
37650,44,person,45,1,131,36,824,195,843,270,19,75,person
37651,45,person,46,1,131,21,838,183,852,286,14,103,person
37652,46,person,47,0,131,35,706,200,725,245,19,45,person
37653,51,person,52,1,131,112,61,151,303,480,242,329,person
37654,58,person,59,0,131,60,498,172,533,294,35,122,person
37655,66,traffic light,67,0,131,25,624,104,658,262,34,158,traffic light
37656,19,truck,20,1,575,34,1,358,309,687,308,329,truck
37657,20,car,21,1,575,33,1,570,278,805,277,235,car
37658,23,door,24,0,575,17,102,581,220,740,118,159,door
37659,26,door,27,0,575,18,50,582,168,753,118,171,door
37660,34,car,35,0,575,42,318,542,512,656,194,114,car
37661,42,door,43,0,575,19,448,548,486,626,38,78,door
37662,45,door,46,0,575,17,462,548,497,625,35,77,door
37663,50,car,51,1,575,17,433,527,505,576,72,49,car
37664,68,truck,69,1,575,24,667,504,714,565,47,61,truck
37665,69,car,70,1,575,15,726,521,747,554,21,33,car
37666,70,truck,71,1,575,23,746,483,817,566,71,83,truck
37667,74,truck,75,0,575,20,824,520,870,560,46,40,truck
37668,75,umbrella,76,0,575,24,771,528,861,566,90,38,umbrella
37669,76,truck,77,1,575,33,866,475,947,555,81,80,truck
37670,79,bus,80,1,575,28,1281,2,2195,1448,914,1446,bus
37671,83,traffic light,84,0,575,40,1244,64,1351,389,107,325,traffic light
37672,84,traffic light,85,0,575,72,585,1,1310,176,725,175,traffic light
37673,87,traffic light,88,0,575,19,436,431,598,524,162,93,traffic light
37674,97,person,98,1,575,36,1030,494,1095,654,65,160,person
37675,98,person,99,1,575,19,997,505,1043,588,46,83,person
37676,100,person,101,1,575,49,943,475,1047,786,104,311,person
37677,105,person,106,0,575,133,787,478,1014,1046,227,568,person
37678,116,umbrella,117,0,575,43,969,695,1038,981,69,286,umbrella
37679,117,person,118,1,575,34,764,538,840,667,76,129,person
37680,118,umbrella,119,0,575,21,757,661,791,708,34,47,umbrella
37681,119,person,120,0,575,41,702,524,743,698,41,174,person
37682,121,person,122,0,575,51,623,531,679,656,56,125,person
37683,122,bicycle,123,0,575,39,631,587,673,671,42,84,bicycle
37684,127,flowerpot,128,0,575,16,1083,563,1132,599,49,36,potted plant
37685,5,fire hydrant,6,0,6517,19,326,516,397,644,71,128,fire hydrant
37686,9,person,10,1,6517,17,158,424,212,611,54,187,person
37687,19,car,20,0,6518,31,154,401,379,607,225,206,car
37688,20,car,21,1,6518,18,270,387,421,545,151,158,car
37689,3,traffic light,4,0,6519,65,1051,509,1375,1679,324,1170,traffic light
37690,5,person,6,0,6519,56,616,985,1104,1826,488,841,person
37691,7,person,8,0,6519,36,193,1038,337,1465,144,427,person
37692,8,person,9,0,6519,22,468,1141,579,1461,111,320,person
37693,10,person,11,1,6519,22,558,1067,648,1465,90,398,person
37694,5,traffic light,6,0,6521,77,665,26,994,1197,329,1171,traffic light
37695,16,person,17,0,6521,24,626,544,676,696,50,152,person
37696,17,person,18,0,6521,28,676,554,718,701,42,147,person
37697,18,person,19,1,6521,15,796,569,837,806,41,237,person
37698,21,person,22,0,6521,23,976,566,1021,730,45,164,person
37699,22,car,23,1,6521,15,1016,568,1123,659,107,91,car
37700,25,car,26,1,6521,18,1251,589,1384,673,133,84,car
37701,27,car,28,1,6521,17,1082,575,1299,697,217,122,car
37702,30,person,31,0,6521,48,1358,547,1566,1194,208,647,person
37703,31,backpack,32,0,6521,25,1392,632,1546,860,154,228,backpack
37704,33,traffic light,34,0,6521,45,1081,340,1200,792,119,452,traffic light
37705,5,traffic light,6,0,6522,60,113,46,216,320,103,274,traffic light
37706,6,traffic light,7,0,6522,62,412,60,514,315,102,255,traffic light
37707,7,traffic light,8,0,6522,32,500,2,586,376,86,374,traffic light
37708,10,traffic light,11,0,6522,28,183,123,232,300,49,177,traffic light
37709,11,person,12,0,6522,52,241,192,291,333,50,141,person
37710,12,person,13,0,6522,38,360,198,417,357,57,159,person
37711,2,car,3,1,6523,27,14,570,203,665,189,95,car
37712,3,car,4,1,6523,15,179,564,278,646,99,82,car
37713,5,person,6,0,6523,18,350,551,374,635,24,84,person
37714,10,person,11,0,6523,31,268,527,352,749,84,222,person
37715,6,car,7,0,6525,17,885,444,988,508,103,64,car
37716,13,person,14,0,6525,74,336,387,631,1270,295,883,person
37717,5,person,6,0,6526,22,318,226,346,301,28,75,person
37718,6,person,7,0,6526,44,367,110,455,371,88,261,person
37719,7,person,8,0,6528,36,170,47,189,137,19,90,person
37720,8,person,9,0,6528,67,128,54,180,184,52,130,person
37721,9,person,10,0,6528,61,76,93,131,180,55,87,person
37722,12,fire hydrant,13,0,6528,18,238,74,250,94,12,20,fire hydrant
37723,6,door,7,0,6529,25,638,240,739,424,101,184,door
37724,12,person,12,0,6529,20,528,382,572,455,44,73,person
37725,13,person,13,0,6529,18,362,338,416,408,54,70,person
37726,14,person,14,0,6529,16,328,335,372,427,44,92,person
37727,15,person,15,0,6529,17,281,331,305,448,24,117,person
37728,16,person,16,0,6529,61,760,327,957,991,197,664,person
37729,18,person,18,0,6529,88,411,392,945,1198,534,806,person
37730,2,car,3,1,23226,36,780,210,1024,390,244,180,car
37731,3,car,4,1,23226,105,379,189,927,439,548,250,car
37732,4,car,5,1,23226,36,297,210,494,364,197,154,car
37733,5,car,6,1,23226,24,158,253,307,333,149,80,car
37734,6,car,7,1,23226,19,87,250,141,319,54,69,car
37735,7,car,8,1,23226,18,123,260,185,326,62,66,car
37736,8,bus,9,1,23226,21,1,180,107,315,106,135,bus
37737,9,car,10,1,23226,16,0,245,79,358,79,113,car
37738,15,person,16,0,23226,107,581,188,735,680,154,492,person
37739,12,person,13,1,23228,77,422,296,604,835,182,539,person
37740,13,person,14,1,23228,60,152,285,354,468,202,183,person
37741,14,person,15,1,23228,88,154,372,317,712,163,340,person
37742,15,car,16,1,23228,26,343,247,507,343,164,96,car
37743,18,person,19,1,23228,79,192,552,358,905,166,353,person
37744,19,person,20,1,23228,101,296,350,524,909,228,559,person
37745,20,person,21,0,23228,98,294,525,520,965,226,440,person
37746,6,car,7,1,23229,18,890,80,977,149,87,69,car
37747,11,person,12,0,23229,44,464,71,539,273,75,202,person
37748,14,bus,15,0,23230,21,885,196,1000,387,115,191,bus
37749,15,car,16,1,23230,18,922,359,1023,594,101,235,car
37750,16,car,17,0,23230,41,683,349,959,564,276,215,car
37751,17,car,18,0,23230,63,422,306,734,516,312,210,car
37752,18,car,19,1,23230,27,382,320,485,456,103,136,car
37753,19,car,20,1,23230,26,628,284,779,371,151,87,car
37754,20,car,21,1,23230,26,337,312,432,415,95,103,car
37755,21,car,22,1,23230,16,233,303,307,413,74,110,car
37756,23,car,24,1,23230,18,123,288,179,372,56,84,car
37757,25,person,26,1,23230,32,125,329,179,564,54,235,person
37758,26,person,27,0,23230,66,288,337,389,671,101,334,person
37759,5,car,6,1,23231,20,1,267,124,345,123,78,car
37760,7,car,8,1,23231,26,164,258,318,356,154,98,car
37761,8,car,9,1,23231,67,395,253,696,478,301,225,car
37762,9,person,10,0,23231,31,860,211,911,345,51,134,person
37763,10,person,11,0,23231,116,25,204,228,770,203,566,person
37764,11,person,12,0,23231,80,469,141,644,745,175,604,person
37765,12,person,13,0,23231,67,662,173,812,672,150,499,person
37766,11,person,12,1,6570,15,367,176,390,220,23,44,person
37767,5,person,6,0,6571,18,397,237,419,308,22,71,person
37768,6,person,7,1,6571,25,368,238,394,308,26,70,person
37769,9,person,10,0,6576,28,446,949,622,1520,176,571,person
37770,10,person,11,0,6576,22,420,994,535,1289,115,295,person
37771,15,person,16,0,6577,33,711,685,768,865,57,180,person
37772,7,cow,8,1,6585,28,3,773,576,1647,573,874,cow
37773,8,cow,9,1,6585,30,63,624,1015,1640,952,1016,cow
37774,9,cow,10,1,6585,36,459,651,1197,1567,738,916,cow
37775,10,cow,11,1,6585,36,453,615,1471,1065,1018,450,cow
37776,11,cow,12,1,6585,34,1098,886,1594,1309,496,423,cow
37777,12,cow,13,1,6585,29,1372,691,1703,1194,331,503,cow
37778,13,cow,14,1,6585,24,1415,588,1776,866,361,278,cow
37779,14,cow,15,1,6585,20,1680,741,1928,1108,248,367,cow
37780,15,cow,16,1,6585,23,1772,619,1994,1074,222,455,cow
37781,17,cow,18,1,6585,17,1831,612,2077,830,246,218,cow
37782,18,cow,19,1,6585,15,2043,516,2189,708,146,192,cow
37783,5,cow,6,1,6586,28,413,328,622,521,209,193,cow
37784,8,cow,9,1,6586,19,529,333,622,582,93,249,cow
37785,11,person,12,0,6586,34,232,217,387,481,155,264,person
37786,12,person,13,0,6586,22,215,320,265,517,50,197,person
37787,5,person,6,0,6587,54,1539,147,2009,1082,470,935,person
37788,7,cow,8,1,6587,19,12,212,505,714,493,502,cow
37789,8,cow,9,1,6587,24,9,636,550,1294,541,658,cow
37790,9,cow,10,1,6587,24,359,308,804,771,445,463,cow
37791,10,cow,11,1,6587,20,624,260,956,729,332,469,cow
37792,11,cow,12,1,6587,20,574,729,930,1026,356,297,cow
37793,12,cow,13,1,6587,17,831,326,1145,667,314,341,cow
37794,13,cow,14,1,6587,19,864,633,1259,941,395,308,cow
37795,14,cow,15,1,6587,18,995,299,1312,595,317,296,cow
37796,16,cow,17,1,6587,16,1291,412,1480,771,189,359,cow
37797,17,cow,18,1,6587,16,1306,706,1545,912,239,206,cow
37798,18,cow,19,1,6587,19,1333,377,1551,726,218,349,cow
37799,3,cow,4,1,6588,25,236,221,721,289,485,68,cow
37800,7,cow,8,1,6588,15,0,214,106,354,106,140,cow
37801,8,cow,9,1,6588,59,77,195,671,697,594,502,cow
37802,9,cow,10,1,6588,64,0,337,452,1022,452,685,cow
37803,10,cow,11,1,6588,36,618,255,1181,426,563,171,cow
37804,11,cow,12,0,6588,126,491,339,1376,1188,885,849,cow
37805,5,cow,6,1,6589,63,15,60,173,209,158,149,cow
37806,6,cow,7,1,6589,27,109,59,245,139,136,80,cow
37807,9,person,10,0,132,75,303,169,349,242,46,73,person
37808,10,bicycle,11,0,132,99,292,192,347,257,55,65,bicycle
37809,6,person,7,1,133,32,405,226,442,300,37,74,person
37810,7,person,8,1,133,47,536,223,592,331,56,108,person
37811,8,person,9,1,133,71,651,226,728,365,77,139,person
37812,9,person,10,0,133,62,743,242,798,430,55,188,person
37813,10,car,11,0,133,118,660,176,946,330,286,154,car
37814,15,door,16,0,133,20,862,183,920,284,58,101,door
37815,24,car,24,0,133,90,120,280,601,454,481,174,car
37816,25,door,25,0,133,17,343,302,485,431,142,129,door
37817,12,car,13,1,23248,21,2,590,1024,768,1022,178,car
37818,25,car,26,0,23251,18,291,445,321,476,30,31,car
37819,36,car,37,1,6724,19,1769,752,2038,1001,269,249,car
37820,0,car,1,1,6725,24,2,174,225,240,223,66,car
37821,7,clock,8,0,6726,15,372,179,430,283,58,104,clock
37822,20,person,21,0,6726,33,939,400,994,564,55,164,person
37823,21,person,22,1,6726,16,692,385,727,470,35,85,person
37824,23,person,24,0,6726,37,793,382,873,550,80,168,person
37825,24,person,25,1,6726,39,843,373,898,558,55,185,person
37826,25,door,26,1,6726,15,720,352,807,538,87,186,door
37827,6,person,7,0,6727,38,277,909,432,1149,155,240,person
37828,10,chair,11,0,6727,22,487,992,630,1177,143,185,chair
37829,7,person,8,1,6728,20,774,893,923,1256,149,363,person
37830,9,chair,10,0,6728,16,436,1164,586,1432,150,268,chair
37831,10,chair,11,0,6728,17,635,1181,800,1445,165,264,chair
37832,3,car,4,1,6729,15,1178,1183,2194,1458,1016,275,car
37833,3,car,4,0,6730,30,1376,988,2196,1309,820,321,car
37834,6,car,7,1,6730,22,1984,961,2199,1089,215,128,car
37835,35,door,36,0,6730,16,1534,1017,1756,1238,222,221,door
37836,38,door,39,0,6730,17,1700,1019,1889,1256,189,237,door
37837,6,car,7,0,6732,51,926,883,1612,1216,686,333,car
37838,21,car,22,1,6732,15,2125,883,2199,990,74,107,car
37839,44,door,45,0,6732,30,1064,909,1186,1145,122,236,door
37840,45,door,46,0,6732,25,985,907,1131,1125,146,218,door
37841,49,window,50,0,6732,16,1230,902,1488,992,258,90,window
37842,6,car,7,0,6735,32,69,288,251,394,182,106,car
37843,7,car,8,1,6735,24,246,310,385,391,139,81,car
37844,8,car,9,1,6735,31,343,279,494,381,151,102,car
37845,9,car,10,1,6735,22,480,310,566,371,86,61,car
37846,10,car,11,1,6735,20,515,304,599,359,84,55,car
37847,9,umbrella,8,0,6736,15,227,104,299,166,72,62,umbrella
37848,15,umbrella,13,1,6736,31,0,98,93,221,93,123,umbrella
37849,16,umbrella,14,1,6736,32,57,121,144,202,87,81,umbrella
37850,20,chair,18,1,6736,17,48,189,76,218,28,29,chair
37851,23,chair,21,1,6736,16,90,194,135,225,45,31,chair
37852,24,table,22,1,6736,17,66,197,128,220,62,23,dining table
37853,29,person,27,1,6736,27,180,160,202,225,22,65,person
37854,4,person,5,1,24945,18,324,578,515,682,191,104,person
37855,5,person,6,1,24945,28,464,512,664,683,200,171,person
37856,6,person,7,1,24945,40,577,466,746,683,169,217,person
37857,7,person,8,1,24945,39,377,439,530,608,153,169,person
37858,8,person,9,1,24945,38,546,417,618,570,72,153,person
37859,10,person,11,1,24945,16,558,384,584,430,26,46,person
37860,11,person,12,1,24945,26,504,417,553,517,49,100,person
37861,12,person,13,1,24945,30,529,392,575,534,46,142,person
37862,13,person,14,1,24945,25,412,410,479,524,67,114,person
37863,14,person,15,1,24945,29,408,388,489,481,81,93,person
37864,15,person,16,1,24945,16,482,397,508,455,26,58,person
37865,23,person,24,1,24945,16,493,370,509,398,16,28,person
37866,26,umbrella,27,0,24945,15,445,334,542,375,97,41,umbrella
37867,30,person,31,1,24945,24,355,395,393,483,38,88,person
37868,31,car,32,1,24945,22,350,383,413,414,63,31,car
37869,32,car,33,0,24945,22,284,365,368,396,84,31,car
37870,37,car,38,1,24945,31,217,371,357,460,140,89,car
37871,38,car,39,1,24945,34,99,362,342,480,243,118,car
37872,39,car,40,1,24945,37,83,385,318,537,235,152,car
37873,41,car,42,1,24945,36,0,355,256,616,256,261,car
37874,20,table,21,0,24946,15,368,446,432,484,64,38,dining table
37875,36,person,37,0,24946,62,217,376,302,571,85,195,person
37876,5,person,6,0,24947,45,334,362,407,587,73,225,person
37877,6,person,7,0,24947,46,501,356,566,570,65,214,person
37878,9,person,10,0,24947,63,587,339,683,600,96,261,person
37879,10,person,11,0,24947,30,659,334,717,522,58,188,person
37880,11,person,12,1,24947,28,587,373,633,542,46,169,person
37881,12,person,13,1,24947,16,590,335,614,444,24,109,person
37882,13,person,14,0,24947,38,282,341,360,521,78,180,person
37883,14,person,15,0,24947,51,143,357,198,585,55,228,person
37884,15,person,16,0,24947,53,170,333,253,575,83,242,person
37885,17,person,18,1,24947,24,332,339,361,426,29,87,person
37886,18,person,19,1,24947,19,784,337,828,412,44,75,person
37887,23,plant pot,24,0,24948,23,17,654,163,712,146,58,potted plant
37888,25,plant pot,26,0,24948,15,540,674,630,713,90,39,potted plant
37889,0,car,1,1,24949,17,331,437,798,600,467,163,car
37890,3,person,4,0,24954,52,921,500,1024,722,103,222,person
37891,6,person,7,0,24954,28,754,454,788,539,34,85,person
37892,7,person,8,1,24954,26,780,468,808,536,28,68,person
37893,8,person,9,0,24954,23,798,446,836,541,38,95,person
37894,9,person,10,0,24954,27,835,473,858,544,23,71,person
37895,5,person,6,0,7305,18,424,681,459,760,35,79,person
37896,6,person,7,0,7305,17,467,676,494,758,27,82,person
37897,10,person,11,0,7308,19,20,219,31,249,11,30,person
37898,2,bench,3,0,7344,16,569,274,638,367,69,93,bench
37899,3,pot,4,0,7349,15,30,291,88,340,58,49,potted plant
37900,5,bench,6,0,7352,32,20,256,161,338,141,82,bench
37901,0,clock,1,0,20695,15,120,23,153,56,33,33,clock
37902,12,person,13,0,24957,51,217,592,267,708,50,116,person
37903,13,person,14,0,24957,24,339,585,356,625,17,40,person
37904,14,person,15,0,24957,22,363,580,379,625,16,45,person
37905,1,door,2,0,24958,17,262,179,548,980,286,801,door
37906,14,traffic light,15,0,7419,28,240,226,417,306,177,80,traffic light
37907,5,person,6,0,7422,20,40,207,45,228,5,21,person
37908,6,person,7,0,7422,17,50,209,55,227,5,18,person
37909,0,boat,1,0,23284,24,1,1,1024,683,1023,682,boat
37910,16,boat,17,0,23284,34,741,468,955,564,214,96,boat
37911,17,boat,18,0,23284,16,952,480,1024,566,72,86,boat
37912,20,person,20,1,23284,20,100,561,124,588,24,27,person
37913,22,boat,22,1,23284,47,76,546,193,608,117,62,boat
37914,12,traffic light,13,0,23285,50,392,0,1024,202,632,202,traffic light
37915,14,traffic light,15,0,23285,38,282,226,1024,381,742,155,traffic light
37916,34,car,35,1,23285,18,0,506,46,549,46,43,car
37917,35,car,36,1,23285,24,45,517,96,545,51,28,car
37918,36,car,37,1,23285,30,86,511,146,549,60,38,car
37919,37,car,38,0,23285,34,136,509,216,553,80,44,car
37920,46,car,47,0,23285,25,739,501,813,537,74,36,car
37921,47,bicycle,48,1,23285,25,811,514,831,533,20,19,bicycle
37922,48,person,49,0,23285,21,812,502,826,526,14,24,person
37923,49,car,50,1,23285,24,866,501,923,531,57,30,car
37924,51,car,52,0,23285,39,918,502,1024,562,106,60,car
37925,53,person,54,0,23285,25,219,508,232,546,13,38,person
37926,2,car,3,0,23286,23,524,674,859,768,335,94,car
37927,10,person,11,0,23286,24,187,668,220,768,33,100,person
37928,12,car,13,1,23286,26,68,678,119,721,51,43,car
37929,13,person,14,0,23286,32,72,672,112,768,40,96,person
37930,16,person,17,1,23286,41,9,671,57,768,48,97,person
37931,17,person,18,1,23286,26,141,669,169,706,28,37,person
37932,18,person,19,1,23286,46,118,677,146,768,28,91,person
37933,19,person,20,1,23286,40,118,686,170,768,52,82,person
37934,20,person,21,1,23286,30,246,668,263,737,17,69,person
37935,31,person,32,1,23286,22,829,687,851,722,22,35,person
37936,6,bus,7,1,23287,30,1,696,507,845,506,149,bus
37937,7,car,8,1,23287,17,330,742,443,830,113,88,car
37938,9,car,10,1,23287,31,327,754,767,1003,440,249,car
37939,12,car,13,0,23288,28,816,702,883,739,67,37,car
37940,13,car,14,0,23288,23,881,696,927,728,46,32,car
37941,14,car,15,1,23288,24,919,693,955,721,36,28,car
37942,15,car,16,1,23288,24,937,686,975,718,38,32,car
37943,16,car,17,1,23288,17,974,692,994,715,20,23,car
37944,17,person,18,1,23288,20,726,685,737,727,11,42,person
37945,23,car,24,1,23288,18,321,700,502,768,181,68,car
37946,24,car,25,0,23288,24,499,709,621,768,122,59,car
37947,7,person,8,0,23289,26,458,510,516,644,58,134,person
37948,8,person,9,0,23289,23,347,582,418,639,71,57,person
37949,9,person,10,1,23289,18,80,611,157,648,77,37,person
37950,10,person,11,0,23289,27,254,507,292,582,38,75,person
37951,11,person,12,0,23289,17,513,530,544,566,31,36,person
37952,18,person,19,0,23289,17,377,506,393,547,16,41,person
37953,13,person,14,0,23290,47,661,702,740,916,79,214,person
37954,14,person,15,0,23290,27,616,716,662,894,46,178,person
37955,15,person,16,0,23290,45,538,688,617,904,79,216,person
37956,16,person,17,0,23290,43,476,720,550,907,74,187,person
37957,17,person,18,0,23290,69,303,645,437,1024,134,379,person
37958,18,person,19,1,23290,52,338,703,420,850,82,147,person
37959,3,car,4,0,7428,21,821,270,927,317,106,47,car
37960,5,person,6,0,7430,41,303,303,835,456,532,153,person
37961,12,person,13,0,7456,33,610,729,796,1210,186,481,person
37962,13,dog,14,1,7456,20,782,950,922,1136,140,186,dog
37963,14,bench,15,0,7463,15,757,331,854,360,97,29,bench
37964,15,person,16,0,7463,28,291,259,321,349,30,90,person
37965,16,person,17,0,7463,29,707,287,752,384,45,97,person
37966,17,person,18,1,7463,15,689,300,704,332,15,32,person
37967,13,car,14,0,7468,26,144,38,315,197,171,159,car
37968,21,chair,22,0,7475,22,181,326,303,488,122,162,chair
37969,11,chair,12,0,23292,26,30,541,110,614,80,73,chair
37970,8,motorbike,9,0,23293,237,286,206,940,579,654,373,motorcycle
37971,9,person,10,0,23293,151,508,148,749,627,241,479,person
37972,10,backpack,11,0,23293,41,643,194,778,355,135,161,backpack
37973,6,bench,7,0,23298,20,218,407,304,459,86,52,bench
37974,11,person,12,0,23298,24,948,392,967,442,19,50,person
37975,10,person,11,0,7588,19,1405,262,1429,322,24,60,person
37976,11,person,12,0,7588,26,1538,398,1585,466,47,68,person
37977,14,person,15,0,7588,69,1147,633,1397,980,250,347,person
37978,15,hat,16,0,7588,15,1145,632,1230,716,85,84,hat
37979,2,truck,3,1,7590,20,2,86,82,339,80,253,truck
37980,9,person,10,0,7590,18,677,373,707,468,30,95,person
37981,10,person,11,0,7590,24,328,160,372,288,44,128,person
37982,11,person,12,0,7590,20,141,86,192,192,51,106,person
37983,15,truck,16,0,7592,33,41,523,233,647,192,124,truck
37984,5,motorbike,6,1,7593,30,123,1067,253,1198,130,131,motorcycle
37985,6,motorbikes,7,1,7593,59,198,1064,853,1198,655,134,motorcycle
37986,30,person,31,1,7593,18,1388,1068,1468,1197,80,129,person
37987,8,car,9,0,7597,27,496,960,746,1072,250,112,car
37988,2,car,3,0,7600,18,249,247,308,272,59,25,car
37989,20,traffic light,21,0,7600,21,145,190,163,281,18,91,traffic light
37990,0,car,1,0,7602,20,62,175,111,198,49,23,car
37991,12,person,13,0,7602,16,173,166,182,184,9,18,person
37992,5,person,6,0,23306,43,588,695,629,823,41,128,person
37993,6,person,7,1,23306,24,675,691,708,780,33,89,person
37994,7,person,8,0,23306,35,702,681,738,782,36,101,person
37995,8,person,9,1,23306,26,566,778,767,1023,201,245,person
37996,4,bus,5,1,23308,17,37,866,123,944,86,78,bus
37997,5,car,6,0,23308,21,1,907,55,979,54,72,car
37998,6,car,7,0,23308,32,53,904,233,1024,180,120,car
37999,13,traffic light,14,0,23308,23,314,815,349,1001,35,186,traffic light
38000,15,person,16,0,23308,40,441,904,481,1019,40,115,person
38001,16,person,17,0,23308,41,503,912,537,1019,34,107,person
38002,18,person,19,0,23308,36,722,902,747,983,25,81,person
38003,19,person,20,0,23308,26,653,909,683,986,30,77,person
38004,20,person,21,0,23308,31,558,919,578,975,20,56,person
38005,22,person,23,0,23308,28,677,916,701,968,24,52,person
38006,24,person,25,0,23308,21,281,910,294,949,13,39,person
38007,26,traffic light,27,0,23308,19,350,823,369,996,19,173,traffic light
38008,3,clock,4,0,23313,16,240,369,302,432,62,63,clock
38009,4,traffic light,5,0,23314,36,868,558,1036,1197,168,639,traffic light
38010,10,traffic light,11,0,23314,46,1310,784,1467,1193,157,409,traffic light
38011,15,car,16,0,23315,46,165,486,600,627,435,141,car
38012,16,car,17,0,23315,42,730,489,1024,623,294,134,car
38013,6,person,7,0,23316,33,705,487,720,511,15,24,person
38014,7,motorbike,8,0,23316,32,705,498,720,522,15,24,motorcycle
38015,10,car,11,1,23316,15,777,492,789,517,12,25,car
38016,22,person,22,0,23316,17,613,478,628,515,15,37,person
38017,8,car,9,1,23318,19,111,584,312,630,201,46,car
38018,10,person,11,0,23318,22,242,543,274,598,32,55,person
38019,11,person,12,1,23318,25,818,555,875,629,57,74,person
38020,10,person,11,0,7628,22,148,69,161,108,13,39,person
38021,6,person,7,0,7629,29,422,147,470,284,48,137,person
38022,4,person,5,1,7630,61,101,873,1473,2187,1372,1314,person
38023,6,person,7,0,7631,26,762,283,832,455,70,172,person
38024,7,person,8,0,7631,40,784,393,884,669,100,276,person
38025,19,person,20,0,7632,30,111,174,143,263,32,89,person
38026,20,person,21,0,7632,18,97,112,109,147,12,35,person
38027,9,person,10,1,7633,15,320,1021,469,1134,149,113,person
38028,15,cow,16,0,7702,20,247,229,268,268,21,39,cow
38029,16,cow,17,0,7702,18,193,232,222,273,29,41,cow
38030,17,cow,18,0,7702,19,124,243,151,285,27,42,cow
38031,19,cow,20,0,7702,20,18,220,54,256,36,36,cow
38032,23,cow,24,0,7702,15,250,190,269,216,19,26,cow
38033,24,cow,25,0,7702,16,139,192,160,215,21,23,cow
38034,25,cow,26,0,7702,16,72,211,95,242,23,31,cow
38035,10,person,11,0,7711,41,1161,548,1289,858,128,310,person
38036,11,person,12,0,7711,28,1097,627,1147,835,50,208,person
38037,1,person,2,0,23344,74,511,681,1480,1642,969,961,person
38038,3,car,4,1,23344,19,1925,836,2178,908,253,72,car
38039,7,person,8,0,23345,75,105,296,243,627,138,331,person
38040,10,person,11,1,23345,45,249,357,332,482,83,125,person
38041,11,person,12,1,23345,57,580,337,643,563,63,226,person
38042,14,person,15,0,23345,63,391,331,477,566,86,235,person
38043,15,person,16,0,23345,84,454,302,589,687,135,385,person
38044,3,horse,4,0,23348,175,512,256,1016,624,504,368,horse
38045,20,cow,21,0,23349,24,189,213,210,224,21,11,cow
38046,21,cow,22,0,23349,254,223,251,841,624,618,373,cow
38047,2,umbrella,3,1,7743,30,906,96,1447,216,541,120,umbrella
38048,6,person,7,0,7746,58,140,52,200,196,60,144,person
38049,3,person,4,1,7758,19,0,436,276,958,276,522,person
38050,4,person,5,0,7758,55,124,485,615,904,491,419,person
38051,5,person,6,1,7758,38,295,451,540,678,245,227,person
38052,6,person,7,1,7758,26,489,538,695,716,206,178,person
38053,7,person,8,1,7758,26,584,460,718,676,134,216,person
38054,8,person,9,1,7758,18,793,465,875,584,82,119,person
38055,10,person,11,1,7758,44,511,476,869,958,358,482,person
38056,17,person,18,1,7758,25,931,491,1058,653,127,162,person
38057,18,person,19,1,7758,21,789,482,996,707,207,225,person
38058,19,person,20,1,7758,26,1035,493,1145,629,110,136,person
38059,20,person,21,1,7758,16,1144,482,1225,565,81,83,person
38060,109,bench,109,0,7758,16,778,675,1148,957,370,282,bench
38061,110,bench,110,0,7758,23,943,642,1210,907,267,265,bench
38062,111,bench,111,0,7758,19,1056,607,1254,816,198,209,bench
38063,2,person,3,1,7759,33,702,371,924,567,222,196,person
38064,3,person,4,1,7759,30,304,480,445,729,141,249,person
38065,4,person,5,1,7759,25,205,498,355,745,150,247,person
38066,5,person,6,1,7759,34,105,493,338,833,233,340,person
38067,6,person,7,1,7759,31,0,491,269,845,269,354,person
38068,8,person,9,1,7759,21,678,487,796,702,118,215,person
38069,9,person,10,1,7759,25,593,453,751,687,158,234,person
38070,13,backpack,14,0,7759,18,329,695,600,824,271,129,backpack
38071,22,person,23,1,7759,18,878,569,962,675,84,106,person
38072,23,person,24,1,7759,20,862,684,971,956,109,272,person
38073,25,person,26,1,7759,16,1093,553,1278,958,185,405,person
38074,26,person,27,1,7759,41,929,413,1258,958,329,545,person
38075,9,person,10,1,7760,31,804,486,954,735,150,249,person
38076,2,car,3,0,23356,18,597,297,623,312,26,15,car
38077,13,car,14,0,23356,73,61,308,289,458,228,150,car
38078,10,motorbike,11,0,23360,96,92,433,366,870,274,437,motorcycle
38079,7,person,8,0,144,78,20,63,259,279,239,216,person
38080,12,person,13,1,7868,22,349,291,373,364,24,73,person
38081,7,person,8,0,7872,23,159,118,229,235,70,117,person
38082,0,person,1,0,7873,52,149,54,239,205,90,151,person
38083,6,person,7,1,23365,52,306,5,685,767,379,762,person
38084,7,car,8,1,23372,16,56,928,231,996,175,68,car
38085,8,car,9,1,23372,16,0,924,102,995,102,71,car
38086,3,person,4,1,145,23,1131,527,1200,963,69,436,person
38087,4,person,5,1,145,72,880,414,1038,1060,158,646,person
38088,11,person,12,0,145,114,661,396,996,1564,335,1168,person
38089,21,person,22,1,145,45,206,329,356,961,150,632,person
38090,27,person,28,0,145,104,160,181,686,1580,526,1399,person
38091,6,traffic light,7,0,7874,25,476,204,521,391,45,187,traffic light
38092,9,car,10,1,7875,19,53,241,109,298,56,57,car
38093,7,dog,8,0,7876,28,173,358,218,387,45,29,dog
38094,8,person,9,0,7876,26,238,307,267,396,29,89,person
38095,26,person,27,1,7877,23,178,276,200,347,22,71,person
38096,27,person,28,0,7877,31,180,271,223,351,43,80,person
38097,28,person,29,1,7877,21,215,271,235,338,20,67,person
38098,6,truck,7,1,7879,24,138,250,243,348,105,98,truck
38099,7,truck,8,1,7879,18,320,237,392,339,72,102,truck
38100,2,truck,3,0,23376,28,762,443,902,588,140,145,truck
38101,3,truck,4,0,23376,43,525,436,785,577,260,141,truck
38102,4,truck,5,0,23376,28,116,451,396,583,280,132,truck
38103,3,car,4,1,23378,18,0,437,92,549,92,112,car
38104,2,car,3,0,23380,47,684,486,994,707,310,221,car
38105,3,car,4,1,23380,15,975,513,1024,665,49,152,car
38106,2,bus,3,1,23382,19,75,288,205,466,130,178,bus
38107,3,bus,4,1,23382,18,194,278,327,473,133,195,bus
38108,4,bus,5,0,23382,35,320,217,696,497,376,280,bus
38109,6,bus,7,0,23382,43,677,319,938,475,261,156,bus
38110,7,bus,8,0,23382,20,879,323,962,427,83,104,bus
38111,9,bus,10,1,23382,21,970,371,994,409,24,38,bus
38112,10,bus,11,0,23382,19,998,362,1024,400,26,38,bus
38113,4,bus,5,0,23384,23,643,231,1023,440,380,209,bus
38114,6,bus,7,0,23384,17,111,102,600,592,489,490,bus
38115,9,person,10,0,23385,23,856,373,882,451,26,78,person
38116,10,bicycle,11,1,23385,52,1,515,257,683,256,168,bicycle
38117,8,umbrella,9,0,7957,21,16,135,118,220,102,85,umbrella
38118,12,car,13,1,7957,23,367,183,499,357,132,174,car
38119,13,person,14,1,7957,50,405,189,499,374,94,185,person
38120,24,person,25,0,7957,28,18,166,57,246,39,80,person
38121,32,bicycle,33,0,7957,38,187,196,247,239,60,43,bicycle
38122,40,car,41,1,7957,16,284,166,333,191,49,25,car
38123,7,person,8,1,7958,21,228,211,327,329,99,118,person
38124,8,person,9,1,7958,20,297,201,349,327,52,126,person
38125,11,person,12,1,7958,22,236,167,261,291,25,124,person
38126,12,person,13,0,7958,29,211,166,240,300,29,134,person
38127,14,person,15,1,7958,32,136,162,214,329,78,167,person
38128,16,person,17,1,7958,25,74,172,145,328,71,156,person
38129,17,person,18,1,7958,29,38,181,125,327,87,146,person
38130,13,person,14,0,7959,24,125,109,139,164,14,55,person
38131,14,person,15,0,7959,26,194,103,220,179,26,76,person
38132,18,person,19,1,7959,22,180,108,194,171,14,63,person
38133,19,person,20,0,7959,50,323,97,360,199,37,102,person
38134,20,person,21,0,7959,23,75,101,94,159,19,58,person
38135,3,umbrella,4,1,7960,25,0,44,190,118,190,74,umbrella
38136,5,person,6,1,7960,18,111,172,152,236,41,64,person
38137,8,person,9,1,7960,54,41,131,135,374,94,243,person
38138,9,person,10,1,7960,22,0,96,77,374,77,278,person
38139,3,person,4,0,7961,26,221,216,265,357,44,141,person
38140,4,person,5,1,7961,20,380,224,426,348,46,124,person
38141,5,person,6,1,7961,18,441,223,494,365,53,142,person
38142,8,person,9,1,7961,15,90,200,155,288,65,88,person
38143,9,person,10,1,7961,22,94,264,194,441,100,177,person
38144,10,person,11,1,7961,27,65,158,119,452,54,294,person
38145,11,person,12,1,7961,27,21,156,83,455,62,299,person
38146,12,person,13,1,7961,24,0,178,58,738,58,560,person
38147,13,person,14,1,7961,27,46,431,149,614,103,183,person
38148,15,person,16,1,7961,15,336,205,379,301,43,96,person
38149,16,person,17,1,7961,16,306,268,379,328,73,60,person
38150,17,person,18,1,7961,20,296,314,351,412,55,98,person
38151,18,person,19,0,7961,29,304,321,412,480,108,159,person
38152,19,person,20,1,7961,28,359,310,496,592,137,282,person
38153,20,person,21,1,7961,32,315,382,495,740,180,358,person
38154,3,chair,4,1,7962,28,370,89,477,305,107,216,chair
38155,4,person,5,1,7962,61,191,25,436,322,245,297,person
38156,6,person,7,1,7962,19,0,0,144,363,144,363,person
38157,9,hat,10,0,7962,27,191,26,385,144,194,118,hat
38158,15,table,16,1,7962,20,471,194,638,316,167,122,dining table
38159,8,person,9,0,7971,36,629,687,756,970,127,283,person
38160,5,person,6,1,7972,23,327,265,400,406,73,141,person
38161,7,person,8,1,7972,34,410,317,515,693,105,376,person
38162,8,person,9,0,7972,41,230,347,471,743,241,396,person
38163,2,car,3,1,7973,19,57,0,245,47,188,47,car
38164,9,person,10,0,7974,22,156,307,169,344,13,37,person
38165,10,person,11,0,7974,24,169,308,184,356,15,48,person
38166,11,person,12,0,7974,27,185,307,202,358,17,51,person
38167,13,person,14,0,7974,23,81,309,96,354,15,45,person
38168,14,person,15,1,7974,15,2,316,29,359,27,43,person
38169,16,person,17,1,7974,18,244,312,269,359,25,47,person
38170,9,person,10,0,7977,66,494,362,745,727,251,365,person
38171,6,person,7,0,7980,35,247,803,577,1480,330,677,person
38172,3,person,4,1,20799,35,129,1,183,128,54,127,person
38173,5,person,6,1,7987,26,2,72,39,127,37,55,person
38174,6,person,7,1,7987,21,256,69,280,165,24,96,person
38175,7,person,8,0,7987,64,194,60,278,266,84,206,person
38176,8,person,9,0,7987,67,286,58,374,238,88,180,person
38177,3,person,4,1,7990,26,895,604,1170,1011,275,407,person
38178,6,chair,7,0,7990,23,1437,630,1570,783,133,153,chair
38179,7,car,8,0,7991,15,71,62,125,99,54,37,car
38180,8,car,9,0,7991,18,260,77,367,117,107,40,car
38181,10,car,11,1,7991,17,935,78,1033,162,98,84,car
38182,11,car,12,1,7991,15,1169,66,1277,332,108,266,car
38183,12,bench,13,0,7991,32,394,335,639,581,245,246,bench
38184,13,bench,14,0,7991,28,530,266,684,419,154,153,bench
38185,15,car,16,0,7991,26,955,93,1112,194,157,101,car
38186,10,car,11,1,7992,32,436,310,1598,753,1162,443,car
38187,12,fire hydrant,13,0,7992,29,826,736,999,1060,173,324,fire hydrant
38188,20,door,21,0,7992,15,1085,397,1300,751,215,354,door
38189,3,car,4,1,7993,17,248,97,337,207,89,110,car
38190,7,person,8,1,7993,40,51,85,161,128,110,43,person
38191,13,car,14,1,7994,30,840,501,1522,870,682,369,car
38192,21,traffic light,22,0,7994,18,912,0,1102,570,190,570,traffic light
38193,2,boat,3,0,8020,37,0,0,275,182,275,182,boat
38194,7,chair,8,1,8020,17,40,99,96,141,56,42,chair
38195,0,boat,1,0,8021,17,0,0,386,255,386,255,boat
38196,1,boat,2,0,8022,32,0,25,399,266,399,241,boat
38197,3,boat,4,1,8022,19,311,20,399,144,88,124,boat
38198,7,car,8,0,8022,16,70,1,108,19,38,18,car
38199,10,car,11,0,8022,15,292,1,331,19,39,18,car
38200,3,chair,4,1,8023,20,61,181,131,285,70,104,chair
38201,3,sofa,4,0,8024,20,0,96,326,299,326,203,couch
38202,5,boat,6,0,8024,29,2,0,449,299,447,299,boat
38203,12,person,13,0,8024,16,140,55,149,83,9,28,person
38204,13,person,14,0,8024,17,148,53,157,78,9,25,person
38205,2,person,3,0,8025,39,96,88,145,195,49,107,person
38206,2,boat,3,1,8026,38,0,0,447,299,447,299,boat
38207,3,chair,4,0,8026,35,276,132,352,253,76,121,chair
38208,4,chair,5,0,8026,41,204,138,279,268,75,130,chair
38209,5,person,6,1,8026,36,260,101,325,247,65,146,person
38210,6,person,7,1,8026,44,192,96,267,243,75,147,person
38211,7,person,8,0,8026,63,79,66,139,285,60,219,person
38212,2,boat,3,0,8027,35,0,0,1598,1064,1598,1064,boat
38213,7,table,8,0,8027,34,481,539,855,842,374,303,dining table
38214,7,car,8,1,151,32,127,412,467,526,340,114,car
38215,8,car,9,1,151,21,433,359,541,436,108,77,car
38216,9,car,10,1,151,15,887,393,943,441,56,48,car
38217,10,car,11,1,151,34,982,368,1070,429,88,61,car
38218,14,table,15,0,151,15,612,447,658,492,46,45,dining table
38219,22,person,23,0,151,40,55,373,121,504,66,131,person
38220,24,person,25,0,151,33,859,403,901,529,42,126,person
38221,25,person,26,0,151,39,1091,415,1137,531,46,116,person
38222,32,person,33,0,151,27,1034,378,1060,430,26,52,person
38223,35,table,36,1,151,18,780,449,834,476,54,27,dining table
38224,44,person,45,0,151,115,288,419,598,1118,310,699,person
38225,57,person,58,0,151,133,627,342,834,1138,207,796,person
38226,69,person,70,1,151,103,789,428,1158,1170,369,742,person
38227,80,person,81,1,151,149,1106,374,1446,1194,340,820,person
38228,91,bicycle,92,1,151,96,1139,705,1383,1199,244,494,bicycle
38229,92,bicycle,93,1,151,111,801,716,1211,1186,410,470,bicycle
38230,93,bicycle,94,1,151,88,487,700,757,1193,270,493,bicycle
38231,94,bicycle,95,1,151,84,286,715,509,1157,223,442,bicycle
38232,7,person,8,0,152,111,121,38,266,336,145,298,person
38233,22,bicycle,23,0,152,62,158,179,247,411,89,232,bicycle
38234,9,person,10,0,153,79,551,308,914,1008,363,700,person
38235,10,bicycle,11,0,153,52,615,641,825,1227,210,586,bicycle
38236,4,person,5,1,154,60,638,137,826,478,188,341,person
38237,13,person,14,1,154,90,394,180,522,479,128,299,person
38238,5,person,6,0,23416,72,325,1,619,564,294,563,person
38239,6,bicycle,7,0,23416,83,394,306,617,718,223,412,bicycle
38240,10,person,11,1,8238,18,191,106,222,141,31,35,person
38241,11,person,12,0,8238,17,227,104,255,150,28,46,person
38242,12,person,13,0,8238,24,253,92,299,144,46,52,person
38243,14,person,15,0,8238,39,311,110,354,194,43,84,person
38244,6,bench,7,0,8241,17,1757,957,1969,1057,212,100,bench
38245,10,person,11,1,8253,15,0,564,17,647,17,83,person
38246,11,person,12,0,155,34,1315,395,1396,673,81,278,person
38247,12,person,13,0,155,35,1247,146,1318,334,71,188,person
38248,13,person,14,0,155,47,1324,134,1414,318,90,184,person
38249,14,person,15,0,155,45,752,492,837,696,85,204,person
38250,15,person,16,1,155,23,1371,82,1422,193,51,111,person
38251,16,person,17,1,155,29,1074,116,1139,233,65,117,person
38252,9,person,10,1,156,22,445,275,499,375,54,100,person
38253,10,person,11,1,156,33,374,292,466,374,92,82,person
38254,11,person,12,1,156,20,376,320,414,357,38,37,person
38255,12,person,13,1,156,19,280,311,365,374,85,63,person
38256,13,person,14,1,156,16,286,327,302,360,16,33,person
38257,14,person,15,1,156,31,249,324,288,373,39,49,person
38258,15,person,16,1,156,23,189,326,220,372,31,46,person
38259,17,person,18,1,156,28,162,322,193,374,31,52,person
38260,19,person,20,1,156,35,124,307,158,374,34,67,person
38261,20,person,21,0,156,25,98,324,126,374,28,50,person
38262,21,person,22,1,156,24,67,341,106,375,39,34,person
38263,22,person,23,1,156,29,59,321,83,374,24,53,person
38264,24,person,25,1,156,27,36,309,59,372,23,63,person
38265,25,person,26,1,156,16,20,337,48,374,28,37,person
38266,4,person,5,0,157,61,30,273,123,580,93,307,person
38267,10,person,11,0,157,86,110,321,194,578,84,257,person
38268,20,person,21,0,157,68,181,331,272,579,91,248,person
38269,7,person,8,0,158,233,311,344,959,2054,648,1710,person
38270,1,person,2,1,159,98,158,611,1358,2200,1200,1589,person
38271,6,person,7,0,8265,15,17,199,24,218,7,19,person
38272,5,person,6,0,8267,44,155,365,222,560,67,195,person
38273,6,person,7,0,8267,28,2,369,47,544,45,175,person
38274,8,person,9,1,8267,22,1049,369,1101,534,52,165,person
38275,9,person,10,1,8267,19,1058,385,1140,514,82,129,person
38276,10,person,11,1,8267,17,1148,375,1192,521,44,146,person
38277,11,person,12,1,8267,16,1139,472,1195,603,56,131,person
38278,12,person,13,0,8267,43,1048,418,1200,790,152,372,person
38279,13,person,14,1,8267,33,1177,301,1277,955,100,654,person
38280,2,car,3,0,8270,15,4,296,35,322,31,26,car
38281,15,person,16,1,8275,19,327,1399,388,1510,61,111,person
38282,16,person,17,1,8275,15,556,1394,623,1469,67,75,person
38283,18,person,19,1,8275,18,1209,1407,1278,1477,69,70,person
38284,19,person,20,1,8275,15,1824,1417,1873,1496,49,79,person
38285,20,person,21,1,8275,15,2,1477,72,1584,70,107,person
38286,3,person,4,0,8276,70,304,400,525,882,221,482,person
38287,9,bench,10,0,8278,16,18,243,142,279,124,36,bench
38288,7,person,8,0,23427,29,841,391,911,475,70,84,person
38289,8,person,9,0,23427,72,555,284,684,566,129,282,person
38290,12,person,13,0,23427,30,496,410,514,460,18,50,person
38291,13,person,14,0,23427,27,565,417,588,462,23,45,person
38292,16,person,17,0,23427,30,802,394,823,457,21,63,person
38293,17,person,18,0,23427,31,835,399,854,453,19,54,person
38294,18,person,19,1,23427,21,780,416,797,447,17,31,person
38295,21,person,22,0,23427,20,782,208,791,238,9,30,person
38296,22,person,23,0,23427,19,791,210,801,237,10,27,person
38297,7,bench,8,0,23428,28,254,411,394,487,140,76,bench
38298,8,person,9,1,23428,53,269,315,336,469,67,154,person
38299,9,person,10,1,23428,47,334,327,404,467,70,140,person
38300,8,person,9,0,23429,48,929,457,959,512,30,55,person
38301,9,person,10,0,23429,31,952,479,965,511,13,32,person
38302,10,person,11,0,23429,21,999,373,1012,389,13,16,person
38303,11,person,12,0,23429,24,989,371,1004,388,15,17,person
38304,12,person,13,0,23429,20,997,349,1008,371,11,22,person
38305,13,person,14,0,23429,19,884,352,895,373,11,21,person
38306,14,person,15,0,23429,18,899,348,905,372,6,24,person
38307,19,person,20,0,23429,22,190,399,207,422,17,23,person
38308,20,person,21,0,23429,29,436,440,450,482,14,42,person
38309,24,person,25,0,23429,18,164,364,175,384,11,20,person
38310,25,person,26,0,23429,17,169,364,184,386,15,22,person
38311,0,car,1,1,23430,16,763,329,898,371,135,42,car
38312,3,car,4,0,23430,17,630,322,732,363,102,41,car
38313,6,car,7,0,23430,16,88,332,239,373,151,41,car
38314,8,car,9,0,23430,15,278,329,315,360,37,31,car
38315,12,car,13,1,23430,17,933,327,964,350,31,23,car
38316,13,person,14,0,23431,26,920,392,933,439,13,47,person
38317,14,person,15,0,23431,35,901,385,921,440,20,55,person
38318,4,person,5,0,23432,54,421,293,559,666,138,373,person
38319,11,person,12,0,23432,18,72,350,94,394,22,44,person
38320,31,plants pot,32,0,23433,19,24,444,63,493,39,49,potted plant
38321,11,truck,12,1,23435,16,203,1504,463,1682,260,178,truck
38322,16,person,17,1,23435,18,61,1523,132,1641,71,118,person
38323,8,car,9,1,23436,20,507,1507,784,1646,277,139,car
38324,11,car,10,0,23436,51,726,1506,1481,1951,755,445,car
38325,12,car,11,0,23436,39,0,1524,675,1922,675,398,car
38326,6,person,7,0,23437,36,156,617,180,697,24,80,person
38327,7,person,8,1,23437,31,100,621,127,703,27,82,person
38328,8,person,9,0,23437,28,5,619,33,701,28,82,person
38329,9,person,10,0,23437,16,0,620,14,695,14,75,person
38330,13,clock,14,0,23437,16,83,396,103,416,20,20,clock
38331,9,person,10,1,23438,19,621,714,666,796,45,82,person
38332,11,person,12,0,23438,27,665,712,736,800,71,88,person
38333,12,person,13,1,23438,17,709,700,740,756,31,56,person
38334,13,person,14,1,23438,17,744,703,772,754,28,51,person
38335,16,person,17,1,23438,30,772,718,859,809,87,91,person
38336,18,person,19,1,23438,24,773,709,826,763,53,54,person
38337,19,person,20,1,23438,15,805,701,843,752,38,51,person
38338,20,person,21,1,23438,18,840,710,879,766,39,56,person
38339,24,umbrella,25,0,23438,16,841,557,887,720,46,163,umbrella
38340,11,person,12,0,23439,21,41,567,82,697,41,130,person
38341,11,car,12,0,23441,24,667,512,733,543,66,31,car
38342,6,person,7,0,23442,18,555,770,571,808,16,38,person
38343,7,person,8,0,23442,22,576,765,593,809,17,44,person
38344,8,person,9,0,23442,20,616,762,635,809,19,47,person
38345,9,person,10,1,23442,17,636,758,651,810,15,52,person
38346,10,person,11,1,23442,23,647,744,664,810,17,66,person
38347,11,person,12,1,23442,16,651,763,671,809,20,46,person
38348,12,person,13,1,23442,20,668,753,692,810,24,57,person
38349,15,person,16,1,23442,20,121,768,145,811,24,43,person
38350,16,person,17,1,23442,15,152,781,167,810,15,29,person
38351,17,person,18,1,23442,19,171,770,185,809,14,39,person
38352,18,person,19,1,23442,23,187,765,210,810,23,45,person
38353,5,person,6,1,23443,41,538,460,641,648,103,188,person
38354,6,person,7,1,23443,31,584,527,633,644,49,117,person
38355,9,table,10,1,23443,41,868,515,941,609,73,94,dining table
38356,11,table,12,1,23443,15,722,505,780,531,58,26,dining table
38357,12,chair,13,0,23443,16,698,501,764,583,66,82,chair
38358,13,person,14,0,23443,50,120,426,177,583,57,157,person
38359,14,person,15,1,23443,26,2,440,49,614,47,174,person
38360,24,umbrella,25,0,23443,27,518,345,642,488,124,143,umbrella
38361,25,plant pot,26,0,23443,17,840,523,904,583,64,60,potted plant
38362,6,car,7,1,23445,19,95,412,172,461,77,49,car
38363,7,car,8,1,23445,18,103,425,150,473,47,48,car
38364,8,car,9,1,23445,15,127,430,154,475,27,45,car
38365,9,car,10,1,23445,18,138,414,235,487,97,73,car
38366,10,truck,11,0,23445,60,232,341,513,506,281,165,truck
38367,11,person,12,0,23445,64,268,384,372,678,104,294,person
38368,8,person,9,0,160,132,463,17,634,457,171,440,person
38369,17,bicycle,18,0,160,70,509,255,565,533,56,278,bicycle
38370,3,bus,4,1,161,29,283,64,415,214,132,150,bus
38371,4,car,5,0,161,24,178,66,248,128,70,62,car
38372,9,car,10,1,161,35,143,150,250,244,107,94,car
38373,10,car,11,0,161,30,151,238,258,317,107,79,car
38374,14,car,15,0,161,52,332,229,469,351,137,122,car
38375,19,car,20,0,161,27,177,281,282,367,105,86,car
38376,22,car,23,1,161,31,132,189,236,275,104,86,car
38377,26,car,27,0,161,29,27,103,114,178,87,75,car
38378,32,car,33,0,161,26,540,55,607,116,67,61,car
38379,38,car,39,0,161,19,666,74,726,124,60,50,car
38380,43,car,44,0,161,20,515,41,567,85,52,44,car
38381,47,car,48,1,161,34,478,176,592,269,114,93,car
38382,50,car,51,0,161,18,496,24,547,69,51,45,car
38383,54,car,55,1,161,20,575,91,632,147,57,56,car
38384,59,car,60,0,161,20,616,140,700,203,84,63,car
38385,63,car,64,1,161,25,660,178,739,243,79,65,car
38386,67,car,68,1,161,22,428,110,498,170,70,60,car
38387,71,car,72,1,161,19,554,2,604,40,50,38,car
38388,76,car,77,1,161,18,587,30,638,71,51,41,car
38389,80,car,81,0,161,22,642,49,706,96,64,47,car
38390,84,car,85,0,161,28,599,97,687,171,88,74,car
38391,13,bus,14,0,162,17,196,71,237,102,41,31,bus
38392,15,motorbike,16,0,162,24,47,171,84,205,37,34,motorcycle
38393,2,truck,3,0,163,35,315,169,491,272,176,103,truck
38394,6,truck,7,1,163,35,163,115,319,282,156,167,truck
38395,8,car,9,1,163,76,490,103,749,341,259,238,car
38396,11,door,12,0,163,24,525,135,635,312,110,177,door
38397,15,window,16,0,163,15,630,129,746,205,116,76,window
38398,16,car,17,1,163,107,0,226,276,499,276,273,car
38399,19,door,20,0,163,15,173,232,264,364,91,132,door
38400,23,door,24,0,163,17,135,231,251,391,116,160,door
38401,28,motorbike,29,1,163,248,0,184,749,499,749,315,motorcycle
38402,14,person,15,1,8280,17,210,132,221,148,11,16,person
38403,15,person,16,1,8280,15,221,134,226,154,5,20,person
38404,16,person,17,1,8280,16,225,140,234,158,9,18,person
38405,18,person,19,0,8280,17,34,105,42,122,8,17,person
38406,30,car,31,0,8280,15,101,97,117,112,16,15,car
38407,31,car,32,0,8280,18,87,119,112,149,25,30,car
38408,32,car,33,0,8280,25,151,173,202,237,51,64,car
38409,15,truck,16,0,8281,17,734,495,803,588,69,93,truck
38410,22,car,23,0,8281,17,431,537,491,571,60,34,car
38411,21,car,22,0,8283,24,539,777,644,839,105,62,car
38412,25,car,26,1,8284,25,2,536,1022,767,1020,231,car
38413,27,car,28,0,8285,15,442,593,538,678,96,85,car
38414,29,car,30,0,8285,16,228,610,301,668,73,58,car
38415,18,car,19,0,8287,20,1016,747,1192,835,176,88,car
38416,27,car,28,0,8287,18,185,760,305,850,120,90,car
38417,28,car,29,1,8287,21,377,752,518,844,141,92,car
38418,32,car,33,1,8287,41,439,722,1136,1048,697,326,car
38419,39,window,40,0,8287,16,654,743,1017,823,363,80,window
38420,41,door,42,0,8287,19,517,732,621,1009,104,277,door
38421,44,door,45,0,8287,23,462,735,588,998,126,263,door
38422,8,person,9,0,8433,49,323,95,422,331,99,236,person
38423,4,person,5,0,8436,20,379,270,388,295,9,25,person
38424,5,person,6,0,8436,18,356,272,367,295,11,23,person
38425,8,person,9,0,8436,16,266,266,275,285,9,19,person
38426,9,person,10,0,8436,16,284,268,291,286,7,18,person
38427,11,car,12,0,8437,16,136,109,172,128,36,19,car
38428,13,car,14,1,8437,20,241,113,285,140,44,27,car
38429,4,table,5,0,8438,38,372,372,581,481,209,109,dining table
38430,10,person,11,1,8438,20,432,307,461,377,29,70,person
38431,11,person,12,1,8438,19,398,309,432,374,34,65,person
38432,12,person,13,1,8438,22,459,309,521,385,62,76,person
38433,13,person,14,1,8438,24,508,302,549,390,41,88,person
38434,17,person,18,1,8438,15,262,302,280,334,18,32,person
38435,18,person,19,1,8438,22,226,319,255,383,29,64,person
38436,19,person,20,1,8438,21,0,298,19,380,19,82,person
38437,20,person,21,0,8438,27,12,296,36,395,24,99,person
38438,2,car,3,1,8506,30,0,63,107,211,107,148,car
38439,2,car,3,1,20863,30,0,63,107,211,107,148,car
38440,3,car,4,1,25009,25,2,494,235,718,233,224,car
38441,7,car,8,0,25011,52,0,259,323,457,323,198,car
38442,1,car,2,0,25018,33,264,170,574,423,310,253,car
38443,5,bench,6,0,25020,16,456,350,518,392,62,42,bench
38444,12,car,13,1,582,16,2,1504,1997,1649,1995,145,car
38445,13,car,14,0,582,33,728,1050,911,1169,183,119,car
38446,15,car,16,0,582,23,1308,1048,1463,1207,155,159,car
38447,16,car,17,0,582,41,1452,1044,2133,1326,681,282,car
38448,31,car,32,0,582,30,430,1046,722,1207,292,161,car
38449,33,car,34,1,582,26,4,1034,306,1207,302,173,car
38450,34,person,35,0,582,18,293,1034,352,1187,59,153,person
38451,37,car,38,1,582,26,933,1090,1090,1200,157,110,car
38452,38,person,39,0,582,29,899,1046,983,1203,84,157,person
38453,65,traffic light,66,0,582,39,1601,892,1894,1046,293,154,traffic light
38454,66,traffic light,67,0,582,17,1896,935,2131,978,235,43,traffic light
38455,11,bicycle,12,1,8517,43,4,606,188,805,184,199,bicycle
38456,10,car,11,1,8519,23,761,480,1325,720,564,240,car
38457,29,person,30,1,8519,19,755,459,809,554,54,95,person
38458,30,person,31,1,8519,20,713,434,775,666,62,232,person
38459,9,car,10,1,8520,18,66,152,99,185,33,33,car
38460,10,truck,11,1,8520,17,0,95,39,205,39,110,truck
38461,0,car,1,0,8521,31,1,699,268,1012,267,313,car
38462,36,table,35,0,8521,19,646,859,760,927,114,68,dining table
38463,38,person,37,0,8521,44,1225,798,1304,1030,79,232,person
38464,39,person,38,0,8521,43,1022,812,1085,967,63,155,person
38465,40,person,39,0,8521,36,939,787,998,972,59,185,person
38466,41,person,40,0,8521,21,768,786,822,922,54,136,person
38467,43,person,42,1,8521,19,756,774,785,906,29,132,person
38468,44,person,43,0,8521,18,845,769,879,898,34,129,person
38469,46,person,45,0,8521,33,1114,833,1213,937,99,104,person
38470,49,bench,48,1,8521,23,1007,854,1135,935,128,81,bench
38471,50,chair,49,1,8521,17,1152,894,1198,936,46,42,chair
38472,51,person,50,1,8521,18,1087,827,1138,889,51,62,person
38473,52,person,51,1,8521,20,984,820,1023,898,39,78,person
38474,53,person,52,1,8521,17,1077,838,1093,902,16,64,person
38475,0,person,1,1,8522,87,19,34,129,207,110,173,person
38476,8,person,9,1,8522,51,139,50,244,207,105,157,person
38477,12,motorbike,13,1,8522,18,253,81,280,127,27,46,motorcycle
38478,5,car,6,0,8523,28,76,344,356,466,280,122,car
38479,13,car,14,0,8525,24,254,135,295,150,41,15,car
38480,17,person,16,1,8527,24,45,183,56,210,11,27,person
38481,19,person,17,1,8527,35,142,189,154,214,12,25,person
38482,20,person,18,0,8527,30,76,185,85,215,9,30,person
38483,21,person,19,1,8527,23,73,183,80,205,7,22,person
38484,23,car,21,1,8527,36,182,191,255,222,73,31,car
38485,24,car,22,1,8527,37,129,190,187,216,58,26,car
38486,25,car,23,1,8527,26,95,187,129,209,34,22,car
38487,26,car,24,1,8527,23,37,181,110,211,73,30,car
38488,27,car,25,1,8527,22,180,188,250,204,70,16,car
38489,0,car,1,0,8529,15,20,176,77,196,57,20,car
38490,24,car,25,0,8531,29,359,227,404,258,45,31,car
38491,25,motorbike,26,1,8531,15,400,240,418,258,18,18,motorcycle
38492,26,motorbike,27,1,8531,15,417,239,437,259,20,20,motorcycle
38493,3,car,4,0,8532,28,16,194,226,332,210,138,car
38494,4,car,5,1,8532,19,339,191,436,257,97,66,car
38495,6,car,7,1,8532,24,365,196,492,290,127,94,car
38496,8,car,9,0,8532,29,447,203,588,314,141,111,car
38497,5,car,6,0,8534,29,446,310,566,370,120,60,car
38498,11,car,12,0,8534,21,2,326,62,377,60,51,car
38499,2,truck,3,0,8535,18,525,247,595,309,70,62,truck
38500,11,person,12,1,8535,19,145,248,163,313,18,65,person
38501,15,person,16,0,8535,25,95,258,116,315,21,57,person
38502,16,person,17,0,8535,18,115,264,135,311,20,47,person
38503,17,person,18,1,8535,27,0,244,35,376,35,132,person
38504,18,person,19,0,8535,18,56,266,68,305,12,39,person
38505,9,car,10,0,8536,56,7,116,123,191,116,75,car
38506,10,person,11,1,8536,17,118,129,130,183,12,54,person
38507,13,car,14,1,8536,16,182,127,199,168,17,41,car
38508,14,person,15,0,8536,16,176,124,183,144,7,20,person
38509,12,person,13,1,8537,58,1200,40,2146,1709,946,1669,person
38510,12,car,13,0,23447,15,19,344,62,360,43,16,car
38511,8,car,9,1,23448,30,530,480,699,560,169,80,car
38512,9,car,10,1,23448,15,228,479,315,562,87,83,car
38513,0,car,1,1,23449,18,609,0,766,74,157,74,car
38514,12,car,12,1,23450,17,318,228,409,311,91,83,car
38515,15,car,15,1,23450,46,488,147,1023,557,535,410,car
38516,17,person,17,0,23450,58,167,200,443,659,276,459,person
38517,4,person,5,1,23452,22,401,596,454,668,53,72,person
38518,10,truck,11,0,23453,19,630,499,721,533,91,34,truck
38519,16,car,17,1,23453,19,821,506,882,528,61,22,car
38520,17,car,18,1,23453,18,866,505,916,527,50,22,car
38521,21,car,22,0,23453,19,498,518,541,537,43,19,car
38522,23,car,24,0,23453,18,408,515,443,536,35,21,car
38523,25,car,26,0,23453,18,290,503,339,533,49,30,car
38524,27,car,28,0,23453,19,156,499,192,529,36,30,car
38525,28,person,29,0,23453,15,194,500,205,529,11,29,person
38526,0,car,1,0,23454,65,121,297,971,614,850,317,car
38527,11,car,12,1,23454,17,937,176,1024,215,87,39,car
38528,14,car,15,1,23454,17,687,197,748,230,61,33,car
38529,15,person,16,1,23454,25,746,185,765,228,19,43,person
38530,16,person,17,1,23454,24,783,182,807,225,24,43,person
38531,26,car,27,0,23454,22,468,206,519,237,51,31,car
38532,42,car,43,0,23454,17,270,211,286,225,16,14,car
38533,5,car,6,1,23455,17,2,625,142,681,140,56,car
38534,6,car,7,0,23455,21,43,637,191,699,148,62,car
38535,7,car,8,0,23455,29,621,625,850,727,229,102,car
38536,6,vase,7,0,8542,16,349,289,377,330,28,41,vase
38537,14,person,15,0,8542,40,160,370,215,465,55,95,person
38538,15,person,16,0,8542,33,54,337,100,448,46,111,person
38539,16,person,17,1,8542,34,23,328,72,446,49,118,person
38540,17,person,18,0,8542,25,407,346,433,421,26,75,person
38541,22,person,23,0,8542,25,392,393,415,463,23,70,person
38542,23,person,24,0,8542,26,441,342,465,424,24,82,person
38543,2,car,3,1,8548,18,0,222,66,248,66,26,car
38544,14,person,15,0,8548,18,137,208,144,233,7,25,person
38545,15,person,16,0,8548,27,111,213,127,257,16,44,person
38546,16,person,17,0,8548,27,97,213,112,256,15,43,person
38547,6,person,7,0,8551,26,925,993,975,1152,50,159,person
38548,5,person,6,1,8592,23,78,174,114,246,36,72,person
38549,6,person,7,0,8592,46,297,161,363,333,66,172,person
38550,7,person,8,0,8592,42,353,175,419,316,66,141,person
38551,8,bicycle,9,1,8592,23,0,244,113,333,113,89,bicycle
38552,9,bicycle,10,0,8592,53,461,250,629,371,168,121,bicycle
38553,11,bicycle,12,1,8592,23,420,233,490,311,70,78,bicycle
38554,14,person,15,0,8592,19,228,192,259,245,31,53,person
38555,10,person,11,0,8593,20,100,192,118,248,18,56,person
38556,11,person,12,0,8593,22,114,198,133,249,19,51,person
38557,12,person,13,0,8593,20,144,205,160,255,16,50,person
38558,14,car,15,1,8593,19,91,259,347,315,256,56,car
38559,5,car,6,0,8597,17,13,299,93,327,80,28,car
38560,2,person,3,1,25033,18,72,715,135,767,63,52,person
38561,3,car,4,1,25034,19,658,479,726,582,68,103,car
38562,4,car,5,1,25034,37,762,473,1024,599,262,126,car
38563,7,person,8,0,25034,46,781,399,842,600,61,201,person
38564,8,person,9,0,25034,47,705,396,781,596,76,200,person
38565,10,person,11,0,25034,41,528,353,592,597,64,244,person
38566,11,person,12,0,25034,51,475,341,525,597,50,256,person
38567,12,person,13,0,25034,43,439,342,507,597,68,255,person
38568,5,car,6,1,25035,15,804,524,1023,768,219,244,car
38569,6,car,7,1,25035,33,657,508,1000,760,343,252,car
38570,7,car,8,1,25035,26,2,530,355,766,353,236,car
38571,9,traffic light,10,0,25035,19,914,354,984,418,70,64,traffic light
38572,11,person,12,0,25035,30,151,428,182,518,31,90,person
38573,6,person,7,1,25036,27,7,584,69,751,62,167,person
38574,7,person,8,0,25036,34,1,587,73,751,72,164,person
38575,9,person,10,0,25036,26,702,597,739,722,37,125,person
38576,4,car,5,0,25038,18,918,467,992,498,74,31,car
38577,8,person,9,0,25038,26,849,457,869,506,20,49,person
38578,9,person,10,0,25038,20,843,471,852,506,9,35,person
38579,10,person,11,0,25038,23,799,442,822,528,23,86,person
38580,11,person,12,0,25038,41,495,440,534,572,39,132,person
38581,5,car,6,1,25039,24,802,417,1007,509,205,92,car
38582,9,plant pot,10,0,25039,19,730,552,774,598,44,46,potted plant
38583,5,person,6,0,25040,21,746,636,780,743,34,107,person
38584,6,person,7,0,25040,23,897,634,927,729,30,95,person
38585,7,person,8,0,25040,39,826,640,858,727,32,87,person
38586,8,person,9,1,25040,45,846,633,874,725,28,92,person
38587,9,person,10,1,25040,29,825,631,847,724,22,93,person
38588,10,person,11,0,25040,43,961,633,996,725,35,92,person
38589,9,person,10,0,25041,35,385,466,414,577,29,111,person
38590,11,person,12,0,25041,51,96,454,144,609,48,155,person
38591,12,person,13,0,25041,52,28,450,94,609,66,159,person
38592,5,car,6,1,8614,17,164,180,241,216,77,36,car
38593,6,car,7,0,8614,19,39,192,77,206,38,14,car
38594,9,car,10,0,8614,23,94,194,216,228,122,34,car
38595,8,car,9,0,8618,25,33,103,106,159,73,56,car
38596,9,person,10,1,8618,17,94,107,113,154,19,47,person
38597,5,person,6,1,8619,47,210,50,309,218,99,168,person
38598,28,person,29,1,8620,18,738,1558,798,1637,60,79,person
38599,5,car,6,1,8624,16,1397,631,1583,747,186,116,car
38600,6,car,7,0,8624,44,1011,620,1527,858,516,238,car
38601,7,car,8,0,8624,35,501,612,873,793,372,181,car
38602,6,car,7,0,8637,60,0,131,435,357,435,226,car
38603,10,person,11,0,8698,19,285,285,301,327,16,42,person
38604,11,person,12,0,8698,23,259,286,280,358,21,72,person
38605,6,door,7,0,8699,24,190,225,297,495,107,270,door
38606,7,door,8,0,8699,15,443,228,461,349,18,121,door
38607,12,chair,13,0,8700,18,222,439,268,512,46,73,chair
38608,13,chair,14,0,8700,20,276,444,321,509,45,65,chair
38609,7,dog,8,0,8702,24,219,165,247,198,28,33,dog
38610,7,person,8,0,8705,27,522,403,586,587,64,184,person
38611,8,person,9,0,8705,32,660,391,739,571,79,180,person
38612,9,person,10,1,8705,22,713,384,749,525,36,141,person
38613,10,person,11,1,8705,24,910,393,948,551,38,158,person
38614,11,person,12,1,8705,28,934,378,973,560,39,182,person
38615,12,person,13,1,8705,21,772,398,805,516,33,118,person
38616,13,person,14,0,8705,31,791,377,851,559,60,182,person
38617,14,person,15,1,8705,35,951,377,1023,585,72,208,person
38618,5,person,6,0,8714,46,443,166,504,383,61,217,person
38619,12,person,13,1,8714,28,259,240,312,341,53,101,person
38620,13,person,14,0,8714,31,301,213,367,365,66,152,person
38621,14,person,15,0,8714,37,377,172,424,295,47,123,person
38622,15,person,16,0,8714,24,506,174,532,241,26,67,person
38623,9,person,10,0,8715,50,216,93,312,354,96,261,person
38624,2,umbrella,3,1,8716,21,50,2,489,446,439,444,umbrella
38625,3,person,4,0,8716,42,100,132,201,388,101,256,person
38626,4,dog,5,0,8716,27,18,308,55,383,37,75,dog
38627,6,person,7,1,8717,29,266,57,327,184,61,127,person
38628,7,person,8,1,8717,36,184,35,285,264,101,229,person
38629,8,person,9,1,8717,43,71,54,143,265,72,211,person
38630,10,person,11,1,8717,22,3,71,27,159,24,88,person
38631,11,person,12,0,8717,37,12,68,64,214,52,146,person
38632,12,vegetables,13,0,8717,26,292,173,399,263,107,90,carrot
38633,9,person,10,0,8718,28,2,84,29,174,27,90,person
38634,10,person,11,0,8718,31,27,74,55,201,28,127,person
38635,11,person,12,1,8718,23,48,79,78,215,30,136,person
38636,19,person,20,1,8719,20,581,686,799,1202,218,516,person
38637,20,person,21,1,8719,27,152,855,312,1406,160,551,person
38638,7,vegetables,8,0,8720,23,362,338,523,479,161,141,carrot
38639,8,vegetables,9,0,8720,29,495,336,626,538,131,202,carrot
38640,9,vegetables,10,0,8720,28,321,94,501,294,180,200,carrot
38641,11,vegetables,12,0,8720,22,582,194,733,308,151,114,carrot
38642,14,vegetables,15,0,8720,53,373,501,774,763,401,262,carrot
38643,15,person,16,0,8720,58,766,161,1022,763,256,602,person
38644,17,vegetables,18,0,8720,20,27,377,188,476,161,99,carrot
38645,18,vegetables,19,0,8720,36,3,94,214,304,211,210,carrot
38646,20,vegetables,21,0,8720,16,754,173,876,270,122,97,carrot
38647,12,person,13,0,8748,26,8,286,38,356,30,70,person
38648,13,person,14,0,8748,23,391,281,408,327,17,46,person
38649,14,person,15,0,8748,18,416,285,428,329,12,44,person
38650,15,person,16,0,8748,15,426,287,440,328,14,41,person
38651,16,person,17,0,8748,20,476,286,493,328,17,42,person
38652,17,person,18,0,8748,17,502,287,515,327,13,40,person
38653,18,person,19,0,8748,19,533,282,542,324,9,42,person
38654,19,person,20,0,8748,20,545,280,558,319,13,39,person
38655,7,person,8,0,8758,43,191,61,248,187,57,126,person
38656,8,person,9,0,8758,35,38,67,75,182,37,115,person
38657,4,plant pot,5,0,25046,27,305,834,503,991,198,157,potted plant
38658,9,plant pot,10,0,25046,20,222,837,308,942,86,105,potted plant
38659,11,bench,12,0,25046,23,500,868,656,943,156,75,bench
38660,16,person,17,1,25046,41,60,764,114,964,54,200,person
38661,17,person,18,0,25046,37,78,858,135,981,57,123,person
38662,13,person,14,0,8764,27,232,107,249,155,17,48,person
38663,4,person,5,1,8767,30,322,80,437,292,115,212,person
38664,8,car,9,1,8767,21,471,161,672,303,201,142,car
38665,10,car,11,0,8767,31,577,231,1061,585,484,354,car
38666,15,window,16,0,8767,16,654,266,1022,376,368,110,window
38667,8,person,9,1,8771,16,157,160,198,208,41,48,person
38668,2,person,3,0,8772,32,222,130,270,299,48,169,person
38669,3,person,4,0,8773,34,643,894,959,1914,316,1020,person
38670,10,person,11,0,8789,31,1133,898,1487,1378,354,480,person
38671,12,person,13,1,8789,23,1239,604,1387,892,148,288,person
38672,14,person,15,0,8789,59,896,567,1105,1124,209,557,person
38673,2,boat,3,1,8791,72,0,0,2197,1463,2197,1463,boat
38674,6,person,7,1,8791,20,1786,290,1937,643,151,353,person
38675,7,person,8,1,8791,29,1577,154,1801,852,224,698,person
38676,3,person,4,1,8794,24,961,331,1195,665,234,334,person
38677,10,person,11,0,8795,25,901,680,967,882,66,202,person
38678,11,person,12,0,8795,26,722,673,816,872,94,199,person
38679,12,person,13,0,8795,23,437,510,482,666,45,156,person
38680,10,person,11,0,8828,20,586,713,614,779,28,66,person
38681,8,airplane,9,1,8875,15,319,155,393,172,74,17,airplane
38682,9,airplane,10,1,8875,18,168,151,257,175,89,24,airplane
38683,9,airplane,10,0,8876,33,166,427,653,563,487,136,airplane
38684,10,person,11,0,8876,20,766,494,787,568,21,74,person
38685,11,person,12,0,8876,22,793,485,813,572,20,87,person
38686,3,airplane,4,0,8877,53,169,1221,1171,1576,1002,355,airplane
38687,2,airplane,3,0,8878,72,90,338,1067,632,977,294,airplane
38688,3,car,4,0,8878,28,703,544,1022,639,319,95,car
38689,23,car,24,0,8879,21,1706,612,1864,672,158,60,car
38690,24,person,25,0,8879,15,1556,628,1576,665,20,37,person
38691,26,person,27,0,8879,15,2104,632,2124,682,20,50,person
38692,4,car,5,0,8880,53,1390,559,2043,894,653,335,car
38693,6,person,7,0,8880,19,97,641,197,870,100,229,person
38694,28,person,29,1,8880,15,693,773,747,862,54,89,person
38695,6,car,7,0,25049,146,246,197,2200,1580,1954,1383,car
38696,2,airplane,3,0,25050,67,0,240,1024,768,1024,528,airplane
38697,3,person,4,1,25050,16,450,294,531,384,81,90,person
38698,7,car,8,0,174,17,479,309,497,319,18,10,car
38699,14,person,15,1,174,19,301,334,350,368,49,34,person
38700,16,boat,17,0,585,20,12,121,97,151,85,30,boat
38701,17,boat,18,0,585,18,83,130,175,151,92,21,boat
38702,19,boat,20,0,585,25,210,126,333,148,123,22,boat
38703,0,boat,1,0,8882,33,925,6,1578,1008,653,1002,boat
38704,3,boat,4,0,8882,16,1200,1101,1372,1268,172,167,boat
38705,4,boat,5,0,8882,51,1375,1119,1709,1429,334,310,boat
38706,11,boat,12,0,8882,29,459,709,894,950,435,241,boat
38707,14,boat,15,0,8882,15,375,693,676,861,301,168,boat
38708,17,car,18,0,8882,15,167,660,330,711,163,51,car
38709,0,boat,1,0,8883,22,289,458,733,629,444,171,boat
38710,1,boat,2,0,8884,25,279,6,1738,1354,1459,1348,boat
38711,4,boat,5,1,8884,39,278,702,975,1059,697,357,boat
38712,8,boat,9,1,8884,22,88,402,478,1009,390,607,boat
38713,0,boat,1,0,8885,66,204,895,714,1279,510,384,boat
38714,9,boat,10,0,8885,39,1416,517,1902,1095,486,578,boat
38715,11,boat,12,0,8885,20,654,917,1239,1151,585,234,boat
38716,12,boat,13,1,8885,17,7,291,189,1149,182,858,boat
38717,8,boat,9,0,8886,15,573,1018,834,1155,261,137,boat
38718,19,boat,20,0,8886,16,1038,737,1255,896,217,159,boat
38719,3,boat,4,0,8887,40,1108,846,1646,1259,538,413,boat
38720,5,boat,6,0,8887,15,652,1123,960,1254,308,131,boat
38721,6,boat,7,0,8887,18,342,1117,702,1255,360,138,boat
38722,7,boat,8,1,8887,24,2,546,198,1226,196,680,boat
38723,9,boat,10,1,8887,19,1620,611,1730,1141,110,530,boat
38724,6,boat,7,0,8888,19,285,9,436,189,151,180,boat
38725,9,boat,10,0,8888,20,112,4,288,184,176,180,boat
38726,25,boat,26,0,8889,22,185,650,568,829,383,179,boat
38727,0,boat,1,0,8890,18,145,552,624,1166,479,614,boat
38728,1,boat,2,0,8890,30,979,643,1925,1220,946,577,boat
38729,12,boat,13,0,8890,16,668,843,1052,1114,384,271,boat
38730,14,person,15,1,8890,22,963,537,999,638,36,101,person
38731,15,person,16,0,8890,20,1149,569,1209,637,60,68,person
38732,16,person,17,1,8890,19,696,529,732,616,36,87,person
38733,17,person,18,1,8890,20,713,457,753,555,40,98,person
38734,18,person,19,1,8890,25,856,577,915,637,59,60,person
38735,19,person,20,1,8890,21,766,543,798,640,32,97,person
38736,20,person,21,1,8890,24,749,530,780,638,31,108,person
38737,21,person,22,1,8890,24,783,525,806,638,23,113,person
38738,22,person,23,0,8890,33,170,533,222,647,52,114,person
38739,25,table,26,0,8890,26,1359,719,1463,796,104,77,dining table
38740,26,chair,27,1,8890,16,1258,699,1337,759,79,60,chair
38741,2,boat,3,0,8891,19,1156,6,1885,1162,729,1156,boat
38742,9,boat,10,0,8891,23,48,556,311,763,263,207,boat
38743,10,boat,11,1,8891,25,177,817,670,1077,493,260,boat
38744,11,person,12,1,8891,16,305,826,381,923,76,97,person
38745,18,person,19,0,8891,37,1059,1057,1160,1376,101,319,person
38746,19,person,20,0,8891,39,1446,974,1563,1264,117,290,person
38747,20,person,21,0,8891,40,1897,968,2029,1229,132,261,person
38748,28,boat,29,1,8891,15,1051,610,1233,747,182,137,boat
38749,9,boat,10,0,8892,17,1760,966,2049,1113,289,147,boat
38750,13,person,14,0,8892,26,915,935,940,982,25,47,person
38751,0,boat,1,0,8893,18,381,252,938,1058,557,806,boat
38752,9,boat,10,0,8893,26,1197,307,1731,1076,534,769,boat
38753,11,boat,12,0,8893,15,116,788,418,901,302,113,boat
38754,0,boat,1,0,8894,22,1393,926,1962,1221,569,295,boat
38755,3,boat,4,0,8894,24,598,786,1040,1028,442,242,boat
38756,4,boat,5,0,8894,18,319,843,697,1053,378,210,boat
38757,5,boat,6,0,8894,19,978,618,1309,719,331,101,boat
38758,6,boat,7,0,8894,23,1065,763,1308,960,243,197,boat
38759,9,boat,10,0,8894,16,1247,755,1447,939,200,184,boat
38760,15,car,14,0,8894,18,1448,212,1506,238,58,26,car
38761,16,car,15,0,8894,17,1601,211,1675,238,74,27,car
38762,27,car,26,0,8894,18,1706,220,1765,242,59,22,car
38763,28,car,27,0,8894,16,1786,219,1842,243,56,24,car
38764,29,car,28,0,8894,15,1941,222,2007,248,66,26,car
38765,35,boat,34,0,8894,34,2,332,162,492,160,160,boat
38766,36,boat,35,0,8894,34,337,361,563,477,226,116,boat
38767,40,boat,39,0,8894,34,1054,327,1246,448,192,121,boat
38768,41,boat,40,1,8894,15,73,329,137,385,64,56,boat
38769,44,boat,43,1,8894,20,296,260,404,360,108,100,boat
38770,45,person,44,0,8894,22,589,346,615,412,26,66,person
38771,50,boat,49,1,8894,21,1196,339,1362,429,166,90,boat
38772,51,boat,50,0,8894,22,1275,343,1534,430,259,87,boat
38773,53,boat,52,0,8894,29,1500,347,1713,416,213,69,boat
38774,55,boat,54,1,8894,19,1792,321,2005,401,213,80,boat
38775,56,boat,55,0,8894,25,1195,601,1384,713,189,112,boat
38776,59,boat,58,1,8894,22,585,265,699,310,114,45,boat
38777,6,boat,7,1,8895,19,0,127,138,180,138,53,boat
38778,7,boat,8,1,8895,27,0,128,241,233,241,105,boat
38779,9,chair,10,0,8895,16,83,104,119,138,36,34,chair
38780,11,table,12,0,8895,16,36,104,96,140,60,36,dining table
38781,22,table,23,0,8896,15,592,388,640,421,48,33,dining table
38782,23,chair,24,0,8896,16,662,389,692,424,30,35,chair
38783,9,boat,10,0,8898,17,441,688,1489,955,1048,267,boat
38784,5,boat,6,1,8901,16,0,171,115,215,115,44,boat
38785,6,boat,7,1,8901,20,2,162,134,200,132,38,boat
38786,8,boat,9,1,8901,21,2,141,159,172,157,31,boat
38787,10,boat,11,1,8901,43,5,71,227,152,222,81,boat
38788,11,boat,12,1,8901,36,176,56,255,153,79,97,boat
38789,12,boat,13,1,8901,27,138,37,198,123,60,86,boat
38790,13,boat,14,1,8901,22,5,62,66,112,61,50,boat
38791,0,boat,1,0,8902,25,32,21,143,240,111,219,boat
38792,1,boat,2,0,8902,20,152,11,227,223,75,212,boat
38793,9,boat,10,1,8902,19,4,165,53,194,49,29,boat
38794,11,boat,12,1,8902,15,51,176,90,198,39,22,boat
38795,3,boat,4,0,23494,56,795,25,1023,325,228,300,boat
38796,4,boat,5,0,23494,68,180,51,632,380,452,329,boat
38797,5,boat,6,0,23494,59,1,2,263,391,262,389,boat
38798,1,boat,2,1,23495,16,335,0,504,87,169,87,boat
38799,7,person,8,0,23495,30,402,129,449,203,47,74,person
38800,3,boat,4,0,23496,40,835,397,1024,653,189,256,boat
38801,4,boat,5,0,23496,28,646,498,826,653,180,155,boat
38802,5,boat,6,1,23496,20,591,503,670,636,79,133,boat
38803,6,boat,7,0,23496,23,444,482,617,644,173,162,boat
38804,7,boat,8,0,23496,22,363,494,472,633,109,139,boat
38805,13,boat,14,0,23496,31,119,465,346,642,227,177,boat
38806,17,boat,18,1,23497,21,576,333,713,364,137,31,boat
38807,10,boat,11,0,23498,51,288,298,664,636,376,338,boat
38808,11,boat,12,1,23498,19,405,565,664,658,259,93,boat
38809,12,boat,13,0,23498,19,485,597,735,682,250,85,boat
38810,2,boat,3,0,23499,118,277,253,925,569,648,316,boat
38811,3,boat,4,1,23500,17,169,624,657,1024,488,400,boat
38812,7,boat,8,0,23501,18,897,308,944,323,47,15,boat
38813,1,boat,2,0,23502,29,364,129,730,806,366,677,boat
38814,6,person,7,0,23502,59,523,538,691,888,168,350,person
38815,7,person,8,1,23502,83,284,489,443,944,159,455,person
38816,8,person,9,0,23502,85,160,374,397,1024,237,650,person
38817,9,person,10,1,23502,73,1,266,204,987,203,721,person
38818,13,person,14,0,23502,23,583,250,619,326,36,76,person
38819,17,person,18,1,23502,17,473,252,508,287,35,35,person
38820,3,boat,4,0,23503,130,89,183,971,525,882,342,boat
38821,14,door,15,0,8970,16,643,388,967,831,324,443,door
38822,15,window,16,0,8970,15,734,427,938,669,204,242,window
38823,8,person,9,0,8971,87,752,705,1106,1529,354,824,person
38824,14,window,15,0,8972,16,1385,778,1554,887,169,109,window
38825,1,airplane,2,1,8973,30,0,480,165,607,165,127,airplane
38826,0,person,1,1,8974,46,79,308,186,563,107,255,person
38827,1,person,2,1,8974,52,287,290,397,526,110,236,person
38828,3,person,4,0,8974,49,674,301,748,457,74,156,person
38829,12,person,13,1,8974,37,736,288,793,434,57,146,person
38830,4,truck,5,1,8976,42,53,346,542,575,489,229,truck
38831,6,person,7,0,8976,40,686,299,785,495,99,196,person
38832,4,person,5,0,8977,18,5,84,19,150,14,66,person
38833,5,person,6,0,8977,19,20,86,43,145,23,59,person
38834,10,car,11,1,8977,28,159,185,315,254,156,69,car
38835,12,person,13,0,8977,19,339,92,367,149,28,57,person
38836,1,airplane,2,0,23508,77,12,225,1008,447,996,222,airplane
38837,1,airplane,2,0,23509,112,113,77,911,618,798,541,airplane
38838,4,airplane,5,0,23510,88,151,343,1278,729,1127,386,airplane
38839,4,airplane,5,0,23512,19,105,474,214,501,109,27,airplane
38840,5,airplane,6,0,23512,25,924,459,1023,489,99,30,airplane
38841,6,airplane,7,0,23512,21,778,462,864,493,86,31,airplane
38842,7,airplane,8,0,23512,21,851,467,916,495,65,28,airplane
38843,3,airplane,4,0,23514,76,88,275,802,591,714,316,airplane
38844,4,airplane,5,0,23514,15,922,290,989,312,67,22,airplane
38845,1,airplane,2,0,23515,61,55,286,962,492,907,206,airplane
38846,3,car,4,1,176,17,719,1,875,84,156,83,car
38847,4,car,5,1,176,85,1,60,747,292,746,232,car
38848,5,motorbike,6,1,176,94,303,165,755,406,452,241,motorcycle
38849,6,person,7,1,176,62,424,49,647,276,223,227,person
38850,7,backpack,8,0,176,24,393,100,547,198,154,98,backpack
38851,8,car,9,1,176,35,1,136,625,492,624,356,car
38852,23,door,24,1,176,22,212,95,411,243,199,148,door
38853,14,car,15,0,177,36,399,169,492,239,93,70,car
38854,24,car,25,1,177,21,443,94,492,121,49,27,car
38855,25,car,26,0,177,30,441,104,504,155,63,51,car
38856,41,car,42,0,177,19,208,229,309,300,101,71,car
38857,44,truck,45,0,177,27,224,147,309,234,85,87,truck
38858,45,car,46,0,177,19,441,26,486,56,45,30,car
38859,46,car,47,1,177,20,400,9,433,39,33,30,car
38860,47,car,48,1,177,15,386,16,420,44,34,28,car
38861,48,car,49,1,177,20,373,29,408,60,35,31,car
38862,49,car,50,1,177,17,384,39,421,62,37,23,car
38863,50,car,51,1,177,21,383,47,422,83,39,36,car
38864,51,car,52,0,177,31,398,54,446,95,48,41,car
38865,58,car,59,1,177,17,347,0,387,28,40,28,car
38866,61,car,62,0,177,16,267,0,299,24,32,24,car
38867,64,car,65,1,177,24,302,33,343,68,41,35,car
38868,68,car,69,1,177,22,306,53,357,105,51,52,car
38869,73,car,74,0,177,23,322,73,374,114,52,41,car
38870,81,truck,82,1,177,20,203,0,248,36,45,36,truck
38871,82,car,83,1,177,18,223,10,253,43,30,33,car
38872,83,car,84,1,177,17,207,27,246,60,39,33,car
38873,88,car,89,0,177,19,217,49,262,86,45,37,car
38874,97,car,98,1,177,16,153,5,186,35,33,30,car
38875,104,car,105,1,177,19,82,143,142,203,60,60,car
38876,110,car,111,1,177,19,0,48,42,87,42,39,car
38877,112,car,113,1,177,15,3,2,24,29,21,27,car
38878,3,car,4,0,178,46,257,5,352,59,95,54,car
38879,4,door,5,0,178,15,319,15,352,50,33,35,door
38880,12,car,13,1,178,22,253,0,279,24,26,24,car
38881,13,car,14,1,178,17,243,0,266,21,23,21,car
38882,15,truck,16,1,178,21,187,1,225,30,38,29,truck
38883,16,truck,17,1,178,99,0,0,135,48,135,48,truck
38884,17,person,18,1,178,43,19,0,55,65,36,65,person
38885,18,person,19,1,178,44,56,1,91,61,35,60,person
38886,19,person,20,1,178,37,99,0,123,41,24,41,person
38887,20,person,21,0,178,32,157,1,168,30,11,29,person
38888,21,person,22,1,178,22,171,1,180,28,9,27,person
38889,22,person,23,1,178,24,177,1,190,32,13,31,person
38890,24,motorbike,25,0,178,137,116,20,377,284,261,264,motorcycle
38891,0,truck,1,0,179,58,1,62,350,225,349,163,truck
38892,0,car,1,0,8989,30,1504,965,1796,1168,292,203,car
38893,2,car,3,0,8992,22,1161,1087,1270,1172,109,85,car
38894,8,car,8,0,8992,22,175,1066,278,1131,103,65,car
38895,9,car,9,0,8992,20,344,1075,427,1126,83,51,car
38896,10,car,10,0,8992,17,459,1091,526,1118,67,27,car
38897,46,person,46,0,8994,28,1291,966,1354,1087,63,121,person
38898,47,motorbike,47,1,8994,19,1303,1032,1358,1113,55,81,motorcycle
38899,27,truck,22,0,8995,15,1172,868,1218,891,46,23,truck
38900,15,car,16,0,8997,17,937,1106,1030,1188,93,82,car
38901,0,car,1,0,8998,33,643,800,1118,1141,475,341,car
38902,1,car,2,0,8998,25,1394,874,1591,1019,197,145,car
38903,3,car,4,1,8998,26,1565,888,1707,999,142,111,car
38904,4,car,5,1,8998,15,1928,901,2041,992,113,91,car
38905,33,door,33,0,8998,18,976,808,1059,1062,83,254,door
38906,35,door,35,0,8998,18,1007,814,1097,1060,90,246,door
38907,12,car,13,1,8999,19,1896,1258,2135,1372,239,114,car
38908,29,car,30,1,8999,15,1161,1241,1263,1331,102,90,car
38909,30,car,31,0,8999,25,1246,1215,1555,1421,309,206,car
38910,35,car,36,0,8999,21,867,1243,956,1316,89,73,car
38911,36,car,37,0,8999,17,973,1248,1123,1370,150,122,car
38912,39,car,40,0,8999,30,309,1179,715,1436,406,257,car
38913,59,car,60,1,9000,15,1183,1293,1234,1357,51,64,car
38914,60,car,61,0,9000,29,1221,1274,1345,1380,124,106,car
38915,61,car,62,0,9000,39,1329,1277,1624,1453,295,176,car
38916,77,car,78,0,9000,20,944,1268,1077,1385,133,117,car
38917,84,car,85,0,9000,31,164,1255,475,1404,311,149,car
38918,85,car,86,0,9000,35,613,1242,843,1405,230,163,car
38919,2,car,3,0,9001,52,1039,1058,1472,1387,433,329,car
38920,0,truck,1,0,9003,38,112,292,1535,894,1423,602,truck
38921,14,car,15,0,9004,17,1247,1246,1347,1313,100,67,car
38922,21,car,22,0,9004,26,881,1236,1000,1328,119,92,car
38923,28,car,29,0,9004,26,704,1237,818,1315,114,78,car
38924,52,car,53,0,9004,32,158,1225,386,1337,228,112,car
38925,23,car,21,0,9005,53,379,922,1147,1398,768,476,car
38926,52,car,50,1,9005,15,270,809,302,851,32,42,car
38927,4,car,5,1,9007,16,401,1195,538,1269,137,74,car
38928,5,car,6,0,9007,21,520,1198,656,1271,136,73,car
38929,12,car,13,0,9007,21,754,1190,857,1256,103,66,car
38930,16,person,17,0,9007,15,1890,1152,1914,1218,24,66,person
38931,23,car,24,0,9007,16,898,1198,973,1243,75,45,car
38932,35,car,36,0,9007,21,1348,1166,1533,1321,185,155,car
38933,5,truck,6,1,9014,15,0,129,41,178,41,49,truck
38934,7,truck,8,0,9014,33,133,129,212,220,79,91,truck
38935,2,car,3,0,9019,27,112,165,180,219,68,54,car
38936,3,car,4,0,9019,18,194,181,256,240,62,59,car
38937,6,bus,7,0,9019,17,37,62,91,115,54,53,bus
38938,7,car,8,0,9019,23,9,106,46,139,37,33,car
38939,8,car,9,0,9019,16,80,111,116,135,36,24,car
38940,10,car,11,0,9019,19,139,90,174,118,35,28,car
38941,6,car,7,0,9026,17,45,170,88,195,43,25,car
38942,11,person,11,0,9027,19,182,122,191,148,9,26,person
38943,12,car,13,1,9030,15,322,318,347,340,25,22,car
38944,13,car,14,0,9030,17,345,313,382,344,37,31,car
38945,14,car,15,0,9030,22,449,324,499,355,50,31,car
38946,15,car,16,0,9030,29,496,323,567,371,71,48,car
38947,22,car,23,0,9030,18,163,314,253,388,90,74,car
38948,25,car,26,1,9030,19,98,304,147,348,49,44,car
38949,26,car,27,0,9030,29,14,310,103,369,89,59,car
38950,0,car,1,0,9031,22,34,156,69,183,35,27,car
38951,3,traffic light,4,0,9033,45,2,56,256,89,254,33,traffic light
38952,12,car,13,0,9033,15,172,154,206,179,34,25,car
38953,9,car,10,0,9034,20,19,133,73,165,54,32,car
38954,14,car,15,0,9038,18,34,163,86,196,52,33,car
38955,8,car,9,0,9039,16,155,131,202,152,47,21,car
38956,5,car,6,0,9040,22,35,118,73,145,38,27,car
38957,7,car,8,0,9040,21,78,117,121,150,43,33,car
38958,0,truck,1,0,9049,19,0,90,95,588,95,498,truck
38959,0,car,1,0,9053,17,112,140,139,156,27,16,car
38960,5,car,6,0,9053,15,198,153,231,176,33,23,car
38961,5,car,6,0,9055,18,175,146,198,162,23,16,car
38962,5,truck,6,0,9056,15,127,120,154,141,27,21,truck
38963,0,car,1,0,9057,17,143,120,228,182,85,62,car
38964,8,car,9,0,9059,18,156,182,204,228,48,46,car
38965,9,bus,10,1,9059,16,132,177,162,211,30,34,bus
38966,13,car,14,0,9064,17,182,146,215,168,33,22,car
38967,12,car,13,0,9068,16,37,144,69,167,32,23,car
38968,7,car,8,0,9070,19,68,131,100,146,32,15,car
38969,9,car,10,0,9070,17,87,145,120,161,33,16,car
38970,13,car,14,0,9070,17,156,156,219,174,63,18,car
38971,17,car,18,0,9070,18,41,127,68,142,27,15,car
38972,7,car,8,0,9071,36,124,142,245,201,121,59,car
38973,11,car,12,0,9072,19,21,160,94,203,73,43,car
38974,14,car,15,0,9072,15,103,163,132,184,29,21,car
38975,3,truck,4,0,9074,20,137,140,158,161,21,21,truck
38976,3,truck,4,0,9075,34,21,136,97,180,76,44,truck
38977,9,person,10,0,9078,17,228,186,239,211,11,25,person
38978,0,car,1,0,9080,20,166,137,211,162,45,25,car
38979,1,car,2,0,9080,31,13,137,107,180,94,43,car
38980,3,car,4,0,9080,17,231,133,253,146,22,13,car
38981,17,car,18,0,9080,15,103,135,147,155,44,20,car
38982,17,car,18,0,9084,15,74,187,97,208,23,21,car
38983,20,car,21,0,9084,16,179,200,218,224,39,24,car
38984,3,car,4,0,9085,18,43,144,86,170,43,26,car
38985,7,car,8,0,9091,30,257,102,324,161,67,59,car
38986,1,motorbikes,2,0,9093,121,0,154,1380,1437,1380,1283,motorcycle
38987,1,car,2,0,9098,16,190,132,256,187,66,55,car
38988,0,car,1,0,9100,17,76,161,95,175,19,14,car
38989,8,car,9,0,9101,21,11,157,65,180,54,23,car
38990,15,car,16,0,9101,15,170,150,200,169,30,19,car
38991,20,car,21,0,9101,19,87,159,144,191,57,32,car
38992,34,car,35,1,9106,19,142,174,177,211,35,37,car
38993,39,car,40,1,9106,15,189,148,210,172,21,24,car
38994,16,car,17,0,9110,17,37,139,79,169,42,30,car
38995,0,truck,1,0,9111,19,145,84,232,195,87,111,truck
38996,1,car,2,0,9119,15,191,94,220,113,29,19,car
38997,4,person,5,0,9119,39,222,93,253,189,31,96,person
38998,11,traffic light,12,0,9119,17,131,74,144,111,13,37,traffic light
38999,0,car,1,0,9121,20,58,131,100,178,42,47,car
39000,1,car,2,0,9121,22,138,111,178,148,40,37,car
39001,3,car,4,1,9121,18,221,127,256,174,35,47,car
39002,4,car,5,0,9121,17,158,54,182,71,24,17,car
39003,5,bus,6,0,9121,15,130,21,148,43,18,22,bus
39004,6,car,7,0,9121,19,37,66,62,86,25,20,car
39005,7,car,8,0,9122,16,74,140,105,167,31,27,car
39006,8,car,9,0,9122,15,41,141,70,161,29,20,car
39007,12,person,13,0,9127,15,7,156,17,182,10,26,person
39008,4,traffic light,5,0,9131,15,43,112,52,184,9,72,traffic light
39009,9,traffic light,10,0,9131,22,172,54,248,125,76,71,traffic light
39010,13,car,14,0,9136,15,156,160,191,197,35,37,car
39011,13,car,14,0,9137,22,6,131,44,153,38,22,car
39012,14,car,15,0,9137,17,76,128,106,143,30,15,car
39013,16,car,17,0,9137,24,101,180,148,215,47,35,car
39014,17,car,18,0,9137,21,127,147,162,168,35,21,car
39015,19,car,20,0,9137,15,186,124,212,141,26,17,car
39016,20,car,21,0,9137,16,214,125,241,141,27,16,car
39017,22,car,23,0,9137,21,189,165,228,192,39,27,car
39018,23,car,24,0,9137,21,214,199,256,236,42,37,car
39019,24,car,25,0,9137,18,2,196,59,236,57,40,car
39020,26,car,27,0,9137,16,173,147,205,168,32,21,car
39021,17,car,18,1,9141,16,158,186,207,229,49,43,car
39022,4,car,5,0,9145,18,204,144,250,170,46,26,car
39023,11,car,12,0,9146,16,67,190,116,233,49,43,car
39024,1,car,2,0,9152,21,2,133,88,185,86,52,car
39025,3,car,4,0,9153,18,0,170,31,183,31,13,car
39026,4,car,5,0,9156,21,11,161,67,191,56,30,car
39027,9,car,10,0,9157,15,30,186,74,219,44,33,car
39028,4,truck,5,0,9160,15,77,157,98,173,21,16,truck
39029,2,truck,3,1,9163,15,53,181,94,198,41,17,truck
39030,4,truck,5,0,9164,18,199,293,237,330,38,37,truck
39031,2,car,3,0,9165,16,118,121,143,137,25,16,car
39032,10,car,11,0,9168,18,44,134,68,151,24,17,car
39033,11,car,12,0,9173,19,29,176,74,208,45,32,car
39034,11,truck,12,0,9176,20,36,120,95,177,59,57,truck
39035,14,car,15,0,9176,18,85,212,137,247,52,35,car
39036,8,car,9,0,9177,19,83,182,145,223,62,41,car
39037,1,car,2,0,9179,17,457,869,793,1089,336,220,car
39038,3,car,4,0,9182,19,103,140,154,168,51,28,car
39039,10,car,11,0,9183,19,64,146,105,174,41,28,car
39040,9,car,10,0,9184,35,0,158,101,216,101,58,car
39041,14,car,15,0,9186,16,19,142,50,165,31,23,car
39042,6,car,7,0,9189,22,388,249,476,337,88,88,car
39043,7,car,8,0,9189,17,242,301,337,402,95,101,car
39044,8,car,9,0,9189,15,4,96,59,144,55,48,car
39045,7,car,8,0,9195,22,137,137,205,184,68,47,car
39046,10,car,11,1,9197,18,72,198,103,223,31,25,car
39047,11,car,12,0,9197,20,277,147,315,172,38,25,car
39048,2,truck,3,0,9198,16,16,159,48,180,32,21,truck
39049,4,person,5,0,9199,16,125,178,133,200,8,22,person
39050,10,car,11,1,9199,15,61,174,104,196,43,22,car
39051,15,car,16,0,9199,15,161,177,194,203,33,26,car
39052,12,traffic light,13,0,9201,29,53,36,81,67,28,31,traffic light
39053,1,truck,2,0,9202,16,194,136,239,158,45,22,truck
39054,2,car,3,0,9208,20,31,173,65,195,34,22,car
39055,5,car,6,0,9209,18,59,143,110,176,51,33,car
39056,7,car,8,0,9212,20,74,132,103,150,29,18,car
39057,19,car,20,1,9214,18,2,165,50,224,48,59,car
39058,33,car,34,0,9215,24,384,317,437,365,53,48,car
39059,7,truck,8,0,9216,32,177,102,256,144,79,42,truck
39060,0,car,1,0,9223,29,39,189,134,249,95,60,car
39061,2,car,3,0,9223,23,75,120,123,146,48,26,car
39062,5,car,6,0,9223,18,186,106,227,128,41,22,car
39063,9,car,10,1,9223,16,0,111,26,136,26,25,car
39064,11,car,12,0,9223,19,105,83,137,106,32,23,car
39065,13,truck,14,0,9223,22,156,54,205,82,49,28,truck
39066,14,car,15,0,9223,17,201,67,224,82,23,15,car
39067,16,car,17,0,9223,15,228,61,247,75,19,14,car
39068,21,traffic light,22,0,9223,18,2,3,134,26,132,23,traffic light
39069,5,car,6,0,9231,23,117,144,156,168,39,24,car
39070,6,car,7,0,9231,22,161,149,214,172,53,23,car
39071,10,traffic light,11,0,9231,16,3,104,18,153,15,49,traffic light
39072,17,car,18,0,9231,15,212,152,234,169,22,17,car
39073,6,car,7,0,9234,18,44,134,103,194,59,60,car
39074,18,car,19,0,9234,15,115,189,181,241,66,52,car
39075,12,car,13,0,9237,18,186,147,228,175,42,28,car
39076,12,truck,13,0,9238,16,123,82,154,123,31,41,truck
39077,22,car,23,0,9238,15,199,191,242,232,43,41,car
39078,24,car,25,0,9238,18,37,170,78,204,41,34,car
39079,25,car,26,0,9238,19,6,210,60,255,54,45,car
39080,11,car,12,0,9242,15,37,172,53,185,16,13,car
39081,7,truck,8,1,9245,17,63,108,107,160,44,52,truck
39082,14,car,15,1,9245,15,202,183,255,227,53,44,car
39083,30,car,31,0,9245,26,35,202,99,256,64,54,car
39084,16,car,17,0,9247,37,13,158,109,216,96,58,car
39085,0,car,1,0,9250,29,284,324,422,421,138,97,car
39086,9,car,10,0,9255,15,195,128,230,153,35,25,car
39087,10,car,11,0,9258,16,0,145,49,187,49,42,car
39088,1,truck,2,0,9271,19,812,400,1023,575,211,175,truck
39089,2,car,3,0,9271,17,471,454,677,623,206,169,car
39090,1,car,2,0,9276,27,419,481,617,644,198,163,car
39091,14,car,12,0,9281,17,405,537,499,620,94,83,car
39092,3,car,4,0,23518,25,52,517,161,571,109,54,car
39093,13,car,14,0,23518,18,452,515,471,531,19,16,car
39094,5,bus,6,0,23520,18,606,340,648,389,42,49,bus
39095,6,bus,7,0,23520,52,419,274,604,431,185,157,bus
39096,1,truck,2,0,23521,27,25,134,188,380,163,246,truck
39097,9,bus,10,0,23521,31,519,302,629,329,110,27,bus
39098,21,car,22,0,23521,29,660,325,724,369,64,44,car
39099,22,car,23,0,23521,15,284,305,299,318,15,13,car
39100,5,car,6,0,23522,40,398,147,538,260,140,113,car
39101,6,car,7,0,23522,43,294,236,466,393,172,157,car
39102,7,car,8,1,23522,36,110,122,269,218,159,96,car
39103,8,car,9,0,23522,48,71,183,239,334,168,151,car
39104,5,horse,6,0,23523,143,990,626,1260,810,270,184,horse
39105,6,horse,7,1,23523,68,842,670,992,797,150,127,horse
39106,7,horse,8,0,23523,109,728,640,1023,806,295,166,horse
39107,8,horse,9,1,23523,40,118,197,264,269,146,72,horse
39108,9,horse,10,1,23523,20,208,226,269,280,61,54,horse
39109,5,car,6,0,23524,24,1057,768,1134,802,77,34,car
39110,8,person,9,0,23526,26,493,330,518,395,25,65,person
39111,10,car,11,0,23526,17,406,313,437,338,31,25,car
39112,11,car,12,0,23526,20,141,307,168,325,27,18,car
39113,12,car,13,0,23526,17,246,300,268,319,22,19,car
39114,12,car,13,0,23527,15,475,521,485,527,10,6,car
39115,3,car,4,0,23528,69,572,328,851,523,279,195,car
39116,4,car,5,0,23528,35,320,346,408,413,88,67,car
39117,5,car,6,0,23528,20,266,352,307,383,41,31,car
39118,6,car,7,0,23528,16,217,352,238,369,21,17,car
39119,10,car,11,1,23529,25,303,382,322,405,19,23,car
39120,11,car,12,0,23529,33,318,371,363,418,45,47,car
39121,2,person,3,0,23530,148,38,106,652,1021,614,915,person
39122,4,car,5,1,23530,29,511,274,764,518,253,244,car
39123,7,car,8,0,23531,30,158,643,275,735,117,92,car
39124,8,truck,9,0,23531,24,382,606,453,677,71,71,truck
39125,3,person,4,0,9441,36,357,219,408,359,51,140,person
39126,4,person,5,1,9441,30,423,232,480,367,57,135,person
39127,5,person,6,0,9441,21,444,289,479,370,35,81,person
39128,7,person,8,1,9441,21,40,109,64,221,24,112,person
39129,10,person,11,1,9441,18,11,120,42,203,31,83,person
39130,6,car,7,0,9443,23,278,241,339,272,61,31,car
39131,7,car,8,0,9443,17,71,251,108,265,37,14,car
39132,8,car,9,0,9443,17,36,251,67,263,31,12,car
39133,2,car,3,0,9444,17,117,209,151,221,34,12,car
39134,3,car,4,0,9444,16,152,208,176,222,24,14,car
39135,9,person,10,0,9444,19,233,211,249,234,16,23,person
39136,10,person,11,0,9444,17,250,202,260,239,10,37,person
39137,2,car,3,0,9449,17,258,213,295,226,37,13,car
39138,6,car,7,0,9449,16,9,225,35,242,26,17,car
39139,2,car,3,0,9452,22,172,179,229,201,57,22,car
39140,3,car,4,0,23544,24,20,329,150,386,130,57,car
39141,5,car,6,0,23544,32,273,328,408,442,135,114,car
39142,12,bus,13,1,23545,18,118,617,191,644,73,27,bus
39143,14,car,15,0,23545,28,197,656,285,731,88,75,car
39144,26,person,27,0,23545,18,127,640,138,664,11,24,person
39145,28,car,29,0,23545,40,647,652,771,703,124,51,car
39146,29,motorbike,30,0,23545,33,808,659,867,697,59,38,motorcycle
39147,30,traffic light,31,0,23545,16,750,606,775,690,25,84,traffic light
39148,32,motorbike,33,1,23545,18,498,658,509,692,11,34,motorcycle
39149,33,car,34,1,23545,21,486,647,524,682,38,35,car
39150,11,person,12,1,23547,16,894,788,924,843,30,55,person
39151,7,car,8,1,23548,17,471,433,535,466,64,33,car
39152,13,car,14,0,23548,31,200,416,287,457,87,41,car
39153,15,car,16,1,23548,20,170,422,210,453,40,31,car
39154,16,car,17,0,23548,29,118,417,183,454,65,37,car
39155,17,car,18,0,23548,25,81,424,139,459,58,35,car
39156,18,car,19,1,23548,16,64,421,112,449,48,28,car
39157,21,car,21,1,23548,19,0,417,56,445,56,28,car
39158,23,car,23,0,23548,21,10,423,66,457,56,34,car
39159,11,car,12,0,9500,31,235,328,374,396,139,68,car
39160,7,table,8,0,9503,26,137,260,201,324,64,64,dining table
39161,9,table,10,0,9503,15,200,240,240,277,40,37,dining table
39162,14,vase,15,0,9503,23,388,174,425,237,37,63,vase
39163,15,vase,16,0,9503,18,287,180,307,221,20,41,vase
39164,3,flowerpot,4,0,9506,17,110,180,145,222,35,42,potted plant
39165,13,car,14,0,9507,23,411,293,531,333,120,40,car
39166,3,car,4,0,9508,25,49,699,375,796,326,97,car
39167,6,person,7,0,9508,16,482,669,515,743,33,74,person
39168,7,person,8,0,9508,17,457,663,481,737,24,74,person
39169,9,person,10,1,9508,17,37,675,70,754,33,79,person
39170,29,door,30,0,9508,19,178,703,253,780,75,77,door
39171,4,umbrella,5,0,25051,20,344,195,503,308,159,113,umbrella
39172,7,plant pot,8,0,25051,22,732,324,837,385,105,61,potted plant
39173,8,plant pot,9,0,25051,22,661,379,900,517,239,138,potted plant
39174,12,chair,13,1,25051,24,623,320,695,414,72,94,chair
39175,14,chair,15,0,25051,24,532,308,601,348,69,40,chair
39176,15,chair,16,0,25051,44,511,340,635,473,124,133,chair
39177,16,chair,17,1,25051,20,421,306,469,344,48,38,chair
39178,19,chair,20,0,25051,42,285,337,407,457,122,120,chair
39179,20,chair,21,1,25051,27,287,314,370,372,83,58,chair
39180,21,umbrella,22,1,25051,26,155,191,328,309,173,118,umbrella
39181,22,table,23,1,25051,21,193,314,279,372,86,58,dining table
39182,24,chair,25,1,25051,17,168,308,204,354,36,46,chair
39183,25,plant pot,26,1,25051,24,271,306,324,350,53,44,potted plant
39184,28,chair,29,1,25051,15,366,296,392,349,26,53,chair
39185,29,table,30,1,25051,24,49,328,179,404,130,76,dining table
39186,30,chair,31,0,25051,33,151,330,210,402,59,72,chair
39187,31,chair,32,1,25051,20,62,328,143,415,81,87,chair
39188,32,plant pot,33,0,25051,21,0,414,202,514,202,100,potted plant
39189,34,umbrella,35,1,25051,16,120,175,246,235,126,60,umbrella
39190,3,car,4,1,25053,20,897,715,1024,825,127,110,car
39191,4,car,5,1,25053,27,590,735,921,858,331,123,car
39192,5,person,6,1,25053,17,556,799,590,857,34,58,person
39193,14,person,15,0,25054,30,324,426,341,460,17,34,person
39194,15,person,16,0,25054,26,323,438,332,460,9,22,person
39195,16,person,17,1,25054,19,356,419,368,442,12,23,person
39196,18,person,19,0,25054,21,344,421,353,446,9,25,person
39197,4,person,5,0,25056,24,199,341,216,385,17,44,person
39198,3,plant pot,4,0,25057,26,120,1038,434,1132,314,94,potted plant
39199,13,person,14,0,25057,43,1147,898,1253,1110,106,212,person
39200,15,clock,16,0,25057,15,1048,566,1117,631,69,65,clock
39201,4,umbrella,5,1,25058,17,65,466,92,502,27,36,umbrella
39202,8,traffic light,9,0,25062,33,390,546,426,631,36,85,traffic light
39203,9,traffic light,10,0,25062,32,118,311,361,747,243,436,traffic light
39204,13,traffic light,14,0,25062,16,818,372,887,737,69,365,traffic light
39205,22,person,23,0,25062,25,73,643,94,707,21,64,person
39206,23,person,24,0,25062,25,128,650,149,706,21,56,person
39207,24,person,25,0,25062,36,536,655,579,738,43,83,person
39208,25,person,26,0,25062,27,624,659,649,741,25,82,person
39209,26,person,27,1,25062,35,617,651,654,726,37,75,person
39210,27,person,28,0,25062,44,684,659,717,745,33,86,person
39211,28,person,29,0,25062,44,801,646,861,761,60,115,person
39212,29,person,30,0,25062,33,740,645,765,722,25,77,person
39213,30,person,31,1,25062,19,754,644,770,711,16,67,person
39214,31,person,32,0,25062,30,776,646,803,723,27,77,person
39215,32,person,33,0,25062,26,948,635,974,700,26,65,person
39216,3,plant pot,4,0,25064,22,787,348,1016,426,229,78,potted plant
39217,5,plant pot,6,0,25064,19,37,350,259,425,222,75,potted plant
39218,19,person,20,1,25067,25,736,625,876,766,140,141,person
39219,20,person,21,1,25067,17,623,645,730,766,107,121,person
39220,26,person,27,1,25067,15,489,586,508,613,19,27,person
39221,3,traffic light,4,0,25068,37,235,527,355,641,120,114,traffic light
39222,9,car,10,1,25069,22,226,458,294,483,68,25,car
39223,16,car,17,0,25069,30,305,436,366,471,61,35,car
39224,19,person,20,0,25069,37,668,354,730,451,62,97,person
39225,21,person,22,0,25069,24,693,352,744,440,51,88,person
39226,22,person,23,0,25069,29,736,336,768,384,32,48,person
39227,23,person,24,0,25069,47,502,395,551,513,49,118,person
39228,24,person,25,0,25069,28,549,389,574,447,25,58,person
39229,25,person,26,0,25069,48,446,405,484,513,38,108,person
39230,26,person,27,0,25069,47,414,414,455,513,41,99,person
39231,27,person,28,0,25069,35,381,428,414,518,33,90,person
39232,28,person,29,0,25069,18,317,439,329,475,12,36,person
39233,29,person,30,0,25069,19,529,392,552,452,23,60,person
39234,30,person,31,0,25069,18,540,395,562,448,22,53,person
39235,3,door,4,1,589,19,254,169,299,285,45,116,door
39236,6,window,7,1,589,29,326,174,371,251,45,77,window
39237,6,car,7,1,9681,27,159,164,255,238,96,74,car
39238,8,person,9,0,9681,30,139,169,160,221,21,52,person
39239,8,car,9,1,9686,24,150,178,256,241,106,63,car
39240,6,car,7,1,9689,22,160,169,256,244,96,75,car
39241,12,car,13,0,9690,16,7,131,40,167,33,36,car
39242,14,car,15,0,9690,23,126,149,180,187,54,38,car
39243,14,motorbike,15,1,9692,20,14,172,94,199,80,27,motorcycle
39244,18,car,19,1,9693,24,2,171,68,229,66,58,car
39245,1,person,2,0,9700,15,931,965,1019,1196,88,231,person
39246,2,person,3,0,9700,16,733,948,811,1187,78,239,person
39247,18,flowerpot,19,0,9700,17,554,851,724,911,170,60,potted plant
39248,22,flowerpot,19,0,9701,24,724,616,760,660,36,44,potted plant
39249,24,flowerpot,21,0,9701,25,822,629,856,665,34,36,potted plant
39250,55,person,54,1,9702,37,1393,761,1457,867,64,106,person
39251,9,person,10,0,9705,20,705,390,773,547,68,157,person
39252,10,person,11,0,9705,16,792,392,857,549,65,157,person
39253,15,window,16,0,9707,15,902,414,1164,735,262,321,window
39254,16,window,17,0,9707,16,588,417,842,743,254,326,window
39255,5,person,6,0,9708,17,0,517,77,658,77,141,person
39256,6,car,6,0,9712,33,764,737,1337,1000,573,263,car
39257,7,car,7,1,9712,21,1101,748,1526,919,425,171,car
39258,20,door,19,0,9716,20,853,228,948,829,95,601,door
39259,23,door,22,0,9716,19,81,245,207,784,126,539,door
39260,22,bench,23,1,9718,27,1002,1090,1093,1136,91,46,bench
39261,24,bench,25,1,9718,18,832,1088,915,1138,83,50,bench
39262,25,chair,26,1,9718,18,822,1088,865,1145,43,57,chair
39263,27,chair,28,0,9718,25,769,1094,812,1172,43,78,chair
39264,29,bench,30,1,9718,17,643,1102,738,1174,95,72,bench
39265,30,chair,31,1,9718,20,581,1080,639,1150,58,70,chair
39266,4,car,5,1,9722,43,99,794,451,953,352,159,car
39267,27,chair,27,1,9724,15,175,649,201,676,26,27,chair
39268,28,chair,28,1,9724,19,153,655,201,705,48,50,chair
39269,29,chair,29,1,9724,16,186,663,261,710,75,47,chair
39270,30,chair,30,1,9724,21,274,674,321,712,47,38,chair
39271,2,car,3,0,9726,19,316,1022,901,1194,585,172,car
39272,13,person,14,0,23567,21,468,259,487,306,19,47,person
39273,14,person,15,1,23567,20,481,256,495,305,14,49,person
39274,9,person,10,0,23571,33,967,553,1019,665,52,112,person
39275,10,car,11,0,23571,38,1,555,323,682,322,127,car
39276,4,chair,5,0,23572,17,366,320,408,374,42,54,chair
39277,5,table,6,1,23572,16,297,327,384,379,87,52,dining table
39278,6,chair,7,0,23572,28,270,317,311,370,41,53,chair
39279,7,chair,8,0,23572,16,311,319,353,381,42,62,chair
39280,8,umbrella,9,0,23572,24,326,207,361,320,35,113,umbrella
39281,13,bench,14,1,23572,15,32,304,122,384,90,80,bench
39282,15,table,16,0,23572,17,535,326,607,377,72,51,dining table
39283,13,chair,14,0,23573,17,644,429,677,464,33,35,chair
39284,14,chair,15,0,23573,21,540,433,578,471,38,38,chair
39285,5,car,6,1,23576,26,344,617,767,858,423,241,car
39286,6,car,7,1,23576,21,1,565,155,822,154,257,car
39287,2,car,3,0,23579,27,911,527,1023,576,112,49,car
39288,3,car,4,1,23579,41,551,530,955,626,404,96,car
39289,7,bench,8,0,23580,21,823,450,923,505,100,55,bench
39290,9,car,10,0,23581,38,105,274,234,386,129,112,car
39291,2,person,3,1,23583,35,620,481,679,630,59,149,person
39292,3,bicycle,4,0,23583,45,594,561,703,692,109,131,bicycle
39293,15,car,16,0,23585,21,45,405,94,434,49,29,car
39294,16,car,17,0,23585,20,4,403,36,427,32,24,car
39295,19,person,20,0,23585,21,179,395,201,467,22,72,person
39296,3,car,4,0,23586,38,434,479,705,616,271,137,car
39297,4,car,5,0,23586,20,356,506,447,601,91,95,car
39298,5,car,6,0,23586,41,146,501,357,609,211,108,car
39299,8,car,9,1,23586,26,9,542,158,609,149,67,car
39300,2,person,3,0,23587,77,842,720,959,1005,117,285,person
39301,9,table,10,0,590,16,520,977,764,1122,244,145,dining table
39302,23,person,24,1,9748,15,269,692,298,744,29,52,person
39303,5,car,6,0,25071,27,110,254,151,277,41,23,car
39304,6,person,7,0,25071,31,244,254,259,302,15,48,person
39305,7,person,8,0,25071,27,191,254,210,300,19,46,person
39306,8,person,9,0,25071,35,153,247,172,297,19,50,person
39307,9,car,10,0,25071,33,0,242,111,283,111,41,car
39308,2,car,3,0,25075,42,561,1204,1420,1642,859,438,car
39309,3,car,4,0,25075,34,0,1262,616,1625,616,363,car
39310,4,person,5,0,9756,26,83,156,115,214,32,58,person
39311,5,person,6,1,9756,19,103,141,124,193,21,52,person
39312,6,person,7,1,9756,19,161,161,184,202,23,41,person
39313,7,person,8,0,9757,23,1034,324,1083,432,49,108,person
39314,9,person,10,1,9757,30,503,357,635,664,132,307,person
39315,10,person,11,0,9757,41,529,515,649,810,120,295,person
39316,11,person,12,0,9757,34,972,476,1078,680,106,204,person
39317,2,door,3,0,9823,17,403,347,570,541,167,194,door
39318,3,person,4,0,9823,28,427,356,558,541,131,185,person
39319,13,skateboard,14,0,9823,20,737,422,836,603,99,181,skateboard
39320,14,skateboard,15,0,9823,23,734,595,850,710,116,115,skateboard
39321,4,person,5,0,9825,20,173,44,181,70,8,26,person
39322,5,person,6,0,9825,24,160,41,173,70,13,29,person
39323,9,person,10,1,9825,19,104,135,144,182,40,47,person
39324,2,person,3,0,9827,38,86,118,140,214,54,96,person
39325,3,dog,4,0,9830,29,11,126,43,169,32,43,dog
39326,4,dog,5,0,9830,22,41,114,71,147,30,33,dog
39327,5,dog,6,0,9830,25,94,115,119,169,25,54,dog
39328,6,dog,7,0,9830,17,121,99,136,131,15,32,dog
39329,7,dog,8,1,9830,19,150,100,165,131,15,31,dog
39330,9,dog,10,0,9830,21,190,117,215,156,25,39,dog
39331,10,dog,11,0,9830,22,238,103,260,136,22,33,dog
39332,2,person,3,1,21004,29,0,133,65,210,65,77,person
39333,8,window,9,0,9834,15,207,154,227,205,20,51,window
39334,10,person,11,0,9836,18,218,315,230,355,12,40,person
39335,11,person,12,0,9836,21,197,311,218,355,21,44,person
39336,12,person,13,0,9836,16,194,310,204,350,10,40,person
39337,14,person,15,0,9840,16,409,411,420,443,11,32,person
39338,16,car,17,1,9883,20,64,367,185,434,121,67,car
39339,17,car,18,1,9883,15,0,364,93,442,93,78,car
39340,24,person,25,1,9885,15,229,160,241,181,12,21,person
39341,25,person,26,1,9885,15,220,160,229,182,9,22,person
39342,5,car,6,1,9888,20,673,690,1199,898,526,208,car
39343,6,car,7,1,9888,22,0,704,594,898,594,194,car
39344,5,umbrella,6,0,9890,19,77,75,152,137,75,62,umbrella
39345,6,chair,7,0,9890,18,107,138,137,178,30,40,chair
39346,8,chair,9,0,9890,17,169,127,193,156,24,29,chair
39347,10,chair,11,0,9890,15,217,135,248,170,31,35,chair
39348,12,umbrella,13,0,9890,30,198,70,277,133,79,63,umbrella
39349,17,umbrella,18,1,9890,15,0,80,35,115,35,35,umbrella
39350,24,chair,25,1,9890,15,0,140,29,178,29,38,chair
39351,25,chair,26,1,9890,17,265,130,287,168,22,38,chair
39352,13,person,14,0,9891,15,217,240,228,260,11,20,person
39353,14,person,15,0,9891,16,208,238,220,259,12,21,person
39354,39,car,40,0,25083,28,435,418,472,447,37,29,car
39355,40,car,41,0,25083,25,468,406,515,434,47,28,car
39356,41,car,42,0,25083,24,509,397,542,423,33,26,car
39357,42,car,43,0,25083,24,535,385,574,410,39,25,car
39358,43,car,44,0,25083,22,554,378,593,401,39,23,car
39359,44,car,45,0,25083,20,607,358,642,379,35,21,car
39360,45,car,46,0,25083,20,630,354,663,375,33,21,car
39361,46,car,47,0,25083,21,647,350,683,371,36,21,car
39362,48,car,49,0,25083,27,711,458,751,489,40,31,car
39363,7,chair,8,0,25084,17,446,676,499,733,53,57,chair
39364,14,table,15,0,25084,20,111,730,218,808,107,78,dining table
39365,5,table,6,0,25085,35,300,1637,1231,2198,931,561,dining table
39366,7,chair,8,1,25085,24,1091,1694,1316,2198,225,504,chair
39367,9,chair,10,1,25085,27,1227,1641,1581,2090,354,449,chair
39368,10,table,11,0,25085,39,1091,1475,1649,2032,558,557,dining table
39369,5,car,6,1,25088,19,909,445,1024,516,115,71,car
39370,9,table,10,0,25088,41,520,501,687,590,167,89,dining table
39371,11,table,12,0,25088,34,197,480,320,546,123,66,dining table
39372,13,bench,14,0,25088,29,84,474,213,530,129,56,bench
39373,15,table,16,0,25088,21,45,462,131,482,86,20,dining table
39374,6,bench,7,0,25090,23,303,410,385,465,82,55,bench
39375,12,bicycle,13,0,25092,33,390,403,429,452,39,49,bicycle
39376,13,person,14,1,25092,16,423,358,429,372,6,14,person
39377,7,person,8,0,9895,15,436,249,454,294,18,45,person
39378,8,person,9,0,9895,16,322,245,342,295,20,50,person
39379,13,bus,14,0,9897,41,110,129,399,249,289,120,bus
39380,4,person,5,1,9904,59,746,175,1258,1195,512,1020,person
39381,9,person,10,0,9905,45,124,59,171,211,47,152,person
39382,10,person,11,0,9905,52,177,89,244,230,67,141,person
39383,11,person,12,0,9981,32,185,115,213,173,28,58,person
39384,12,person,13,0,9981,27,158,150,181,211,23,61,person
39385,13,person,14,0,9981,26,214,103,233,155,19,52,person
39386,14,person,15,0,9981,28,241,103,257,156,16,53,person
39387,15,person,16,1,9981,21,220,91,236,137,16,46,person
39388,16,person,17,0,9981,27,214,51,228,88,14,37,person
39389,17,person,18,0,9981,21,250,47,263,82,13,35,person
39390,18,person,19,0,9981,21,276,40,288,69,12,29,person
39391,19,person,20,0,9981,21,261,37,272,69,11,32,person
39392,13,person,14,0,9984,21,16,707,52,829,36,122,person
39393,2,car,3,1,9985,17,352,156,399,189,47,33,car
39394,3,car,4,0,9985,20,308,151,348,181,40,30,car
39395,10,car,11,1,9988,15,1301,881,1413,947,112,66,car
39396,7,person,8,1,10012,21,102,1062,221,1236,119,174,person
39397,17,person,18,1,10012,16,1284,1070,1389,1161,105,91,person
39398,20,person,21,1,10014,25,901,873,958,1019,57,146,person
39399,8,person,9,1,10015,21,34,184,52,226,18,42,person
39400,10,person,11,0,10015,23,174,170,188,214,14,44,person
39401,11,person,12,0,10015,24,186,171,201,220,15,49,person
39402,12,person,13,0,10015,23,299,178,319,237,20,59,person
39403,13,person,14,1,10015,16,201,176,212,219,11,43,person
39404,9,table,10,0,592,22,183,198,300,288,117,90,dining table
39405,8,person,9,1,10036,24,184,72,232,127,48,55,person
39406,9,chair,10,0,10036,15,246,132,282,186,36,54,chair
39407,14,person,15,0,10037,48,142,239,224,522,82,283,person
39408,15,person,16,0,10037,41,249,277,317,485,68,208,person
39409,16,person,17,1,10037,37,299,267,354,467,55,200,person
39410,17,person,18,0,10037,34,348,260,424,483,76,223,person
39411,18,person,19,1,10037,34,401,246,447,456,46,210,person
39412,19,person,20,1,10037,22,454,271,500,483,46,212,person
39413,20,person,21,1,10037,32,488,304,551,525,63,221,person
39414,21,person,22,1,10037,32,528,313,574,556,46,243,person
39415,22,person,23,0,10037,32,562,303,676,595,114,292,person
39416,23,person,24,1,10037,24,539,352,591,583,52,231,person
39417,24,person,25,1,10037,37,621,303,775,598,154,295,person
39418,25,person,26,1,10037,34,745,304,799,597,54,293,person
39419,26,person,27,1,10037,20,769,408,799,568,30,160,person
39420,27,person,28,0,10037,42,414,300,482,542,68,242,person
39421,19,bench,20,1,10039,18,799,651,892,697,93,46,bench
39422,17,dog,17,0,10040,17,219,966,264,1024,45,58,dog
39423,19,table,19,0,10040,25,1246,1170,1550,1365,304,195,dining table
39424,37,pot,37,0,10040,39,1099,1047,1259,1176,160,129,potted plant
39425,52,person,52,0,10040,42,1767,922,1837,1122,70,200,person
39426,53,person,53,0,10040,32,1893,932,1953,1112,60,180,person
39427,15,bicycle,16,1,10070,37,1836,980,1905,1062,69,82,bicycle
39428,5,car,6,1,10075,15,90,503,128,529,38,26,car
39429,6,car,7,1,10075,15,126,497,185,534,59,37,car
39430,7,car,8,0,10075,22,161,507,228,540,67,33,car
39431,8,person,9,0,10075,19,224,503,243,551,19,48,person
39432,9,person,10,0,10075,16,135,501,151,537,16,36,person
39433,12,motorbike,13,1,10075,18,723,586,796,614,73,28,motorcycle
39434,14,person,15,1,10075,18,772,524,805,580,33,56,person
39435,19,person,20,0,10075,18,393,507,408,558,15,51,person
39436,23,person,24,1,10075,61,0,486,139,765,139,279,person
39437,5,person,6,1,10079,16,75,1178,131,1298,56,120,person
39438,3,person,4,1,10080,31,705,824,1024,1195,319,371,person
39439,11,person,12,1,10080,24,2,237,81,411,79,174,person
39440,23,glasses,24,0,10080,23,880,895,1020,945,140,50,eye glasses
39441,9,person,10,0,10081,18,33,584,51,635,18,51,person
39442,18,table,19,1,23664,18,263,301,311,336,48,35,dining table
39443,2,person,3,0,23666,27,261,346,285,422,24,76,person
39444,3,person,4,0,23666,24,248,341,270,423,22,82,person
39445,5,person,6,1,23666,19,11,647,32,737,21,90,person
39446,6,person,7,0,23666,26,564,641,595,736,31,95,person
39447,7,person,8,0,23666,38,529,647,570,750,41,103,person
39448,8,person,9,0,23666,46,278,870,338,1017,60,147,person
39449,9,person,10,0,23666,41,358,801,401,928,43,127,person
39450,11,person,12,1,23666,41,562,873,626,1024,64,151,person
39451,12,person,13,0,23666,39,413,790,451,916,38,126,person
39452,14,person,15,1,23666,27,449,782,486,898,37,116,person
39453,15,person,16,0,23666,35,459,797,512,921,53,124,person
39454,16,person,17,1,23666,24,483,749,526,835,43,86,person
39455,17,person,18,1,23666,19,506,729,532,814,26,85,person
39456,18,person,19,0,23666,30,500,810,548,934,48,124,person
39457,19,person,20,0,23666,42,555,810,599,935,44,125,person
39458,20,person,21,1,23666,26,571,788,604,891,33,103,person
39459,21,person,22,1,23666,25,600,803,632,903,32,100,person
39460,22,person,23,1,23666,30,576,729,619,809,43,80,person
39461,23,person,24,1,23666,50,619,753,659,882,40,129,person
39462,24,backpack,25,0,23666,20,637,781,667,841,30,60,backpack
39463,25,person,26,1,23666,26,642,791,677,914,35,123,person
39464,26,person,27,1,23666,16,656,747,678,810,22,63,person
39465,4,car,5,1,10095,16,0,893,144,999,144,106,car
39466,5,boat,6,1,10095,18,32,833,289,951,257,118,boat
39467,14,dog,15,0,10097,17,427,491,469,547,42,56,dog
39468,15,dog,16,0,10097,23,165,469,211,554,46,85,dog
39469,0,dog,1,0,10098,15,172,117,194,163,22,46,dog
39470,0,dog,1,0,10099,30,120,201,184,272,64,71,dog
39471,0,dog,1,0,10100,29,161,143,193,198,32,55,dog
39472,1,person,2,0,10100,42,177,121,214,200,37,79,person
39473,4,dog,5,0,10101,16,196,144,214,168,18,24,dog
39474,10,chair,11,0,10102,26,244,911,344,1041,100,130,chair
39475,11,table,12,0,10102,19,336,923,437,1030,101,107,dining table
39476,56,dog,57,0,10102,66,1708,967,1818,1228,110,261,dog
39477,58,chair,59,0,10102,27,454,889,529,1020,75,131,chair
39478,20,dog,21,0,10105,21,281,412,334,432,53,20,dog
39479,21,dog,22,0,10105,18,357,383,379,430,22,47,dog
39480,22,dog,23,0,10105,19,402,390,427,432,25,42,dog
39481,23,dog,24,0,10105,20,573,396,599,442,26,46,dog
39482,24,dog,25,0,10105,23,678,382,702,438,24,56,dog
39483,25,dog,26,0,10105,32,744,387,788,441,44,54,dog
39484,26,dog,27,0,10105,18,731,386,752,428,21,42,dog
39485,4,car,5,1,10138,20,1545,701,2046,1533,501,832,car
39486,8,umbrella,9,0,10139,58,92,110,230,678,138,568,umbrella
39487,10,chair,11,0,10140,19,278,148,299,194,21,46,chair
39488,11,person,12,1,10140,19,277,126,299,171,22,45,person
39489,17,person,18,1,10141,17,1375,557,1400,636,25,79,person
39490,18,person,19,0,10141,23,1427,558,1458,656,31,98,person
39491,19,person,20,1,10141,16,1456,563,1477,649,21,86,person
39492,20,person,21,0,10141,22,1517,554,1561,657,44,103,person
39493,21,person,22,0,10141,27,1549,593,1591,669,42,76,person
39494,32,car,33,1,10141,15,166,527,216,587,50,60,car
39495,33,person,34,0,10141,26,140,510,197,640,57,130,person
39496,34,person,35,1,10141,35,68,498,147,767,79,269,person
39497,35,person,36,1,10141,16,12,522,70,585,58,63,person
39498,36,person,37,0,10141,46,0,533,83,876,83,343,person
39499,41,person,42,0,10141,49,178,556,317,952,139,396,person
39500,6,table,7,0,10142,22,0,142,31,179,31,37,dining table
39501,8,window,9,0,10142,15,41,43,111,148,70,105,window
39502,10,person,11,0,10142,45,126,83,167,209,41,126,person
39503,6,person,7,1,10143,20,220,111,246,150,26,39,person
39504,7,person,8,1,10143,18,84,109,111,143,27,34,person
39505,8,person,9,1,10143,38,310,99,360,238,50,139,person
39506,2,chair,3,0,10144,20,552,964,738,1203,186,239,chair
39507,13,bicycle,14,1,10144,24,842,908,958,1132,116,224,bicycle
39508,4,car,5,1,10145,15,103,831,202,931,99,100,car
39509,5,car,6,1,10145,30,1071,849,1418,994,347,145,car
39510,6,car,7,1,10145,21,1382,846,1599,1001,217,155,car
39511,10,car,11,1,10145,18,0,822,138,958,138,136,car
39512,16,person,17,1,10145,15,973,854,1003,949,30,95,person
39513,59,door,60,0,10145,16,1195,853,1280,951,85,98,door
39514,3,bottle,4,0,10146,15,77,264,118,407,41,143,bottle
39515,9,person,10,0,10147,22,1916,1074,1999,1451,83,377,person
39516,10,chair,11,0,10147,19,1983,1265,2140,1429,157,164,chair
39517,9,person,10,0,10782,27,1085,772,1142,862,57,90,person
39518,14,person,15,0,10784,23,463,388,495,469,32,81,person
39519,15,person,16,0,10784,17,246,350,260,405,14,55,person
39520,16,person,17,0,10784,23,67,391,92,459,25,68,person
39521,5,person,6,0,10785,24,283,109,302,143,19,34,person
39522,6,person,7,0,10785,19,159,99,173,129,14,30,person
39523,7,person,8,0,10785,20,112,103,126,130,14,27,person
39524,8,person,9,0,10785,18,85,103,96,133,11,30,person
39525,8,person,9,0,10786,32,651,151,727,373,76,222,person
39526,7,person,8,0,10787,23,349,395,404,543,55,148,person
39527,3,airplane,4,0,198,46,707,178,917,289,210,111,airplane
39528,9,airplane,10,0,198,50,462,165,692,273,230,108,airplane
39529,18,airplane,19,0,198,41,309,156,526,242,217,86,airplane
39530,22,airplane,23,0,198,83,102,209,543,371,441,162,airplane
39531,11,person,12,0,199,99,222,111,418,350,196,239,person
39532,18,airplane,19,1,201,27,80,261,500,386,420,125,airplane
39533,19,person,20,0,201,29,392,207,410,249,18,42,person
39534,20,person,21,0,201,30,448,207,468,252,20,45,person
39535,2,airplane,3,0,202,54,341,296,658,423,317,127,airplane
39536,0,airplane,1,0,10863,58,971,226,1759,591,788,365,airplane
39537,2,airplane,3,0,10863,126,0,205,979,1131,979,926,airplane
39538,6,person,7,1,10863,18,873,763,919,810,46,47,person
39539,7,person,8,1,10863,17,820,773,867,828,47,55,person
39540,1,airplane,2,1,10864,51,0,12,511,195,511,183,airplane
39541,3,person,4,1,10864,58,200,103,425,287,225,184,person
39542,4,person,5,1,10864,58,79,76,283,287,204,211,person
39543,4,airplane,5,0,10865,30,358,191,450,222,92,31,airplane
39544,5,airplane,6,0,10865,24,200,190,335,217,135,27,airplane
39545,3,person,4,1,10866,17,60,563,103,667,43,104,person
39546,4,person,5,1,10866,15,104,578,145,663,41,85,person
39547,6,person,7,1,10866,18,193,601,251,692,58,91,person
39548,8,person,9,1,10866,17,308,628,359,677,51,49,person
39549,9,person,10,1,10866,16,398,627,434,691,36,64,person
39550,11,airplane,12,0,10866,124,5,172,1457,767,1452,595,airplane
39551,13,person,14,0,10866,34,213,652,387,778,174,126,person
39552,14,person,15,0,10866,25,140,648,240,784,100,136,person
39553,15,person,16,0,10866,23,65,643,150,756,85,113,person
39554,16,person,17,0,10866,23,14,621,87,743,73,122,person
39555,0,person,1,0,10867,36,432,584,697,1134,265,550,person
39556,1,airplane,2,0,10867,135,28,185,2153,996,2125,811,airplane
39557,1,airplane,2,0,10868,34,429,47,610,117,181,70,airplane
39558,4,airplane,5,0,10868,96,61,300,707,511,646,211,airplane
39559,3,airplane,4,0,10869,73,199,403,1281,709,1082,306,airplane
39560,4,person,5,0,10869,30,500,1343,573,1499,73,156,person
39561,5,person,6,0,10869,27,1082,1035,1125,1157,43,122,person
39562,6,person,7,0,10869,19,1176,1357,1219,1496,43,139,person
39563,7,person,8,0,10869,26,1515,1183,1555,1320,40,137,person
39564,8,person,9,0,10869,22,1602,1141,1645,1286,43,145,person
39565,9,person,10,1,10869,22,1639,1119,1688,1263,49,144,person
39566,10,person,11,0,10869,29,1653,1165,1717,1310,64,145,person
39567,11,person,12,1,10869,20,1723,1131,1765,1277,42,146,person
39568,12,person,13,0,10869,24,1734,1173,1795,1321,61,148,person
39569,13,person,14,0,10869,19,1795,1150,1870,1277,75,127,person
39570,14,person,15,1,10869,15,1873,1156,1914,1231,41,75,person
39571,15,person,16,0,10869,20,1905,1145,1943,1291,38,146,person
39572,16,person,17,0,10869,20,1874,1032,1917,1150,43,118,person
39573,17,person,18,0,10869,23,2023,1257,2068,1411,45,154,person
39574,18,person,19,0,10869,20,1999,1024,2041,1141,42,117,person
39575,19,person,20,1,10869,15,1956,1040,1994,1086,38,46,person
39576,20,person,21,0,10869,25,1953,1067,1999,1183,46,116,person
39577,21,person,22,0,10869,19,1913,1037,1953,1164,40,127,person
39578,2,airplane,3,0,10870,66,677,45,1166,345,489,300,airplane
39579,4,person,5,0,10870,46,337,405,465,706,128,301,person
39580,6,person,7,0,10870,23,237,456,305,569,68,113,person
39581,4,airplane,5,0,10871,42,5,71,240,136,235,65,airplane
39582,5,person,6,0,10871,18,101,111,112,144,11,33,person
39583,2,airplane,3,0,10872,22,529,299,806,400,277,101,airplane
39584,3,airplane,4,0,10872,29,666,491,891,562,225,71,airplane
39585,4,airplane,5,0,10872,28,735,230,951,283,216,53,airplane
39586,5,airplane,6,0,10872,26,954,168,1165,217,211,49,airplane
39587,6,airplane,7,0,10872,33,824,433,1105,539,281,106,airplane
39588,7,airplane,8,0,10872,36,754,613,1004,693,250,80,airplane
39589,1,airplane,2,0,10873,82,875,162,1924,606,1049,444,airplane
39590,5,person,6,0,10873,15,53,768,76,834,23,66,person
39591,6,person,7,1,10873,78,193,215,450,1354,257,1139,person
39592,7,person,8,0,10873,92,266,124,724,1532,458,1408,person
39593,3,airplane,4,0,10874,23,308,81,365,102,57,21,airplane
39594,4,airplane,5,1,10874,23,25,76,161,120,136,44,airplane
39595,5,airplane,6,1,10874,18,0,87,107,124,107,37,airplane
39596,3,airplane,4,0,10875,60,62,211,1473,593,1411,382,airplane
39597,5,person,6,0,10875,67,385,458,787,878,402,420,person
39598,6,person,7,0,10875,50,174,385,412,990,238,605,person
39599,4,airplane,5,0,10876,23,345,179,434,206,89,27,airplane
39600,5,airplane,6,0,10876,19,199,179,290,203,91,24,airplane
39601,3,airplane,4,0,10877,22,190,273,271,312,81,39,airplane
39602,4,airplane,5,0,10877,23,105,266,217,305,112,39,airplane
39603,3,airplane,4,0,10878,20,373,389,521,434,148,45,airplane
39604,1,airplane,2,0,10879,72,63,369,722,588,659,219,airplane
39605,4,person,5,0,10879,45,106,630,313,809,207,179,person
39606,5,person,6,0,10879,57,334,619,782,1053,448,434,person
39607,6,airplane,7,0,10879,110,626,164,2163,840,1537,676,airplane
39608,3,airplane,4,0,10880,75,27,54,362,135,335,81,airplane
39609,6,airplane,7,0,10881,16,317,357,369,385,52,28,airplane
39610,7,airplane,8,0,10881,41,170,305,303,353,133,48,airplane
39611,5,airplane,6,0,10882,37,163,60,331,113,168,53,airplane
39612,6,airplane,7,1,10882,34,2,89,201,184,199,95,airplane
39613,7,airplane,8,0,10882,28,28,58,108,90,80,32,airplane
39614,2,airplane,3,0,10883,29,59,42,235,97,176,55,airplane
39615,3,airplane,4,0,10883,43,202,58,414,115,212,57,airplane
39616,4,airplane,5,0,10883,42,60,140,415,254,355,114,airplane
39617,3,airplane,4,0,10884,44,25,142,144,255,119,113,airplane
39618,4,airplane,5,0,10884,28,36,91,116,158,80,67,airplane
39619,5,airplane,6,0,10884,24,119,94,200,156,81,62,airplane
39620,5,person,6,0,10885,28,2107,699,2176,859,69,160,person
39621,7,person,8,0,10885,25,1298,742,1375,887,77,145,person
39622,3,person,4,0,21155,33,1176,907,1245,1105,69,198,person
39623,2,airplane,3,0,23719,49,1108,841,1827,1028,719,187,airplane
39624,1,airplane,2,0,23720,79,108,251,694,499,586,248,airplane
39625,4,person,5,0,23720,16,601,299,622,351,21,52,person
39626,3,boat,4,0,23721,139,2,96,680,636,678,540,boat
39627,4,boat,5,0,23721,51,147,545,451,680,304,135,boat
39628,5,person,6,0,23721,21,373,573,404,648,31,75,person
39629,6,person,7,1,23721,18,317,566,346,625,29,59,person
39630,6,person,7,0,10933,40,743,307,913,608,170,301,person
39631,7,backpack,8,0,10933,19,819,319,920,458,101,139,backpack
39632,7,person,8,0,10934,35,504,363,622,628,118,265,person
39633,8,person,9,1,10934,21,467,415,519,516,52,101,person
39634,5,person,6,0,10936,48,222,279,347,543,125,264,person
39635,6,person,7,0,10936,38,662,334,767,619,105,285,person
39636,7,person,8,0,10936,39,503,394,629,537,126,143,person
39637,5,person,6,1,10937,43,378,429,514,816,136,387,person
39638,6,person,7,0,10937,25,119,468,203,742,84,274,person
39639,7,person,8,0,10937,41,0,431,129,761,129,330,person
39640,8,person,9,0,10988,26,238,290,255,352,17,62,person
39641,6,person,7,0,10990,38,1339,1327,1428,1542,89,215,person
39642,7,person,8,0,10990,26,1522,1305,1560,1417,38,112,person
39643,9,person,10,0,10990,23,1647,1309,1681,1417,34,108,person
39644,10,bicycle,11,0,10990,28,115,1296,179,1376,64,80,bicycle
39645,30,window,31,0,10991,17,1421,480,1511,671,90,191,window
39646,49,window,50,1,10991,15,220,717,329,884,109,167,window
39647,5,car,6,0,10994,45,1180,684,1657,858,477,174,car
39648,4,person,5,0,25120,18,955,439,977,499,22,60,person
39649,7,person,8,1,25122,30,681,1826,743,2012,62,186,person
39650,8,person,9,0,25122,29,716,1831,802,2008,86,177,person
39651,12,person,13,0,25124,30,5,658,40,767,35,109,person
39652,13,person,14,1,25124,21,167,692,227,768,60,76,person
39653,4,person,5,1,25125,20,974,706,1023,743,49,37,person
39654,3,bus,4,1,25126,16,888,1548,2034,1649,1146,101,bus
39655,6,car,7,1,25127,28,1,520,158,659,157,139,car
39656,2,person,3,0,25129,36,314,393,358,526,44,133,person
39657,3,person,4,0,25129,41,374,435,425,597,51,162,person
39658,4,person,5,0,25129,55,411,384,461,523,50,139,person
39659,5,person,6,1,25129,36,472,392,491,519,19,127,person
39660,6,person,7,0,25129,49,475,381,535,521,60,140,person
39661,7,person,8,1,25129,53,799,439,850,683,51,244,person
39662,8,person,9,0,25129,43,757,451,841,697,84,246,person
39663,9,person,10,1,25129,58,823,454,943,697,120,243,person
39664,8,person,9,0,25133,22,522,454,544,520,22,66,person
39665,6,person,7,1,650,17,265,401,291,448,26,47,person
39666,13,person,14,0,650,37,42,401,79,517,37,116,person
39667,14,person,15,0,650,32,66,406,93,510,27,104,person
39668,15,person,16,0,650,23,82,406,112,504,30,98,person
39669,16,person,17,0,650,31,112,401,145,491,33,90,person
39670,17,person,18,0,650,26,145,397,175,478,30,81,person
39671,26,person,27,0,650,22,831,695,905,739,74,44,person
39672,27,person,28,0,650,17,896,624,932,642,36,18,person
39673,30,person,31,0,650,18,871,613,897,638,26,25,person
39674,6,person,7,0,11003,16,596,282,631,327,35,45,person
39675,7,person,8,1,11003,15,470,284,501,319,31,35,person
39676,14,person,15,1,11003,16,77,276,97,318,20,42,person
39677,2,person,3,1,11004,16,284,141,314,200,30,59,person
39678,3,person,4,1,11004,17,148,152,178,208,30,56,person
39679,4,person,5,1,11004,15,46,431,81,491,35,60,person
39680,5,person,6,1,11004,22,134,419,177,487,43,68,person
39681,6,person,7,1,11004,15,300,434,345,490,45,56,person
39682,13,person,14,1,11004,15,21,181,44,228,23,47,person
39683,9,person,10,0,11009,16,579,34,618,129,39,95,person
39684,35,person,36,1,11009,17,704,262,751,313,47,51,person
39685,38,person,39,0,11009,18,1041,224,1071,317,30,93,person
39686,39,person,40,0,11009,18,969,232,990,322,21,90,person
39687,40,person,41,0,11009,25,908,243,948,319,40,76,person
39688,41,person,42,1,11009,16,861,246,890,301,29,55,person
39689,44,person,45,0,11009,21,754,264,811,331,57,67,person
39690,45,person,46,1,11009,18,759,236,788,291,29,55,person
39691,47,person,48,1,11009,15,548,250,578,297,30,47,person
39692,24,person,25,1,11010,16,46,354,143,439,97,85,person
39693,25,person,26,1,11010,17,333,336,403,434,70,98,person
39694,27,person,28,1,11010,18,678,366,739,435,61,69,person
39695,28,person,29,1,11010,15,788,348,856,443,68,95,person
39696,29,person,30,1,11010,15,842,354,899,437,57,83,person
39697,30,person,31,1,11010,21,926,348,1000,452,74,104,person
39698,31,person,32,1,11010,17,989,360,1055,452,66,92,person
39699,33,person,34,1,11010,27,530,1249,656,1409,126,160,person
39700,34,person,35,1,11010,47,926,1446,1195,1645,269,199,person
39701,54,door,54,0,11010,16,713,320,825,434,112,114,door
39702,10,person,11,0,11011,19,153,178,165,223,12,45,person
39703,11,person,12,0,11011,20,164,178,180,226,16,48,person
39704,17,person,18,0,11011,16,214,163,229,195,15,32,person
39705,18,person,19,1,11011,21,241,160,256,199,15,39,person
39706,19,person,20,1,11011,20,245,170,262,207,17,37,person
39707,2,boat,3,0,21170,34,3,588,1534,2045,1531,1457,boat
39708,3,person,4,0,21170,20,1436,1343,1482,1458,46,115,person
39709,4,car,5,0,11019,22,1266,1075,1396,1175,130,100,car
39710,14,car,15,0,11021,15,1885,875,1931,896,46,21,car
39711,16,car,17,0,11021,20,2022,860,2073,886,51,26,car
39712,6,person,7,0,11026,37,516,575,601,712,85,137,person
39713,7,person,8,0,11026,32,415,569,454,666,39,97,person
39714,8,person,9,0,11026,32,363,563,411,688,48,125,person
39715,9,person,10,0,11026,25,324,552,363,653,39,101,person
39716,10,person,11,0,11026,21,245,558,279,647,34,89,person
39717,11,person,12,0,11026,15,216,556,233,609,17,53,person
39718,13,person,14,0,11026,15,299,559,316,603,17,44,person
39719,0,person,1,1,11041,39,2,266,235,959,233,693,person
39720,4,car,5,0,11041,28,395,531,572,673,177,142,car
39721,5,car,6,0,11041,19,564,539,648,668,84,129,car
39722,6,car,7,0,11041,34,709,562,980,657,271,95,car
39723,12,person,13,1,11041,18,209,435,239,504,30,69,person
39724,22,bench,23,1,11044,17,408,843,432,872,24,29,bench
39725,16,person,17,0,11050,15,791,654,925,761,134,107,person
39726,6,traffic light,7,0,11053,18,544,681,766,728,222,47,traffic light
39727,20,car,21,0,11053,23,358,798,506,907,148,109,car
39728,19,window,20,0,11056,16,195,413,246,472,51,59,window
39729,7,person,8,0,11058,66,210,976,249,1105,39,129,person
39730,8,person,9,0,11058,36,81,1037,135,1100,54,63,person
39731,9,person,10,1,11058,50,177,1063,214,1191,37,128,person
39732,10,person,11,0,11058,53,143,1062,186,1192,43,130,person
39733,11,person,12,0,11058,35,481,984,517,1108,36,124,person
39734,12,person,13,0,11058,48,601,1049,644,1174,43,125,person
39735,13,person,14,0,11058,37,629,989,675,1096,46,107,person
39736,14,person,15,0,11058,37,691,1024,725,1150,34,126,person
39737,15,person,16,0,11058,44,721,1033,781,1153,60,120,person
39738,16,person,17,1,11058,19,809,1062,833,1100,24,38,person
39739,17,person,18,1,11058,19,794,1068,817,1097,23,29,person
39740,18,person,19,1,11058,25,1035,1083,1078,1124,43,41,person
39741,21,person,22,0,11058,42,416,1005,446,1115,30,110,person
39742,22,person,23,1,11058,26,377,1024,418,1086,41,62,person
39743,23,person,24,1,11058,37,364,1006,400,1101,36,95,person
39744,24,person,25,1,11058,29,374,1077,412,1125,38,48,person
39745,25,person,26,1,11058,32,329,1060,373,1123,44,63,person
39746,26,person,27,1,11058,41,7,1100,46,1214,39,114,person
39747,27,person,28,1,11058,30,1,1095,21,1216,20,121,person
39748,10,person,11,1,23748,27,219,596,260,682,41,86,person
39749,2,person,3,1,23751,16,613,439,654,490,41,51,person
39750,6,bird,7,0,23758,15,345,71,395,90,50,19,bird
39751,7,boat,8,0,23760,54,1040,926,1606,1236,566,310,boat
39752,8,boat,9,0,23760,52,1347,854,1916,1122,569,268,boat
39753,0,person,1,0,11085,17,3,369,42,453,39,84,person
39754,12,person,13,1,11085,18,28,378,56,445,28,67,person
39755,7,person,8,1,11086,38,183,225,254,395,71,170,person
39756,5,car,6,0,11089,17,0,900,57,927,57,27,car
39757,14,car,15,0,11089,38,1687,953,2197,1427,510,474,car
39758,15,motorbike,16,0,11089,70,625,988,1368,1470,743,482,motorcycle
39759,27,person,28,1,11089,16,2145,873,2172,959,27,86,person
39760,30,door,31,0,11089,19,1759,967,1939,1257,180,290,door
39761,32,door,33,0,11089,19,1840,973,1992,1297,152,324,door
39762,10,fire hydrant,11,1,11091,29,1358,1011,1511,1172,153,161,fire hydrant
39763,17,car,18,1,11092,32,1579,1186,2198,1648,619,462,car
39764,38,door,37,0,11092,29,1806,1226,2090,1595,284,369,door
39765,5,person,6,0,11515,48,20,226,133,423,113,197,person
39766,2,truck,3,0,11519,73,242,367,1065,729,823,362,truck
39767,10,car,11,0,23781,23,238,562,279,592,41,30,car
39768,12,car,13,0,23781,33,73,561,155,637,82,76,car
39769,3,person,4,0,23782,31,494,273,548,485,54,212,person
39770,7,car,8,1,23782,29,100,310,230,444,130,134,car
39771,8,car,9,0,23782,33,31,326,204,467,173,141,car
39772,1,table,2,0,23784,21,118,1,949,659,831,658,dining table
39773,6,chair,7,0,23784,45,613,288,901,734,288,446,chair
39774,4,person,5,0,23785,33,164,619,207,749,43,130,person
39775,5,truck,6,0,23785,69,171,532,647,770,476,238,truck
39776,6,car,7,0,23785,24,649,652,768,739,119,87,car
39777,2,car,3,0,23786,60,71,226,549,376,478,150,car
39778,3,car,4,1,23786,23,517,227,640,327,123,100,car
39779,3,table,4,0,23788,24,409,991,735,1243,326,252,dining table
39780,6,table,7,0,23788,16,1148,1149,1677,1284,529,135,dining table
39781,2,car,3,0,23789,67,417,323,984,602,567,279,car
39782,5,person,6,0,23789,34,256,338,299,459,43,121,person
39783,6,person,7,1,23789,17,66,356,92,482,26,126,person
39784,7,person,8,0,23789,29,8,351,42,480,34,129,person
39785,8,person,9,1,23789,20,28,356,55,412,27,56,person
39786,1,truck,2,0,23793,109,94,200,927,636,833,436,truck
39787,2,truck,3,1,23793,42,27,304,132,561,105,257,truck
39788,3,car,4,1,23793,18,6,441,79,536,73,95,car
39789,5,person,6,1,11580,35,171,174,264,389,93,215,person
39790,1,person,2,1,11581,18,272,212,370,342,98,130,person
39791,2,person,3,1,11581,24,881,170,982,298,101,128,person
39792,2,car,3,0,11582,22,455,178,538,208,83,30,car
39793,16,boat,17,0,11586,27,105,83,169,134,64,51,boat
39794,17,boat,18,0,11586,35,2,87,134,221,132,134,boat
39795,3,boat,4,0,23813,25,1266,637,2195,1399,929,762,boat
39796,5,boat,6,0,23813,44,362,602,1742,1325,1380,723,boat
39797,6,boat,7,0,23813,33,2,879,909,1344,907,465,boat
39798,7,boat,8,0,23813,34,0,700,461,981,461,281,boat
39799,4,hat,5,0,23814,19,1295,1147,1467,1259,172,112,hat
39800,5,person,6,0,23814,78,783,574,1069,1218,286,644,person
39801,7,bird,8,0,23814,43,1129,498,1265,676,136,178,bird
39802,8,bird,9,0,23814,40,605,556,758,725,153,169,bird
39803,5,person,6,1,11612,17,705,867,820,1007,115,140,person
39804,6,person,7,1,11612,15,925,888,1024,1014,99,126,person
39805,7,person,8,1,11612,29,1072,810,1177,1013,105,203,person
39806,5,car,6,1,11636,24,2,287,79,327,77,40,car
39807,1,bench,2,0,11637,17,3,234,47,255,44,21,bench
39808,14,chair,15,0,11639,16,139,391,162,427,23,36,chair
39809,15,chair,16,0,11639,16,109,390,127,425,18,35,chair
39810,16,chair,17,0,11639,17,306,389,331,429,25,40,chair
39811,16,vase,17,0,11644,15,125,346,158,386,33,40,vase
39812,4,person,5,0,11651,19,1097,920,1172,1102,75,182,person
39813,5,person,6,0,11651,16,740,929,802,1066,62,137,person
39814,6,person,7,1,11651,15,795,920,855,1064,60,144,person
39815,7,bench,8,0,11651,17,455,1005,656,1142,201,137,bench
39816,10,bench,11,0,23819,55,600,345,796,543,196,198,bench
39817,11,bench,12,1,23819,33,1,341,143,550,142,209,bench
39818,12,bench,13,0,23819,29,20,391,315,575,295,184,bench
39819,21,person,22,0,23820,25,233,318,244,340,11,22,person
39820,22,person,23,0,23820,24,308,321,319,343,11,22,person
39821,23,person,24,0,23820,21,381,324,389,344,8,20,person
39822,24,person,25,0,23820,30,423,322,434,344,11,22,person
39823,25,person,26,0,23820,23,445,320,452,344,7,24,person
39824,26,person,27,0,23820,24,573,322,579,342,6,20,person
39825,27,person,28,0,23820,19,587,322,594,343,7,21,person
39826,21,person,22,0,23823,27,136,951,157,1011,21,60,person
39827,6,person,7,0,23826,38,691,535,747,712,56,177,person
39828,7,person,8,0,23826,21,729,553,749,709,20,156,person
39829,9,car,10,1,23826,37,0,543,219,705,219,162,car
39830,3,person,4,1,23828,18,656,747,701,829,45,82,person
39831,4,person,5,1,23828,15,869,749,930,816,61,67,person
39832,5,person,6,1,23828,15,935,747,994,824,59,77,person
39833,2,car,3,1,23830,24,792,563,1023,667,231,104,car
39834,3,car,4,0,23830,54,463,585,1017,760,554,175,car
39835,9,person,10,1,23830,28,682,524,712,592,30,68,person
39836,10,person,11,1,23830,40,613,526,658,626,45,100,person
39837,11,person,12,1,23830,31,566,526,599,560,33,34,person
39838,12,person,13,1,23830,33,510,531,551,583,41,52,person
39839,13,person,14,1,23830,28,512,541,550,636,38,95,person
39840,14,person,15,1,23830,41,549,537,604,629,55,92,person
39841,15,person,16,0,23830,41,452,515,479,633,27,118,person
39842,16,person,17,0,23830,57,360,544,401,661,41,117,person
39843,17,person,18,0,23830,37,240,525,276,639,36,114,person
39844,18,person,19,1,23830,26,266,536,293,628,27,92,person
39845,19,person,20,1,23830,17,229,575,250,628,21,53,person
39846,20,person,21,0,23830,32,120,530,148,652,28,122,person
39847,21,person,22,1,23830,48,145,535,176,644,31,109,person
39848,22,person,23,0,23830,47,169,533,205,650,36,117,person
39849,23,person,24,1,23830,19,168,502,185,544,17,42,person
39850,24,person,25,1,23830,18,62,497,83,541,21,44,person
39851,26,person,27,1,23830,18,142,504,162,543,20,39,person
39852,31,chair,32,1,23830,22,207,568,247,621,40,53,chair
39853,7,car,8,0,11656,23,389,481,509,526,120,45,car
39854,7,car,8,1,11657,19,263,139,296,169,33,30,car
39855,12,bench,13,0,11658,27,62,138,159,189,97,51,bench
39856,15,bench,16,0,11658,15,227,128,265,165,38,37,bench
39857,6,car,7,0,11659,33,805,450,1116,597,311,147,car
39858,9,car,10,0,23837,21,633,369,674,383,41,14,car
39859,2,car,3,1,23838,22,713,274,800,349,87,75,car
39860,6,table,7,0,23838,25,0,318,116,398,116,80,dining table
39861,8,person,9,0,23838,81,351,188,439,523,88,335,person
39862,9,person,10,0,23838,59,429,281,494,520,65,239,person
39863,4,car,5,1,23840,30,698,306,1024,768,326,462,car
39864,5,person,6,1,931,59,800,305,1091,730,291,425,person
39865,6,person,7,1,931,50,230,196,441,965,211,769,person
39866,63,person,64,1,931,63,1986,319,2199,1001,213,682,person
39867,65,person,66,1,931,39,1943,354,2116,766,173,412,person
39868,66,person,67,1,931,17,2091,336,2146,395,55,59,person
39869,67,person,68,1,931,26,1979,392,2042,547,63,155,person
39870,68,person,69,1,931,38,1934,376,2004,673,70,297,person
39871,69,person,70,1,931,23,1928,336,1986,421,58,85,person
39872,70,person,71,1,931,51,1840,319,1952,781,112,462,person
39873,72,person,73,1,931,38,1727,410,1855,753,128,343,person
39874,73,person,74,1,931,25,1777,370,1852,494,75,124,person
39875,74,person,75,1,931,18,1826,349,1878,460,52,111,person
39876,75,person,76,1,931,20,1723,352,1785,493,62,141,person
39877,76,person,77,1,931,15,2010,350,2062,392,52,42,person
39878,10,person,11,0,11672,25,956,705,1052,1076,96,371,person
39879,20,person,21,0,11673,23,354,1178,435,1403,81,225,person
39880,21,person,22,1,11673,22,235,1147,312,1406,77,259,person
39881,22,person,23,0,11673,23,274,1164,344,1413,70,249,person
39882,5,person,6,1,11674,32,267,728,654,1648,387,920,person
39883,6,person,7,1,11674,25,238,840,396,1367,158,527,person
39884,7,person,8,1,11674,21,235,1294,356,1647,121,353,person
39885,12,person,12,1,11674,43,50,749,301,1489,251,740,person
39886,14,person,14,0,11674,26,718,867,763,1031,45,164,person
39887,15,person,15,1,11674,27,641,858,704,1037,63,179,person
39888,16,person,16,1,11674,22,813,828,872,1071,59,243,person
39889,0,bottle,1,0,11675,31,267,1034,340,1222,73,188,bottle
39890,3,bottle,4,0,11675,20,174,1021,248,1182,74,161,bottle
39891,4,bottle,5,0,11675,15,213,698,251,798,38,100,bottle
39892,1,hat,2,0,11676,18,434,650,614,805,180,155,hat
39893,8,hat,9,0,11676,15,976,599,1144,689,168,90,hat
39894,13,hat,14,0,11676,15,1255,638,1395,716,140,78,hat
39895,27,hat,28,0,11676,15,712,803,802,899,90,96,hat
39896,28,person,29,0,11676,63,105,612,279,1043,174,431,person
39897,29,person,30,1,11676,38,2,571,120,1066,118,495,person
39898,30,person,31,0,11676,28,345,657,433,914,88,257,person
39899,31,person,32,1,11676,30,423,652,478,920,55,268,person
39900,32,hat,33,1,11676,18,440,762,603,882,163,120,hat
39901,36,person,37,1,11676,18,77,618,155,766,78,148,person
39902,37,person,38,1,11676,32,287,629,356,899,69,270,person
39903,38,person,39,1,11676,34,242,650,316,910,74,260,person
39904,46,hat,47,0,11676,15,1344,729,1478,795,134,66,hat
39905,48,hat,49,0,11676,16,773,600,861,663,88,63,hat
39906,51,hat,52,0,11676,15,1551,565,1678,630,127,65,hat
39907,60,hat,61,0,11676,16,747,701,857,793,110,92,hat
39908,0,person,1,0,11677,21,1787,672,1938,1024,151,352,person
39909,1,person,2,0,11677,19,1610,632,1740,993,130,361,person
39910,13,person,12,1,11677,24,1887,646,1972,993,85,347,person
39911,14,person,13,0,11677,27,2107,665,2169,858,62,193,person
39912,24,person,23,0,11677,47,635,575,780,1028,145,453,person
39913,3,person,4,1,11678,18,1129,617,1262,747,133,130,person
39914,8,person,9,1,11678,38,42,635,288,950,246,315,person
39915,9,person,10,0,11678,52,28,649,291,1329,263,680,person
39916,10,person,11,0,11678,48,326,691,523,1298,197,607,person
39917,8,person,9,1,11679,27,512,800,659,975,147,175,person
39918,10,person,11,0,11679,41,831,786,1010,1280,179,494,person
39919,12,person,13,0,11679,34,1697,842,1869,1305,172,463,person
39920,13,person,14,0,11679,32,1855,828,1988,1308,133,480,person
39921,18,person,19,1,11679,15,1478,789,1637,934,159,145,person
39922,7,person,8,0,11681,24,992,1066,1098,1305,106,239,person
39923,8,person,9,0,11681,19,719,1047,803,1263,84,216,person
39924,14,person,15,0,11681,22,151,1049,208,1253,57,204,person
39925,22,person,23,1,11681,15,785,1060,843,1142,58,82,person
39926,23,person,24,0,11681,17,540,1071,572,1178,32,107,person
39927,1,person,2,0,11682,39,1224,855,1501,1509,277,654,person
39928,4,person,5,0,11682,24,363,860,525,1205,162,345,person
39929,9,person,10,0,11682,15,613,852,727,1213,114,361,person
39930,12,person,13,0,11682,31,802,847,907,1204,105,357,person
39931,62,person,63,1,11682,48,1004,852,1076,1126,72,274,person
39932,63,person,64,1,11682,36,1039,852,1136,1088,97,236,person
39933,64,person,65,0,11682,85,1071,839,1268,1473,197,634,person
39934,65,person,66,1,11682,20,1117,826,1190,931,73,105,person
39935,66,person,67,1,11682,17,1226,867,1274,963,48,96,person
39936,68,person,69,1,11682,16,1389,893,1445,984,56,91,person
39937,69,person,70,1,11682,20,1497,844,1535,913,38,69,person
39938,70,person,71,1,11682,18,1566,855,1612,926,46,71,person
39939,71,person,72,1,11682,34,1438,884,1545,1129,107,245,person
39940,72,person,73,1,11682,39,1531,884,1615,1131,84,247,person
39941,73,person,74,1,11682,33,1511,858,1564,1087,53,229,person
39942,76,person,77,1,11682,29,1635,839,1702,1055,67,216,person
39943,77,person,78,1,11682,43,931,856,1015,1128,84,272,person
39944,78,person,79,1,11682,19,702,842,763,948,61,106,person
39945,79,person,80,1,11682,23,357,850,380,943,23,93,person
39946,80,person,81,1,11682,15,401,829,469,939,68,110,person
39947,81,person,82,0,11682,20,379,842,401,958,22,116,person
39948,82,person,83,1,11682,19,319,838,360,937,41,99,person
39949,84,person,85,0,11682,25,3,879,61,1030,58,151,person
39950,88,person,89,1,11682,18,166,839,192,925,26,86,person
39951,90,bicycle,91,1,11682,48,34,929,162,1023,128,94,bicycle
39952,93,hat,94,0,11682,15,1163,841,1255,899,92,58,hat
39953,3,person,4,1,11683,18,553,195,635,284,82,89,person
39954,4,person,5,1,11683,16,588,208,669,295,81,87,person
39955,5,person,6,1,11683,23,593,225,673,416,80,191,person
39956,8,person,9,1,11683,42,487,198,619,469,132,271,person
39957,9,person,10,1,11683,40,603,189,799,601,196,412,person
39958,10,person,11,1,11683,29,420,190,518,350,98,160,person
39959,12,person,13,1,11683,38,250,158,393,342,143,184,person
39960,15,person,16,1,11683,48,161,200,276,600,115,400,person
39961,17,person,18,1,11683,24,0,157,64,346,64,189,person
39962,18,person,19,1,11683,44,50,189,213,550,163,361,person
39963,19,person,20,1,11683,21,0,249,185,600,185,351,person
39964,20,person,21,1,11683,66,209,171,562,600,353,429,person
39965,21,person,22,1,11683,27,539,441,638,601,99,160,person
39966,7,person,8,1,11684,24,77,92,127,213,50,121,person
39967,12,person,13,1,11684,17,175,82,202,176,27,94,person
39968,13,person,14,1,11684,27,181,87,246,208,65,121,person
39969,16,vegetables,17,0,11684,31,69,224,201,272,132,48,carrot
39970,17,vegetables,18,0,11684,25,0,181,108,222,108,41,carrot
39971,18,vegetables,19,0,11684,16,220,211,285,242,65,31,carrot
39972,19,vegetables,20,0,11684,23,311,176,416,220,105,44,carrot
39973,4,person,5,1,11685,18,170,88,196,124,26,36,person
39974,5,person,6,1,11685,24,200,95,237,138,37,43,person
39975,6,person,7,1,11685,18,239,114,278,155,39,41,person
39976,8,vegetables,9,0,11685,23,183,165,299,200,116,35,carrot
39977,9,vegetables,10,0,11685,58,106,122,282,199,176,77,carrot
39978,10,vegetables,11,0,11685,25,109,97,178,139,69,42,carrot
39979,11,person,12,1,11685,20,97,97,115,170,18,73,person
39980,12,person,13,1,11685,18,85,94,103,154,18,60,person
39981,14,person,15,1,11685,25,52,108,96,198,44,90,person
39982,15,person,16,0,11685,32,23,96,52,170,29,74,person
39983,0,person,1,1,11686,60,93,148,238,321,145,173,person
39984,1,person,2,1,11686,53,209,118,338,283,129,165,person
39985,4,person,5,1,11686,20,372,194,499,332,127,138,person
39986,5,person,6,1,11686,28,0,1,71,176,71,175,person
39987,6,person,7,1,11686,18,12,125,58,176,46,51,person
39988,9,person,10,1,11686,35,12,169,124,332,112,163,person
39989,11,person,12,1,11686,43,356,132,456,296,100,164,person
39990,12,person,13,1,11686,61,206,15,398,215,192,200,person
39991,13,person,14,1,11686,26,349,0,425,140,76,140,person
39992,14,person,15,1,11686,20,430,65,499,202,69,137,person
39993,15,person,16,1,11686,30,85,127,167,270,82,143,person
39994,16,person,17,1,11686,28,98,44,150,182,52,138,person
39995,20,person,21,1,11686,21,245,34,294,108,49,74,person
39996,21,person,22,1,11686,19,419,24,461,134,42,110,person
39997,3,person,4,0,11687,39,629,124,711,284,82,160,person
39998,4,person,5,0,11687,32,33,45,179,328,146,283,person
39999,5,person,6,1,11687,31,119,28,217,301,98,273,person
40000,6,person,7,0,11688,18,32,19,40,47,8,28,person
40001,7,person,8,0,11688,20,24,20,34,48,10,28,person
40002,8,person,9,0,11688,16,15,17,23,46,8,29,person
40003,9,person,10,0,11688,16,4,18,13,46,9,28,person
40004,15,person,16,1,11688,25,87,17,114,64,27,47,person
40005,16,person,17,1,11688,48,150,0,231,123,81,123,person
40006,18,person,19,1,11688,17,175,26,197,48,22,22,person
40007,4,person,5,1,11690,23,2,74,56,319,54,245,person
40008,6,person,7,1,11690,29,215,55,289,201,74,146,person
40009,8,person,9,1,11690,31,397,50,455,336,58,286,person
40010,9,person,10,1,11690,43,434,0,503,358,69,358,person
40011,20,person,21,1,11690,63,456,1,639,479,183,478,person
40012,21,person,22,1,11690,25,588,59,639,375,51,316,person
40013,19,person,20,1,11691,24,2,156,238,243,236,87,person
40014,10,person,11,1,11692,26,8,56,66,127,58,71,person
40015,11,person,12,1,11692,37,57,59,129,142,72,83,person
40016,13,person,14,1,11692,62,187,36,322,257,135,221,person
40017,9,table,9,0,11693,26,178,150,472,334,294,184,dining table
40018,11,table,11,0,11693,24,0,170,163,327,163,157,dining table
40019,15,person,15,1,11693,38,273,221,464,448,191,227,person
40020,16,person,16,1,11693,32,50,197,240,351,190,154,person
40021,17,person,17,1,11693,24,109,88,184,193,75,105,person
40022,18,person,18,1,11693,24,177,104,239,192,62,88,person
40023,19,person,19,1,11693,19,370,93,447,186,77,93,person
40024,20,person,20,1,11693,18,386,47,421,105,35,58,person
40025,22,person,22,1,11693,18,322,103,370,165,48,62,person
40026,28,person,28,1,11693,16,258,48,280,102,22,54,person
40027,30,person,30,1,11693,16,65,37,98,95,33,58,person
40028,32,person,32,1,11693,23,17,47,84,166,67,119,person
40029,6,person,7,1,11694,21,264,54,306,115,42,61,person
40030,25,car,26,1,11694,15,33,68,82,98,49,30,car
40031,26,car,27,1,11694,23,47,65,137,112,90,47,car
40032,27,person,28,1,11694,22,2,63,40,116,38,53,person
40033,1,person,2,1,11695,42,3,374,344,1289,341,915,person
40034,2,person,3,1,11695,30,244,445,422,1210,178,765,person
40035,4,table,5,0,11695,34,789,786,1496,1281,707,495,dining table
40036,6,vegetables,7,1,11695,29,1151,771,1406,855,255,84,carrot
40037,9,vegetables,10,1,11695,31,422,563,1101,832,679,269,carrot
40038,10,table,11,0,11695,31,391,755,1130,1137,739,382,dining table
40039,15,person,16,1,11695,35,1126,429,1310,795,184,366,person
40040,16,person,17,1,11695,18,1262,552,1346,792,84,240,person
40041,20,person,21,1,11695,21,1301,519,1416,804,115,285,person
40042,21,person,22,1,11695,28,1363,501,1491,864,128,363,person
40043,25,person,26,1,11695,19,1467,499,1576,752,109,253,person
40044,26,person,27,1,11695,17,1008,493,1113,710,105,217,person
40045,0,person,1,1,11696,78,830,142,1471,1042,641,900,person
40046,4,bowl,5,1,11696,16,42,1095,378,1252,336,157,bowl
40047,5,vegetables,6,0,11696,28,82,1102,356,1179,274,77,carrot
40048,9,bowl,10,0,11696,15,838,944,1234,1198,396,254,bowl
40049,10,vegetables,11,0,11696,30,870,1151,1386,1241,516,90,carrot
40050,12,vegetables,12,0,11696,150,1347,895,2167,1564,820,669,carrot
40051,15,vegetables,15,1,11696,28,1158,970,1445,1092,287,122,carrot
40052,16,bowl,16,1,11696,16,1991,1174,2199,1431,208,257,bowl
40053,22,chair,22,1,11696,15,172,1082,473,1208,301,126,chair
40054,8,person,7,1,11697,35,963,659,1132,964,169,305,person
40055,9,person,8,1,11697,34,1085,652,1340,998,255,346,person
40056,10,person,9,0,11697,61,1188,441,1343,1007,155,566,person
40057,12,person,11,0,11697,56,392,431,669,807,277,376,person
40058,13,person,12,1,11697,25,319,453,467,607,148,154,person
40059,14,person,13,1,11697,16,284,483,355,581,71,98,person
40060,15,person,14,1,11697,48,1008,517,1099,710,91,193,person
40061,16,person,15,1,11697,18,719,550,770,597,51,47,person
40062,18,person,16,1,11697,24,940,567,1009,648,69,81,person
40063,19,person,17,1,11697,30,971,516,1022,627,51,111,person
40064,43,person,40,1,11697,35,872,549,971,733,99,184,person
40065,1,person,2,1,21505,59,23,11,273,385,250,374,person
40066,2,person,3,1,21505,22,0,0,107,214,107,214,person
40067,3,vegetables,4,0,21505,31,0,208,273,451,273,243,carrot
40068,5,person,6,1,25136,16,0,564,18,666,18,102,person
40069,6,person,7,1,25136,41,1,534,129,672,128,138,person
40070,7,person,8,1,25136,28,86,539,111,660,25,121,person
40071,8,person,9,0,25136,38,128,530,171,666,43,136,person
40072,11,person,12,1,25136,29,160,535,189,637,29,102,person
40073,12,person,13,0,25136,28,178,544,212,629,34,85,person
40074,13,person,14,1,25136,23,278,543,295,607,17,64,person
40075,14,person,15,0,25136,54,244,537,304,653,60,116,person
40076,16,person,17,1,25136,22,352,544,371,618,19,74,person
40077,17,person,18,0,25136,33,354,545,394,651,40,106,person
40078,19,person,20,1,25136,32,381,534,406,607,25,73,person
40079,20,person,21,0,25136,40,390,545,423,654,33,109,person
40080,21,person,22,1,25136,22,422,544,441,649,19,105,person
40081,22,person,23,1,25136,40,432,530,472,672,40,142,person
40082,23,person,24,1,25136,28,469,536,487,633,18,97,person
40083,24,person,25,0,25136,45,471,552,515,654,44,102,person
40084,25,person,26,0,25136,38,518,554,545,635,27,81,person
40085,26,person,27,0,25136,32,569,542,601,636,32,94,person
40086,29,person,30,0,25136,32,652,534,686,624,34,90,person
40087,30,person,31,1,25136,23,682,532,703,621,21,89,person
40088,31,person,32,1,25136,30,687,539,730,672,43,133,person
40089,32,person,33,1,25136,44,706,456,870,672,164,216,person
40090,33,person,34,1,25136,27,828,518,897,672,69,154,person
40091,4,bowl,5,0,25137,21,222,370,922,890,700,520,bowl
40092,0,person,1,0,25138,82,138,14,472,1024,334,1010,person
40093,1,person,2,1,25138,49,409,203,610,1023,201,820,person
40094,2,person,3,1,25138,53,403,88,568,927,165,839,person
40095,3,person,4,1,25138,16,636,172,696,254,60,82,person
40096,10,person,11,1,25138,15,739,295,767,421,28,126,person
40097,2,person,3,1,25139,26,588,283,710,457,122,174,person
40098,4,plant pot,5,0,25139,15,204,790,332,911,128,121,potted plant
40099,5,plant pot,6,0,25139,15,490,816,612,919,122,103,potted plant
40100,6,plant pot,7,1,25139,15,398,782,491,892,93,110,potted plant
40101,19,plant pot,20,0,25139,25,573,738,664,849,91,111,potted plant
40102,42,truck,43,1,25139,29,812,190,1596,661,784,471,truck
40103,3,person,4,1,25140,65,670,154,915,536,245,382,person
40104,5,person,6,1,25140,54,868,281,1023,587,155,306,person
40105,6,person,7,1,25140,61,895,209,994,554,99,345,person
40106,34,person,35,1,25140,41,781,490,920,562,139,72,person
40107,4,person,5,1,25141,40,0,1,188,730,188,729,person
40108,5,person,6,1,25141,94,2,1,348,725,346,724,person
40109,6,person,7,1,25141,96,287,180,498,642,211,462,person
40110,7,person,8,1,25141,130,388,0,714,590,326,590,person
40111,8,hat,9,0,25141,39,618,396,762,536,144,140,hat
40112,10,apple,11,0,25141,21,394,552,483,633,89,81,apple
40113,11,apple,12,0,25141,24,401,625,500,720,99,95,apple
40114,12,apple,13,1,25141,29,475,577,589,671,114,94,apple
40115,13,apple,14,0,25141,15,278,680,419,748,141,68,apple
40116,14,apple,15,1,25141,26,265,638,405,729,140,91,apple
40117,15,apple,16,1,25141,20,253,637,322,714,69,77,apple
40118,16,apple,17,1,25141,20,147,632,251,705,104,73,apple
40119,17,apple,18,1,25141,15,95,679,287,748,192,69,apple
40120,19,plate,20,0,25141,28,762,679,952,739,190,60,plate
40121,16,person,17,0,11725,17,215,385,226,411,11,26,person
40122,17,person,18,0,11725,16,338,353,347,373,9,20,person
40123,12,person,13,0,11726,19,86,119,99,154,13,35,person
40124,3,person,4,0,11728,18,176,271,200,385,24,114,person
40125,4,person,5,0,11728,29,195,269,268,458,73,189,person
40126,5,person,6,1,11728,19,0,269,48,471,48,202,person
40127,11,person,12,0,11730,19,1089,815,1114,904,25,89,person
40128,12,person,13,0,11730,17,1187,814,1212,903,25,89,person
40129,13,person,14,0,11730,22,1208,802,1248,903,40,101,person
40130,14,person,15,0,11730,25,347,804,413,938,66,134,person
40131,15,dog,16,0,11730,15,1060,889,1092,930,32,41,dog
40132,7,car,8,1,11738,17,206,159,299,200,93,41,car
40133,8,car,9,1,11738,23,106,155,244,200,138,45,car
40134,9,car,10,1,11738,16,0,162,138,200,138,38,car
40135,1,car,2,1,23863,18,938,413,1023,678,85,265,car
40136,6,car,7,1,23863,17,2,471,104,641,102,170,car
40137,7,motorbike,8,0,23863,64,264,500,457,650,193,150,motorcycle
40138,4,vase,5,0,23868,60,269,29,387,234,118,205,vase
40139,9,person,10,0,11743,29,565,643,711,1059,146,416,person
40140,6,person,7,0,11744,40,251,244,294,341,43,97,person
40141,7,person,8,0,11744,25,159,251,179,334,20,83,person
40142,8,person,9,0,11744,25,28,243,76,343,48,100,person
40143,9,person,10,0,11744,29,71,247,116,327,45,80,person
40144,15,person,16,0,11744,20,123,253,141,315,18,62,person
40145,4,person,5,1,11746,16,890,1267,932,1437,42,170,person
40146,6,person,7,0,11747,36,504,205,624,533,120,328,person
40147,13,person,14,0,11749,42,119,240,187,440,68,200,person
40148,6,person,7,0,11750,25,11,330,35,411,24,81,person
40149,7,person,8,0,11750,27,21,359,65,423,44,64,person
40150,8,person,9,0,11750,26,48,358,94,430,46,72,person
40151,6,person,7,1,11751,18,246,148,275,236,29,88,person
40152,11,person,12,0,11753,44,261,128,321,330,60,202,person
40153,5,person,6,0,11754,67,312,18,425,311,113,293,person
40154,10,person,11,1,11754,15,138,141,147,189,9,48,person
40155,9,person,10,1,23870,26,699,617,768,696,69,79,person
40156,10,person,11,0,23870,31,644,573,698,731,54,158,person
40157,11,person,12,0,23870,28,369,596,408,705,39,109,person
40158,12,person,13,0,23870,30,294,600,333,707,39,107,person
40159,16,motorbike,17,0,23870,16,332,607,348,631,16,24,motorcycle
40160,1,person,2,1,23871,20,174,78,227,243,53,165,person
40161,2,person,3,0,23871,32,173,139,332,444,159,305,person
40162,2,person,3,1,23873,22,133,424,229,757,96,333,person
40163,32,person,33,0,23874,50,766,256,827,482,61,226,person
40164,33,person,34,1,23874,52,847,272,898,463,51,191,person
40165,34,person,35,0,23874,54,877,268,932,484,55,216,person
40166,36,motorbike,37,1,23874,24,658,387,704,455,46,68,motorcycle
40167,5,person,6,0,23875,43,615,782,674,934,59,152,person
40168,6,person,7,0,23875,28,576,740,611,910,35,170,person
40169,7,person,8,0,23875,31,530,734,585,935,55,201,person
40170,4,dog,5,0,23876,57,468,583,767,1005,299,422,dog
40171,11,person,12,0,23877,49,540,710,585,829,45,119,person
40172,13,umbrella,14,0,23877,22,198,665,459,841,261,176,umbrella
40173,14,umbrella,15,0,23877,23,217,634,431,695,214,61,umbrella
40174,24,person,25,0,23877,29,145,643,167,729,22,86,person
40175,25,person,26,1,23877,31,146,633,171,720,25,87,person
40176,26,person,27,0,23877,29,257,548,279,611,22,63,person
40177,27,person,28,0,23877,32,277,544,299,611,22,67,person
40178,28,person,29,0,23877,23,290,522,311,570,21,48,person
40179,30,person,31,1,23877,16,554,516,562,566,8,50,person
40180,31,truck,32,1,23877,24,431,502,529,539,98,37,truck
40181,32,truck,33,1,23877,18,527,488,563,518,36,30,truck
40182,56,chair,57,1,23877,17,476,830,514,875,38,45,chair
40183,58,chair,59,1,23877,28,391,800,433,850,42,50,chair
40184,60,chair,61,1,23877,19,464,791,507,829,43,38,chair
40185,66,chair,67,1,23877,20,203,800,240,849,37,49,chair
40186,67,chair,68,0,23877,20,352,771,384,825,32,54,chair
40187,69,chair,70,1,23877,17,167,783,209,829,42,46,chair
40188,8,car,9,0,23878,32,1366,1148,1696,1618,330,470,car
40189,3,car,4,0,11760,20,9,170,43,193,34,23,car
40190,5,car,6,0,11760,18,180,167,207,179,27,12,car
40191,13,car,14,1,11781,16,561,350,639,461,78,111,car
40192,6,person,7,1,11790,23,578,167,600,303,22,136,person
40193,26,car,27,0,11825,16,604,277,639,291,35,14,car
40194,23,person,24,0,11828,28,221,398,239,444,18,46,person
40195,24,person,25,0,11828,20,195,399,210,445,15,46,person
40196,25,person,26,0,11828,24,180,396,197,445,17,49,person
40197,9,person,10,0,11830,19,161,246,170,275,9,29,person
40198,10,person,11,1,11830,15,167,242,174,273,7,31,person
40199,11,person,12,0,11830,16,172,243,180,275,8,32,person
40200,12,person,13,0,11830,25,208,234,223,270,15,36,person
40201,13,person,14,1,11830,15,226,234,237,256,11,22,person
40202,14,person,15,0,11830,20,312,236,322,271,10,35,person
40203,15,person,16,0,11830,19,306,238,314,271,8,33,person
40204,14,person,15,0,11837,17,220,474,236,516,16,42,person
40205,15,person,16,0,11837,19,126,486,147,539,21,53,person
40206,16,person,17,0,11837,21,100,482,123,541,23,59,person
40207,17,person,18,0,11837,17,85,489,101,549,16,60,person
40208,18,person,19,0,11837,20,71,497,86,548,15,51,person
40209,19,person,20,0,11837,18,59,503,71,551,12,48,person
40210,38,person,39,0,11838,22,45,259,64,304,19,45,person
40211,17,window,18,0,11851,15,435,627,485,707,50,80,window
40212,10,person,11,0,25144,21,362,272,432,352,70,80,person
40213,13,person,14,1,25144,15,390,228,400,248,10,20,person
40214,14,person,15,1,25144,21,405,226,424,247,19,21,person
40215,10,chair,11,0,11855,16,290,185,312,209,22,24,chair
40216,13,car,14,1,11856,20,258,128,320,169,62,41,car
40217,3,person,4,0,11857,32,121,197,154,281,33,84,person
40218,13,person,14,1,11858,24,113,77,134,132,21,55,person
40219,1,person,2,0,11859,57,10,150,102,240,92,90,person
40220,2,ball,3,0,11859,17,22,23,53,54,31,31,sports ball
40221,9,person,10,0,11859,39,140,211,201,252,61,41,person
40222,2,car,3,1,11860,16,17,61,50,133,33,72,car
40223,5,window,6,0,11861,17,57,63,180,130,123,67,window
40224,10,person,11,0,11866,19,359,197,374,227,15,30,person
40225,13,person,14,1,11866,37,131,186,172,256,41,70,person
40226,14,person,15,1,11866,20,114,217,137,257,23,40,person
40227,15,person,16,1,11866,21,80,209,122,256,42,47,person
40228,16,person,17,0,11866,17,254,172,261,206,7,34,person
40229,17,person,18,0,11866,18,241,174,249,207,8,33,person
40230,18,person,19,0,11866,16,235,176,243,208,8,32,person
40231,19,person,20,0,11866,20,209,176,218,203,9,27,person
40232,20,person,21,0,11866,17,186,184,191,203,5,19,person
40233,21,person,22,0,11866,19,67,178,77,206,10,28,person
40234,22,person,23,0,11866,19,60,178,67,208,7,30,person
40235,23,person,24,0,11866,18,52,174,60,208,8,34,person
40236,3,person,4,0,11874,24,2119,1040,2178,1187,59,147,person
40237,21,person,22,0,11875,16,18,166,28,197,10,31,person
40238,9,person,10,0,11877,16,161,451,187,504,26,53,person
40239,25,car,26,0,11918,22,1226,1415,1346,1481,120,66,car
40240,19,motorbike,20,0,11922,38,778,450,868,539,90,89,motorcycle
40241,20,motorbike,21,0,11922,33,631,448,712,530,81,82,motorcycle
40242,21,person,22,0,11923,18,948,1329,978,1408,30,79,person
40243,31,person,32,0,11923,23,1565,1317,1606,1416,41,99,person
40244,8,person,9,0,11924,31,246,331,284,399,38,68,person
40245,9,person,10,0,11924,20,174,314,188,348,14,34,person
40246,10,person,11,0,11924,16,101,307,114,338,13,31,person
40247,0,person,1,0,11925,18,1602,931,1662,1103,60,172,person
40248,1,person,2,0,11925,15,1766,922,1819,1098,53,176,person
40249,10,person,11,0,11925,24,558,1004,638,1083,80,79,person
40250,11,person,12,0,11925,26,638,1002,696,1079,58,77,person
40251,12,person,13,1,11925,27,1078,908,1118,1078,40,170,person
40252,13,person,14,0,11925,28,986,911,1033,1079,47,168,person
40253,14,person,15,0,11925,42,1011,885,1104,1112,93,227,person
40254,15,person,16,0,11925,20,697,1006,768,1078,71,72,person
40255,16,person,17,1,11925,18,752,1000,797,1076,45,76,person
40256,18,person,19,0,11925,17,494,1025,532,1075,38,50,person
40257,19,person,20,0,11925,25,413,1003,490,1081,77,78,person
40258,20,person,21,0,11925,22,350,1007,415,1078,65,71,person
40259,21,person,22,0,11925,21,295,1001,352,1071,57,70,person
40260,22,person,23,1,11925,18,539,1002,587,1080,48,78,person
40261,34,door,35,0,11925,18,818,885,926,1023,108,138,door
40262,2,bench,3,0,11926,15,580,1542,836,1646,256,104,bench
40263,5,car,6,0,11929,21,1063,627,1132,670,69,43,car
40264,6,car,7,0,11929,21,904,613,970,659,66,46,car
40265,10,car,11,1,11929,18,676,618,742,673,66,55,car
40266,33,person,34,0,11929,17,780,613,828,705,48,92,person
40267,0,umbrella,1,0,11930,17,1281,1121,1535,1349,254,228,umbrella
40268,1,person,2,0,11930,36,368,1134,447,1394,79,260,person
40269,6,person,7,0,11930,39,1335,1204,1398,1368,63,164,person
40270,7,person,8,0,11930,22,1298,1222,1346,1362,48,140,person
40271,42,person,43,0,11930,23,442,1186,494,1364,52,178,person
40272,43,person,44,1,11930,17,606,1181,651,1268,45,87,person
40273,45,person,46,1,11930,15,603,1097,635,1170,32,73,person
40274,50,person,51,1,11930,27,363,1186,401,1348,38,162,person
40275,52,person,53,0,11930,42,288,1174,375,1361,87,187,person
40276,53,person,54,1,11930,29,247,1208,298,1359,51,151,person
40277,54,person,55,0,11930,19,70,1127,99,1227,29,100,person
40278,57,umbrella,58,0,11930,22,69,1053,293,1219,224,166,umbrella
40279,59,person,60,1,11930,17,110,1173,152,1266,42,93,person
40280,60,person,61,0,11930,34,50,1183,161,1402,111,219,person
40281,61,person,62,0,11930,27,3,1170,81,1367,78,197,person
40282,65,umbrella,66,0,11930,26,595,1138,808,1201,213,63,umbrella
40283,66,umbrella,67,0,11930,19,778,1118,952,1202,174,84,umbrella
40284,67,umbrella,68,0,11930,30,932,1123,1180,1274,248,151,umbrella
40285,68,umbrella,69,1,11930,20,1777,1103,1882,1182,105,79,umbrella
40286,69,umbrella,70,0,11930,23,1852,1124,1981,1207,129,83,umbrella
40287,76,umbrella,77,1,11930,16,1967,1143,2094,1212,127,69,umbrella
40288,141,person,142,1,11930,20,1139,1101,1167,1162,28,61,person
40289,142,person,143,1,11930,18,1164,1097,1189,1143,25,46,person
40290,143,person,144,1,11930,24,1165,1130,1195,1198,30,68,person
40291,144,person,145,1,11930,21,1191,1101,1215,1186,24,85,person
40292,146,person,147,1,11930,21,1211,1101,1234,1166,23,65,person
40293,147,person,148,1,11930,24,1248,1108,1280,1165,32,57,person
40294,148,person,149,1,11930,16,1244,1150,1288,1193,44,43,person
40295,149,person,150,1,11930,16,1323,1103,1352,1144,29,41,person
40296,150,person,151,1,11930,16,1315,1098,1341,1145,26,47,person
40297,151,person,152,1,11930,15,1343,1095,1361,1134,18,39,person
40298,152,person,153,1,11930,15,1365,1102,1397,1131,32,29,person
40299,158,person,159,1,11930,21,1474,1107,1503,1149,29,42,person
40300,163,person,164,1,11930,22,1511,1136,1540,1206,29,70,person
40301,164,person,165,1,11930,26,1530,1105,1563,1155,33,50,person
40302,165,person,166,1,11930,21,1534,1139,1554,1209,20,70,person
40303,167,person,168,1,11930,32,1541,1132,1593,1210,52,78,person
40304,168,person,169,1,11930,20,1579,1114,1603,1148,24,34,person
40305,169,person,170,1,11930,16,1585,1139,1606,1184,21,45,person
40306,170,person,171,1,11930,15,1570,1148,1592,1197,22,49,person
40307,171,person,172,1,11930,15,1564,1169,1585,1209,21,40,person
40308,172,person,173,1,11930,17,1585,1171,1609,1208,24,37,person
40309,173,person,174,1,11930,18,1582,1184,1619,1224,37,40,person
40310,176,person,177,1,11930,23,1606,1140,1636,1210,30,70,person
40311,178,person,179,1,11930,17,1633,1176,1656,1215,23,39,person
40312,179,person,180,1,11930,26,1648,1151,1701,1215,53,64,person
40313,180,person,181,1,11930,17,1668,1152,1695,1202,27,50,person
40314,181,person,182,1,11930,15,1688,1174,1712,1198,24,24,person
40315,182,person,183,1,11930,16,1714,1142,1736,1187,22,45,person
40316,28,person,29,0,11931,22,705,422,738,510,33,88,person
40317,29,person,30,0,11931,30,728,384,768,507,40,123,person
40318,30,person,31,0,11931,27,752,380,795,509,43,129,person
40319,32,person,33,0,11931,15,515,397,525,426,10,29,person
40320,18,person,19,1,25146,55,236,1170,557,1599,321,429,person
40321,19,person,20,1,25146,33,206,1218,388,1599,182,381,person
40322,20,person,21,0,25146,16,1171,1160,1199,1288,28,128,person
40323,14,person,15,0,25148,27,694,576,721,647,27,71,person
40324,15,person,16,0,25148,29,716,581,734,646,18,65,person
40325,16,person,17,0,25148,22,666,582,677,627,11,45,person
40326,18,person,19,1,25148,24,636,603,657,649,21,46,person
40327,20,person,21,0,25148,28,603,613,622,656,19,43,person
40328,21,person,22,0,25148,39,581,598,608,657,27,59,person
40329,22,person,23,0,25148,41,551,591,577,657,26,66,person
40330,23,person,24,0,25148,21,545,595,557,636,12,41,person
40331,24,person,25,1,25148,25,519,593,534,636,15,43,person
40332,25,person,26,0,25148,30,506,593,524,636,18,43,person
40333,26,person,27,0,25148,15,447,585,454,607,7,22,person
40334,27,person,28,0,25148,29,415,593,426,625,11,32,person
40335,28,person,29,0,25148,32,387,595,401,625,14,30,person
40336,30,person,31,0,25148,22,268,593,281,626,13,33,person
40337,31,person,32,0,25148,22,255,593,262,620,7,27,person
40338,32,person,33,0,25148,24,246,589,255,621,9,32,person
40339,33,person,34,0,25148,23,237,590,247,621,10,31,person
40340,34,person,35,1,25148,18,233,593,240,621,7,28,person
40341,18,person,19,0,25152,23,78,362,92,404,14,42,person
40342,19,person,20,0,25152,18,58,360,73,399,15,39,person
40343,2,car,3,1,11933,19,295,279,399,356,104,77,car
40344,3,car,4,1,11933,15,335,304,399,385,64,81,car
40345,11,car,12,0,11933,18,92,288,140,322,48,34,car
40346,17,person,18,0,11933,19,174,275,190,329,16,54,person
40347,18,person,19,0,11933,22,199,273,218,329,19,56,person
40348,2,car,3,1,11934,17,251,129,275,147,24,18,car
40349,3,car,4,1,11934,19,228,131,256,140,28,9,car
40350,4,car,5,0,11934,20,89,130,119,141,30,11,car
40351,5,car,6,0,11934,17,65,129,87,139,22,10,car
40352,6,car,7,0,11934,18,43,127,65,137,22,10,car
40353,7,car,8,0,11934,17,18,126,36,135,18,9,car
40354,13,person,14,0,11937,45,161,120,212,305,51,185,person
40355,14,person,15,1,11937,55,167,115,260,315,93,200,person
40356,15,person,16,1,11937,54,49,132,134,314,85,182,person
40357,16,person,17,0,11937,41,92,144,147,302,55,158,person
40358,3,car,4,1,11938,15,287,159,335,195,48,36,car
40359,9,car,10,0,11942,25,220,134,267,150,47,16,car
40360,10,car,11,0,11942,31,148,119,221,153,73,34,car
40361,10,car,11,0,23880,23,1810,1009,1898,1067,88,58,car
40362,11,bus,12,1,23880,20,1775,990,1858,1063,83,73,bus
40363,13,bench,14,1,23880,28,1525,1075,1613,1139,88,64,bench
40364,14,bench,15,1,23880,40,1177,1094,1328,1184,151,90,bench
40365,15,bench,16,1,23880,51,1428,1086,1596,1197,168,111,bench
40366,16,bench,17,1,23880,49,1682,1101,1870,1216,188,115,bench
40367,17,bench,18,0,23880,43,1924,1077,2085,1169,161,92,bench
40368,18,bench,19,1,23880,27,2069,1077,2175,1166,106,89,bench
40369,27,bench,28,1,23880,25,499,1085,598,1149,99,64,bench
40370,41,fire hydrant,42,0,23880,15,940,1095,977,1169,37,74,fire hydrant
40371,42,bench,43,1,23880,25,297,1067,376,1117,79,50,bench
40372,4,car,5,0,23883,33,21,470,359,598,338,128,car
40373,5,car,6,1,23883,19,64,431,242,513,178,82,car
40374,8,car,9,0,23883,30,621,455,734,521,113,66,car
40375,9,car,10,1,23883,21,701,455,769,515,68,60,car
40376,10,car,11,1,23883,18,761,465,821,516,60,51,car
40377,11,car,12,1,23883,16,777,469,860,506,83,37,car
40378,12,car,13,1,23883,15,841,471,898,507,57,36,car
40379,13,car,14,1,23883,16,844,461,929,492,85,31,car
40380,14,car,15,0,23883,17,881,467,1023,530,142,63,car
40381,21,chair,22,1,23885,15,255,765,283,809,28,44,chair
40382,1,car,2,0,23888,36,0,378,236,453,236,75,car
40383,2,car,3,0,23888,57,342,320,573,517,231,197,car
40384,12,car,13,1,23888,27,561,377,636,447,75,70,car
40385,13,car,14,1,23888,16,625,382,654,433,29,51,car
40386,14,car,15,1,23888,18,650,391,691,431,41,40,car
40387,15,car,16,1,23888,43,673,348,770,572,97,224,car
40388,16,car,17,1,23888,25,677,337,799,599,122,262,car
40389,20,traffic light,21,0,23888,28,96,89,799,200,703,111,traffic light
40390,4,car,5,1,23889,26,1348,635,1617,852,269,217,car
40391,5,motorbike,6,1,23889,45,949,675,1209,832,260,157,motorcycle
40392,7,car,8,1,23889,21,288,600,437,710,149,110,car
40393,8,car,9,0,23889,38,110,591,337,706,227,115,car
40394,9,car,10,1,23889,26,40,605,188,692,148,87,car
40395,10,motorbike,11,1,23889,24,1,607,48,681,47,74,motorcycle
40396,12,person,13,1,23889,25,247,603,300,732,53,129,person
40397,13,car,14,0,23889,44,300,631,666,787,366,156,car
40398,17,table,18,0,23889,16,860,656,971,704,111,48,dining table
40399,21,table,22,0,23889,30,688,774,1122,951,434,177,dining table
40400,23,bench,24,0,23889,18,759,815,1139,915,380,100,bench
40401,24,table,25,0,23889,30,37,717,366,851,329,134,dining table
40402,25,bench,26,0,23889,15,2,771,274,866,272,95,bench
40403,26,bench,27,0,23889,22,139,751,400,833,261,82,bench
40404,4,umbrella,5,0,23890,15,484,455,525,500,41,45,umbrella
40405,6,umbrella,7,0,23890,15,439,477,477,505,38,28,umbrella
40406,9,car,10,0,23890,30,315,546,501,608,186,62,car
40407,10,car,11,1,23890,17,302,546,383,600,81,54,car
40408,11,car,12,0,23890,16,218,533,291,559,73,26,car
40409,12,car,13,0,23890,20,8,546,132,582,124,36,car
40410,13,car,14,1,23893,23,0,436,196,533,196,97,car
40411,16,car,17,1,23893,29,577,442,796,524,219,82,car
40412,17,car,18,1,23893,21,795,414,1013,469,218,55,car
40413,19,car,20,1,23893,36,465,461,1024,753,559,292,car
40414,2,person,3,0,12045,15,110,156,126,194,16,38,person
40415,8,person,9,1,12045,21,89,152,102,198,13,46,person
40416,9,person,10,0,12045,25,78,162,94,203,16,41,person
40417,6,person,7,0,12199,18,166,77,178,122,12,45,person
40418,7,person,8,0,12199,15,187,77,199,121,12,44,person
40419,7,person,8,0,12200,32,1634,1143,1699,1442,65,299,person
40420,8,person,9,1,12200,29,1518,1124,1636,1465,118,341,person
40421,9,person,10,1,12200,22,1430,1142,1507,1258,77,116,person
40422,10,person,11,1,12200,19,1385,1151,1461,1263,76,112,person
40423,12,person,13,1,12200,23,1107,1137,1168,1323,61,186,person
40424,14,person,15,1,12200,22,871,1158,936,1275,65,117,person
40425,15,person,16,1,12200,31,807,1149,877,1335,70,186,person
40426,16,person,17,1,12200,22,781,1172,831,1336,50,164,person
40427,17,person,18,1,12200,26,658,1135,734,1276,76,141,person
40428,18,person,19,1,12200,16,662,1198,717,1280,55,82,person
40429,19,person,20,1,12200,22,572,1147,645,1282,73,135,person
40430,20,person,21,1,12200,21,491,1199,561,1331,70,132,person
40431,21,person,22,1,12200,23,430,1168,494,1290,64,122,person
40432,22,person,23,1,12200,23,384,1157,445,1283,61,126,person
40433,23,person,24,1,12200,19,261,1177,339,1286,78,109,person
40434,28,person,29,0,12200,24,2143,1096,2196,1322,53,226,person
40435,3,person,4,1,12204,17,2074,1407,2196,1643,122,236,person
40436,7,truck,8,1,12205,15,167,214,235,264,68,50,truck
40437,8,person,9,0,12205,20,40,226,56,265,16,39,person
40438,15,person,16,1,12208,21,1418,918,1624,1105,206,187,person
40439,18,person,19,1,12208,24,1864,917,1929,1082,65,165,person
40440,19,person,20,1,12208,16,1919,920,1952,1080,33,160,person
40441,20,person,21,0,12208,26,751,916,798,1053,47,137,person
40442,21,person,22,0,12208,23,849,913,897,1044,48,131,person
40443,22,person,23,0,12208,17,891,927,922,1045,31,118,person
40444,28,window,29,0,12208,20,365,423,1537,783,1172,360,window
40445,7,car,8,0,12209,15,102,322,142,351,40,29,car
40446,10,car,11,0,12209,21,23,314,100,376,77,62,car
40447,11,chair,12,0,12209,22,226,351,261,396,35,45,chair
40448,12,person,13,0,12209,18,192,312,206,363,14,51,person
40449,13,person,14,0,12209,22,202,313,223,365,21,52,person
40450,15,person,16,0,12209,17,153,323,174,360,21,37,person
40451,7,car,8,0,12257,31,10,549,184,627,174,78,car
40452,8,person,9,0,12257,26,414,535,447,631,33,96,person
40453,13,person,14,0,12257,24,526,534,565,648,39,114,person
40454,14,person,15,0,12257,21,497,546,532,654,35,108,person
40455,17,person,18,0,12260,15,340,354,353,387,13,33,person
40456,22,person,23,0,12260,22,424,400,445,440,21,40,person
40457,23,person,24,0,12260,17,392,368,409,403,17,35,person
40458,14,car,15,0,12262,23,1984,1418,2172,1536,188,118,car
40459,15,person,16,0,12262,24,1583,1384,1629,1491,46,107,person
40460,16,person,17,0,12262,17,1956,1265,1979,1350,23,85,person
40461,17,person,18,0,12262,15,1560,1307,1601,1370,41,63,person
40462,30,person,31,0,12262,23,2060,1255,2104,1343,44,88,person
40463,31,person,32,0,12262,22,2038,1247,2068,1336,30,89,person
40464,3,person,4,0,25157,31,1552,1058,1592,1125,40,67,person
40465,4,person,5,0,25157,41,1485,1014,1534,1121,49,107,person
40466,5,person,6,1,25157,22,1369,1050,1403,1123,34,73,person
40467,6,person,7,0,25157,31,1337,1019,1371,1125,34,106,person
40468,7,person,8,0,25157,27,1,1038,28,1143,27,105,person
40469,8,person,9,0,25157,26,15,1047,47,1145,32,98,person
40470,9,person,10,1,25157,23,39,1052,61,1144,22,92,person
40471,10,person,11,0,25157,38,43,1048,83,1151,40,103,person
40472,11,person,12,1,25157,26,71,1058,91,1144,20,86,person
40473,12,person,13,0,25157,33,93,1045,124,1142,31,97,person
40474,13,person,14,0,25157,24,114,1064,140,1141,26,77,person
40475,8,traffic light,9,0,25159,18,7,487,154,540,147,53,traffic light
40476,9,car,10,0,25159,19,85,583,156,610,71,27,car
40477,3,person,4,1,25161,23,383,443,412,480,29,37,person
40478,4,person,5,1,25161,19,527,439,548,480,21,41,person
40479,5,person,6,0,25161,23,555,435,570,468,15,33,person
40480,6,person,7,1,25161,26,324,442,338,480,14,38,person
40481,7,person,8,1,25161,21,300,440,316,480,16,40,person
40482,8,person,9,1,25161,19,291,443,301,480,10,37,person
40483,9,person,10,1,25161,24,199,453,251,479,52,26,person
40484,10,person,11,1,25161,23,110,435,126,480,16,45,person
40485,11,person,12,1,25161,24,132,446,149,480,17,34,person
40486,12,person,13,0,25161,25,71,441,84,479,13,38,person
40487,17,person,18,0,25161,21,348,435,361,472,13,37,person
40488,18,person,19,0,25161,20,338,440,348,472,10,32,person
40489,19,person,20,1,25161,21,123,441,131,475,8,34,person
40490,7,person,8,0,25162,19,951,1311,988,1399,37,88,person
40491,8,person,9,0,25162,18,1145,1310,1178,1406,33,96,person
40492,6,traffic light,7,0,25164,91,69,375,228,680,159,305,traffic light
40493,8,traffic light,9,0,25164,46,1,77,73,235,72,158,traffic light
40494,11,umbrella,12,0,25164,19,15,597,88,632,73,35,umbrella
40495,14,person,15,0,25164,26,945,643,978,680,33,37,person
40496,15,person,16,0,25164,23,859,615,877,680,18,65,person
40497,16,person,17,0,25164,23,884,630,909,675,25,45,person
40498,17,person,18,0,25164,19,904,624,927,680,23,56,person
40499,18,person,19,1,25164,17,922,638,940,675,18,37,person
40500,19,person,20,0,25164,25,729,635,758,680,29,45,person
40501,20,person,21,1,25164,18,816,634,838,680,22,46,person
40502,21,person,22,1,25164,17,841,643,869,680,28,37,person
40503,23,person,24,0,25164,26,572,621,592,665,20,44,person
40504,24,person,25,1,25164,16,597,613,609,638,12,25,person
40505,25,person,26,0,25164,22,579,572,595,615,16,43,person
40506,28,person,29,0,25164,16,559,555,569,591,10,36,person
40507,29,person,30,1,25164,16,580,609,592,629,12,20,person
40508,30,person,31,1,25164,18,568,611,580,648,12,37,person
40509,33,person,34,0,25164,23,429,559,444,604,15,45,person
40510,34,person,35,0,25164,19,450,566,462,607,12,41,person
40511,37,person,38,1,25164,18,420,604,434,636,14,32,person
40512,38,person,39,1,25164,19,408,641,421,680,13,39,person
40513,39,person,40,1,25164,23,419,639,441,681,22,42,person
40514,40,person,41,0,25164,34,350,608,372,654,22,46,person
40515,41,person,42,0,25164,31,339,615,354,649,15,34,person
40516,42,person,43,1,25164,20,458,636,484,680,26,44,person
40517,43,person,44,1,25164,21,322,638,334,680,12,42,person
40518,44,person,45,1,25164,24,302,636,328,681,26,45,person
40519,45,person,46,1,25164,18,292,639,306,680,14,41,person
40520,46,person,47,0,25164,19,307,608,317,644,10,36,person
40521,47,person,48,1,25164,25,274,629,302,680,28,51,person
40522,48,person,49,0,25164,23,234,639,268,680,34,41,person
40523,49,person,50,0,25164,26,278,607,291,656,13,49,person
40524,50,person,51,0,25164,31,260,615,279,676,19,61,person
40525,51,person,52,0,25164,25,245,600,263,653,18,53,person
40526,52,person,53,1,25164,20,233,599,247,630,14,31,person
40527,53,person,54,1,25164,33,223,617,246,679,23,62,person
40528,54,person,55,1,25164,18,216,637,235,681,19,44,person
40529,55,person,56,0,25164,28,201,603,224,654,23,51,person
40530,56,person,57,1,25164,17,126,638,155,666,29,28,person
40531,57,person,58,0,25164,20,163,602,176,635,13,33,person
40532,58,person,59,1,25164,15,122,630,140,650,18,20,person
40533,59,person,60,1,25164,16,142,647,157,666,15,19,person
40534,60,person,61,1,25164,26,137,602,153,641,16,39,person
40535,61,person,62,1,25164,27,115,594,140,642,25,48,person
40536,62,person,63,1,25164,17,111,601,128,639,17,38,person
40537,63,person,64,1,25164,24,84,600,103,636,19,36,person
40538,18,person,19,0,13831,23,557,181,583,261,26,80,person
40539,19,person,20,0,13831,34,274,174,318,304,44,130,person
40540,22,parking meter,23,0,13831,16,2,204,22,319,20,115,parking meter
40541,6,person,7,0,13832,33,326,140,365,242,39,102,person
40542,11,person,12,1,13832,33,240,131,287,287,47,156,person
40543,17,table,18,0,13832,15,102,211,245,268,143,57,dining table
40544,7,person,8,0,13833,32,399,197,485,476,86,279,person
40545,9,person,10,0,13833,42,29,194,133,477,104,283,person
40546,2,car,3,1,13834,16,1,148,41,220,40,72,car
40547,6,table,7,0,13835,46,1216,819,1706,1147,490,328,dining table
40548,10,bicycle,11,0,13836,36,277,737,380,866,103,129,bicycle
40549,11,person,12,1,13836,16,130,652,183,799,53,147,person
40550,13,person,14,1,13836,16,1434,661,1488,839,54,178,person
40551,14,person,15,0,13836,24,1383,682,1485,990,102,308,person
40552,4,car,5,1,13837,19,2,415,79,445,77,30,car
40553,17,person,18,0,13837,45,982,396,1072,645,90,249,person
40554,89,window,90,0,13838,16,178,189,400,364,222,175,window
40555,3,person,4,1,13859,42,482,235,566,389,84,154,person
40556,4,person,5,1,13859,30,476,349,576,490,100,141,person
40557,5,person,6,1,13859,28,428,236,485,373,57,137,person
40558,6,person,7,1,13859,31,377,245,430,361,53,116,person
40559,7,person,8,0,13859,42,316,235,385,458,69,223,person
40560,8,person,9,1,13859,31,425,336,502,489,77,153,person
40561,9,person,10,0,13859,32,356,332,455,489,99,157,person
40562,4,person,5,1,13860,16,80,242,93,265,13,23,person
40563,6,person,7,0,13861,22,119,223,137,279,18,56,person
40564,7,person,8,0,13861,19,143,226,158,276,15,50,person
40565,9,person,10,1,13861,38,5,202,76,324,71,122,person
40566,2,person,3,0,13864,16,529,322,549,371,20,49,person
40567,12,car,13,0,13946,50,178,190,446,327,268,137,car
40568,11,horse,12,0,13950,21,300,200,327,271,27,71,horse
40569,12,horse,13,0,13950,25,327,207,356,273,29,66,horse
40570,13,horse,14,0,13950,38,416,208,511,271,95,63,horse
40571,16,person,17,0,23939,32,59,1021,161,1257,102,236,person
40572,17,person,18,0,23939,42,114,1002,189,1245,75,243,person
40573,18,person,19,0,23939,47,583,1231,873,1356,290,125,person
40574,19,person,20,0,23939,28,332,1202,439,1342,107,140,person
40575,20,person,21,1,23939,19,492,1112,552,1256,60,144,person
40576,25,person,26,1,23939,21,1917,1026,1989,1239,72,213,person
40577,29,person,30,1,23939,21,1289,1111,1358,1193,69,82,person
40578,3,clock,4,0,23941,18,676,1177,774,1293,98,116,clock
40579,5,bench,6,0,23941,27,1099,1879,1195,1937,96,58,bench
40580,8,person,9,0,23943,31,285,420,322,527,37,107,person
40581,3,car,4,1,13960,24,12,181,137,244,125,63,car
40582,11,bench,12,0,13962,33,84,989,683,1229,599,240,bench
40583,16,person,17,1,13963,21,923,798,1031,931,108,133,person
40584,6,window,7,0,13967,16,150,37,239,141,89,104,window
40585,6,person,7,0,13968,33,199,109,237,265,38,156,person
40586,7,person,8,1,13968,24,226,199,280,297,54,98,person
40587,3,window,4,0,13970,15,72,77,153,163,81,86,window
40588,6,person,7,1,13970,46,120,58,232,188,112,130,person
40589,5,person,6,1,13971,26,0,275,323,703,323,428,person
40590,3,person,4,0,13972,23,477,211,506,322,29,111,person
40591,2,car,3,1,14112,27,0,532,328,728,328,196,car
40592,3,car,4,0,14112,29,471,528,878,679,407,151,car
40593,4,car,5,1,14112,19,743,515,1015,658,272,143,car
40594,10,person,11,0,14113,17,14,258,27,289,13,31,person
40595,11,person,12,0,14113,16,26,260,38,283,12,23,person
40596,12,person,13,0,14113,20,40,257,61,299,21,42,person
40597,25,window,26,1,14119,15,218,193,276,231,58,38,window
40598,7,car,8,0,14120,15,496,882,606,938,110,56,car
40599,9,person,10,0,14120,17,407,877,446,981,39,104,person
40600,10,car,11,1,14120,19,608,838,748,961,140,123,car
40601,3,car,4,0,14124,20,913,625,981,664,68,39,car
40602,4,truck,5,1,14124,21,751,590,883,696,132,106,truck
40603,6,car,7,0,14124,31,364,664,592,767,228,103,car
40604,90,door,91,0,14124,16,799,623,823,684,24,61,door
40605,99,door,100,0,14124,15,677,635,711,701,34,66,door
40606,108,door,109,0,14124,15,478,669,535,753,57,84,door
40607,111,door,112,0,14124,17,524,669,570,747,46,78,door
40608,3,car,4,0,14126,17,787,444,851,492,64,48,car
40609,5,car,6,0,14130,16,4,192,44,213,40,21,car
40610,6,car,7,0,14130,23,195,193,242,215,47,22,car
40611,4,car,5,1,14132,22,1036,1381,2196,1649,1160,268,car
40612,18,table,18,0,14133,18,535,1197,603,1239,68,42,dining table
40613,22,table,22,1,14133,17,216,1209,296,1265,80,56,dining table
40614,52,person,51,0,14133,38,811,1358,872,1517,61,159,person
40615,53,person,52,0,14133,20,886,1368,943,1510,57,142,person
40616,54,person,53,0,14133,23,1369,1320,1419,1437,50,117,person
40617,55,person,54,1,14133,23,1657,1327,1712,1430,55,103,person
40618,56,person,55,1,14133,25,1639,1258,1698,1351,59,93,person
40619,61,person,60,0,14133,18,2106,1197,2135,1254,29,57,person
40620,3,car,4,0,23978,17,935,571,1024,633,89,62,car
40621,4,car,5,1,23978,23,803,553,936,638,133,85,car
40622,5,car,6,1,23978,32,720,554,881,648,161,94,car
40623,6,car,7,0,23978,36,549,566,793,655,244,89,car
40624,8,car,9,1,23978,20,318,545,418,609,100,64,car
40625,9,car,10,1,23978,17,292,550,373,603,81,53,car
40626,10,car,11,0,23978,21,229,557,303,605,74,48,car
40627,13,person,14,0,23978,46,115,563,174,673,59,110,person
40628,5,car,6,1,23979,20,70,418,110,444,40,26,car
40629,7,car,8,0,23983,15,744,542,805,560,61,18,car
40630,8,car,9,1,23983,15,882,535,932,555,50,20,car
40631,21,motorbikes,22,1,23983,35,953,525,1024,602,71,77,motorcycle
40632,14,person,15,0,23984,26,114,633,146,716,32,83,person
40633,15,person,16,0,23984,15,468,641,476,675,8,34,person
40634,16,person,17,0,23984,16,480,642,489,674,9,32,person
40635,17,person,18,0,23984,36,848,627,883,716,35,89,person
40636,12,car,12,1,23985,22,357,729,549,799,192,70,car
40637,17,car,17,1,23985,19,510,725,542,752,32,27,car
40638,18,car,18,0,23985,20,534,725,558,749,24,24,car
40639,20,person,20,1,23985,17,567,740,600,799,33,59,person
40640,8,car,9,1,23989,21,0,844,85,937,85,93,car
40641,7,car,8,0,23991,21,259,992,348,1023,89,31,car
40642,9,car,10,1,23991,18,412,992,491,1023,79,31,car
40643,16,person,17,1,23991,17,598,982,608,1012,10,30,person
40644,10,person,11,1,14193,95,704,65,2120,1464,1416,1399,person
40645,11,person,12,1,14193,51,654,538,1384,1464,730,926,person
40646,1,toilet,2,0,14194,16,0,0,766,937,766,937,toilet
40647,5,person,6,0,14197,26,120,149,140,229,20,80,person
40648,2,person,2,0,14202,52,77,145,143,281,66,136,person
40649,12,person,13,0,14203,30,1039,591,1306,1155,267,564,person
40650,13,person,14,0,14203,38,419,168,675,1206,256,1038,person
40651,2,car,3,0,14206,24,241,114,302,140,61,26,car
40652,2,car,3,0,14207,16,809,958,914,1048,105,90,car
40653,11,person,12,1,230,47,1186,1092,1279,1200,93,108,person
40654,12,person,13,1,230,47,1183,1150,1241,1378,58,228,person
40655,13,person,14,0,230,68,1210,1131,1324,1478,114,347,person
40656,14,person,15,1,230,40,1337,1160,1457,1535,120,375,person
40657,1,window,2,0,231,44,160,251,510,1236,350,985,window
40658,13,person,14,1,231,39,537,1149,680,1576,143,427,person
40659,14,person,15,0,231,61,398,1161,697,1709,299,548,person
40660,22,person,23,0,231,72,674,1101,1200,1791,526,690,person
40661,6,person,7,1,14943,19,0,277,15,423,15,146,person
40662,9,person,10,0,14943,15,129,170,151,203,22,33,person
40663,4,person,5,1,14946,18,161,496,215,572,54,76,person
40664,2,person,3,1,14951,32,350,1205,704,2044,354,839,person
40665,3,person,4,1,14951,50,553,1153,1054,1945,501,792,person
40666,4,person,5,1,14951,33,935,1300,1487,2044,552,744,person
40667,5,person,6,1,14951,21,1217,1348,1531,2040,314,692,person
40668,6,person,7,1,14951,29,577,1388,1010,2040,433,652,person
40669,9,person,10,0,24009,35,881,609,918,713,37,104,person
40670,10,person,11,0,24009,32,961,602,1008,708,47,106,person
40671,11,person,12,0,24009,26,935,605,961,674,26,69,person
40672,12,person,13,0,24009,21,920,624,935,672,15,48,person
40673,13,person,14,0,24009,47,325,636,377,767,52,131,person
40674,14,person,15,0,24009,39,262,633,318,768,56,135,person
40675,15,person,16,0,24009,23,216,631,239,703,23,72,person
40676,16,person,17,1,24009,16,202,638,219,700,17,62,person
40677,7,car,8,1,24013,25,0,1726,120,1840,120,114,car
40678,8,chair,9,0,24013,22,92,1787,169,1894,77,107,chair
40679,9,person,10,1,24013,38,61,1738,156,1893,95,155,person
40680,10,person,11,0,24013,16,141,1730,169,1833,28,103,person
40681,14,car,15,1,24013,15,141,1721,175,1756,34,35,car
40682,18,person,19,0,24013,17,206,1709,225,1755,19,46,person
40683,23,motorbike,24,0,24013,25,1331,1738,1385,1797,54,59,motorcycle
40684,24,motorbike,25,0,24013,16,1398,1742,1421,1790,23,48,motorcycle
40685,25,motorbike,26,0,24013,23,1427,1728,1495,1792,68,64,motorcycle
40686,26,motorbike,27,0,24013,21,1482,1715,1535,1793,53,78,motorcycle
40687,2,person,3,1,24015,20,223,966,262,1023,39,57,person
40688,3,person,4,0,24015,31,241,867,273,969,32,102,person
40689,4,person,5,0,24015,31,466,900,502,991,36,91,person
40690,5,person,6,0,24015,26,668,907,699,997,31,90,person
40691,6,person,7,0,24015,33,699,942,732,997,33,55,person
40692,7,person,8,0,24015,19,110,896,135,967,25,71,person
40693,19,person,20,0,24016,49,372,757,403,868,31,111,person
40694,20,person,21,0,24016,22,401,762,427,811,26,49,person
40695,21,chair,22,1,24016,17,406,783,426,812,20,29,chair
40696,22,person,23,0,24016,42,37,761,85,936,48,175,person
40697,23,backpack,24,0,24016,17,72,779,103,840,31,61,backpack
40698,24,person,25,0,24016,27,185,731,210,797,25,66,person
40699,25,person,26,0,24016,23,156,714,175,749,19,35,person
40700,26,person,27,0,24016,23,173,713,188,761,15,48,person
40701,27,person,28,1,24016,15,188,716,205,742,17,26,person
40702,28,person,29,1,24016,32,94,740,122,815,28,75,person
40703,29,person,30,1,24016,18,84,732,100,771,16,39,person
40704,30,person,31,1,24016,22,59,738,87,786,28,48,person
40705,31,person,32,1,24016,18,49,733,68,771,19,38,person
40706,32,person,33,1,24016,21,0,740,16,831,16,91,person
40707,34,person,35,0,24016,17,74,715,82,738,8,23,person
40708,35,person,36,0,24016,17,66,715,74,739,8,24,person
40709,4,person,5,1,24017,15,19,406,42,437,23,31,person
40710,5,person,6,0,24017,15,0,408,20,438,20,30,person
40711,27,car,28,0,942,18,35,715,93,750,58,35,car
40712,28,car,29,0,942,19,130,699,201,731,71,32,car
40713,29,car,30,0,942,17,209,726,286,764,77,38,car
40714,14,bench,15,0,14953,19,2,261,38,300,36,39,bench
40715,10,person,11,0,14954,22,1958,1076,1998,1188,40,112,person
40716,11,person,12,0,14954,22,2002,1069,2032,1186,30,117,person
40717,12,person,13,0,14954,26,1841,1162,1883,1285,42,123,person
40718,13,person,14,0,14954,16,1750,1198,1772,1318,22,120,person
40719,14,person,15,0,14954,21,1905,1127,1948,1224,43,97,person
40720,15,person,16,1,14954,18,1828,1136,1892,1176,64,40,person
40721,18,person,19,0,14954,28,1651,1192,1683,1320,32,128,person
40722,19,person,20,0,14954,19,1634,1211,1655,1319,21,108,person
40723,40,person,41,0,14954,15,832,1102,848,1159,16,57,person
40724,0,truck,1,0,14956,52,349,338,497,393,148,55,truck
40725,5,truck,6,0,14956,59,363,338,489,391,126,53,truck
40726,6,car,7,0,14956,22,634,361,698,387,64,26,car
40727,7,car,8,0,14956,34,259,363,326,392,67,29,car
40728,13,car,14,0,14956,18,488,365,547,388,59,23,car
40729,15,car,16,0,14956,18,549,362,580,384,31,22,car
40730,17,car,18,0,14956,17,578,365,611,382,33,17,car
40731,28,person,29,0,14957,19,143,416,155,454,12,38,person
40732,2,car,3,0,14960,20,26,184,53,197,27,13,car
40733,3,car,4,0,14960,19,52,187,81,198,29,11,car
40734,14,person,15,0,14960,16,183,185,190,199,7,14,person
40735,7,car,8,1,14961,17,1481,608,1555,664,74,56,car
40736,8,car,9,1,14961,15,1422,613,1499,665,77,52,car
40737,19,person,20,0,14962,18,114,137,120,153,6,16,person
40738,6,car,7,0,14963,27,0,219,77,250,77,31,car
40739,7,car,8,0,14963,24,160,230,214,251,54,21,car
40740,17,person,18,0,24019,31,595,470,622,543,27,73,person
40741,18,person,19,0,24019,27,633,470,653,541,20,71,person
40742,19,person,20,1,24019,18,656,469,669,537,13,68,person
40743,20,person,21,0,24019,35,664,465,692,541,28,76,person
40744,21,person,22,1,24019,20,350,467,365,534,15,67,person
40745,22,person,23,0,24019,20,358,463,374,537,16,74,person
40746,23,person,24,0,24019,27,422,466,433,500,11,34,person
40747,24,person,25,0,24019,19,435,464,445,501,10,37,person
40748,25,person,26,0,24019,21,517,465,529,499,12,34,person
40749,26,person,27,0,24019,21,539,470,549,492,10,22,person
40750,28,person,29,0,24019,18,576,468,589,504,13,36,person
40751,29,person,30,1,24019,20,569,468,579,504,10,36,person
40752,30,person,31,1,24019,20,559,468,570,500,11,32,person
40753,6,table,6,0,24020,21,204,650,293,720,89,70,dining table
40754,7,person,7,0,24020,34,927,570,962,673,35,103,person
40755,8,person,8,0,24020,49,761,583,792,662,31,79,person
40756,9,person,9,0,24020,40,633,574,660,660,27,86,person
40757,10,person,10,0,24020,38,599,576,626,657,27,81,person
40758,12,person,12,0,24020,25,723,583,737,624,14,41,person
40759,13,person,13,0,24020,21,736,582,748,624,12,42,person
40760,14,person,14,1,24020,22,780,577,791,633,11,56,person
40761,15,person,15,0,24020,20,791,580,802,634,11,54,person
40762,16,person,16,1,24020,15,818,580,836,602,18,22,person
40763,18,person,18,0,24020,16,968,591,984,622,16,31,person
40764,20,chair,20,0,24020,38,177,654,241,728,64,74,chair
40765,21,table,21,0,24020,21,272,641,341,700,69,59,dining table
40766,22,chair,22,0,24020,36,317,637,367,697,50,60,chair
40767,23,chair,23,0,24020,26,33,657,99,735,66,78,chair
40768,26,umbrella,26,0,24020,20,25,552,118,602,93,50,umbrella
40769,28,umbrella,28,0,24020,19,118,547,218,621,100,74,umbrella
40770,32,umbrella,32,0,24020,16,276,553,370,592,94,39,umbrella
40771,37,chair,37,0,24020,33,126,642,186,703,60,61,chair
40772,38,person,38,1,24020,25,45,593,71,658,26,65,person
40773,40,person,40,1,24020,15,207,602,224,625,17,23,person
40774,47,person,47,0,24020,21,182,590,202,631,20,41,person
40775,48,chair,48,0,24020,23,368,625,408,671,40,46,chair
40776,5,person,6,0,24022,23,988,459,1020,565,32,106,person
40777,6,person,7,0,24022,60,923,454,984,622,61,168,person
40778,7,person,8,0,24022,41,859,457,923,643,64,186,person
40779,8,person,9,0,24022,29,797,480,838,585,41,105,person
40780,9,person,10,0,24022,35,744,475,782,588,38,113,person
40781,10,person,11,0,24022,30,782,484,804,570,22,86,person
40782,11,person,12,0,24022,33,721,493,745,570,24,77,person
40783,12,person,13,0,24022,29,695,490,726,567,31,77,person
40784,13,person,14,0,24022,24,616,493,632,547,16,54,person
40785,14,person,15,0,24022,37,592,485,621,554,29,69,person
40786,15,person,16,0,24022,42,575,492,597,553,22,61,person
40787,16,person,17,1,24022,16,754,377,765,393,11,16,person
40788,17,person,18,0,24022,16,751,376,758,394,7,18,person
40789,19,person,20,0,24022,52,411,481,441,546,30,65,person
40790,20,person,21,0,24022,45,384,487,411,542,27,55,person
40791,21,person,22,0,24022,36,353,493,375,547,22,54,person
40792,22,person,23,0,24022,37,686,489,704,556,18,67,person
40793,23,person,24,0,24022,24,563,479,572,510,9,31,person
40794,24,person,25,0,24022,25,573,478,583,510,10,32,person
40795,25,person,26,1,24022,21,671,491,686,529,15,38,person
40796,26,person,27,0,24022,33,342,492,356,547,14,55,person
40797,27,person,28,1,24022,19,364,491,379,531,15,40,person
40798,28,person,29,1,24022,21,315,490,329,520,14,30,person
40799,29,person,30,0,24022,30,239,488,260,542,21,54,person
40800,30,person,31,0,24022,35,170,493,194,546,24,53,person
40801,31,person,32,0,24022,28,103,487,116,521,13,34,person
40802,32,person,33,0,24022,25,136,488,150,532,14,44,person
40803,33,person,34,0,24022,29,152,485,166,529,14,44,person
40804,39,person,40,0,24022,20,60,480,72,517,12,37,person
40805,44,person,45,1,24022,16,494,403,505,415,11,12,person
40806,50,person,51,1,24022,15,803,482,814,499,11,17,person
40807,56,person,57,0,24022,18,35,487,47,518,12,31,person
40808,58,person,59,0,24022,15,834,483,847,507,13,24,person
40809,5,person,6,1,24027,28,93,427,120,532,27,105,person
40810,6,person,7,0,24027,40,107,440,149,546,42,106,person
40811,13,person,14,0,24027,34,845,424,875,507,30,83,person
40812,14,person,15,0,24027,37,829,425,858,507,29,82,person
40813,15,person,16,0,24027,29,630,432,654,499,24,67,person
40814,16,person,17,0,24027,28,544,433,568,502,24,69,person
40815,17,person,18,0,24027,24,559,431,579,499,20,68,person
40816,18,person,19,1,24027,35,588,422,612,497,24,75,person
40817,19,person,20,1,24027,17,616,431,631,472,15,41,person
40818,20,person,21,1,24027,22,629,430,640,491,11,61,person
40819,21,person,22,0,24027,31,409,433,432,493,23,60,person
40820,5,person,6,0,15104,18,20,195,31,217,11,22,person
40821,14,car,15,0,15106,29,418,325,517,398,99,73,car
40822,16,traffic light,17,0,15106,85,23,0,457,377,434,377,traffic light
40823,2,car,3,1,15107,23,121,192,173,215,52,23,car
40824,6,car,7,0,15107,21,263,201,367,237,104,36,car
40825,8,person,9,0,15107,15,130,203,141,234,11,31,person
40826,9,person,10,0,15107,16,110,201,120,228,10,27,person
40827,7,car,8,0,15108,18,483,350,529,382,46,32,car
40828,12,person,13,0,15108,34,586,328,617,415,31,87,person
40829,14,person,15,0,15108,22,607,319,631,410,24,91,person
40830,15,car,16,1,15108,16,618,335,640,411,22,76,car
40831,22,person,23,0,15108,19,462,350,476,381,14,31,person
40832,7,car,8,0,15109,33,520,362,621,420,101,58,car
40833,8,car,9,1,15112,16,13,337,46,363,33,26,car
40834,9,car,10,1,15112,15,23,344,58,369,35,25,car
40835,10,car,11,0,15112,15,39,347,77,377,38,30,car
40836,4,car,5,1,25167,17,38,1047,159,1147,121,100,car
40837,5,car,6,0,25167,27,114,1051,415,1162,301,111,car
40838,8,car,9,1,25167,45,1090,1036,1557,1355,467,319,car
40839,9,car,10,1,25167,47,1477,1013,2200,1396,723,383,car
40840,10,car,11,1,25167,19,2031,1108,2200,1439,169,331,car
40841,8,bench,9,0,25169,16,693,701,916,748,223,47,bench
40842,24,person,25,1,25169,15,293,583,304,603,11,20,person
40843,25,person,26,1,25169,15,304,584,315,604,11,20,person
40844,26,person,27,0,25169,25,371,580,386,612,15,32,person
40845,14,car,15,0,25170,29,15,505,99,565,84,60,car
40846,17,car,18,1,25170,21,954,512,1011,552,57,40,car
40847,18,car,19,1,25170,21,916,514,974,559,58,45,car
40848,19,car,20,1,25170,24,853,515,934,569,81,54,car
40849,20,car,21,0,25170,29,759,518,877,580,118,62,car
40850,10,car,11,0,15113,32,298,1008,1179,1307,881,299,car
40851,11,car,12,1,15113,26,1133,980,1451,1141,318,161,car
40852,12,car,13,1,15113,18,1403,976,1684,1116,281,140,car
40853,14,car,15,0,15113,23,1788,979,2101,1078,313,99,car
40854,0,car,1,0,15114,30,222,195,1579,797,1357,602,car
40855,4,car,5,0,15114,22,944,182,1599,642,655,460,car
40856,22,door,22,0,15114,15,733,222,1083,647,350,425,door
40857,0,car,1,0,15116,36,293,739,767,935,474,196,car
40858,26,truck,27,0,15116,23,1665,740,1866,810,201,70,truck
40859,0,car,1,0,15117,26,1075,775,1598,1176,523,401,car
40860,2,car,3,0,15117,27,351,783,971,1146,620,363,car
40861,3,car,4,1,15117,18,1757,772,2200,1179,443,407,car
40862,0,car,1,0,15118,26,290,1128,842,1309,552,181,car
40863,1,car,2,1,15118,21,735,1107,1043,1218,308,111,car
40864,5,car,5,0,15118,43,1799,1048,2018,1171,219,123,car
40865,13,car,13,1,15118,27,851,1065,1048,1166,197,101,car
40866,14,car,14,1,15118,16,1029,1077,1077,1136,48,59,car
40867,38,car,38,0,15118,19,1206,1074,1250,1110,44,36,car
40868,41,car,41,0,15118,25,1349,1065,1401,1109,52,44,car
40869,42,car,42,0,15118,24,1400,1065,1460,1120,60,55,car
40870,44,car,44,0,15118,37,1468,1074,1602,1131,134,57,car
40871,45,car,45,0,15118,37,1595,1053,1715,1139,120,86,car
40872,47,car,47,1,15118,17,1782,1052,1859,1118,77,66,car
40873,54,door,54,0,15118,16,432,1137,566,1285,134,148,door
40874,58,door,58,0,15118,20,553,1133,668,1280,115,147,door
40875,23,car,24,0,15119,16,1771,861,2045,1113,274,252,car
40876,0,car,1,0,15120,26,310,822,1369,1231,1059,409,car
40877,2,car,3,1,15120,18,373,893,567,984,194,91,car
40878,5,person,6,0,15120,44,26,895,102,1062,76,167,person
40879,9,car,10,0,15120,26,2005,753,2186,923,181,170,car
40880,3,car,4,0,15121,22,129,196,721,397,592,201,car
40881,2,car,3,0,15122,36,580,877,1352,1153,772,276,car
40882,17,car,16,1,15122,24,335,886,688,1019,353,133,car
40883,0,car,1,0,15123,15,166,123,1221,902,1055,779,car
40884,1,car,2,0,15123,23,1504,81,2011,404,507,323,car
40885,0,car,1,0,15124,16,507,1043,1110,1322,603,279,car
40886,1,person,2,0,15124,18,213,1003,345,1393,132,390,person
40887,10,car,7,1,15124,17,1525,1010,1780,1142,255,132,car
40888,11,car,8,1,15124,21,1114,1015,1501,1180,387,165,car
40889,17,car,14,1,15124,22,1275,999,1583,1160,308,161,car
40890,18,car,15,1,15124,23,920,1020,1260,1196,340,176,car
40891,20,car,17,1,15124,19,353,1019,681,1200,328,181,car
40892,21,car,18,1,15124,53,0,982,417,1300,417,318,car
40893,15,car,16,1,15125,17,1265,1022,1527,1245,262,223,car
40894,16,car,17,0,15125,25,3,1046,552,1276,549,230,car
40895,19,car,20,1,15125,17,992,1054,1213,1286,221,232,car
40896,21,car,22,1,15125,18,635,1058,937,1314,302,256,car
40897,1,car,2,0,15126,36,770,935,1069,1086,299,151,car
40898,0,car,1,0,15128,29,349,543,1042,766,693,223,car
40899,7,truck,6,0,15128,27,1095,417,1385,578,290,161,truck
40900,29,person,28,0,15128,34,1182,482,1254,699,72,217,person
40901,30,person,29,0,15128,21,947,498,976,576,29,78,person
40902,0,car,1,0,15129,23,1164,835,1587,966,423,131,car
40903,8,car,8,1,15129,20,1979,810,2196,908,217,98,car
40904,9,car,9,1,15129,17,2008,841,2145,928,137,87,car
40905,10,car,10,1,15129,21,2072,856,2137,932,65,76,car
40906,11,car,11,1,15129,16,2116,826,2200,943,84,117,car
40907,12,car,12,1,15129,16,1384,816,1601,908,217,92,car
40908,18,person,18,0,15129,27,1091,820,1132,912,41,92,person
40909,24,car,24,1,15129,15,263,855,438,892,175,37,car
40910,33,person,33,0,15129,23,724,850,761,914,37,64,person
40911,60,door,60,0,15129,17,1276,840,1384,941,108,101,door
40912,61,door,61,0,15129,20,1378,838,1482,938,104,100,door
40913,64,car,64,1,15129,17,1213,829,1388,883,175,54,car
40914,2,person,3,0,15130,24,1102,469,1206,766,104,297,person
40915,6,car,7,1,15130,19,3,534,368,732,365,198,car
40916,9,car,10,1,15130,19,117,475,573,662,456,187,car
40917,10,car,11,1,15130,15,542,560,625,672,83,112,car
40918,11,car,12,1,15130,20,525,508,708,647,183,139,car
40919,12,person,13,0,15130,32,727,460,799,666,72,206,person
40920,17,person,18,0,15130,27,62,530,333,1200,271,670,person
40921,30,person,31,0,15130,16,1175,456,1193,508,18,52,person
40922,2,car,3,0,15131,20,267,89,388,151,121,62,car
40923,0,car,1,0,15132,15,363,828,919,1007,556,179,car
40924,17,car,14,1,15132,38,300,765,789,903,489,138,car
40925,18,car,15,1,15132,28,323,813,654,939,331,126,car
40926,24,car,21,1,15132,18,1540,767,1651,800,111,33,car
40927,25,car,22,1,15132,35,1528,788,1698,870,170,82,car
40928,27,car,24,0,15132,32,1388,770,1566,841,178,71,car
40929,29,car,26,1,15132,31,1314,768,1410,838,96,70,car
40930,30,car,27,1,15132,22,1285,766,1387,822,102,56,car
40931,31,car,28,1,15132,18,1230,781,1291,817,61,36,car
40932,33,car,30,0,15132,27,1091,775,1203,815,112,40,car
40933,49,car,46,1,15132,26,1816,791,1975,857,159,66,car
40934,50,car,47,1,15132,25,1854,795,2047,858,193,63,car
40935,51,car,48,1,15132,24,1883,804,2046,896,163,92,car
40936,52,car,49,1,15132,20,1983,797,2048,982,65,185,car
40937,7,car,8,0,15133,15,297,1049,504,1259,207,210,car
40938,14,car,15,1,15133,27,622,1021,1163,1267,541,246,car
40939,15,car,16,1,15133,18,1052,1069,1383,1242,331,173,car
40940,18,car,19,1,15133,21,1561,1047,1873,1236,312,189,car
40941,1,car,2,0,15134,20,281,722,783,976,502,254,car
40942,3,car,4,0,15134,15,1513,728,1944,984,431,256,car
40943,1,car,2,0,15135,21,834,988,1250,1191,416,203,car
40944,0,car,1,0,15136,26,587,1019,1050,1172,463,153,car
40945,0,car,1,0,15137,21,1195,798,1527,986,332,188,car
40946,1,car,2,0,15137,16,688,781,866,890,178,109,car
40947,6,car,7,0,15137,23,1637,801,2048,956,411,155,car
40948,31,car,32,1,15137,17,1177,771,1395,837,218,66,car
40949,0,car,1,0,15138,20,283,750,1124,1069,841,319,car
40950,4,car,5,1,15138,18,884,744,1439,977,555,233,car
40951,0,car,1,0,15140,29,635,1084,1238,1299,603,215,car
40952,1,car,2,0,15140,36,1037,1122,1844,1385,807,263,car
40953,3,car,2,0,15141,15,653,983,842,1067,189,84,car
40954,4,car,3,0,15141,16,1796,954,1987,1049,191,95,car
40955,5,car,4,0,15141,15,516,1005,653,1101,137,96,car
40956,6,car,5,0,15141,17,7,1015,143,1104,136,89,car
40957,7,car,6,0,15141,21,1453,970,1514,1024,61,54,car
40958,8,car,7,0,15141,21,1371,970,1434,1025,63,55,car
40959,11,car,9,0,15141,25,963,996,1062,1050,99,54,car
40960,12,car,10,0,15141,26,1053,994,1164,1048,111,54,car
40961,14,car,12,0,15141,19,1295,978,1356,1032,61,54,car
40962,15,car,13,0,15141,18,895,981,972,1037,77,56,car
40963,18,car,16,0,15141,17,267,996,518,1215,251,219,car
40964,24,car,22,1,15141,19,792,983,886,1048,94,65,car
40965,27,car,25,1,15141,18,1230,976,1281,1027,51,51,car
40966,30,car,28,1,15141,25,162,994,319,1075,157,81,car
40967,11,car,12,0,15142,18,1570,1000,1742,1062,172,62,car
40968,12,car,13,0,15142,19,1710,1004,1846,1050,136,46,car
40969,16,car,17,0,15142,23,1826,1020,2047,1094,221,74,car
40970,23,car,24,1,15142,24,247,1004,498,1156,251,152,car
40971,27,car,28,1,15142,18,2,1006,183,1108,181,102,car
40972,28,car,29,1,15142,17,104,1018,225,1094,121,76,car
40973,30,car,31,0,15142,39,4,1122,476,1411,472,289,car
40974,31,car,32,0,15142,39,470,1124,893,1409,423,285,car
40975,4,car,5,1,15143,16,1648,816,2194,1120,546,304,car
40976,5,car,6,0,15143,17,1103,781,1665,976,562,195,car
40977,0,car,1,0,15144,19,1182,957,1659,1103,477,146,car
40978,10,car,11,1,15144,17,3,916,156,1366,153,450,car
40979,12,car,13,1,15144,20,78,993,347,1216,269,223,car
40980,13,car,14,1,15144,17,95,996,420,1176,325,180,car
40981,6,car,7,1,15145,18,4,1159,356,1295,352,136,car
40982,8,car,9,1,15145,22,342,1076,698,1287,356,211,car
40983,11,car,11,0,15145,24,1115,1035,1364,1182,249,147,car
40984,13,car,13,1,15145,17,1341,1055,1474,1148,133,93,car
40985,15,car,15,0,15145,19,1503,1061,1635,1129,132,68,car
40986,16,car,16,1,15145,15,1618,1046,1706,1125,88,79,car
40987,1,car,2,0,15146,33,204,1033,758,1367,554,334,car
40988,3,car,4,0,15146,41,748,961,1254,1389,506,428,car
40989,4,car,5,0,15146,46,1357,933,1947,1391,590,458,car
40990,5,car,6,1,15146,17,1849,914,2047,1237,198,323,car
40991,7,car,8,1,15146,20,2,992,358,1342,356,350,car
40992,11,car,12,1,15146,17,1263,999,1389,1135,126,136,car
40993,12,car,13,1,15146,15,1329,1069,1380,1240,51,171,car
40994,0,car,1,0,15147,28,1154,186,1339,327,185,141,car
40995,1,car,2,0,15147,30,531,181,778,298,247,117,car
40996,2,truck,3,0,15147,16,837,68,1185,239,348,171,truck
40997,16,bench,17,0,15148,16,234,677,282,712,48,35,bench
40998,10,car,11,1,15149,16,293,127,362,160,69,33,car
40999,11,car,12,0,15149,21,313,130,400,194,87,64,car
41000,12,car,13,0,15149,28,203,129,309,180,106,51,car
41001,14,car,15,0,15149,26,91,124,181,165,90,41,car
41002,16,car,17,1,15149,19,58,128,115,162,57,34,car
41003,9,car,10,0,24047,27,336,235,420,265,84,30,car
41004,10,car,11,1,24047,23,424,240,481,274,57,34,car
41005,11,car,12,0,24047,27,442,244,489,279,47,35,car
41006,12,car,13,0,24047,46,484,236,599,284,115,48,car
41007,13,car,14,1,24047,20,108,235,195,260,87,25,car
41008,14,car,15,1,24047,18,119,239,217,260,98,21,car
41009,15,car,16,0,24047,36,91,245,257,300,166,55,car
41010,9,umbrella,10,1,24048,15,221,2,356,133,135,131,umbrella
41011,11,umbrella,12,1,24048,20,480,0,671,59,191,59,umbrella
41012,12,person,13,1,24048,72,488,82,724,529,236,447,person
41013,13,car,14,1,24048,35,50,118,477,359,427,241,car
41014,14,car,15,1,24048,21,0,92,559,528,559,436,car
41015,2,car,3,0,24049,20,387,312,531,369,144,57,car
41016,6,person,7,0,24049,46,589,40,878,488,289,448,person
41017,1,car,2,0,24051,18,786,78,848,264,62,186,car
41018,2,car,3,0,24051,29,675,97,775,279,100,182,car
41019,3,car,4,0,24051,23,559,51,654,258,95,207,car
41020,4,car,5,0,24051,25,434,59,532,271,98,212,car
41021,5,car,6,0,24051,25,327,78,414,272,87,194,car
41022,6,car,7,0,24051,26,205,70,302,268,97,198,car
41023,7,car,8,0,24051,26,98,71,191,240,93,169,car
41024,8,car,9,0,24051,22,1,56,84,237,83,181,car
41025,9,car,10,0,24051,15,2,287,54,490,52,203,car
41026,10,car,11,0,24051,33,85,268,188,473,103,205,car
41027,11,car,12,0,24051,31,207,299,311,515,104,216,car
41028,12,car,13,0,24051,28,321,297,417,472,96,175,car
41029,13,car,14,0,24051,28,448,293,543,491,95,198,car
41030,14,car,15,0,24051,28,575,268,677,487,102,219,car
41031,15,car,16,0,24051,29,695,314,797,505,102,191,car
41032,6,car,7,0,24052,79,39,31,758,588,719,557,car
41033,10,car,11,1,24052,29,1,227,318,420,317,193,car
41034,13,person,14,1,24052,15,126,204,154,228,28,24,person
41035,4,car,5,0,24053,16,138,343,179,367,41,24,car
41036,5,car,6,0,24053,18,533,346,587,375,54,29,car
41037,6,car,7,0,24053,19,711,338,763,377,52,39,car
41038,7,car,8,0,24053,47,407,380,701,561,294,181,car
41039,8,car,9,0,24053,39,53,384,304,561,251,177,car
41040,8,car,9,0,24054,36,516,325,731,439,215,114,car
41041,9,car,10,0,24054,28,718,330,884,415,166,85,car
41042,10,car,11,1,24054,22,843,341,982,402,139,61,car
41043,12,car,13,0,24054,52,77,303,342,495,265,192,car
41044,24,person,25,0,24054,29,392,295,428,421,36,126,person
41045,25,person,26,1,24054,26,416,305,455,419,39,114,person
41046,26,person,27,1,24054,20,509,309,533,411,24,102,person
41047,27,person,28,1,24054,18,528,302,561,351,33,49,person
41048,6,car,7,0,24055,50,185,377,579,609,394,232,car
41049,7,car,8,0,24055,48,715,397,1058,647,343,250,car
41050,8,car,9,1,24055,26,1031,409,1165,621,134,212,car
41051,9,person,10,0,24055,59,561,306,677,601,116,295,person
41052,1,truck,2,0,24056,66,1,20,644,736,643,716,truck
41053,4,person,5,0,24056,24,981,307,1023,387,42,80,person
41054,14,car,15,0,24057,24,667,430,724,467,57,37,car
41055,20,car,21,1,24057,19,797,452,900,481,103,29,car
41056,21,car,22,1,24057,21,771,459,895,486,124,27,car
41057,22,car,23,1,24057,26,762,471,897,501,135,30,car
41058,24,car,25,1,24057,20,791,483,903,519,112,36,car
41059,25,car,26,1,24057,25,773,489,907,533,134,44,car
41060,26,car,27,1,24057,24,760,509,905,539,145,30,car
41061,27,car,28,1,24057,24,772,511,917,556,145,45,car
41062,28,car,29,1,24057,22,758,529,918,569,160,40,car
41063,29,car,30,1,24057,19,771,536,920,573,149,37,car
41064,30,car,31,1,24057,27,744,550,931,594,187,44,car
41065,31,car,32,1,24057,20,768,559,923,608,155,49,car
41066,33,car,34,1,24057,19,633,568,709,662,76,94,car
41067,34,car,35,1,24057,19,634,582,706,679,72,97,car
41068,35,car,36,0,24057,25,673,567,997,679,324,112,car
41069,2,car,3,0,24058,31,325,268,452,309,127,41,car
41070,3,car,4,0,24058,39,125,260,302,324,177,64,car
41071,4,person,5,0,24058,23,64,264,81,322,17,58,person
41072,2,bus,3,1,24059,26,432,459,629,498,197,39,bus
41073,4,car,5,1,24059,32,363,469,461,558,98,89,car
41074,7,person,8,1,24059,16,341,483,368,520,27,37,person
41075,8,car,9,1,24059,26,922,502,1009,551,87,49,car
41076,9,car,10,1,24059,16,885,500,936,532,51,32,car
41077,10,car,11,0,24059,23,838,501,900,546,62,45,car
41078,11,car,12,0,24059,27,776,501,839,544,63,43,car
41079,13,car,14,1,24059,15,719,498,768,518,49,20,car
41080,14,car,15,1,24059,23,434,497,489,561,55,64,car
41081,16,car,17,1,24059,15,634,499,677,528,43,29,car
41082,17,car,18,1,24059,31,578,495,656,564,78,69,car
41083,19,car,20,0,24059,26,478,476,589,580,111,104,car
41084,20,car,21,0,24059,44,210,497,399,586,189,89,car
41085,21,car,22,0,24059,17,196,482,312,501,116,19,car
41086,22,car,23,1,24059,33,113,496,235,580,122,84,car
41087,23,car,24,1,24059,27,0,480,128,590,128,110,car
41088,25,car,26,1,24059,16,66,488,142,503,76,15,car
41089,37,car,38,1,24059,24,719,503,773,556,54,53,car
41090,38,car,39,0,24059,35,653,500,745,565,92,65,car
41091,7,car,8,0,24060,26,902,297,991,336,89,39,car
41092,8,car,9,0,24060,31,648,327,768,371,120,44,car
41093,9,car,10,1,24060,24,563,320,674,360,111,40,car
41094,10,car,11,0,24060,30,842,332,952,377,110,45,car
41095,11,car,12,1,24060,23,958,326,1079,389,121,63,car
41096,12,car,13,1,24060,15,1001,350,1079,423,78,73,car
41097,13,car,14,0,24060,32,371,388,624,483,253,95,car
41098,14,car,15,1,24060,24,334,366,518,433,184,67,car
41099,15,car,16,1,24060,24,323,353,498,407,175,54,car
41100,16,car,17,1,24060,19,325,350,469,386,144,36,car
41101,17,car,18,1,24060,19,288,340,414,392,126,52,car
41102,18,car,19,1,24060,19,279,335,398,378,119,43,car
41103,19,car,20,1,24060,21,98,320,228,363,130,43,car
41104,21,car,22,0,24060,23,94,344,261,391,167,47,car
41105,22,car,23,1,24060,21,103,360,279,390,176,30,car
41106,23,car,24,1,24060,31,89,368,302,425,213,57,car
41107,24,car,25,1,24060,27,104,383,310,444,206,61,car
41108,25,car,26,0,24060,36,51,436,367,576,316,140,car
41109,22,table,23,1,945,17,804,745,938,851,134,106,dining table
41110,24,chair,25,1,945,23,1003,728,1101,879,98,151,chair
41111,25,chair,26,1,945,17,884,747,1016,863,132,116,chair
41112,26,chair,27,1,945,83,624,715,985,1113,361,398,chair
41113,27,chair,28,1,945,66,140,703,423,959,283,256,chair
41114,28,chair,29,1,945,88,209,752,862,1133,653,381,chair
41115,29,table,30,1,945,17,205,964,472,1046,267,82,dining table
41116,30,chair,31,1,945,129,13,832,869,1389,856,557,chair
41117,31,chair,32,0,945,166,124,952,1197,1804,1073,852,chair
41118,34,chair,35,1,945,21,2,711,85,942,83,231,chair
41119,12,bench,13,0,15288,23,175,200,367,344,192,144,bench
41120,13,chair,14,0,15288,25,49,243,162,388,113,145,chair
41121,5,table,6,0,15289,15,350,348,718,728,368,380,dining table
41122,6,umbrella,7,1,15289,44,469,0,1021,365,552,365,umbrella
41123,7,chair,8,0,15289,21,703,395,849,723,146,328,chair
41124,71,flowerpot,72,1,15289,16,137,490,175,551,38,61,potted plant
41125,11,chair,12,0,15291,19,659,741,808,972,149,231,chair
41126,12,table,13,1,15291,24,359,772,638,939,279,167,dining table
41127,13,chair,14,0,15291,16,234,737,371,964,137,227,chair
41128,15,chair,16,0,15291,17,437,778,684,1034,247,256,chair
41129,31,door,32,1,15291,25,683,422,834,857,151,435,door
41130,46,chair,47,1,15291,89,754,811,1017,1056,263,245,chair
41131,52,chair,53,0,15291,130,780,894,1064,1199,284,305,chair
41132,78,flowerpot,79,1,15291,32,202,767,320,880,118,113,potted plant
41133,17,table,18,0,15293,15,118,140,181,177,63,37,dining table
41134,19,chair,20,0,15293,21,99,139,142,192,43,53,chair
41135,20,chair,21,0,15293,21,157,139,197,188,40,49,chair
41136,24,chair,25,0,15293,23,233,126,259,162,26,36,chair
41137,25,chair,26,0,15293,22,265,126,298,160,33,34,chair
41138,5,pot,6,0,15294,26,106,155,175,227,69,72,potted plant
41139,16,chair,16,1,15294,15,116,77,180,160,64,83,chair
41140,17,chair,17,0,15294,26,214,79,284,169,70,90,chair
41141,20,table,20,1,15294,40,165,88,241,160,76,72,dining table
41142,11,plant pot,12,0,24072,16,898,586,968,663,70,77,potted plant
41143,7,table,8,0,24073,40,279,513,697,680,418,167,dining table
41144,9,chair,10,1,24073,22,666,492,900,679,234,187,chair
41145,11,chair,12,1,24073,15,250,457,376,608,126,151,chair
41146,12,chair,13,1,24073,18,12,521,289,679,277,158,chair
41147,13,table,14,0,24073,39,144,381,281,469,137,88,dining table
41148,14,chair,15,1,24073,20,289,372,360,462,71,90,chair
41149,15,chair,16,1,24073,15,213,386,292,457,79,71,chair
41150,17,chair,18,0,24073,29,78,390,183,502,105,112,chair
41151,18,chair,19,1,24073,20,153,365,212,455,59,90,chair
41152,21,umbrella,22,0,24073,19,274,246,433,339,159,93,umbrella
41153,22,umbrella,23,0,24073,17,246,265,336,322,90,57,umbrella
41154,23,umbrella,24,0,24073,15,179,272,261,317,82,45,umbrella
41155,2,plant pot,3,0,24074,18,529,195,598,230,69,35,potted plant
41156,3,plant pot,4,1,24074,17,432,195,501,244,69,49,potted plant
41157,4,plant pot,5,1,24074,23,445,242,523,322,78,80,potted plant
41158,5,plant pot,6,0,24074,17,520,227,599,302,79,75,potted plant
41159,14,plate,15,0,24074,26,1,275,163,364,162,89,plate
41160,15,ball,16,0,24074,18,1,206,104,330,103,124,sports ball
41161,17,person,18,0,24074,92,223,60,417,538,194,478,person
41162,18,chair,19,1,24074,125,81,119,462,515,381,396,chair
41163,2,chair,3,0,24075,20,1069,660,1163,852,94,192,chair
41164,18,chair,19,0,24075,39,670,696,783,874,113,178,chair
41165,19,chair,20,0,24075,39,759,702,905,910,146,208,chair
41166,20,table,21,1,24075,25,852,729,959,874,107,145,dining table
41167,21,chair,22,1,24075,28,874,688,961,852,87,164,chair
41168,22,chair,23,0,24075,51,910,699,1044,889,134,190,chair
41169,12,chair,13,0,24076,84,161,47,373,296,212,249,chair
41170,13,chair,14,0,24076,67,590,54,752,325,162,271,chair
41171,14,chair,15,0,24076,135,627,165,909,519,282,354,chair
41172,15,chair,16,0,24076,115,86,205,374,601,288,396,chair
41173,16,table,17,0,24076,100,284,185,626,455,342,270,dining table
41174,6,person,7,1,24078,48,174,214,245,301,71,87,person
41175,7,bench,8,1,24078,28,240,248,292,306,52,58,bench
41176,8,table,9,1,24078,24,189,268,261,305,72,37,dining table
41177,9,table,10,0,24078,47,187,300,295,441,108,141,dining table
41178,11,plant pot,12,0,24078,16,335,282,365,326,30,44,potted plant
41179,12,plant pot,13,0,24078,23,491,344,719,480,228,136,potted plant
41180,14,car,15,0,24078,29,614,157,716,196,102,39,car
41181,20,person,21,1,24078,83,75,252,259,407,184,155,person
41182,21,person,22,0,24078,71,36,252,231,479,195,227,person
41183,22,bench,23,1,24078,55,33,362,158,479,125,117,bench
41184,30,person,31,1,24078,20,181,195,202,223,21,28,person
41185,7,table,8,0,24079,17,367,260,487,396,120,136,dining table
41186,24,plant pot,25,0,24080,17,205,583,250,629,45,46,potted plant
41187,29,chair,30,0,24080,18,432,619,539,765,107,146,chair
41188,23,person,24,0,24081,39,82,361,116,433,34,72,person
41189,1,chair,2,0,24082,84,90,364,293,674,203,310,chair
41190,2,chair,3,1,24082,37,349,362,532,586,183,224,chair
41191,3,chair,4,0,24082,79,342,460,584,805,242,345,chair
41192,4,table,5,0,24082,36,150,427,427,732,277,305,dining table
41193,10,plant pot,11,0,24083,19,787,461,900,550,113,89,potted plant
41194,13,table,14,0,24083,18,451,413,609,472,158,59,dining table
41195,14,chair,15,0,24083,24,589,407,664,529,75,122,chair
41196,15,chair,16,0,24083,24,491,444,620,584,129,140,chair
41197,16,chair,17,0,24083,26,378,405,476,541,98,136,chair
41198,7,car,8,1,946,24,163,585,296,689,133,104,car
41199,8,car,9,0,946,21,75,584,206,677,131,93,car
41200,9,car,10,1,946,15,3,583,111,648,108,65,car
41201,13,car,14,1,946,31,891,598,1093,759,202,161,car
41202,19,car,20,1,946,36,991,618,1137,777,146,159,car
41203,23,car,24,1,946,38,1059,618,1259,796,200,178,car
41204,29,motorbike,30,1,946,19,1164,693,1246,802,82,109,motorcycle
41205,1,person,2,1,24090,41,0,122,202,480,202,358,person
41206,3,car,4,1,24094,19,545,190,603,221,58,31,car
41207,5,car,6,1,24094,18,427,189,496,223,69,34,car
41208,6,traffic light,7,0,24094,67,481,1,612,416,131,415,traffic light
41209,8,car,9,1,24094,15,0,255,183,475,183,220,car
41210,11,car,12,1,24094,23,4,154,84,200,80,46,car
41211,12,car,13,0,24094,21,63,164,160,212,97,48,car
41212,13,person,14,0,24094,25,108,169,134,220,26,51,person
41213,15,traffic light,16,0,24094,21,74,0,114,35,40,35,traffic light
41214,6,person,7,0,24105,20,308,313,316,346,8,33,person
41215,5,boat,6,0,24106,82,138,187,667,396,529,209,boat
41216,6,person,7,0,24107,19,94,76,145,130,51,54,person
41217,7,person,8,1,24107,16,155,96,194,128,39,32,person
41218,8,person,9,0,24107,18,303,89,335,127,32,38,person
41219,9,person,10,1,24107,17,437,77,465,124,28,47,person
41220,14,person,15,1,24107,21,831,101,853,121,22,20,person
41221,17,person,18,1,24107,15,858,103,879,121,21,18,person
41222,20,person,21,1,24107,15,914,104,925,120,11,16,person
41223,4,bench,5,0,24110,27,382,198,547,299,165,101,bench
41224,5,person,6,0,24110,31,602,212,690,287,88,75,person
41225,6,person,7,1,24110,15,740,258,781,291,41,33,person
41226,9,boat,10,0,24110,16,1,309,200,401,199,92,boat
41227,10,person,11,1,24110,20,105,253,177,313,72,60,person
41228,11,person,12,1,24110,23,1,236,59,318,58,82,person
41229,10,boat,11,0,24112,144,61,138,855,542,794,404,boat
41230,6,person,7,1,24113,123,228,1,1023,766,795,765,person
41231,6,boat,7,0,24115,44,520,61,725,364,205,303,boat
41232,7,boat,8,0,24115,16,827,220,904,281,77,61,boat
41233,8,boat,9,0,24115,19,920,264,977,289,57,25,boat
41234,15,person,16,1,24115,19,542,223,560,245,18,22,person
41235,16,boat,17,1,24115,15,678,260,706,280,28,20,boat
41236,17,person,18,0,24115,27,495,252,504,287,9,35,person
41237,18,person,19,1,24115,21,413,251,431,288,18,37,person
41238,19,person,20,0,24115,17,405,265,416,290,11,25,person
41239,1,boat,2,1,15327,38,0,47,799,599,799,552,boat
41240,5,person,6,1,15331,17,0,195,82,341,82,146,person
41241,4,car,5,0,15332,30,14,152,98,183,84,31,car
41242,15,person,16,1,15335,55,827,1032,1032,1515,205,483,person
41243,16,person,17,1,15335,44,1008,1015,1167,1523,159,508,person
41244,9,bench,10,0,15336,22,813,1002,965,1109,152,107,bench
41245,33,person,34,0,15337,16,993,1141,1014,1242,21,101,person
41246,34,person,35,0,15337,30,1008,1183,1053,1299,45,116,person
41247,11,person,12,0,15342,29,50,141,64,182,14,41,person
41248,12,person,13,0,15342,30,37,140,51,181,14,41,person
41249,13,person,14,0,15342,37,2,140,17,175,15,35,person
41250,14,person,15,0,15342,17,17,138,21,158,4,20,person
41251,15,person,16,0,15342,18,23,138,29,157,6,19,person
41252,10,door,11,1,15346,17,396,377,436,446,40,69,door
41253,11,person,12,0,15346,16,412,397,437,449,25,52,person
41254,12,person,13,0,15346,17,386,401,410,451,24,50,person
41255,15,person,13,0,15421,35,260,675,310,833,50,158,person
41256,16,person,14,0,15421,31,307,668,362,831,55,163,person
41257,19,bench,17,0,15421,17,1093,723,1171,764,78,41,bench
41258,20,bench,18,0,15421,15,1569,740,1680,793,111,53,bench
41259,21,person,19,0,15421,25,1559,715,1609,786,50,71,person
41260,0,door,1,0,15422,15,299,201,366,335,67,134,door
41261,6,dog,7,0,15422,27,486,343,515,359,29,16,dog
41262,0,person,1,0,15423,27,1843,842,1909,1013,66,171,person
41263,1,person,2,0,15423,28,1537,848,1650,1038,113,190,person
41264,2,car,3,0,15423,17,1265,881,1431,1002,166,121,car
41265,3,car,4,0,15423,19,1086,880,1248,995,162,115,car
41266,9,person,10,0,15424,15,109,358,121,383,12,25,person
41267,12,person,13,0,15424,18,429,344,442,380,13,36,person
41268,16,car,17,0,15424,15,475,351,518,370,43,19,car
41269,120,person,120,0,15424,15,580,352,592,370,12,18,person
41270,121,person,121,1,15424,15,572,350,582,365,10,15,person
41271,124,person,124,1,15424,16,391,351,398,368,7,17,person
41272,125,person,125,1,15424,15,386,351,393,368,7,17,person
41273,9,car,10,1,15425,19,395,925,722,1052,327,127,car
41274,11,motorbike,12,0,15425,18,1094,941,1211,1067,117,126,motorcycle
41275,12,motorbike,13,0,15425,20,1255,956,1377,1079,122,123,motorcycle
41276,15,car,16,1,15425,24,1632,900,2048,1199,416,299,car
41277,16,car,17,1,15425,17,1891,950,2048,1252,157,302,car
41278,1,person,2,0,15426,21,299,1065,428,1411,129,346,person
41279,15,person,16,0,15426,28,1448,1099,1489,1272,41,173,person
41280,16,person,17,0,15426,27,1287,1088,1331,1270,44,182,person
41281,17,person,18,0,15426,31,1339,1082,1414,1277,75,195,person
41282,19,person,20,0,15426,23,1140,1082,1184,1180,44,98,person
41283,26,person,27,0,15426,44,1958,1074,2014,1219,56,145,person
41284,27,person,28,0,15426,27,1826,1089,1861,1180,35,91,person
41285,28,person,29,0,15426,19,825,1128,879,1192,54,64,person
41286,29,person,30,0,15426,21,684,1093,726,1166,42,73,person
41287,30,person,31,0,15426,28,1233,1101,1291,1170,58,69,person
41288,31,person,32,1,15426,18,802,1120,827,1178,25,58,person
41289,32,person,33,0,15426,20,945,1129,1000,1200,55,71,person
41290,10,person,8,0,15427,47,255,1014,440,1450,185,436,person
41291,11,person,9,0,15427,46,121,1014,216,1336,95,322,person
41292,12,person,10,0,15427,32,3,1010,73,1249,70,239,person
41293,13,person,11,1,15427,34,381,1026,473,1355,92,329,person
41294,16,person,12,0,15427,25,532,1045,584,1204,52,159,person
41295,17,person,13,0,15427,28,615,1043,676,1185,61,142,person
41296,19,person,15,0,15427,22,731,1076,777,1186,46,110,person
41297,23,person,17,1,15427,42,1667,1059,1889,1648,222,589,person
41298,24,person,18,1,15427,43,1859,1119,2186,1651,327,532,person
41299,27,umbrella,20,0,15427,17,1442,648,1613,806,171,158,umbrella
41300,28,person,21,0,15427,31,972,1057,1069,1284,97,227,person
41301,29,person,22,0,15427,33,1547,1107,1646,1367,99,260,person
41302,57,person,48,0,15427,69,1259,1107,1452,1614,193,507,person
41303,58,person,49,0,15427,72,1073,1034,1263,1634,190,600,person
41304,59,person,50,0,15427,44,1881,1081,1953,1282,72,201,person
41305,60,person,51,1,15427,44,1206,1056,1308,1400,102,344,person
41306,61,person,52,1,15427,42,1275,1058,1354,1313,79,255,person
41307,62,person,53,0,15427,30,825,1111,894,1207,69,96,person
41308,64,person,55,0,15427,29,690,1076,730,1184,40,108,person
41309,65,person,56,1,15427,21,666,1076,704,1152,38,76,person
41310,66,person,57,1,15427,41,76,1022,150,1244,74,222,person
41311,67,person,58,1,15427,38,217,1024,300,1352,83,328,person
41312,68,person,59,1,15427,33,194,1043,235,1291,41,248,person
41313,70,person,61,1,15427,23,2136,1115,2197,1214,61,99,person
41314,71,person,62,1,15427,28,2092,1094,2140,1251,48,157,person
41315,72,person,63,1,15427,28,1658,1120,1717,1287,59,167,person
41316,74,person,65,1,15427,23,1612,1086,1656,1204,44,118,person
41317,75,person,66,1,15427,28,1866,1086,1899,1215,33,129,person
41318,76,umbrella,67,0,15427,25,1543,668,1733,773,190,105,umbrella
41319,0,person,1,0,15429,21,1967,795,2129,1313,162,518,person
41320,2,person,3,0,15429,45,1754,813,1916,1291,162,478,person
41321,3,person,4,1,15429,33,1851,778,1970,1255,119,477,person
41322,4,person,5,1,15429,34,2029,837,2175,1275,146,438,person
41323,9,person,10,1,15429,29,184,776,253,1099,69,323,person
41324,10,person,11,0,15429,42,71,733,201,1140,130,407,person
41325,39,person,40,0,15429,43,702,800,753,946,51,146,person
41326,40,person,41,1,15429,35,664,802,705,943,41,141,person
41327,41,person,42,0,15429,26,617,831,649,916,32,85,person
41328,42,person,43,0,15429,37,1121,867,1184,980,63,113,person
41329,43,person,44,0,15429,43,1165,860,1238,983,73,123,person
41330,44,person,45,0,15429,42,1544,884,1636,1019,92,135,person
41331,45,chair,46,0,15429,24,1581,934,1670,1032,89,98,chair
41332,46,chair,47,0,15429,17,1405,918,1464,1009,59,91,chair
41333,47,table,48,0,15429,22,1446,929,1528,1018,82,89,dining table
41334,0,person,1,0,15430,21,1222,849,1378,1301,156,452,person
41335,1,person,2,0,15430,25,1383,844,1572,1353,189,509,person
41336,2,person,3,0,15430,23,1602,833,1739,1383,137,550,person
41337,9,bench,10,0,15430,23,1868,847,1977,872,109,25,bench
41338,10,person,11,0,15430,19,1865,811,1888,868,23,57,person
41339,12,person,13,0,15430,73,1988,833,2124,1155,136,322,person
41340,13,person,14,1,15430,23,2123,890,2200,1105,77,215,person
41341,17,person,18,0,15430,25,1557,795,1591,896,34,101,person
41342,18,person,19,0,15430,19,1595,799,1632,902,37,103,person
41343,19,person,20,0,15430,23,1767,814,1803,911,36,97,person
41344,29,person,30,0,15430,30,1043,776,1084,922,41,146,person
41345,30,person,31,1,15430,27,1012,787,1057,916,45,129,person
41346,2,person,3,0,15431,24,228,716,321,928,93,212,person
41347,1,person,2,0,15432,16,744,802,884,1243,140,441,person
41348,2,person,3,0,15432,17,517,778,677,1254,160,476,person
41349,3,person,4,0,15432,15,384,772,499,1180,115,408,person
41350,19,person,18,0,15432,26,1674,879,1804,1069,130,190,person
41351,20,chair,19,0,15432,16,1672,960,1766,1071,94,111,chair
41352,25,chair,24,0,15432,29,1957,990,2086,1125,129,135,chair
41353,46,car,45,1,15432,19,1849,825,2071,975,222,150,car
41354,47,car,46,1,15432,20,1763,792,1898,950,135,158,car
41355,48,table,47,0,15432,51,1428,963,1535,1115,107,152,dining table
41356,49,chair,48,0,15432,30,1490,985,1622,1125,132,140,chair
41357,50,chair,49,0,15432,21,1355,983,1476,1120,121,137,chair
41358,51,chair,50,0,15432,25,1238,970,1347,1085,109,115,chair
41359,52,chair,51,1,15432,21,1318,948,1407,1019,89,71,chair
41360,53,chair,52,1,15432,22,1525,968,1638,1098,113,130,chair
41361,57,table,56,0,15432,46,1883,965,1991,1113,108,148,dining table
41362,58,chair,57,0,15432,32,1805,997,1933,1122,128,125,chair
41363,59,chair,58,1,15432,16,1590,948,1678,996,88,48,chair
41364,60,chair,59,1,15432,18,1560,923,1642,970,82,47,chair
41365,61,person,60,1,15432,21,1634,870,1703,947,69,77,person
41366,7,bench,8,0,15433,17,1704,1003,2048,1143,344,140,bench
41367,3,person,3,0,15434,21,330,456,348,513,18,57,person
41368,4,person,4,0,15434,27,353,460,374,512,21,52,person
41369,13,person,13,0,15434,15,713,440,733,490,20,50,person
41370,34,person,33,0,15434,21,668,443,681,486,13,43,person
41371,35,person,34,0,15434,22,754,437,768,488,14,51,person
41372,56,person,55,0,15434,32,107,470,125,505,18,35,person
41373,57,window,56,0,15434,16,107,421,133,476,26,55,window
41374,65,car,64,1,15434,23,309,468,358,491,49,23,car
41375,86,person,85,0,15434,25,641,445,651,487,10,42,person
41376,0,person,1,0,15436,35,1660,910,1766,1361,106,451,person
41377,5,person,6,0,15436,22,1788,949,1813,1043,25,94,person
41378,6,person,7,0,15437,19,976,870,1012,940,36,70,person
41379,30,person,31,0,15437,19,404,977,476,1057,72,80,person
41380,1,bus,2,0,15438,24,809,788,1622,1013,813,225,bus
41381,3,car,4,0,15438,30,395,863,683,966,288,103,car
41382,4,bench,5,0,15438,28,573,1114,887,1229,314,115,bench
41383,5,bench,6,0,15438,22,310,1084,585,1185,275,101,bench
41384,13,horse,13,1,15438,18,1657,883,1759,978,102,95,horse
41385,14,car,14,1,15438,19,1743,908,2120,1022,377,114,car
41386,16,person,15,0,15438,22,2066,890,2125,1076,59,186,person
41387,17,person,16,1,15438,15,1882,879,1928,995,46,116,person
41388,21,person,20,0,15438,17,1363,871,1406,1007,43,136,person
41389,24,person,23,1,15438,20,981,877,1023,968,42,91,person
41390,25,person,24,1,15438,25,1634,884,1674,1010,40,126,person
41391,26,person,25,1,15438,24,1600,884,1642,1002,42,118,person
41392,28,person,27,1,15438,37,2014,881,2072,1058,58,177,person
41393,31,car,30,1,15438,17,547,857,689,930,142,73,car
41394,32,car,31,1,15438,25,688,873,797,929,109,56,car
41395,34,person,33,0,15438,17,747,872,767,932,20,60,person
41396,35,traffic light,34,0,15438,29,381,695,634,905,253,210,traffic light
41397,39,person,38,1,15438,25,41,848,79,941,38,93,person
41398,17,person,13,0,15439,16,466,709,512,853,46,144,person
41399,19,person,15,0,15439,18,312,705,376,891,64,186,person
41400,20,person,16,0,15439,19,1043,715,1108,898,65,183,person
41401,25,table,19,0,15439,18,1211,1051,1673,1473,462,422,dining table
41402,33,person,26,0,15439,30,788,704,825,816,37,112,person
41403,34,person,27,0,15439,32,822,708,859,813,37,105,person
41404,35,table,28,1,15439,15,908,921,1144,959,236,38,dining table
41405,36,chair,29,1,15439,30,969,940,1135,1141,166,201,chair
41406,37,table,30,1,15439,19,1340,893,1588,972,248,79,dining table
41407,39,table,32,1,15439,15,1764,873,2007,949,243,76,dining table
41408,59,person,52,0,15439,26,886,710,925,810,39,100,person
41409,60,person,53,0,15439,33,915,737,949,808,34,71,person
41410,61,person,54,0,15439,25,959,722,993,808,34,86,person
41411,63,person,56,1,15439,21,1079,704,1113,792,34,88,person
41412,64,person,57,0,15439,31,1592,680,1641,818,49,138,person
41413,65,person,58,1,15439,27,1570,690,1602,812,32,122,person
41414,66,person,59,1,15439,29,1647,691,1682,811,35,120,person
41415,67,person,60,0,15439,27,1668,693,1698,813,30,120,person
41416,68,person,61,0,15439,36,1956,684,2015,840,59,156,person
41417,75,person,68,1,15439,31,1947,683,1977,770,30,87,person
41418,83,person,76,1,15439,20,1136,711,1158,808,22,97,person
41419,84,person,77,1,15439,30,923,706,956,755,33,49,person
41420,86,umbrella,79,0,15439,24,93,649,153,723,60,74,umbrella
41421,87,person,80,0,15439,26,3,739,42,851,39,112,person
41422,12,person,13,0,15440,49,384,994,504,1302,120,308,person
41423,13,person,14,0,15440,42,479,1017,611,1309,132,292,person
41424,16,person,17,0,15440,44,670,1000,775,1305,105,305,person
41425,19,person,20,0,15440,33,1820,991,1893,1227,73,236,person
41426,20,person,21,0,15440,40,1689,1012,1792,1264,103,252,person
41427,24,person,25,0,15440,20,1506,1044,1567,1142,61,98,person
41428,26,person,27,0,15440,24,1019,996,1067,1139,48,143,person
41429,57,person,58,0,15440,25,1199,1012,1255,1103,56,91,person
41430,58,person,59,1,15440,19,1197,1011,1218,1092,21,81,person
41431,59,person,60,1,15440,18,449,987,498,1058,49,71,person
41432,60,person,61,1,15440,42,1651,1024,1762,1254,111,230,person
41433,61,person,62,0,15440,26,1555,1039,1623,1142,68,103,person
41434,67,person,68,0,15440,24,308,1014,366,1079,58,65,person
41435,68,person,69,1,15440,18,510,1024,528,1085,18,61,person
41436,69,flowerpot,70,0,15440,18,1971,1102,2047,1145,76,43,potted plant
41437,71,person,72,0,15440,21,9,994,40,1059,31,65,person
41438,22,bicycle,23,0,15441,36,1744,1149,1817,1192,73,43,bicycle
41439,28,person,29,0,15441,40,968,1084,1030,1302,62,218,person
41440,29,person,30,0,15441,22,1103,1114,1132,1187,29,73,person
41441,30,person,31,0,15441,21,1311,1119,1330,1186,19,67,person
41442,31,person,32,0,15441,21,1328,1129,1348,1182,20,53,person
41443,32,person,33,0,15441,29,1356,1121,1386,1204,30,83,person
41444,33,person,34,0,15441,21,1377,1117,1404,1204,27,87,person
41445,34,person,35,0,15441,32,1522,1117,1558,1201,36,84,person
41446,62,person,63,0,15441,25,665,1121,701,1196,36,75,person
41447,96,person,97,0,15441,23,407,1104,438,1186,31,82,person
41448,97,person,98,0,15441,21,433,1107,451,1182,18,75,person
41449,98,person,99,0,15441,17,1588,1120,1612,1197,24,77,person
41450,99,umbrella,100,0,15441,28,1945,1039,1989,1231,44,192,umbrella
41451,105,person,106,0,15441,22,32,1109,70,1246,38,137,person
41452,35,person,36,0,15443,23,54,157,64,190,10,33,person
41453,36,person,37,0,15443,25,68,154,79,187,11,33,person
41454,37,person,38,0,15443,26,81,158,90,186,9,28,person
41455,38,person,39,0,15443,23,138,155,147,182,9,27,person
41456,39,person,40,0,15443,20,130,157,138,182,8,25,person
41457,2,person,3,0,15445,21,126,161,143,195,17,34,person
41458,4,person,5,0,15445,20,5,168,17,204,12,36,person
41459,6,person,7,0,15446,34,195,166,223,256,28,90,person
41460,9,person,10,0,15446,22,252,188,278,223,26,35,person
41461,10,person,11,0,15446,15,239,182,254,210,15,28,person
41462,11,person,12,0,15446,17,292,176,304,210,12,34,person
41463,12,person,13,0,15446,21,307,173,319,211,12,38,person
41464,13,person,14,0,15446,20,348,171,363,218,15,47,person
41465,14,person,15,0,15446,16,328,174,337,206,9,32,person
41466,15,person,16,0,15446,23,365,176,379,216,14,40,person
41467,16,person,17,0,15446,21,378,175,393,217,15,42,person
41468,17,person,18,0,15446,30,400,175,424,245,24,70,person
41469,20,person,21,0,15446,19,53,183,75,216,22,33,person
41470,21,person,22,0,15446,20,89,169,104,215,15,46,person
41471,22,person,23,0,15446,18,78,172,88,210,10,38,person
41472,24,person,25,0,15446,27,13,171,39,238,26,67,person
41473,25,person,26,1,15446,19,35,173,46,233,11,60,person
41474,26,person,27,1,15446,17,0,165,13,238,13,73,person
41475,25,person,26,0,15448,20,202,135,213,158,11,23,person
41476,4,truck,5,0,15449,23,670,1096,786,1236,116,140,truck
41477,5,truck,6,0,15449,20,790,1138,902,1242,112,104,truck
41478,10,person,11,0,15449,46,1556,1156,1663,1367,107,211,person
41479,11,car,12,0,15449,18,1643,1171,1701,1217,58,46,car
41480,13,car,14,0,15449,20,1749,1176,1836,1223,87,47,car
41481,14,car,15,0,15449,20,1869,1174,1961,1229,92,55,car
41482,22,person,23,0,15449,18,642,1162,664,1227,22,65,person
41483,23,person,24,0,15449,27,711,1176,760,1288,49,112,person
41484,29,person,30,0,15449,15,1474,1174,1489,1219,15,45,person
41485,30,person,31,0,15449,17,1492,1168,1511,1212,19,44,person
41486,11,umbrella,12,0,15451,16,631,394,647,485,16,91,umbrella
41487,13,umbrella,14,0,15451,17,707,432,717,481,10,49,umbrella
41488,20,person,21,0,15451,23,717,447,756,502,39,55,person
41489,21,car,22,0,15451,22,80,466,190,511,110,45,car
41490,22,person,23,0,15451,24,208,507,275,554,67,47,person
41491,23,person,24,1,15451,18,237,503,273,544,36,41,person
41492,24,person,25,1,15451,17,277,499,304,538,27,39,person
41493,25,person,26,0,15451,24,272,509,332,549,60,40,person
41494,29,person,30,0,15451,29,770,447,799,529,29,82,person
41495,30,person,31,0,15451,40,802,494,861,610,59,116,person
41496,31,person,32,0,15451,36,848,568,911,622,63,54,person
41497,6,person,7,0,15452,19,81,166,96,205,15,39,person
41498,11,person,12,0,24129,69,374,97,527,254,153,157,person
41499,9,person,10,1,24130,18,508,439,555,508,47,69,person
41500,11,person,12,0,24130,18,246,486,260,522,14,36,person
41501,12,person,13,0,24130,21,310,480,330,538,20,58,person
41502,13,bicycle,14,0,24130,84,261,513,362,658,101,145,bicycle
41503,18,bicycle,19,1,24130,22,346,507,392,594,46,87,bicycle
41504,4,umbrella,5,0,24131,17,296,677,494,812,198,135,umbrella
41505,5,table,6,0,24131,20,272,876,357,974,85,98,dining table
41506,6,chair,7,0,24131,21,118,873,201,977,83,104,chair
41507,7,chair,8,0,24131,30,480,849,560,937,80,88,chair
41508,8,chair,9,0,24131,22,452,836,501,919,49,83,chair
41509,9,person,10,1,24131,23,444,817,480,877,36,60,person
41510,10,person,11,0,24131,32,601,754,663,903,62,149,person
41511,11,person,12,0,24131,33,567,754,605,905,38,151,person
41512,14,person,15,1,24131,25,391,813,452,920,61,107,person
41513,15,chair,16,1,24131,20,395,852,459,930,64,78,chair
41514,17,chair,18,1,24131,27,27,869,102,956,75,87,chair
41515,18,chair,19,1,24131,16,261,833,309,888,48,55,chair
41516,20,table,21,0,24131,16,97,858,171,943,74,85,dining table
41517,24,person,25,0,24131,21,42,751,68,816,26,65,person
41518,28,chair,29,1,24131,16,304,820,348,871,44,51,chair
41519,29,person,30,1,24131,18,744,757,766,798,22,41,person
41520,12,person,13,0,24132,24,506,578,524,633,18,55,person
41521,13,person,14,0,24132,24,541,576,562,633,21,57,person
41522,14,person,15,0,24132,29,570,579,587,632,17,53,person
41523,15,person,16,0,24132,41,484,644,516,736,32,92,person
41524,16,person,17,0,24132,34,559,646,592,748,33,102,person
41525,17,person,18,0,24132,31,786,602,811,671,25,69,person
41526,18,person,19,0,24132,30,813,604,838,679,25,75,person
41527,19,person,20,0,24132,25,855,607,876,679,21,72,person
41528,20,person,21,0,24132,27,880,600,901,674,21,74,person
41529,21,person,22,1,24132,18,236,720,283,767,47,47,person
41530,22,person,23,0,24132,35,144,621,177,711,33,90,person
41531,24,person,25,0,24132,28,90,660,120,740,30,80,person
41532,25,person,26,0,24132,34,64,666,94,745,30,79,person
41533,26,person,27,1,24132,24,1,683,34,767,33,84,person
41534,27,person,28,0,24132,23,480,549,497,589,17,40,person
41535,28,person,29,0,24132,24,453,545,468,584,15,39,person
41536,29,person,30,0,24132,22,608,544,621,583,13,39,person
41537,30,person,31,0,24132,21,622,552,634,588,12,36,person
41538,31,person,32,0,24132,20,595,533,607,568,12,35,person
41539,32,person,33,0,24132,20,647,527,659,557,12,30,person
41540,33,person,34,0,24132,20,635,527,646,554,11,27,person
41541,34,person,35,0,24132,17,304,512,316,537,12,25,person
41542,35,person,36,0,24132,18,471,516,482,542,11,26,person
41543,36,person,37,0,24132,19,484,518,494,542,10,24,person
41544,37,person,38,0,24132,21,663,533,673,571,10,38,person
41545,38,person,39,0,24132,17,671,541,681,574,10,33,person
41546,39,person,40,0,24132,17,497,520,506,546,9,26,person
41547,41,person,42,0,24132,20,569,530,582,569,13,39,person
41548,45,person,46,0,24132,15,568,503,578,523,10,20,person
41549,46,person,47,0,24132,16,368,514,376,538,8,24,person
41550,47,person,48,0,24132,15,391,509,399,532,8,23,person
41551,48,person,49,0,24132,15,356,512,365,538,9,26,person
41552,49,person,50,1,24132,25,114,689,150,730,36,41,person
41553,50,person,51,1,24132,19,119,705,166,762,47,57,person
41554,6,bench,7,1,24133,17,0,691,135,723,135,32,bench
41555,16,person,17,0,24133,19,119,677,163,733,44,56,person
41556,17,person,18,0,24133,26,29,664,68,749,39,85,person
41557,18,person,19,0,24133,19,236,664,262,720,26,56,person
41558,19,person,20,0,24133,17,268,662,297,711,29,49,person
41559,22,person,23,0,24133,17,290,661,314,711,24,50,person
41560,23,person,24,0,24133,15,310,664,331,709,21,45,person
41561,24,person,25,1,24133,17,396,642,424,701,28,59,person
41562,25,person,26,1,24133,17,423,645,448,703,25,58,person
41563,26,person,27,1,24133,15,627,629,639,665,12,36,person
41564,27,person,28,1,24133,17,640,633,653,669,13,36,person
41565,28,person,29,0,24133,15,755,638,763,666,8,28,person
41566,33,person,34,1,24133,15,146,672,162,714,16,42,person
41567,6,car,7,0,24134,15,307,406,371,429,64,23,car
41568,7,car,8,1,24134,16,713,405,785,436,72,31,car
41569,9,car,10,0,24134,20,848,403,895,421,47,18,car
41570,21,bench,22,0,24134,28,11,459,133,526,122,67,bench
41571,22,bench,23,1,24134,15,133,447,181,496,48,49,bench
41572,23,bench,24,0,24134,26,152,447,233,496,81,49,bench
41573,28,person,29,0,24134,29,428,396,448,444,20,48,person
41574,29,person,30,1,24134,19,463,400,476,437,13,37,person
41575,34,umbrella,35,0,24134,40,313,315,529,471,216,156,umbrella
41576,35,table,36,0,24134,33,384,467,462,533,78,66,dining table
41577,36,chair,37,0,24134,33,329,467,385,544,56,77,chair
41578,37,chair,38,1,24134,20,375,463,415,525,40,62,chair
41579,38,person,39,1,24134,50,374,431,476,500,102,69,person
41580,39,umbrella,40,0,24134,33,426,345,566,492,140,147,umbrella
41581,41,chair,42,0,24134,17,502,445,537,497,35,52,chair
41582,42,umbrella,43,0,24134,37,571,343,703,477,132,134,umbrella
41583,43,table,44,0,24134,37,612,440,660,482,48,42,dining table
41584,44,chair,45,0,24134,24,588,439,625,484,37,45,chair
41585,45,chair,46,0,24134,20,664,451,715,510,51,59,chair
41586,46,umbrella,47,0,24134,37,642,320,825,510,183,190,umbrella
41587,47,table,48,0,24134,39,694,451,762,512,68,61,dining table
41588,48,umbrella,49,0,24134,39,753,334,901,487,148,153,umbrella
41589,49,table,50,0,24134,34,792,440,856,491,64,51,dining table
41590,50,chair,51,0,24134,21,770,440,817,489,47,49,chair
41591,51,chair,52,0,24134,18,847,455,911,527,64,72,chair
41592,52,umbrella,53,0,24134,41,798,301,1022,526,224,225,umbrella
41593,53,table,54,0,24134,39,877,458,965,529,88,71,dining table
41594,54,umbrella,55,0,24134,17,531,374,600,444,69,70,umbrella
41595,55,table,56,0,24134,25,554,426,580,449,26,23,dining table
41596,56,umbrella,57,1,24134,25,427,362,532,375,105,13,umbrella
41597,60,person,61,1,24134,16,788,401,797,422,9,21,person
41598,61,car,62,1,24134,15,771,403,790,419,19,16,car
41599,63,bench,64,1,24134,20,746,421,794,444,48,23,bench
41600,66,umbrella,67,1,24134,24,675,356,788,371,113,15,umbrella
41601,67,umbrella,68,1,24134,17,451,376,529,385,78,9,umbrella
41602,8,person,9,0,24135,38,328,375,362,460,34,85,person
41603,9,person,10,0,24135,32,279,382,312,476,33,94,person
41604,10,person,11,0,24135,31,254,373,295,475,41,102,person
41605,11,person,12,0,24135,40,199,368,235,460,36,92,person
41606,12,person,13,0,24135,27,235,380,261,460,26,80,person
41607,13,person,14,1,24135,27,231,370,249,448,18,78,person
41608,14,person,15,0,24135,30,306,382,332,461,26,79,person
41609,15,person,16,0,24135,30,350,369,376,444,26,75,person
41610,16,person,17,0,24135,25,383,373,410,447,27,74,person
41611,17,person,18,0,24135,24,421,390,444,440,23,50,person
41612,18,person,19,0,24135,23,405,394,425,440,20,46,person
41613,7,person,8,0,24136,53,827,536,892,719,65,183,person
41614,8,person,9,0,24136,39,782,551,825,689,43,138,person
41615,9,person,10,0,24136,49,734,546,783,685,49,139,person
41616,10,person,11,0,24136,34,600,547,643,700,43,153,person
41617,11,person,12,0,24136,48,563,547,605,704,42,157,person
41618,12,person,13,0,24136,67,54,542,144,762,90,220,person
41619,14,person,15,0,24136,48,1,522,66,757,65,235,person
41620,15,person,16,0,24136,38,249,532,296,682,47,150,person
41621,16,person,17,0,24136,30,293,574,333,682,40,108,person
41622,17,person,18,1,24136,33,194,540,234,654,40,114,person
41623,19,person,20,0,24136,36,428,535,460,639,32,104,person
41624,20,person,21,0,24136,33,462,540,493,644,31,104,person
41625,21,person,22,0,24136,29,497,540,524,646,27,106,person
41626,22,person,23,0,24136,38,643,542,694,649,51,107,person
41627,23,person,24,1,24136,23,633,537,657,630,24,93,person
41628,24,person,25,1,24136,31,906,532,935,632,29,100,person
41629,25,person,26,0,24136,35,924,531,966,635,42,104,person
41630,26,person,27,0,24136,36,968,538,1023,674,55,136,person
41631,27,person,28,0,24136,34,521,551,562,648,41,97,person
41632,28,person,29,0,24136,30,344,545,372,633,28,88,person
41633,29,person,30,0,24136,28,393,544,423,636,30,92,person
41634,31,person,32,1,24136,24,169,536,194,617,25,81,person
41635,32,person,33,1,24136,30,126,549,150,643,24,94,person
41636,12,bus,13,0,24137,22,49,404,184,465,135,61,bus
41637,6,car,7,1,24138,22,734,441,781,463,47,22,car
41638,7,car,8,1,24138,19,768,442,838,462,70,20,car
41639,8,car,9,1,24138,23,972,436,1022,458,50,22,car
41640,11,person,12,0,24138,28,174,467,209,515,35,48,person
41641,19,bench,20,0,24138,24,562,542,623,590,61,48,bench
41642,32,person,33,0,24138,19,137,438,147,472,10,34,person
41643,33,person,34,0,24138,24,150,439,162,473,12,34,person
41644,36,person,37,0,24138,17,889,438,896,459,7,21,person
41645,6,car,7,1,24139,18,20,481,121,547,101,66,car
41646,7,car,8,1,24139,15,113,491,219,543,106,52,car
41647,3,person,4,0,24141,22,640,231,656,276,16,45,person
41648,4,person,5,1,24141,16,553,224,570,250,17,26,person
41649,6,person,7,0,24141,25,43,241,77,281,34,40,person
41650,11,person,12,0,24141,186,671,70,878,609,207,539,person
41651,12,skateboard,13,0,24141,60,694,515,829,626,135,111,skateboard
41652,1,person,2,0,24142,64,938,239,1024,556,86,317,person
41653,2,person,3,1,24142,38,915,287,975,517,60,230,person
41654,3,person,4,1,24142,23,862,265,924,364,62,99,person
41655,4,person,5,0,24142,111,726,263,873,756,147,493,person
41656,5,backpack,6,0,24142,34,811,319,928,475,117,156,backpack
41657,7,person,8,0,24142,101,422,239,670,702,248,463,person
41658,8,backpack,9,0,24142,23,611,308,695,440,84,132,backpack
41659,9,person,10,0,24142,90,108,292,365,670,257,378,person
41660,11,person,12,0,24142,54,666,269,731,504,65,235,person
41661,12,backpack,13,0,24142,16,712,318,743,388,31,70,backpack
41662,13,person,14,1,24142,25,637,258,680,344,43,86,person
41663,14,person,15,1,24142,68,435,277,514,522,79,245,person
41664,15,person,16,1,24142,55,439,254,533,401,94,147,person
41665,16,person,17,1,24142,19,540,351,575,457,35,106,person
41666,18,person,19,1,24142,80,263,258,353,532,90,274,person
41667,20,backpack,21,0,24142,22,300,300,348,370,48,70,backpack
41668,21,person,22,1,24142,55,329,264,392,508,63,244,person
41669,22,person,23,1,24142,24,367,249,419,353,52,104,person
41670,23,person,24,1,24142,21,190,255,240,344,50,89,person
41671,24,person,25,0,24142,79,119,249,194,534,75,285,person
41672,26,person,27,0,24142,81,55,259,129,549,74,290,person
41673,28,person,29,1,24142,56,1,243,73,568,72,325,person
41674,31,person,32,0,24142,25,407,268,430,345,23,77,person
41675,2,person,3,1,24143,58,746,169,914,678,168,509,person
41676,3,person,4,0,24143,52,158,230,314,679,156,449,person
41677,4,person,5,1,24143,50,249,314,368,679,119,365,person
41678,5,person,6,1,24143,50,498,336,590,578,92,242,person
41679,11,person,12,1,24143,21,594,504,618,577,24,73,person
41680,12,person,13,1,24143,20,577,516,597,574,20,58,person
41681,18,person,19,0,24143,40,66,475,105,577,39,102,person
41682,20,person,21,0,24143,29,455,502,473,572,18,70,person
41683,21,person,22,0,24143,29,437,497,460,570,23,73,person
41684,22,person,23,0,24143,27,417,498,438,567,21,69,person
41685,23,person,24,1,24143,21,400,490,421,567,21,77,person
41686,24,person,25,1,24143,19,422,487,444,515,22,28,person
41687,2,person,3,0,15464,65,48,124,181,473,133,349,person
41688,3,person,4,0,15464,63,235,60,443,432,208,372,person
41689,4,person,5,0,15464,67,332,6,493,430,161,424,person
41690,5,person,6,1,15464,35,538,144,653,478,115,334,person
41691,6,person,7,1,15464,37,555,212,683,496,128,284,person
41692,4,person,5,0,15465,78,398,385,707,1182,309,797,person
41693,5,person,6,0,15465,80,702,278,1031,1018,329,740,person
41694,6,person,7,0,15465,80,1036,232,1248,1110,212,878,person
41695,2,person,3,0,15466,46,95,23,149,179,54,156,person
41696,3,person,4,0,15466,46,149,26,194,181,45,155,person
41697,4,person,5,0,15466,39,190,22,244,183,54,161,person
41698,5,person,6,1,15466,37,11,45,64,178,53,133,person
41699,10,person,11,1,15466,40,247,26,301,95,54,69,person
41700,11,person,12,0,15466,58,245,59,306,243,61,184,person
41701,15,person,16,1,15466,32,83,39,108,163,25,124,person
41702,1,person,2,1,15467,52,153,43,427,336,274,293,person
41703,4,person,5,0,15468,69,1082,304,1340,1046,258,742,person
41704,5,person,6,0,15468,62,745,260,965,967,220,707,person
41705,6,person,7,0,15468,70,401,362,669,1154,268,792,person
41706,10,person,11,1,15468,26,1034,592,1138,1006,104,414,person
41707,11,person,12,1,15468,17,906,564,993,934,87,370,person
41708,12,person,13,1,15468,19,600,671,671,1082,71,411,person
41709,6,person,7,0,15469,33,80,7,108,99,28,92,person
41710,5,car,6,0,15470,32,172,256,332,308,160,52,car
41711,6,car,7,0,15470,27,56,253,166,294,110,41,car
41712,7,car,8,1,15470,15,0,246,44,282,44,36,car
41713,3,person,4,1,15588,20,14,218,61,305,47,87,person
41714,4,person,5,1,15588,28,54,237,145,374,91,137,person
41715,5,person,6,0,15588,24,55,281,126,430,71,149,person
41716,6,person,7,1,15588,16,62,199,110,250,48,51,person
41717,11,person,12,1,15588,19,194,151,252,212,58,61,person
41718,12,person,13,1,15588,20,214,196,268,250,54,54,person
41719,13,person,14,0,15588,27,218,229,277,364,59,135,person
41720,16,person,17,1,15588,26,120,240,185,395,65,155,person
41721,18,person,19,1,15588,18,160,339,232,450,72,111,person
41722,19,person,20,1,15588,18,89,429,173,498,84,69,person
41723,21,person,22,1,15588,17,271,131,309,173,38,42,person
41724,22,person,23,1,15588,15,269,168,307,212,38,44,person
41725,24,person,25,1,15588,17,255,203,313,261,58,58,person
41726,25,person,26,1,15588,20,278,240,336,313,58,73,person
41727,26,person,27,1,15588,19,289,284,333,412,44,128,person
41728,27,person,28,0,15588,32,250,302,334,483,84,181,person
41729,28,person,29,0,15588,25,354,252,394,399,40,147,person
41730,29,person,30,0,15588,32,417,241,469,373,52,132,person
41731,30,person,31,0,15588,31,478,263,541,389,63,126,person
41732,33,person,34,1,15588,15,333,135,363,203,30,68,person
41733,38,person,39,1,15588,16,435,158,467,211,32,53,person
41734,40,person,41,1,15588,16,480,163,514,238,34,75,person
41735,41,person,42,1,15588,17,515,163,548,258,33,95,person
41736,43,person,44,1,15588,21,569,175,629,247,60,72,person
41737,44,person,45,1,15588,21,524,219,582,284,58,65,person
41738,45,person,46,1,15588,15,569,231,622,299,53,68,person
41739,47,person,48,1,15588,23,668,215,737,284,69,69,person
41740,48,person,49,1,15588,21,589,263,644,324,55,61,person
41741,49,person,50,1,15588,28,635,252,714,402,79,150,person
41742,50,person,51,1,15588,19,680,277,751,377,71,100,person
41743,51,person,52,1,15588,17,668,339,748,441,80,102,person
41744,52,person,53,1,15588,19,614,409,723,498,109,89,person
41745,54,person,55,1,15588,30,550,286,635,407,85,121,person
41746,55,person,56,1,15588,17,520,251,560,371,40,120,person
41747,56,person,57,0,15588,31,552,335,635,489,83,154,person
41748,5,person,6,0,15592,15,183,194,189,212,6,18,person
41749,17,person,18,0,15592,16,219,184,224,205,5,21,person
41750,6,person,7,0,15605,17,220,118,225,148,5,30,person
41751,5,window,6,0,15608,18,1096,291,1251,731,155,440,window
41752,9,person,10,0,15609,52,809,584,1045,1297,236,713,person
41753,9,umbrella,10,0,15613,22,1083,745,1333,1036,250,291,umbrella
41754,10,umbrella,11,0,15613,18,287,777,488,1029,201,252,umbrella
41755,14,umbrella,15,0,15613,20,109,779,291,1010,182,231,umbrella
41756,6,person,7,0,15616,24,277,519,314,652,37,133,person
41757,7,person,8,0,15616,31,678,523,751,658,73,135,person
41758,8,person,9,0,15616,21,787,510,824,585,37,75,person
41759,11,car,12,0,15616,22,2,555,203,681,201,126,car
41760,45,person,46,0,15616,35,253,522,277,594,24,72,person
41761,46,person,47,0,15616,30,233,530,252,595,19,65,person
41762,47,person,48,0,15616,33,206,525,230,597,24,72,person
41763,48,person,49,1,15616,26,327,524,351,574,24,50,person
41764,49,traffic light,50,0,15616,28,286,398,327,659,41,261,traffic light
41765,10,bicycle,11,0,15619,47,233,349,320,406,87,57,bicycle
41766,15,traffic light,16,0,15619,30,370,209,431,416,61,207,traffic light
41767,5,car,6,1,15620,26,545,331,709,415,164,84,car
41768,8,person,9,1,15620,16,536,311,566,377,30,66,person
41769,9,person,10,0,15620,23,514,327,544,404,30,77,person
41770,2,train,3,0,24222,118,33,100,1022,767,989,667,train
41771,1,person,2,1,24223,67,558,0,1335,1066,777,1066,person
41772,3,train,4,0,24224,65,102,199,1023,513,921,314,train
41773,5,train,6,0,24224,15,0,266,149,341,149,75,train
41774,3,train,4,0,24225,76,185,246,843,539,658,293,train
41775,8,car,9,0,24226,15,288,525,374,549,86,24,car
41776,1,train,2,0,24227,33,1,14,1023,428,1022,414,train
41777,4,train,5,0,24228,69,87,176,940,550,853,374,train
41778,3,train,4,0,24229,53,267,14,999,601,732,587,train
41779,5,train,6,0,24230,65,184,229,1405,1085,1221,856,train
41780,1,train,2,0,24231,49,1,314,1024,684,1023,370,train
41781,1,train,2,0,24232,146,24,194,1000,525,976,331,train
41782,2,person,3,1,24232,18,811,300,846,355,35,55,person
41783,12,traffic light,13,0,24232,24,595,319,654,522,59,203,traffic light
41784,13,person,14,0,24232,41,8,439,66,576,58,137,person
41785,14,person,15,0,24232,34,170,545,257,602,87,57,person
41786,15,chair,16,1,24232,20,154,511,219,573,65,62,chair
41787,16,person,17,1,24232,23,171,495,212,544,41,49,person
41788,17,person,18,0,24232,32,255,533,309,602,54,69,person
41789,18,person,19,1,24232,25,283,528,323,582,40,54,person
41790,15,traffic light,16,0,24233,16,744,467,757,526,13,59,traffic light
41791,2,person,3,1,24234,82,554,35,694,373,140,338,person
41792,3,person,4,0,24234,84,330,41,460,385,130,344,person
41793,4,backpack,5,0,24234,25,377,87,441,188,64,101,backpack
41794,5,backpack,6,0,24234,32,651,75,737,181,86,106,backpack
41795,6,person,7,0,24234,45,237,47,326,282,89,235,person
41796,7,person,8,0,24234,61,297,51,365,268,68,217,person
41797,2,train,3,0,24235,28,2,370,554,800,552,430,train
41798,1,train,2,0,24236,56,1,172,601,800,600,628,train
41799,1,train,2,0,24237,72,81,146,720,854,639,708,train
41800,5,person,6,0,15660,40,166,277,264,389,98,112,person
41801,6,train,7,1,15662,19,383,171,738,330,355,159,train
41802,9,train,10,0,15662,25,344,201,756,494,412,293,train
41803,5,person,6,0,15666,65,111,19,197,176,86,157,person
41804,1,car,2,1,15671,21,1062,127,1278,344,216,217,car
41805,16,horse,17,0,15672,38,90,153,145,237,55,84,horse
41806,17,person,18,0,15672,27,104,135,135,203,31,68,person
41807,18,horse,19,0,15672,21,222,182,250,237,28,55,horse
41808,19,person,20,1,15672,15,227,156,247,190,20,34,person
41809,20,horse,21,0,15672,17,305,188,324,220,19,32,horse
41810,21,person,22,0,15672,19,305,173,326,207,21,34,person
41811,4,cow,5,0,15674,26,97,170,203,229,106,59,cow
41812,5,cow,6,1,15674,19,0,210,34,248,34,38,cow
41813,8,cow,9,0,15674,26,329,182,386,209,57,27,cow
41814,9,person,10,0,15674,41,207,144,263,307,56,163,person
41815,10,person,11,0,15674,38,264,156,307,308,43,152,person
41816,11,cow,12,0,15675,29,84,202,146,239,62,37,cow
41817,12,cow,13,1,15675,15,133,199,169,241,36,42,cow
41818,13,cow,14,1,15675,18,185,200,229,242,44,42,cow
41819,3,person,4,0,15677,31,118,171,181,306,63,135,person
41820,4,person,5,1,15677,28,150,133,205,401,55,268,person
41821,8,cow,9,0,15678,24,22,179,88,220,66,41,cow
41822,9,cow,10,0,15678,15,82,185,108,223,26,38,cow
41823,10,cow,11,0,15678,19,116,182,161,224,45,42,cow
41824,11,cow,12,0,15678,26,155,184,208,227,53,43,cow
41825,12,cow,13,0,15678,20,230,177,277,211,47,34,cow
41826,13,cow,14,0,15678,36,280,172,357,224,77,52,cow
41827,14,cow,15,0,15678,18,356,176,402,207,46,31,cow
41828,11,cow,12,0,15681,38,128,143,172,187,44,44,cow
41829,12,cow,13,0,15681,32,243,121,274,180,31,59,cow
41830,13,cow,14,0,15681,26,19,139,55,183,36,44,cow
41831,14,cow,15,0,15681,33,60,137,113,190,53,53,cow
41832,15,cow,16,0,15681,17,13,111,36,127,23,16,cow
41833,17,cow,18,1,15681,20,163,128,195,160,32,32,cow
41834,7,car,8,1,15689,21,0,360,85,397,85,37,car
41835,18,person,19,1,245,81,966,187,1568,1538,602,1351,person
41836,35,person,36,0,245,34,696,432,820,704,124,272,person
41837,14,car,15,0,15783,22,485,308,552,359,67,51,car
41838,25,car,26,0,15783,20,260,285,349,363,89,78,car
41839,10,car,11,1,15787,22,166,183,225,228,59,45,car
41840,13,car,14,1,15787,17,2,179,39,234,37,55,car
41841,14,car,15,0,24259,36,444,435,605,488,161,53,car
41842,15,car,16,1,24259,57,293,420,436,482,143,62,car
41843,16,car,17,0,24259,36,177,434,286,475,109,41,car
41844,17,car,18,0,24259,22,34,412,102,445,68,33,car
41845,20,person,21,0,24259,37,383,423,423,500,40,77,person
41846,8,car,9,1,24261,26,834,629,972,693,138,64,car
41847,10,car,11,0,24261,20,1080,644,1152,676,72,32,car
41848,11,car,12,1,24261,19,1143,650,1188,676,45,26,car
41849,14,car,15,0,24261,23,1209,653,1304,689,95,36,car
41850,18,car,19,0,24261,15,1391,646,1415,668,24,22,car
41851,20,car,21,1,24261,24,1421,651,1485,698,64,47,car
41852,21,car,22,0,24261,21,1460,668,1518,728,58,60,car
41853,30,car,31,1,24261,16,41,600,79,624,38,24,car
41854,32,car,33,0,24261,17,104,607,137,634,33,27,car
41855,7,person,8,0,24262,27,648,414,686,518,38,104,person
41856,8,car,9,1,24262,36,780,333,1024,697,244,364,car
41857,11,car,12,1,24264,16,642,462,727,485,85,23,car
41858,12,car,13,1,24264,15,690,465,776,496,86,31,car
41859,13,car,14,0,24264,17,728,463,800,520,72,57,car
41860,14,car,15,0,24264,46,548,482,786,567,238,85,car
41861,17,car,18,0,24264,32,148,477,187,500,39,23,car
41862,18,car,19,0,24264,32,94,472,131,501,37,29,car
41863,19,car,20,0,24264,19,90,468,118,489,28,21,car
41864,20,car,21,0,24264,19,58,473,84,491,26,18,car
41865,23,car,24,1,24264,20,0,473,46,494,46,21,car
41866,24,car,25,1,24264,21,1,484,51,534,50,50,car
41867,21,car,22,1,24266,26,1,410,212,608,211,198,car
41868,22,car,23,0,24266,41,484,412,693,622,209,210,car
41869,23,car,24,1,24266,20,632,407,711,512,79,105,car
41870,24,car,25,1,24266,16,653,397,717,446,64,49,car
41871,3,car,4,0,24267,34,560,321,791,409,231,88,car
41872,4,car,5,0,24267,16,784,331,837,395,53,64,car
41873,8,person,9,0,24267,28,846,340,878,418,32,78,person
41874,9,person,10,0,24267,64,454,265,565,629,111,364,person
41875,10,bicycle,11,1,24267,67,459,436,559,657,100,221,bicycle
41876,11,bicycle,12,1,24267,15,850,377,877,429,27,52,bicycle
41877,13,car,14,1,24267,27,228,341,334,414,106,73,car
41878,14,person,15,0,24267,20,224,387,268,432,44,45,person
41879,15,person,16,0,24267,22,112,398,191,457,79,59,person
41880,16,person,17,0,24267,21,138,399,210,449,72,50,person
41881,17,car,18,1,24267,17,40,365,104,437,64,72,car
41882,19,person,20,1,24267,26,0,356,45,471,45,115,person
41883,21,car,22,0,24267,16,9,417,51,453,42,36,car
41884,18,person,19,1,24268,21,933,475,956,501,23,26,person
41885,19,person,20,0,24268,17,952,472,975,500,23,28,person
41886,33,person,34,0,24268,32,678,459,706,530,28,71,person
41887,34,person,35,0,24268,33,714,455,738,528,24,73,person
41888,35,person,36,1,24268,18,804,470,824,493,20,23,person
41889,36,person,37,0,24268,16,566,484,575,515,9,31,person
41890,37,person,38,0,24268,17,591,478,600,505,9,27,person
41891,38,person,39,1,24268,80,504,547,602,768,98,221,person
41892,44,person,45,0,24268,15,603,466,614,497,11,31,person
41893,23,car,24,0,24269,27,145,523,258,620,113,97,car
41894,8,car,9,0,24270,19,209,306,265,346,56,40,car
41895,18,bicycle,19,0,24270,37,142,298,178,326,36,28,bicycle
41896,7,car,8,1,24271,16,317,422,341,440,24,18,car
41897,8,car,9,0,24271,39,531,455,614,500,83,45,car
41898,9,car,10,0,24271,51,800,470,984,552,184,82,car
41899,10,car,11,1,24271,22,971,495,1024,565,53,70,car
41900,11,car,12,0,24271,42,650,459,764,520,114,61,car
41901,12,person,13,1,24271,22,544,436,567,462,23,26,person
41902,14,car,15,0,24271,22,228,419,269,453,41,34,car
41903,15,bus,16,1,24271,19,228,396,269,433,41,37,bus
41904,15,traffic light,16,0,24272,63,3,386,135,1173,132,787,traffic light
41905,2,umbrella,3,0,250,51,1,1,1274,949,1273,948,umbrella
41906,3,umbrella,4,0,250,65,567,381,1379,706,812,325,umbrella
41907,7,table,8,0,250,42,182,745,639,1000,457,255,dining table
41908,8,chair,9,0,250,31,483,724,688,956,205,232,chair
41909,9,chair,10,0,250,26,636,714,783,941,147,227,chair
41910,11,chair,12,1,250,37,732,708,979,943,247,235,chair
41911,12,chair,13,1,250,20,1044,700,1198,869,154,169,chair
41912,13,person,14,0,250,26,959,597,1194,805,235,208,person
41913,14,person,15,1,250,22,864,564,943,724,79,160,person
41914,15,person,16,1,250,22,806,586,860,725,54,139,person
41915,16,person,17,1,250,39,723,536,812,845,89,309,person
41916,17,person,18,1,250,40,579,529,688,760,109,231,person
41917,18,person,19,1,250,19,334,616,444,754,110,138,person
41918,19,chair,20,0,250,98,39,743,328,1000,289,257,chair
41919,20,chair,21,0,250,31,1186,692,1275,817,89,125,chair
41920,22,flowerpot,23,0,250,25,1404,752,1493,861,89,109,potted plant
41921,23,flowerpot,24,0,250,22,1229,792,1450,956,221,164,potted plant
41922,24,flowerpot,25,0,250,40,899,896,1276,1000,377,104,potted plant
41923,30,dog,31,1,250,71,505,793,607,948,102,155,dog
41924,32,person,33,1,250,37,1297,620,1360,747,63,127,person
41925,0,person,1,0,15818,26,1347,817,1931,1647,584,830,person
41926,6,chair,7,0,15818,18,1312,1121,1731,1648,419,527,chair
41927,8,umbrella,9,1,15818,16,1243,490,2133,1123,890,633,umbrella
41928,9,umbrella,10,0,15818,17,822,189,2197,834,1375,645,umbrella
41929,10,person,11,1,15818,15,5,929,558,1651,553,722,person
41930,13,person,14,1,15818,35,646,613,889,1043,243,430,person
41931,16,person,17,1,15818,19,227,809,364,944,137,135,person
41932,17,person,18,1,15818,38,194,613,449,991,255,378,person
41933,18,person,19,1,15818,35,502,704,671,1078,169,374,person
41934,19,person,20,1,15818,64,506,906,1055,1610,549,704,person
41935,20,umbrella,21,0,15818,20,3,3,2097,1651,2094,1648,umbrella
41936,21,table,22,0,15818,25,659,1197,1350,1648,691,451,dining table
41937,22,person,23,1,15818,20,979,809,1149,1197,170,388,person
41938,23,chair,24,1,15818,15,1197,1012,1355,1201,158,189,chair
41939,24,person,25,1,15818,17,1176,842,1284,1000,108,158,person
41940,25,person,26,1,15818,24,1209,861,1388,1033,179,172,person
41941,26,chair,27,0,15818,20,1761,984,1925,1254,164,270,chair
41942,27,person,28,0,15818,40,1806,858,2024,1182,218,324,person
41943,28,person,29,1,15818,18,2128,845,2199,1022,71,177,person
41944,2,chair,3,1,15819,15,1464,1254,1694,1527,230,273,chair
41945,5,chair,6,1,15819,15,1746,1272,2048,1463,302,191,chair
41946,14,table,15,0,15819,17,305,1283,620,1527,315,244,dining table
41947,16,person,17,1,15819,19,1524,983,1726,1224,202,241,person
41948,20,table,21,0,15819,24,1384,1164,1581,1399,197,235,dining table
41949,23,chair,24,1,15819,15,1602,1134,1751,1292,149,158,chair
41950,24,table,25,0,15819,19,1369,1127,1525,1317,156,190,dining table
41951,26,table,27,0,15819,15,581,1205,817,1421,236,216,dining table
41952,30,chair,31,1,15819,16,536,1279,847,1534,311,255,chair
41953,32,person,33,1,15819,32,58,1021,472,1378,414,357,person
41954,41,table,42,0,15819,17,795,1129,970,1260,175,131,dining table
41955,43,person,44,0,15819,39,197,830,290,1072,93,242,person
41956,44,person,45,0,15819,37,117,828,212,1064,95,236,person
41957,46,chair,47,1,15819,29,945,1108,1096,1381,151,273,chair
41958,51,person,52,0,15819,22,319,848,381,1043,62,195,person
41959,52,table,53,0,15819,15,882,1100,1041,1179,159,79,dining table
41960,57,chair,58,1,15819,31,636,1233,921,1534,285,301,chair
41961,58,person,59,0,15819,27,1053,863,1119,1021,66,158,person
41962,60,person,61,1,15819,15,1187,955,1233,1059,46,104,person
41963,61,chair,62,1,15819,26,3,1220,259,1505,256,285,chair
41964,69,chair,70,0,15819,24,200,1190,398,1536,198,346,chair
41965,72,chair,73,0,15819,18,765,1021,901,1194,136,173,chair
41966,74,person,75,0,15819,35,1038,953,1200,1162,162,209,person
41967,80,person,81,1,15819,20,284,826,346,989,62,163,person
41968,88,chair,89,1,15819,23,900,1177,965,1512,65,335,chair
41969,91,chair,92,0,15819,15,1241,962,1306,1059,65,97,chair
41970,93,chair,94,1,15819,15,1082,1074,1132,1319,50,245,chair
41971,117,person,118,1,15819,19,460,997,582,1244,122,247,person
41972,3,table,4,0,15820,31,355,975,693,1270,338,295,dining table
41973,6,chair,7,0,15820,24,153,940,404,1292,251,352,chair
41974,8,chair,9,1,15820,16,383,1037,559,1206,176,169,chair
41975,9,chair,10,0,15820,22,631,921,798,1228,167,307,chair
41976,12,person,13,0,15820,26,1296,697,1414,1130,118,433,person
41977,13,chair,14,0,15820,23,1358,905,1534,1144,176,239,chair
41978,14,chair,15,0,15820,17,1478,872,1602,1115,124,243,chair
41979,15,person,16,1,15820,27,1420,798,1593,1092,173,294,person
41980,20,chair,21,1,15820,15,1584,880,1665,1092,81,212,chair
41981,21,bicycle,22,1,15820,55,1570,845,1741,1055,171,210,bicycle
41982,35,person,36,1,15820,19,375,750,508,901,133,151,person
41983,4,umbrella,4,0,15821,37,273,493,515,1465,242,972,umbrella
41984,5,umbrella,5,0,15821,38,487,619,632,1313,145,694,umbrella
41985,6,umbrella,6,0,15821,29,614,711,735,1220,121,509,umbrella
41986,9,motorbike,9,1,15821,26,2,1036,139,1157,137,121,motorcycle
41987,10,chair,10,1,15821,44,582,1261,835,1464,253,203,chair
41988,12,bench,12,0,15821,19,1457,1060,1641,1185,184,125,bench
41989,14,person,14,0,15821,30,1362,1021,1447,1146,85,125,person
41990,15,bench,15,0,15821,27,580,1069,657,1153,77,84,bench
41991,18,chair,18,0,15821,19,959,1058,1008,1130,49,72,chair
41992,21,person,21,1,15821,23,1352,971,1394,1090,42,119,person
41993,29,person,29,0,15821,23,1009,993,1035,1072,26,79,person
41994,33,person,33,1,15821,25,167,973,240,1086,73,113,person
41995,38,motorbike,38,1,15821,40,1436,1003,1496,1067,60,64,motorcycle
41996,39,person,39,0,15821,30,1303,991,1324,1057,21,66,person
41997,42,ball,42,0,15821,21,2041,1181,2128,1266,87,85,sports ball
41998,46,person,46,1,15821,21,943,993,964,1023,21,30,person
41999,47,car,47,1,15821,38,962,1002,1005,1035,43,33,car
42000,49,person,49,0,15821,16,983,1018,996,1052,13,34,person
42001,51,person,51,1,15821,20,89,982,123,1039,34,57,person
42002,52,person,52,1,15821,24,56,970,90,1043,34,73,person
42003,0,person,1,0,15822,48,299,450,713,924,414,474,person
42004,1,person,2,1,15822,80,596,155,1154,958,558,803,person
42005,6,person,7,1,15822,19,4,776,94,880,90,104,person
42006,2,person,3,1,15823,38,1035,726,1378,1522,343,796,person
42007,3,table,4,1,15823,21,1269,919,1529,1452,260,533,dining table
42008,6,person,7,1,15823,42,1347,596,1917,1508,570,912,person
42009,7,umbrella,8,1,15823,23,777,2,2047,1455,1270,1453,umbrella
42010,8,umbrella,9,0,15823,37,1849,293,2010,866,161,573,umbrella
42011,12,person,13,1,15823,48,833,662,1049,923,216,261,person
42012,16,table,17,1,15823,23,297,942,441,1404,144,462,dining table
42013,17,person,18,1,15823,38,159,711,385,1022,226,311,person
42014,29,person,30,0,15823,27,1043,670,1150,864,107,194,person
42015,31,person,32,1,15823,25,1336,672,1418,876,82,204,person
42016,32,person,33,1,15823,16,1284,713,1332,831,48,118,person
42017,7,person,8,1,15824,26,3,818,109,1083,106,265,person
42018,14,person,15,1,15824,28,395,839,491,1062,96,223,person
42019,16,umbrella,17,0,15824,24,352,502,1022,912,670,410,umbrella
42020,19,person,20,1,15824,15,638,728,688,842,50,114,person
42021,24,person,25,0,15824,36,1116,747,1251,1033,135,286,person
42022,25,umbrella,26,1,15824,19,863,560,1345,822,482,262,umbrella
42023,29,person,30,0,15824,27,1721,776,1776,984,55,208,person
42024,37,person,38,0,15824,30,1631,785,1712,981,81,196,person
42025,44,person,44,1,15824,22,805,820,884,939,79,119,person
42026,2,table,3,0,15825,17,16,189,48,230,32,41,dining table
42027,3,person,4,0,15825,27,2,161,26,229,24,68,person
42028,4,person,5,0,15825,36,34,160,85,229,51,69,person
42029,5,umbrella,6,0,15825,16,0,100,113,185,113,85,umbrella
42030,6,person,7,1,15825,23,75,160,108,235,33,75,person
42031,7,umbrella,8,0,15825,20,142,99,255,166,113,67,umbrella
42032,8,person,9,1,15825,19,171,167,214,200,43,33,person
42033,9,person,10,1,15825,15,204,166,232,196,28,30,person
42034,9,chair,10,0,15826,22,233,145,308,244,75,99,chair
42035,10,chair,11,1,15826,15,221,183,333,263,112,80,chair
42036,11,table,12,1,15826,15,28,191,230,264,202,73,dining table
42037,22,chair,23,1,15826,25,93,125,151,184,58,59,chair
42038,23,chair,24,1,15826,20,41,133,104,210,63,77,chair
42039,25,chair,26,1,15826,15,179,124,221,186,42,62,chair
42040,3,person,4,1,15827,24,45,140,79,204,34,64,person
42041,5,person,6,1,15827,21,3,131,49,190,46,59,person
42042,7,person,8,1,15827,15,13,138,31,171,18,33,person
42043,9,umbrella,10,1,15827,18,0,72,91,139,91,67,umbrella
42044,10,person,11,1,15827,24,132,142,164,207,32,65,person
42045,18,umbrella,19,0,15827,24,139,78,255,143,116,65,umbrella
42046,8,table,9,0,15828,24,118,154,235,198,117,44,dining table
42047,11,umbrella,12,0,15828,45,66,3,289,169,223,166,umbrella
42048,13,chair,14,0,15828,32,76,157,144,231,68,74,chair
42049,14,chair,15,1,15828,15,151,196,244,231,93,35,chair
42050,15,chair,16,1,15828,25,228,152,265,231,37,79,chair
42051,2,umbrella,3,1,15829,18,107,0,150,215,43,215,umbrella
42052,3,umbrella,4,0,15829,15,34,1,166,71,132,70,umbrella
42053,7,chair,8,1,15829,26,17,111,87,212,70,101,chair
42054,8,person,9,0,15829,46,25,64,117,208,92,144,person
42055,9,person,10,1,15829,33,58,64,138,174,80,110,person
42056,10,person,11,1,15829,20,83,70,127,118,44,48,person
42057,11,chair,12,0,15829,31,143,117,211,236,68,119,chair
42058,12,person,13,1,15829,19,121,53,170,112,49,59,person
42059,13,person,14,1,15829,27,178,63,236,125,58,62,person
42060,15,person,16,1,15829,23,203,63,255,165,52,102,person
42061,6,chair,7,0,15830,15,410,549,504,682,94,133,chair
42062,9,chair,10,0,15830,18,519,556,629,708,110,152,chair
42063,11,chair,12,0,15830,17,635,557,742,722,107,165,chair
42064,26,chair,27,0,15830,20,890,520,987,655,97,135,chair
42065,4,table,5,0,15831,25,199,219,237,254,38,35,dining table
42066,5,person,6,1,15831,18,211,191,237,223,26,32,person
42067,6,person,7,1,15831,18,188,188,210,224,22,36,person
42068,7,table,8,0,15831,16,149,214,186,234,37,20,dining table
42069,8,person,9,1,15831,20,93,184,116,224,23,40,person
42070,9,person,10,1,15831,26,64,190,102,253,38,63,person
42071,10,person,11,1,15831,19,50,189,72,227,22,38,person
42072,11,person,12,0,15831,25,121,169,149,254,28,85,person
42073,13,person,14,1,15831,17,158,191,185,215,27,24,person
42074,5,umbrella,6,0,15832,15,0,73,224,205,224,132,umbrella
42075,7,person,8,1,15832,25,86,157,120,228,34,71,person
42076,8,chair,9,0,15832,19,125,182,160,224,35,42,chair
42077,9,chair,10,0,15832,15,44,183,78,222,34,39,chair
42078,10,person,11,1,15832,17,43,157,70,198,27,41,person
42079,12,person,13,0,15832,17,19,171,38,213,19,42,person
42080,13,person,14,1,15832,23,12,153,53,214,41,61,person
42081,14,person,15,1,15832,18,77,146,96,182,19,36,person
42082,16,person,17,0,15832,30,189,169,255,238,66,69,person
42083,18,person,19,1,15832,24,151,149,179,200,28,51,person
42084,19,person,20,1,15832,18,143,129,163,163,20,34,person
42085,21,person,22,1,15832,16,171,132,187,161,16,29,person
42086,25,person,26,1,15832,16,36,145,53,173,17,28,person
42087,27,person,28,1,15832,17,12,116,22,145,10,29,person
42088,28,person,29,1,15832,16,39,116,48,143,9,27,person
42089,30,person,31,1,15832,17,64,146,80,179,16,33,person
42090,33,person,34,1,15832,15,64,121,74,147,10,26,person
42091,34,person,35,1,15832,15,75,120,87,150,12,30,person
42092,25,bench,21,1,15833,21,0,398,35,488,35,90,bench
42093,35,umbrella,30,0,15833,29,0,190,141,343,141,153,umbrella
42094,39,table,34,1,15833,19,213,336,289,403,76,67,dining table
42095,40,chair,35,0,15833,18,213,343,266,406,53,63,chair
42096,43,table,38,1,15833,22,294,343,389,421,95,78,dining table
42097,44,umbrella,39,1,15833,34,258,197,410,347,152,150,umbrella
42098,45,chair,40,1,15833,20,266,344,307,417,41,73,chair
42099,47,table,42,1,15833,24,582,340,661,402,79,62,dining table
42100,48,umbrella,43,0,15833,29,546,212,708,343,162,131,umbrella
42101,49,chair,44,0,15833,21,592,346,646,406,54,60,chair
42102,50,chair,45,1,15833,22,641,344,691,403,50,59,chair
42103,51,chair,46,1,15833,18,554,338,606,401,52,63,chair
42104,52,table,47,1,15833,19,460,330,525,388,65,58,dining table
42105,53,umbrella,48,1,15833,27,458,211,566,332,108,121,umbrella
42106,54,chair,49,1,15833,20,503,335,555,388,52,53,chair
42107,57,table,52,1,15833,17,529,316,575,361,46,45,dining table
42108,3,chair,4,0,15834,18,394,491,494,642,100,151,chair
42109,6,chair,7,1,15834,17,543,497,630,676,87,179,chair
42110,8,chair,9,1,15834,17,473,487,573,629,100,142,chair
42111,10,chair,11,1,15834,17,282,473,358,600,76,127,chair
42112,11,chair,12,0,15834,19,626,514,739,686,113,172,chair
42113,13,chair,14,0,15834,19,923,476,1016,618,93,142,chair
42114,15,chair,16,1,15834,15,159,471,212,592,53,121,chair
42115,18,chair,19,0,15834,18,77,470,158,582,81,112,chair
42116,20,table,21,1,15834,15,357,447,481,483,124,36,dining table
42117,21,person,22,1,15834,16,393,393,453,456,60,63,person
42118,26,person,27,1,15834,15,142,350,192,451,50,101,person
42119,26,chair,27,1,15835,26,135,229,212,358,77,129,chair
42120,27,chair,28,1,15835,20,354,233,410,319,56,86,chair
42121,28,person,29,1,15835,40,166,175,282,360,116,185,person
42122,29,person,30,1,15835,27,281,188,369,303,88,115,person
42123,74,plate,73,0,15835,17,299,262,326,275,27,13,plate
42124,77,plate,76,0,15835,16,263,303,291,313,28,10,plate
42125,15,chair,16,1,15836,22,40,152,172,267,132,115,chair
42126,6,bench,7,0,24284,39,493,361,670,461,177,100,bench
42127,9,chair,10,0,24284,35,537,361,653,512,116,151,chair
42128,10,chair,11,0,24284,20,685,359,784,517,99,158,chair
42129,12,chair,13,1,24284,36,338,367,460,537,122,170,chair
42130,13,table,14,1,24284,34,106,395,357,538,251,143,dining table
42131,15,chair,16,1,24284,32,6,379,159,537,153,158,chair
42132,16,chair,17,0,24284,21,166,381,303,537,137,156,chair
42133,17,chair,18,0,24284,18,226,360,314,395,88,35,chair
42134,21,table,22,0,24284,25,629,460,714,537,85,77,dining table
42135,23,chair,24,1,24284,48,374,449,502,538,128,89,chair
42136,4,person,5,0,24285,47,485,223,799,599,314,376,person
42137,14,chair,15,0,24285,48,257,396,471,599,214,203,chair
42138,15,chair,16,1,24285,33,271,373,435,504,164,131,chair
42139,17,chair,18,0,24285,33,76,359,201,523,125,164,chair
42140,18,chair,19,1,24285,15,163,353,211,430,48,77,chair
42141,21,person,22,1,24285,32,224,294,301,368,77,74,person
42142,22,person,23,1,24285,33,321,299,397,371,76,72,person
42143,25,chair,26,1,24285,28,207,365,309,495,102,130,chair
42144,26,bottle,27,0,24285,22,193,449,269,600,76,151,bottle
42145,27,bottle,28,0,24285,24,329,433,399,600,70,167,bottle
42146,28,chair,29,0,24285,22,427,329,485,399,58,70,chair
42147,29,person,30,0,24285,27,425,293,471,364,46,71,person
42148,30,person,31,1,24285,21,471,295,500,361,29,66,person
42149,31,person,32,1,24285,24,498,293,529,355,31,62,person
42150,32,person,33,1,24285,21,535,298,553,346,18,48,person
42151,6,table,7,0,24286,32,40,540,783,747,743,207,dining table
42152,7,person,8,1,24286,60,79,329,523,816,444,487,person
42153,8,person,9,1,24286,51,266,295,625,815,359,520,person
42154,11,chair,12,1,24286,37,750,532,1041,818,291,286,chair
42155,21,car,22,0,24286,20,968,218,1200,308,232,90,car
42156,23,person,24,1,24286,31,435,170,555,481,120,311,person
42157,24,person,25,1,24286,16,306,290,369,410,63,120,person
42158,25,person,26,1,24286,21,111,272,213,455,102,183,person
42159,26,person,27,1,24286,21,185,214,253,331,68,117,person
42160,27,person,28,1,24286,19,250,188,300,328,50,140,person
42161,28,person,29,1,24286,29,257,180,377,352,120,172,person
42162,29,person,30,1,24286,15,360,218,401,306,41,88,person
42163,30,person,31,1,24286,23,590,314,649,518,59,204,person
42164,31,chair,32,1,24286,24,536,427,673,550,137,123,chair
42165,35,traffic light,36,0,24286,16,778,102,802,135,24,33,traffic light
42166,8,bus,9,1,24287,37,603,392,1024,627,421,235,bus
42167,11,person,12,1,24287,15,537,548,567,612,30,64,person
42168,12,person,13,1,24287,23,653,518,679,616,26,98,person
42169,13,person,14,0,24287,23,635,523,666,621,31,98,person
42170,14,person,15,0,24287,36,768,501,816,638,48,137,person
42171,15,person,16,0,24287,32,858,520,910,641,52,121,person
42172,13,person,14,0,24288,25,276,363,294,414,18,51,person
42173,16,person,17,0,24288,25,437,384,468,425,31,41,person
42174,17,bench,18,0,24288,38,144,424,203,460,59,36,bench
42175,18,person,19,0,24288,32,171,410,198,463,27,53,person
42176,21,person,22,1,24288,25,140,372,169,418,29,46,person
42177,22,chair,23,0,24288,15,135,383,160,417,25,34,chair
42178,24,bench,25,0,24288,34,477,420,528,455,51,35,bench
42179,25,bench,26,0,24288,25,754,421,798,450,44,29,bench
42180,26,motorbike,27,0,24288,25,701,399,744,429,43,30,motorcycle
42181,27,person,28,0,24288,23,681,388,701,437,20,49,person
42182,28,person,29,0,24288,15,669,407,681,436,12,29,person
42183,29,motorbike,30,0,24288,25,564,393,618,429,54,36,motorcycle
42184,12,table,13,0,24289,43,92,623,200,709,108,86,dining table
42185,13,chair,14,1,24289,32,126,582,209,699,83,117,chair
42186,14,chair,15,0,24289,40,166,591,256,709,90,118,chair
42187,15,chair,16,0,24289,18,13,573,55,630,42,57,chair
42188,2,person,3,1,24290,25,1,394,46,575,45,181,person
42189,3,person,4,0,24290,52,46,382,131,659,85,277,person
42190,4,person,5,0,24290,56,203,347,303,682,100,335,person
42191,5,person,6,0,24290,45,319,379,401,682,82,303,person
42192,12,chair,13,0,24290,33,651,486,820,682,169,196,chair
42193,13,chair,14,1,24290,28,491,476,560,679,69,203,chair
42194,14,person,15,0,24290,46,659,392,791,672,132,280,person
42195,15,person,16,1,24290,48,512,401,627,637,115,236,person
42196,4,person,5,0,15844,68,288,374,472,1001,184,627,person
42197,5,person,6,0,15844,48,442,410,600,1005,158,595,person
42198,2,toilet,3,0,15845,31,34,0,509,449,475,449,toilet
42199,2,person,3,1,251,27,130,234,215,332,85,98,person
42200,3,person,4,0,251,82,330,179,433,512,103,333,person
42201,13,person,14,0,251,60,668,237,782,424,114,187,person
42202,1,person,2,0,950,26,26,25,44,70,18,45,person
42203,3,person,4,0,950,18,148,15,162,59,14,44,person
42204,4,person,5,0,950,21,159,134,218,176,59,42,person
42205,5,person,6,0,950,34,126,153,186,201,60,48,person
42206,6,person,7,0,950,26,66,165,135,240,69,75,person
42207,7,person,8,0,950,32,97,198,177,267,80,69,person
42208,4,cat,5,1,24292,28,43,452,183,641,140,189,cat
42209,10,car,11,0,24293,22,867,713,899,727,32,14,car
42210,6,person,7,1,24295,32,60,216,99,311,39,95,person
42211,7,person,8,0,24295,38,202,220,239,345,37,125,person
42212,8,person,9,0,24295,55,301,211,357,333,56,122,person
42213,9,person,10,0,24295,45,448,200,503,314,55,114,person
42214,10,person,11,0,24295,34,548,204,581,306,33,102,person
42215,11,person,12,0,24295,45,623,203,663,302,40,99,person
42216,14,person,15,0,24296,26,172,526,197,561,25,35,person
42217,9,person,10,1,24298,17,751,213,769,239,18,26,person
42218,1,person,2,0,24299,73,161,158,571,678,410,520,person
42219,2,person,3,1,24299,64,487,134,767,650,280,516,person
42220,3,person,4,0,15910,44,418,478,527,764,109,286,person
42221,6,truck,7,0,15915,19,299,439,365,502,66,63,truck
42222,3,person,4,0,15929,40,651,202,771,543,120,341,person
42223,6,chair,7,0,15935,26,13,129,77,214,64,85,chair
42224,7,chair,8,1,15935,17,20,107,58,150,38,43,chair
42225,9,chair,10,0,15935,18,56,90,90,123,34,33,chair
42226,10,chair,11,0,15935,17,91,80,117,116,26,36,chair
42227,7,person,8,0,15936,20,94,107,110,159,16,52,person
42228,8,person,9,0,15936,27,112,99,133,159,21,60,person
42229,19,table,20,0,15937,35,242,256,300,342,58,86,dining table
42230,20,chair,21,0,15937,23,174,262,260,372,86,110,chair
42231,21,chair,22,0,15937,21,300,255,371,343,71,88,chair
42232,12,car,13,0,15938,15,3,123,67,157,64,34,car
42233,9,chair,10,1,15942,15,0,79,91,223,91,144,chair
42234,6,plant pot,7,0,24312,21,1,855,448,1346,447,491,potted plant
42235,2,plant pot,3,0,24314,17,319,1041,512,1199,193,158,potted plant
42236,3,plant pot,4,0,24314,17,615,1024,810,1195,195,171,potted plant
42237,5,plant pot,6,0,24314,17,964,948,1154,1116,190,168,potted plant
42238,7,plant pot,8,0,24314,31,1260,908,1424,1031,164,123,potted plant
42239,9,plant pot,10,0,24314,19,1506,843,1645,959,139,116,potted plant
42240,11,plant pot,12,0,24314,15,191,836,328,970,137,134,potted plant
42241,12,plant pot,13,0,24314,23,11,851,120,958,109,107,potted plant
42242,13,plant pot,14,1,24314,17,1183,709,1247,782,64,73,potted plant
42243,3,plant pot,4,0,24317,23,684,1471,1125,1885,441,414,potted plant
42244,4,plant pot,5,0,24317,23,71,1377,570,1895,499,518,potted plant
42245,5,plant pot,6,0,24317,45,800,1057,1373,1664,573,607,potted plant
42246,19,chair,20,0,24319,18,63,311,145,415,82,104,chair
42247,4,person,5,0,24320,27,418,666,438,720,20,54,person
42248,5,person,6,0,24320,35,32,656,60,741,28,85,person
42249,7,umbrella,8,1,24320,29,58,623,172,654,114,31,umbrella
42250,8,umbrella,9,1,24320,17,161,630,238,701,77,71,umbrella
42251,9,umbrella,10,1,24320,16,225,634,297,663,72,29,umbrella
42252,11,motorbike,12,1,24320,46,341,686,391,745,50,59,motorcycle
42253,12,motorbike,13,0,24320,55,299,694,358,748,59,54,motorcycle
42254,22,traffic light,23,0,24320,33,294,279,499,402,205,123,traffic light
42255,5,person,6,0,24322,29,221,219,247,333,26,114,person
42256,6,person,7,1,24322,19,576,151,591,203,15,52,person
42257,8,person,9,1,24322,102,477,247,610,641,133,394,person
42258,9,person,10,0,24322,50,475,408,536,655,61,247,person
42259,10,person,11,1,24322,18,272,222,298,267,26,45,person
42260,11,person,12,0,24322,39,239,222,276,361,37,139,person
42261,12,person,13,0,24322,39,262,246,313,389,51,143,person
42262,13,person,14,1,24322,17,747,153,776,210,29,57,person
42263,19,plant pot,20,1,24322,18,606,600,668,674,62,74,potted plant
42264,20,plant pot,21,1,24322,19,623,613,676,689,53,76,potted plant
42265,21,plant pot,22,1,24322,15,648,688,712,786,64,98,potted plant
42266,26,plant pots,27,1,24322,35,764,492,849,548,85,56,potted plant
42267,27,plant pots,28,1,24322,54,879,507,1023,685,144,178,potted plant
42268,3,plant pot,4,0,24324,21,654,973,856,1227,202,254,potted plant
42269,5,bowl,6,0,24324,18,704,1211,913,1377,209,166,bowl
42270,16,motorbike,9,0,15963,44,29,1020,188,1204,159,184,motorcycle
42271,18,person,11,0,15963,27,57,978,153,1154,96,176,person
42272,20,motorbike,13,0,15963,48,261,1013,409,1155,148,142,motorcycle
42273,21,person,14,0,15963,24,317,979,361,1124,44,145,person
42274,22,motorbike,15,1,15963,16,1,1035,65,1128,64,93,motorcycle
42275,23,person,16,1,15963,26,2,994,65,1118,63,124,person
42276,30,traffic light,23,0,15963,60,1904,621,2073,1020,169,399,traffic light
42277,32,traffic light,25,0,15963,16,135,882,158,978,23,96,traffic light
42278,33,motorbike,26,0,15963,43,1624,995,1721,1064,97,69,motorcycle
42279,34,person,27,0,15963,29,1650,961,1692,1052,42,91,person
42280,36,bicycle,29,1,15963,44,1531,991,1580,1041,49,50,bicycle
42281,37,person,30,0,15963,27,1536,959,1571,1019,35,60,person
42282,38,car,31,1,15963,21,2037,968,2127,1010,90,42,car
42283,41,person,34,0,15963,22,2107,961,2124,1016,17,55,person
42284,53,person,46,0,15963,19,169,966,185,1029,16,63,person
42285,54,person,47,0,15963,32,181,960,213,1031,32,71,person
42286,55,person,48,1,15963,23,205,965,219,1021,14,56,person
42287,56,person,49,1,15963,22,220,967,242,1021,22,54,person
42288,58,person,51,1,15963,24,1507,961,1525,1017,18,56,person
42289,59,person,52,1,15963,16,1523,956,1538,1013,15,57,person
42290,60,person,53,0,15963,24,1381,963,1400,1021,19,58,person
42291,61,person,54,0,15963,17,1401,967,1414,1020,13,53,person
42292,66,person,59,0,15963,24,2155,952,2185,1011,30,59,person
42293,85,car,78,0,15963,39,1715,979,1946,1089,231,110,car
42294,3,car,4,0,15964,18,851,1003,949,1049,98,46,car
42295,4,car,5,0,15964,16,1219,1002,1285,1052,66,50,car
42296,12,car,13,0,15964,25,124,1021,299,1087,175,66,car
42297,15,car,16,0,15964,20,505,1009,570,1052,65,43,car
42298,17,car,18,0,15964,20,401,1016,497,1046,96,30,car
42299,18,car,19,1,15964,24,656,1011,855,1072,199,61,car
42300,24,person,25,0,15964,21,2141,967,2166,1046,25,79,person
42301,25,person,26,0,15964,23,2165,958,2199,1048,34,90,person
42302,18,truck,15,0,15967,17,369,882,457,941,88,59,truck
42303,26,person,22,0,15967,21,985,913,1001,949,16,36,person
42304,30,car,26,0,15967,17,636,922,716,954,80,32,car
42305,17,truck,17,0,15970,18,140,1114,354,1197,214,83,truck
42306,33,car,33,0,15970,22,981,1110,1376,1235,395,125,car
42307,75,door,75,0,15970,15,471,1138,557,1217,86,79,door
42308,38,person,39,0,15971,24,196,389,207,418,11,29,person
42309,17,car,18,0,15972,27,2,421,251,510,249,89,car
42310,63,person,64,0,15973,21,244,639,268,707,24,68,person
42311,64,person,65,0,15973,20,270,631,295,709,25,78,person
42312,65,person,66,0,15973,16,408,641,437,710,29,69,person
42313,66,person,67,0,15973,16,439,636,454,711,15,75,person
42314,20,car,21,1,15974,17,1020,568,1082,613,62,45,car
42315,21,car,22,1,15974,17,1037,577,1086,624,49,47,car
42316,22,car,23,0,15974,26,1067,570,1172,645,105,75,car
42317,26,car,27,0,15974,21,116,559,271,620,155,61,car
42318,1,car,2,0,15976,17,286,171,315,183,29,12,car
42319,7,motorbike,8,0,15980,29,381,823,460,864,79,41,motorcycle
42320,8,car,9,0,15980,20,292,823,386,882,94,59,car
42321,9,car,10,0,15980,21,461,824,544,877,83,53,car
42322,10,car,11,0,15980,18,598,817,670,864,72,47,car
42323,21,car,22,0,15980,52,775,834,1111,1169,336,335,car
42324,23,motorbike,24,0,15980,15,1070,838,1101,884,31,46,motorcycle
42325,27,motorbike,28,1,15980,25,1456,853,1600,1102,144,249,motorcycle
42326,28,motorbike,29,1,15980,26,1416,874,1539,1089,123,215,motorcycle
42327,29,motorbike,30,1,15980,21,1369,919,1467,1065,98,146,motorcycle
42328,35,motorbikes,36,0,15980,17,1122,840,1221,879,99,39,motorcycle
42329,36,motorbikes,37,0,15980,18,1232,843,1369,889,137,46,motorcycle
42330,1,car,2,0,15981,22,150,828,444,894,294,66,car
42331,18,car,19,1,15981,15,420,811,544,873,124,62,car
42332,19,truck,20,1,15981,18,255,782,423,861,168,79,truck
42333,47,person,48,0,15982,28,366,750,384,805,18,55,person
42334,2,car,3,0,15984,15,259,125,294,149,35,24,car
42335,5,car,5,0,15984,15,2,125,35,151,33,26,car
42336,26,car,24,0,15984,27,116,129,203,156,87,27,car
42337,1,car,2,0,15985,24,5,136,93,189,88,53,car
42338,20,car,21,0,15985,16,256,134,277,149,21,15,car
42339,2,person,3,0,15986,22,1191,541,1235,635,44,94,person
42340,5,bus,6,0,15986,34,582,329,891,662,309,333,bus
42341,6,car,7,1,15986,16,881,553,980,621,99,68,car
42342,9,motorbike,10,0,15986,20,351,584,441,686,90,102,motorcycle
42343,10,person,11,1,15986,17,354,576,393,669,39,93,person
42344,0,car,1,0,15987,59,608,733,1297,966,689,233,car
42345,13,person,14,1,15987,15,1021,769,1097,829,76,60,person
42346,38,person,39,1,15987,21,999,756,1064,828,65,72,person
42347,18,car,19,1,15991,17,1140,723,1280,793,140,70,car
42348,26,clock,27,0,15991,25,596,387,668,484,72,97,clock
42349,36,car,37,1,15991,23,36,733,192,802,156,69,car
42350,42,person,43,0,15991,16,972,693,987,734,15,41,person
42351,1,person,2,0,15992,26,691,634,733,742,42,108,person
42352,23,person,24,0,15992,38,113,594,171,738,58,144,person
42353,30,person,31,0,15992,15,492,612,508,664,16,52,person
42354,35,truck,36,0,15992,19,728,633,897,706,169,73,truck
42355,44,car,45,0,15992,16,1013,679,1065,704,52,25,car
42356,47,car,48,0,15992,15,1356,700,1410,721,54,21,car
42357,6,car,7,0,15993,24,216,165,266,187,50,22,car
42358,0,car,1,0,15994,16,70,121,135,146,65,25,car
42359,0,car,1,0,15996,76,0,116,85,147,85,31,car
42360,3,car,4,0,15998,16,113,108,141,124,28,16,car
42361,4,car,5,1,15998,16,189,112,230,129,41,17,car
42362,5,car,6,0,15998,20,235,111,276,135,41,24,car
42363,6,car,7,1,15998,18,276,114,320,138,44,24,car
42364,19,person,20,0,15998,18,43,107,56,130,13,23,person
42365,20,person,21,0,15998,18,50,109,66,130,16,21,person
42366,0,person,1,0,15999,47,599,564,1014,1157,415,593,person
42367,2,person,3,0,15999,24,119,639,189,761,70,122,person
42368,24,person,25,0,15999,20,326,646,362,728,36,82,person
42369,25,person,26,0,15999,22,198,644,232,729,34,85,person
42370,29,person,30,0,15999,20,23,632,54,719,31,87,person
42371,3,person,4,0,16000,17,141,78,157,118,16,40,person
42372,4,car,5,1,16000,15,118,94,150,150,32,56,car
42373,3,car,4,0,16001,22,42,93,65,106,23,13,car
42374,26,person,27,0,16005,22,575,954,742,1146,167,192,person
42375,27,person,28,0,16005,23,676,960,878,1102,202,142,person
42376,0,car,1,0,16006,19,720,411,935,503,215,92,car
42377,1,car,2,0,16007,15,43,103,73,116,30,13,car
42378,21,truck,22,0,16007,17,176,107,206,118,30,11,truck
42379,9,car,10,0,16008,26,181,82,246,110,65,28,car
42380,10,car,11,0,16008,27,60,96,133,128,73,32,car
42381,11,car,12,0,16008,25,28,80,82,109,54,29,car
42382,1,car,2,0,16009,22,649,209,855,330,206,121,car
42383,6,car,7,0,16013,17,1832,964,2009,1031,177,67,car
42384,1,car,2,0,16014,17,773,660,1049,756,276,96,car
42385,38,motorbike,39,0,16014,19,102,680,140,713,38,33,motorcycle
42386,39,person,40,0,16014,15,105,667,128,699,23,32,person
42387,7,car,8,0,22078,29,169,93,226,116,57,23,car
42388,8,car,9,0,22078,25,28,94,66,115,38,21,car
42389,9,car,10,0,22078,20,35,69,71,83,36,14,car
42390,12,person,13,0,22079,39,285,225,308,266,23,41,person
42391,13,person,14,0,22079,30,214,224,230,260,16,36,person
42392,14,person,15,0,22079,18,128,224,134,246,6,22,person
42393,15,person,16,0,22079,23,91,224,104,250,13,26,person
42394,16,person,17,0,22079,24,108,224,118,255,10,31,person
42395,24,person,25,0,22079,18,247,223,254,243,7,20,person
42396,25,person,26,0,22079,17,252,222,258,244,6,22,person
42397,26,person,27,0,22079,24,537,226,546,263,9,37,person
42398,5,window,6,0,16032,23,143,0,163,72,20,72,window
42399,5,person,6,1,24325,36,128,792,429,1022,301,230,person
42400,7,bicycle,8,0,24327,45,803,302,930,384,127,82,bicycle
42401,2,person,3,1,24335,62,235,297,354,479,119,182,person
42402,0,airplane,1,0,16039,40,739,727,1455,1023,716,296,airplane
42403,10,car,11,0,16039,19,653,873,715,897,62,24,car
42404,0,airplane,1,0,16040,30,313,623,601,746,288,123,airplane
42405,3,airplane,4,1,16040,19,624,657,819,731,195,74,airplane
42406,5,airplane,6,0,16040,21,841,654,979,739,138,85,airplane
42407,6,airplane,7,1,16040,17,965,700,1082,744,117,44,airplane
42408,7,airplane,8,0,16040,21,1196,646,1337,742,141,96,airplane
42409,0,airplane,1,0,16041,35,474,705,1147,984,673,279,airplane
42410,0,airplane,1,0,16042,16,329,443,508,501,179,58,airplane
42411,1,airplane,2,0,16043,32,325,188,500,253,175,65,airplane
42412,1,airplane,2,0,16045,42,44,197,302,280,258,83,airplane
42413,2,airplane,3,0,16045,44,263,201,473,271,210,70,airplane
42414,3,airplane,4,0,16045,32,480,221,619,261,139,40,airplane
42415,4,airplane,5,1,16045,25,566,221,674,257,108,36,airplane
42416,7,airplane,8,0,16046,56,9,80,463,209,454,129,airplane
42417,5,car,6,0,16048,16,102,293,151,315,49,22,car
42418,10,airplane,11,1,16048,78,2,88,672,571,670,483,airplane
42419,12,car,13,0,16048,15,378,285,442,353,64,68,car
42420,14,car,15,1,16048,29,469,229,711,453,242,224,car
42421,0,airplane,1,0,16049,24,646,782,1497,1011,851,229,airplane
42422,0,airplane,1,0,16050,25,1690,1002,1769,1032,79,30,airplane
42423,3,truck,4,0,16050,33,1473,1115,1612,1170,139,55,truck
42424,5,car,6,1,16050,35,1560,1494,1718,1650,158,156,car
42425,6,person,7,1,16050,27,1617,1465,1665,1538,48,73,person
42426,11,airplane,12,0,16050,24,1243,998,1350,1041,107,43,airplane
42427,12,airplane,13,1,16050,23,1190,1002,1289,1038,99,36,airplane
42428,13,airplane,14,0,16050,23,1021,1016,1103,1047,82,31,airplane
42429,14,airplane,15,0,16050,23,1093,1013,1190,1045,97,32,airplane
42430,15,airplane,16,0,16050,21,759,1035,819,1058,60,23,airplane
42431,16,airplane,17,0,16050,20,412,1043,474,1063,62,20,airplane
42432,19,truck,20,1,16050,21,2,1161,70,1216,68,55,truck
42433,20,airplane,21,0,16050,19,14,1050,53,1069,39,19,airplane
42434,24,airplane,25,0,16050,16,555,1041,609,1061,54,20,airplane
42435,25,airplane,26,0,16050,23,609,1024,699,1053,90,29,airplane
42436,1,airplane,2,1,22083,36,2,836,1385,1274,1383,438,airplane
42437,0,airplane,1,0,22084,38,238,453,1947,1032,1709,579,airplane
42438,8,airplane,9,0,24340,142,26,193,966,458,940,265,airplane
42439,0,airplane,1,0,24341,97,92,149,972,458,880,309,airplane
42440,6,airplane,7,0,24342,126,1,130,957,605,956,475,airplane
42441,7,airplane,8,1,24342,96,467,171,1023,530,556,359,airplane
42442,1,airplane,2,0,24343,139,1,192,1024,577,1023,385,airplane
42443,2,airplane,3,1,24343,47,758,315,1023,485,265,170,airplane
42444,2,airplane,3,0,24344,95,175,173,854,351,679,178,airplane
42445,6,person,7,0,24345,16,990,421,1008,467,18,46,person
42446,8,person,9,1,24345,20,944,421,964,464,20,43,person
42447,11,airplane,12,0,24345,88,12,165,1021,477,1009,312,airplane
42448,13,car,14,1,24345,21,157,446,235,466,78,20,car
42449,8,airplane,9,0,24346,68,15,133,956,422,941,289,airplane
42450,1,airplane,2,0,24347,60,29,174,998,431,969,257,airplane
42451,6,airplane,7,0,24348,76,528,328,975,477,447,149,airplane
42452,7,airplane,8,0,24348,85,68,324,617,500,549,176,airplane
42453,2,airplane,3,0,24349,73,29,192,1002,438,973,246,airplane
42454,9,car,10,0,24350,30,674,480,863,567,189,87,car
42455,10,car,11,1,24350,35,87,488,218,571,131,83,car
42456,11,car,12,1,24350,20,1,503,100,573,99,70,car
42457,15,car,16,0,24350,24,782,372,833,407,51,35,car
42458,16,car,17,0,24350,29,682,373,751,406,69,33,car
42459,20,airplane,21,0,24350,261,37,125,938,408,901,283,airplane
42460,24,person,25,0,24350,18,884,374,892,403,8,29,person
42461,26,person,27,0,24350,17,876,372,887,404,11,32,person
42462,10,airplane,11,0,24351,85,107,78,952,363,845,285,airplane
42463,8,airplane,9,0,24352,152,131,209,964,511,833,302,airplane
42464,9,person,10,0,24352,38,818,321,861,500,43,179,person
42465,10,person,11,0,24352,52,867,310,924,503,57,193,person
42466,11,person,12,0,24352,23,140,420,197,473,57,53,person
42467,12,person,13,0,24352,50,84,390,149,497,65,107,person
42468,13,car,14,1,24352,35,0,289,102,602,102,313,car
42469,0,airplane,1,0,24353,105,57,191,1003,477,946,286,airplane
42470,1,airplane,2,0,24354,188,9,25,1023,641,1014,616,airplane
42471,2,person,3,0,24354,69,344,99,462,335,118,236,person
42472,3,person,4,0,24354,61,476,216,687,452,211,236,person
42473,4,person,5,1,24354,47,456,229,606,478,150,249,person
42474,5,person,6,1,24354,27,449,242,540,386,91,144,person
42475,6,person,7,1,24354,46,541,126,635,285,94,159,person
42476,7,person,8,1,24354,41,482,128,557,282,75,154,person
42477,8,person,9,0,24354,68,347,99,462,335,115,236,person
42478,9,person,10,0,24354,57,60,343,168,652,108,309,person
42479,6,person,7,0,16188,32,64,138,110,282,46,144,person
42480,5,flowerpot,6,0,16190,15,196,201,225,232,29,31,potted plant
42481,7,bench,8,1,16190,27,0,163,59,257,59,94,bench
42482,8,bench,9,0,16191,19,200,145,260,180,60,35,bench
42483,2,person,3,0,16192,54,2,97,84,282,82,185,person
42484,5,door,6,0,24366,54,747,9,973,767,226,758,door
42485,7,person,8,1,24366,64,798,148,1015,768,217,620,person
42486,1,chair,2,0,24375,16,317,360,402,472,85,112,chair
42487,2,person,3,0,24377,76,211,227,516,684,305,457,person
42488,10,plant pot,11,1,24377,19,735,617,868,667,133,50,potted plant
42489,11,car,12,1,16203,15,2,247,192,304,190,57,car
42490,10,boat,11,1,16204,16,357,354,472,423,115,69,boat
42491,2,car,3,0,24382,18,230,391,280,430,50,39,car
42492,5,car,6,1,24382,20,105,367,153,424,48,57,car
42493,19,bench,20,0,24382,17,312,397,345,431,33,34,bench
42494,22,person,23,0,24382,28,275,357,298,452,23,95,person
42495,12,person,13,1,24383,54,731,349,793,582,62,233,person
42496,13,person,14,0,24383,66,742,360,847,620,105,260,person
42497,15,person,16,1,24383,22,1,389,43,595,42,206,person
42498,2,chair,3,0,24385,26,27,599,117,710,90,111,chair
42499,6,chair,7,0,24385,33,785,561,903,707,118,146,chair
42500,7,table,8,0,24385,28,864,582,1015,713,151,131,dining table
42501,9,chair,10,1,24385,25,974,562,1023,705,49,143,chair
42502,2,person,3,0,24386,55,649,405,754,725,105,320,person
42503,1,person,2,0,24388,60,1145,1048,1304,1593,159,545,person
42504,2,person,3,0,24388,72,816,759,1042,1509,226,750,person
42505,3,person,4,0,24388,71,637,751,871,1503,234,752,person
42506,1,motorbike,2,1,24391,24,681,392,798,532,117,140,motorcycle
42507,2,bicycle,3,1,24393,29,2,443,167,649,165,206,bicycle
42508,7,plant pot,8,0,24394,21,220,593,286,655,66,62,potted plant
42509,8,plant pot,9,0,24394,22,486,645,566,722,80,77,potted plant
42510,2,car,3,1,16279,28,242,229,373,287,131,58,car
42511,3,car,4,1,16279,24,338,246,432,293,94,47,car
42512,4,car,5,1,16279,17,393,247,460,299,67,52,car
42513,6,person,7,0,16320,29,186,222,260,325,74,103,person
42514,7,person,8,1,16320,20,545,218,594,307,49,89,person
42515,8,person,9,1,16320,18,450,234,503,305,53,71,person
42516,9,person,10,1,16320,16,497,234,546,303,49,69,person
42517,10,person,11,0,16320,20,323,178,343,240,20,62,person
42518,11,person,12,0,16320,16,89,215,111,272,22,57,person
42519,12,person,13,0,16320,23,43,202,81,268,38,66,person
42520,16,person,17,0,16320,15,541,166,555,198,14,32,person
42521,4,car,5,1,16321,21,4,353,72,384,68,31,car
42522,6,car,7,0,16321,24,546,383,604,424,58,41,car
42523,7,car,8,0,16321,29,437,386,529,441,92,55,car
42524,8,car,9,1,16321,26,352,391,440,435,88,44,car
42525,9,car,10,1,16321,22,316,381,399,422,83,41,car
42526,10,truck,11,1,16321,20,273,364,343,420,70,56,truck
42527,11,car,12,1,16321,19,223,378,273,410,50,32,car
42528,12,car,13,1,16321,20,179,367,258,409,79,42,car
42529,4,person,5,1,16324,30,151,145,183,224,32,79,person
42530,5,dog,6,0,16324,22,154,193,179,241,25,48,dog
42531,15,door,16,1,16324,16,163,118,198,201,35,83,door
42532,9,car,10,1,16325,15,556,345,639,395,83,50,car
42533,10,car,11,0,16325,26,489,356,583,395,94,39,car
42534,0,window,1,0,16328,47,0,1,639,261,639,260,window
42535,12,person,13,0,16329,15,140,221,144,238,4,17,person
42536,7,person,8,0,16330,18,3,192,18,218,15,26,person
42537,10,person,11,0,16330,18,151,220,162,250,11,30,person
42538,11,person,12,0,16330,19,188,221,201,249,13,28,person
42539,12,person,13,1,16333,17,0,159,36,254,36,95,person
42540,13,person,14,0,16333,31,40,170,62,219,22,49,person
42541,14,person,15,0,16333,20,229,199,239,222,10,23,person
42542,15,person,16,0,16333,15,126,188,132,208,6,20,person
42543,7,person,8,0,16334,19,390,285,401,316,11,31,person
42544,9,person,10,0,16334,16,402,284,416,314,14,30,person
42545,11,person,12,1,16335,17,244,187,254,218,10,31,person
42546,12,person,13,0,16335,16,233,185,239,213,6,28,person
42547,3,car,4,0,24408,15,240,506,363,551,123,45,car
42548,3,car,4,0,24410,23,54,459,144,502,90,43,car
42549,8,person,9,0,24410,22,923,469,955,559,32,90,person
42550,8,person,9,0,24411,29,7,378,46,483,39,105,person
42551,10,bench,11,0,24411,17,0,526,101,569,101,43,bench
42552,15,table,16,0,24411,15,72,526,266,595,194,69,dining table
42553,16,bench,17,0,24411,15,101,589,256,657,155,68,bench
42554,17,bench,18,0,24411,16,252,550,312,612,60,62,bench
42555,18,table,19,0,24411,20,811,523,1023,602,212,79,dining table
42556,19,bench,20,0,24411,20,739,552,816,639,77,87,bench
42557,20,bench,21,0,24411,18,819,589,1008,688,189,99,bench
42558,21,snowboard,22,0,24411,18,394,404,464,549,70,145,snowboard
42559,24,snowboard,25,0,24411,17,272,410,357,554,85,144,snowboard
42560,29,person,30,1,24411,31,859,394,971,532,112,138,person
42561,30,person,31,1,24411,35,875,370,975,531,100,161,person
42562,31,person,32,0,24411,27,836,375,874,525,38,150,person
42563,32,person,33,1,24411,15,993,383,1023,628,30,245,person
42564,7,traffic light,8,0,954,22,284,1561,414,1829,130,268,traffic light
42565,3,car,4,0,16357,23,146,217,192,234,46,17,car
42566,4,car,5,0,16357,15,2,222,25,239,23,17,car
42567,5,car,6,0,16357,20,28,218,62,239,34,21,car
42568,4,person,5,1,16367,17,196,238,218,255,22,17,person
42569,5,person,6,1,16367,17,154,237,163,256,9,19,person
42570,13,car,14,0,16367,15,47,239,73,256,26,17,car
42571,6,car,7,0,16396,17,163,221,198,236,35,15,car
42572,7,car,8,0,16396,21,208,222,256,239,48,17,car
42573,9,person,10,0,16396,19,130,224,141,255,11,31,person
42574,10,person,11,0,16396,19,81,227,104,255,23,28,person
42575,17,person,18,0,16400,15,38,224,50,255,12,31,person
42576,18,person,19,1,16400,16,20,225,36,256,16,31,person
42577,4,car,5,0,16406,22,82,354,193,397,111,43,car
42578,10,person,11,0,16406,16,39,349,51,384,12,35,person
42579,11,person,12,0,16406,15,49,347,60,382,11,35,person
42580,12,truck,12,1,16413,23,33,223,74,252,41,29,truck
42581,15,truck,15,1,16413,28,88,217,125,251,37,34,truck
42582,16,person,16,0,16413,15,2,237,13,256,11,19,person
42583,17,car,17,1,16413,17,45,237,68,256,23,19,car
42584,20,car,18,0,16413,23,131,232,171,256,40,24,car
42585,23,person,21,0,16413,21,21,236,30,252,9,16,person
42586,24,motorbike,22,0,16413,20,21,239,30,254,9,15,motorcycle
42587,9,car,10,0,16414,19,22,242,50,253,28,11,car
42588,10,car,11,0,16414,20,119,240,156,256,37,16,car
42589,11,car,12,0,16414,21,211,237,240,250,29,13,car
42590,18,car,19,1,16415,18,210,209,256,252,46,43,car
42591,18,bus,19,1,16431,16,52,241,81,254,29,13,bus
42592,7,boat,8,0,16442,15,86,210,212,245,126,35,boat
42593,2,car,3,1,16446,17,172,242,240,256,68,14,car
42594,9,car,10,0,16475,17,166,215,191,227,25,12,car
42595,10,car,11,0,16475,18,102,217,123,230,21,13,car
42596,11,car,12,0,16475,15,71,212,93,228,22,16,car
42597,3,airplane,4,0,16477,33,148,84,303,151,155,67,airplane
42598,3,person,4,0,16494,22,205,224,216,248,11,24,person
42599,10,car,11,0,16496,19,331,728,436,804,105,76,car
42600,15,bus,16,1,16525,17,143,220,173,240,30,20,bus
42601,21,car,22,1,16525,16,45,229,65,243,20,14,car
42602,24,car,25,0,16525,25,78,226,118,249,40,23,car
42603,28,car,29,0,16525,16,151,226,171,241,20,15,car
42604,10,person,11,0,16545,58,59,135,125,299,66,164,person
42605,11,person,12,1,16545,36,48,162,79,284,31,122,person
42606,11,car,12,0,16579,16,183,234,211,256,28,22,car
42607,20,truck,21,1,16587,17,25,226,78,256,53,30,truck
42608,27,person,28,1,16592,16,86,233,99,255,13,22,person
42609,3,truck,4,1,16597,21,198,202,256,250,58,48,truck
42610,4,truck,5,1,16597,17,78,205,120,226,42,21,truck
42611,5,car,6,0,16597,18,98,220,125,234,27,14,car
42612,8,car,9,0,16597,24,139,223,189,248,50,25,car
42613,21,boat,22,0,16609,16,128,208,227,224,99,16,boat
42614,2,car,3,0,16628,17,0,297,91,335,91,38,car
42615,4,car,5,0,16628,35,2,280,370,459,368,179,car
42616,5,person,6,0,16628,42,137,239,207,451,70,212,person
42617,1,person,2,0,16630,24,157,73,175,125,18,52,person
42618,2,person,3,0,16630,26,170,89,197,141,27,52,person
42619,3,person,4,0,16649,24,72,194,91,269,19,75,person
42620,7,person,8,1,16649,16,2,219,32,299,30,80,person
42621,8,person,9,1,16649,30,3,180,64,275,61,95,person
42622,9,person,10,0,16649,20,92,197,109,267,17,70,person
42623,10,person,11,0,16649,25,56,189,74,267,18,78,person
42624,3,truck,4,0,16661,18,546,1923,1176,2196,630,273,truck
42625,6,car,7,0,16674,20,585,1888,1577,2196,992,308,car
42626,8,car,9,1,24437,16,1,951,44,997,43,46,car
42627,9,car,10,1,24437,21,27,946,76,999,49,53,car
42628,10,car,11,1,24437,25,48,946,122,1004,74,58,car
42629,11,car,12,1,24437,24,95,951,159,1009,64,58,car
42630,12,car,13,0,24437,31,139,944,238,1015,99,71,car
42631,13,car,14,0,24437,20,286,960,410,1022,124,62,car
42632,14,car,15,0,24437,20,396,929,602,1024,206,95,car
42633,7,bicycle,8,0,24441,47,229,950,281,985,52,35,bicycle
42634,8,motorbike,9,0,24441,52,401,942,451,985,50,43,motorcycle
42635,10,car,11,0,24446,33,247,827,346,875,99,48,car
42636,11,car,12,0,24446,25,391,834,472,868,81,34,car
42637,12,car,13,0,24446,18,473,834,528,862,55,28,car
42638,13,car,14,0,24446,18,523,832,574,860,51,28,car
42639,14,car,15,1,24446,15,572,833,603,857,31,24,car
42640,15,car,16,1,24446,16,594,832,628,855,34,23,car
42641,17,car,18,0,24446,23,635,832,706,872,71,40,car
42642,18,traffic light,19,0,24446,41,329,490,559,913,230,423,traffic light
42643,9,person,10,0,16678,27,221,381,255,449,34,68,person
42644,5,person,6,1,16680,22,92,883,268,1213,176,330,person
42645,6,person,7,0,16680,30,240,961,373,1277,133,316,person
42646,7,person,8,0,16680,31,366,779,477,1090,111,311,person
42647,2,car,3,0,16681,19,137,374,226,408,89,34,car
42648,3,car,4,0,16681,18,312,371,395,404,83,33,car
42649,4,car,5,0,16681,18,601,371,676,404,75,33,car
42650,5,car,6,0,16681,21,704,370,795,401,91,31,car
42651,7,person,8,0,16683,32,148,151,174,228,26,77,person
42652,8,person,9,1,16683,25,191,115,223,168,32,53,person
42653,6,person,7,0,16684,22,614,204,650,248,36,44,person
42654,7,person,8,1,16684,59,56,269,208,577,152,308,person
42655,8,car,9,0,16685,19,199,243,250,276,51,33,car
42656,3,person,4,1,16686,21,223,96,265,169,42,73,person
42657,6,person,7,1,16686,16,308,102,327,150,19,48,person
42658,9,person,10,1,16686,21,444,108,488,196,44,88,person
42659,10,person,11,0,16686,61,407,157,537,378,130,221,person
42660,11,bicycle,12,0,16686,58,402,207,513,387,111,180,bicycle
42661,13,person,14,0,16686,59,278,143,363,303,85,160,person
42662,14,bicycle,15,0,16686,57,271,229,355,368,84,139,bicycle
42663,15,person,16,0,16686,86,151,146,276,387,125,241,person
42664,4,person,5,0,16688,49,122,186,192,417,70,231,person
42665,5,person,6,0,16688,36,411,208,469,417,58,209,person
42666,6,person,7,1,16688,27,280,234,338,361,58,127,person
42667,7,person,8,0,16688,21,237,277,290,382,53,105,person
42668,8,person,9,0,16688,31,301,302,415,425,114,123,person
42669,10,person,11,0,16688,18,367,131,403,183,36,52,person
42670,6,person,7,0,16691,15,175,200,184,224,9,24,person
42671,9,person,10,0,16691,18,129,210,143,236,14,26,person
42672,7,person,8,0,16692,21,100,78,110,102,10,24,person
42673,8,person,9,0,16692,18,83,80,94,105,11,25,person
42674,1,person,2,1,24454,51,200,285,584,720,384,435,person
42675,2,person,3,1,24454,33,342,383,559,692,217,309,person
42676,4,person,5,1,24454,43,547,2,767,667,220,665,person
42677,5,person,6,1,24454,30,404,2,539,408,135,406,person
42678,6,person,7,1,24454,26,497,33,589,420,92,387,person
42679,2,person,3,0,24455,114,815,430,974,739,159,309,person
42680,3,person,4,0,24455,54,282,258,382,562,100,304,person
42681,4,bench,5,0,24455,24,16,429,259,554,243,125,bench
42682,4,person,5,0,24456,45,13,142,63,251,50,109,person
42683,5,person,6,0,24456,58,68,150,103,251,35,101,person
42684,6,person,7,1,24456,57,415,157,448,296,33,139,person
42685,7,person,8,0,24456,121,171,181,292,468,121,287,person
42686,8,person,9,0,24456,127,417,190,548,480,131,290,person
42687,9,person,10,0,24456,87,586,209,664,360,78,151,person
42688,10,person,11,1,24456,60,680,215,720,369,40,154,person
42689,11,person,12,0,24456,126,698,160,820,472,122,312,person
42690,12,person,13,1,24456,83,774,176,838,384,64,208,person
42691,13,person,14,1,24456,58,447,178,535,362,88,184,person
42692,14,person,15,0,24456,90,304,210,432,371,128,161,person
42693,15,person,16,0,24456,103,157,177,234,401,77,224,person
42694,16,person,17,1,24456,92,167,191,233,430,66,239,person
42695,17,person,18,1,24456,35,256,201,307,245,51,44,person
42696,18,person,19,1,24456,86,102,211,186,424,84,213,person
42697,19,person,20,0,24456,105,41,207,165,456,124,249,person
42698,20,person,21,0,24456,104,816,237,900,455,84,218,person
42699,21,person,22,0,24456,68,881,222,943,438,62,216,person
42700,22,person,23,1,24456,65,892,215,946,400,54,185,person
42701,23,person,24,0,24456,78,940,187,1003,417,63,230,person
42702,2,bicycle,3,0,24457,30,538,347,677,435,139,88,bicycle
42703,3,person,4,0,24457,28,972,314,1018,445,46,131,person
42704,13,person,14,0,24459,116,537,307,1117,1160,580,853,person
42705,14,person,15,1,24459,80,1021,596,1327,1109,306,513,person
42706,15,person,16,0,24459,96,1110,727,1574,1199,464,472,person
42707,2,person,3,1,24460,36,521,214,662,530,141,316,person
42708,3,person,4,1,24460,77,160,97,395,530,235,433,person
42709,5,person,6,1,24460,22,484,255,509,309,25,54,person
42710,7,person,8,0,16850,16,1244,392,1262,438,18,46,person
42711,6,person,7,0,274,49,293,192,349,344,56,152,person
42712,7,backpack,8,0,274,18,319,214,349,260,30,46,backpack
42713,8,car,9,1,274,46,322,177,438,283,116,106,car
42714,14,car,15,0,274,26,499,179,592,267,93,88,car
42715,19,car,20,0,274,45,557,186,687,296,130,110,car
42716,28,car,29,1,274,47,645,223,829,381,184,158,car
42717,34,car,35,0,274,54,707,252,973,456,266,204,car
42718,45,car,46,1,274,19,168,179,292,234,124,55,car
42719,46,car,47,1,274,56,80,181,307,401,227,220,car
42720,47,window,48,0,274,15,97,201,272,266,175,65,window
42721,53,car,54,1,274,61,2,265,258,470,256,205,car
42722,57,window,58,0,274,18,36,279,216,326,180,47,window
42723,61,car,62,0,274,39,365,196,522,315,157,119,car
42724,62,window,63,0,274,16,394,204,502,233,108,29,window
42725,73,person,74,1,274,20,45,188,69,256,24,68,person
42726,74,person,75,0,274,19,12,222,43,265,31,43,person
42727,75,car,76,1,274,24,0,389,148,532,148,143,car
42728,80,traffic light,81,0,274,18,790,2,816,222,26,220,traffic light
42729,81,person,82,1,274,16,696,192,730,224,34,32,person
42730,83,person,84,1,274,16,799,186,822,232,23,46,person
42731,84,person,85,1,274,20,864,192,892,251,28,59,person
42732,85,person,86,1,274,20,891,197,918,254,27,57,person
42733,86,person,87,1,274,33,977,173,1011,287,34,114,person
42734,10,car,11,1,275,37,2,374,811,1151,809,777,car
42735,22,window,23,0,275,19,355,433,770,652,415,219,window
42736,24,car,25,1,275,49,675,474,1239,1026,564,552,car
42737,26,door,27,0,275,17,690,490,924,817,234,327,door
42738,36,car,37,1,275,35,1160,631,1462,940,302,309,car
42739,42,car,43,1,275,50,843,462,1868,883,1025,421,car
42740,49,door,50,0,275,15,1119,486,1396,673,277,187,door
42741,50,window,51,0,275,15,1136,499,1329,623,193,124,window
42742,53,car,54,1,275,21,1345,478,1864,724,519,246,car
42743,59,car,60,1,275,22,1767,485,1919,790,152,305,car
42744,68,person,69,1,275,15,864,405,913,461,49,56,person
42745,28,car,28,1,276,24,2035,450,2065,472,30,22,car
42746,31,car,31,1,276,17,2022,454,2040,485,18,31,car
42747,32,car,32,1,276,23,1994,453,2031,487,37,34,car
42748,33,car,33,1,276,17,2005,463,2023,502,18,39,car
42749,34,car,34,1,276,25,1973,456,2011,521,38,65,car
42750,37,car,37,0,276,17,2063,453,2077,469,14,16,car
42751,38,car,38,1,276,22,2119,446,2169,492,50,46,car
42752,39,car,39,1,276,16,2124,463,2145,496,21,33,car
42753,40,car,40,1,276,17,2130,466,2157,502,27,36,car
42754,41,car,41,1,276,15,2139,466,2163,508,24,42,car
42755,42,car,42,1,276,27,2143,463,2200,518,57,55,car
42756,43,car,43,1,276,22,2154,474,2199,525,45,51,car
42757,44,car,44,1,276,18,2161,477,2199,532,38,55,car
42758,45,car,45,0,276,31,2046,471,2114,515,68,44,car
42759,46,car,46,1,276,46,1855,446,1984,574,129,128,car
42760,47,car,47,1,276,43,1804,468,1933,603,129,135,car
42761,48,car,48,1,276,49,1749,485,1909,641,160,156,car
42762,52,car,52,1,276,40,1748,502,1835,697,87,195,car
42763,55,car,55,1,276,70,1399,445,1781,814,382,369,car
42764,70,car,70,0,276,59,404,488,1517,1199,1113,711,car
42765,73,door,73,0,276,19,1219,523,1411,989,192,466,door
42766,74,mirror,74,0,276,19,1250,660,1335,738,85,78,mirror
42767,76,door,76,0,276,18,1339,521,1481,900,142,379,door
42768,79,window,79,0,276,16,1251,534,1370,690,119,156,window
42769,4,car,5,1,277,22,275,147,324,178,49,31,car
42770,5,car,6,1,277,43,229,147,306,215,77,68,car
42771,6,truck,7,0,277,59,112,106,250,219,138,113,truck
42772,7,car,8,0,277,31,113,161,154,231,41,70,car
42773,13,car,14,0,277,39,45,156,134,250,89,94,car
42774,14,car,15,1,277,40,79,172,125,255,46,83,car
42775,15,car,16,1,277,39,64,162,110,283,46,121,car
42776,16,car,17,1,277,47,10,161,102,304,92,143,car
42777,17,car,18,1,277,34,26,178,89,314,63,136,car
42778,18,car,19,1,277,52,10,171,77,371,67,200,car
42779,19,car,20,1,277,39,0,154,77,371,77,217,car
42780,29,car,30,1,277,27,416,147,460,214,44,67,car
42781,30,car,31,1,277,35,437,146,507,216,70,70,car
42782,31,car,32,1,277,23,448,160,476,225,28,65,car
42783,32,car,33,1,277,32,463,149,528,229,65,80,car
42784,33,car,34,1,277,34,471,162,522,231,51,69,car
42785,34,car,35,1,277,38,507,144,599,241,92,97,car
42786,35,car,36,1,277,31,523,162,591,246,68,84,car
42787,36,car,37,1,277,23,573,146,620,252,47,106,car
42788,37,car,38,0,277,58,310,132,431,236,121,104,car
42789,40,window,41,0,277,16,330,143,417,170,87,27,window
42790,4,person,4,1,278,24,1484,178,1551,309,67,131,person
42791,14,car,14,1,278,34,1984,230,2192,421,208,191,car
42792,20,door,20,0,278,15,2083,242,2152,380,69,138,door
42793,26,car,26,1,278,35,1835,233,2033,430,198,197,car
42794,37,car,37,1,278,38,1481,210,1867,445,386,235,car
42795,51,door,51,0,278,16,1758,221,1833,387,75,166,door
42796,55,car,55,1,278,55,932,195,1511,473,579,278,car
42797,56,door,56,0,278,15,1254,208,1420,413,166,205,door
42798,59,door,59,0,278,16,1157,207,1301,413,144,206,door
42799,70,car,70,0,278,56,20,185,1001,517,981,332,car
42800,78,door,78,0,278,17,533,202,740,454,207,252,door
42801,79,window,79,0,278,16,552,207,711,284,159,77,window
42802,82,door,82,0,278,20,720,202,892,444,172,242,door
42803,16,door,17,0,279,15,1026,394,1068,523,42,129,door
42804,17,truck,18,1,279,19,627,385,694,455,67,70,truck
42805,27,car,28,0,279,23,549,419,629,486,80,67,car
42806,37,car,38,1,279,19,490,421,524,459,34,38,car
42807,39,car,40,1,279,18,431,448,450,539,19,91,car
42808,40,car,41,1,279,69,259,385,443,567,184,182,car
42809,41,car,42,1,279,43,14,424,180,558,166,134,car
42810,45,car,46,1,279,76,110,402,364,623,254,221,car
42811,54,person,55,0,279,29,630,422,651,471,21,49,person
42812,56,person,57,0,279,33,477,417,505,494,28,77,person
42813,57,person,58,0,279,101,291,396,439,677,148,281,person
42814,69,person,70,0,279,74,766,405,893,687,127,282,person
42815,76,person,77,1,279,50,816,373,874,617,58,244,person
42816,77,person,78,1,279,37,778,351,816,503,38,152,person
42817,78,person,79,0,279,74,676,376,804,672,128,296,person
42818,79,person,80,0,279,71,986,409,1075,681,89,272,person
42819,88,person,89,0,279,55,1067,358,1152,669,85,311,person
42820,98,traffic light,99,0,279,18,664,340,687,386,23,46,traffic light
42821,99,traffic light,100,0,279,17,443,329,471,408,28,79,traffic light
42822,3,person,4,1,280,17,1971,921,2200,1650,229,729,person
42823,4,person,5,1,280,95,1375,53,2147,1646,772,1593,person
42824,16,person,17,1,280,74,785,462,1525,1650,740,1188,person
42825,29,person,30,1,280,88,107,247,927,1650,820,1403,person
42826,41,bench,42,0,280,21,29,1350,961,1650,932,300,bench
42827,4,car,5,0,281,43,81,98,497,340,416,242,car
42828,15,person,16,0,281,38,38,86,110,276,72,190,person
42829,24,car,25,1,281,25,0,112,59,283,59,171,car
42830,29,person,30,0,281,30,476,139,495,181,19,42,person
42831,11,car,12,1,282,39,752,301,916,408,164,107,car
42832,19,door,20,0,282,16,824,308,876,381,52,73,door
42833,25,car,26,1,282,22,584,308,689,369,105,61,car
42834,35,person,36,0,282,31,701,300,715,349,14,49,person
42835,36,person,37,1,282,27,692,303,705,349,13,46,person
42836,40,bus,41,1,282,68,328,243,590,371,262,128,bus
42837,47,person,48,1,282,42,422,300,442,382,20,82,person
42838,48,person,49,0,282,34,437,309,454,383,17,74,person
42839,49,car,50,1,282,26,256,298,297,333,41,35,car
42840,50,car,51,0,282,21,206,302,237,323,31,21,car
42841,52,person,53,0,282,31,240,299,261,342,21,43,person
42842,53,bicycle,54,0,282,23,244,320,259,351,15,31,bicycle
42843,54,person,55,0,282,50,318,302,358,367,40,65,person
42844,55,bicycle,56,0,282,44,314,339,360,391,46,52,bicycle
42845,63,person,64,0,282,38,33,299,64,397,31,98,person
42846,65,person,66,0,282,43,64,291,103,399,39,108,person
42847,66,person,67,0,282,43,111,301,139,398,28,97,person
42848,67,person,68,0,282,49,143,284,212,477,69,193,person
42849,73,person,74,1,282,17,788,302,805,329,17,27,person
42850,7,person,8,0,283,127,211,60,293,318,82,258,person
42851,10,person,11,0,284,36,272,364,289,409,17,45,person
42852,11,person,12,0,284,26,304,363,317,398,13,35,person
42853,13,person,14,0,284,37,340,364,360,425,20,61,person
42854,15,person,16,0,284,16,379,365,387,388,8,23,person
42855,16,person,17,0,284,20,369,362,379,387,10,25,person
42856,18,person,19,0,284,31,355,375,376,427,21,52,person
42857,19,person,20,0,284,39,390,368,413,430,23,62,person
42858,20,person,21,0,284,38,545,366,570,440,25,74,person
42859,21,flowerpot,22,0,284,18,582,438,670,515,88,77,potted plant
42860,30,person,31,1,284,33,472,377,498,510,26,133,person
42861,32,person,33,1,284,42,452,362,482,522,30,160,person
42862,33,person,34,0,284,65,412,354,470,527,58,173,person
42863,11,person,12,1,285,43,104,1,165,123,61,122,person
42864,12,person,13,1,285,49,179,0,229,111,50,111,person
42865,13,person,14,1,285,50,244,0,290,123,46,123,person
42866,14,person,15,1,285,50,296,17,362,76,66,59,person
42867,15,person,16,1,285,30,408,52,440,119,32,67,person
42868,16,person,17,1,285,34,426,38,469,139,43,101,person
42869,17,person,18,0,285,84,449,86,533,276,84,190,person
42870,18,backpack,19,0,285,22,486,264,538,325,52,61,backpack
42871,19,person,20,0,285,92,363,77,457,342,94,265,person
42872,32,person,33,0,285,84,276,71,362,359,86,288,person
42873,44,person,45,0,285,124,170,61,253,349,83,288,person
42874,57,person,58,0,285,126,45,48,142,367,97,319,person
42875,70,person,71,1,285,53,0,22,45,306,45,284,person
42876,1,boat,2,1,286,15,2,148,74,180,72,32,boat
42877,2,boat,3,1,286,31,1,148,213,204,212,56,boat
42878,3,boat,4,0,286,36,108,170,365,215,257,45,boat
42879,4,person,5,1,286,20,185,157,209,191,24,34,person
42880,5,person,6,0,286,23,281,151,314,180,33,29,person
42881,6,person,7,0,286,28,153,139,173,186,20,47,person
42882,7,person,8,0,286,23,129,138,149,167,20,29,person
42883,1,person,2,1,287,69,395,2,619,332,224,330,person
42884,7,person,8,1,287,74,240,0,425,299,185,299,person
42885,12,person,13,1,287,62,107,1,243,246,136,245,person
42886,20,person,21,1,287,43,8,0,138,233,130,233,person
42887,20,person,21,0,288,28,185,460,209,531,24,71,person
42888,26,person,27,0,288,33,208,454,233,530,25,76,person
42889,32,person,33,0,288,44,414,453,438,522,24,69,person
42890,39,person,40,0,288,32,477,457,495,517,18,60,person
42891,42,person,43,0,288,30,497,451,522,518,25,67,person
42892,3,car,4,0,16858,47,308,1034,1028,1351,720,317,car
42893,4,car,5,0,16858,54,1082,1078,2199,1634,1117,556,car
42894,43,door,44,0,16858,19,385,1046,552,1267,167,221,door
42895,44,door,45,0,16858,22,480,1047,618,1276,138,229,door
42896,53,door,54,0,16858,18,1179,1098,1440,1437,261,339,door
42897,92,car,92,0,16859,39,1529,1118,1686,1226,157,108,car
42898,3,person,4,1,16860,27,5,831,82,1172,77,341,person
42899,5,person,6,1,16860,33,159,843,254,1143,95,300,person
42900,6,person,7,0,16860,21,251,947,288,1136,37,189,person
42901,7,person,8,0,16860,37,302,865,401,1165,99,300,person
42902,9,person,10,1,16860,30,689,836,766,1124,77,288,person
42903,12,person,13,0,16860,37,780,855,921,1131,141,276,person
42904,13,person,14,0,16860,44,904,911,1005,1169,101,258,person
42905,14,person,15,0,16860,34,1068,923,1133,1128,65,205,person
42906,15,person,16,0,16860,38,1165,814,1254,1121,89,307,person
42907,16,person,17,0,16860,39,1235,829,1331,1124,96,295,person
42908,17,person,18,0,16860,42,1377,855,1491,1182,114,327,person
42909,18,person,19,1,16860,15,1469,855,1522,1003,53,148,person
42910,19,person,20,0,16860,42,1491,851,1597,1196,106,345,person
42911,20,person,21,0,16860,42,1590,834,1684,1179,94,345,person
42912,21,person,22,0,16860,45,1687,865,1795,1177,108,312,person
42913,23,person,24,0,16860,45,1889,851,2018,1167,129,316,person
42914,24,person,25,1,16860,20,2013,863,2049,1157,36,294,person
42915,9,car,10,0,16861,17,350,943,611,1123,261,180,car
42916,10,car,11,0,16861,22,1565,977,1760,1110,195,133,car
42917,11,car,12,0,16861,19,1745,978,1951,1108,206,130,car
42918,19,car,20,1,16861,19,612,958,767,1103,155,145,car
42919,58,motorbike,59,0,16861,23,1263,998,1299,1077,36,79,motorcycle
42920,59,motorbike,60,0,16861,22,1309,992,1346,1077,37,85,motorcycle
42921,0,person,1,0,16862,17,675,524,759,694,84,170,person
42922,15,person,16,0,16862,19,0,575,82,745,82,170,person
42923,16,person,17,0,16862,23,90,557,150,734,60,177,person
42924,17,person,18,0,16862,19,176,561,229,733,53,172,person
42925,19,person,20,0,16862,17,251,613,326,707,75,94,person
42926,20,person,21,0,16862,19,317,536,355,672,38,136,person
42927,22,person,23,1,16862,15,396,595,466,706,70,111,person
42928,23,person,24,0,16862,24,464,537,523,702,59,165,person
42929,24,person,25,0,16862,21,500,530,575,707,75,177,person
42930,25,person,26,0,16862,15,561,596,621,690,60,94,person
42931,26,person,27,0,16862,22,793,503,854,686,61,183,person
42932,27,person,28,1,16862,19,836,496,888,652,52,156,person
42933,28,person,29,0,16862,20,883,518,940,681,57,163,person
42934,29,person,30,0,16862,24,965,501,1032,677,67,176,person
42935,30,person,31,1,16862,17,1026,496,1075,620,49,124,person
42936,32,person,33,0,16862,23,1112,500,1175,664,63,164,person
42937,33,person,34,1,16862,19,570,514,629,595,59,81,person
42938,34,person,35,1,16862,21,622,553,675,646,53,93,person
42939,40,person,41,0,16862,32,936,504,993,645,57,141,person
42940,41,person,42,1,16862,40,396,554,439,610,43,56,person
42941,42,person,43,1,16862,28,227,609,264,672,37,63,person
42942,43,person,44,1,16862,37,752,575,781,660,29,85,person
42943,46,person,47,1,16862,31,136,617,176,720,40,103,person
42944,47,person,48,1,16862,27,33,565,94,734,61,169,person
42945,13,person,14,1,16864,38,85,637,258,1097,173,460,person
42946,14,person,15,0,16864,34,2,503,138,1169,136,666,person
42947,0,person,1,0,16865,22,1065,531,1134,686,69,155,person
42948,17,car,17,1,16865,17,1602,581,2023,740,421,159,car
42949,28,person,27,0,16865,35,1187,538,1285,780,98,242,person
42950,39,person,38,1,16865,15,1584,542,1621,598,37,56,person
42951,40,traffic light,39,0,16865,25,1339,414,1434,688,95,274,traffic light
42952,41,person,40,0,16865,27,1001,550,1049,684,48,134,person
42953,44,traffic light,43,0,16865,22,1587,311,1928,392,341,81,traffic light
42954,50,person,49,0,16865,45,1178,542,1203,614,25,72,person
42955,51,person,50,1,16865,28,805,529,836,588,31,59,person
42956,14,traffic light,15,0,16868,15,1518,691,2020,1168,502,477,traffic light
42957,20,car,21,0,16868,17,1511,1045,1918,1371,407,326,car
42958,4,car,5,0,16869,23,1454,885,1650,971,196,86,car
42959,7,person,8,0,16869,27,561,858,616,996,55,138,person
42960,8,person,9,0,16869,24,807,868,843,981,36,113,person
42961,16,car,17,1,16869,15,835,872,937,941,102,69,car
42962,17,person,18,0,16869,28,739,875,778,982,39,107,person
42963,18,person,19,0,16869,26,775,875,805,984,30,109,person
42964,19,person,20,0,16869,34,416,871,467,1005,51,134,person
42965,22,car,23,1,16869,15,1358,901,1498,951,140,50,car
42966,24,car,25,0,16869,21,1772,896,1940,960,168,64,car
42967,33,motorbike,34,0,16869,56,1024,912,1177,1012,153,100,motorcycle
42968,37,person,38,0,16869,26,1233,869,1260,951,27,82,person
42969,38,person,39,0,16869,19,1267,875,1280,951,13,76,person
42970,48,traffic light,49,0,16869,36,934,755,1009,988,75,233,traffic light
42971,51,traffic light,52,0,16869,20,1187,805,1230,951,43,146,traffic light
42972,53,person,54,0,16869,33,1416,885,1441,962,25,77,person
42973,66,person,67,0,16869,25,1313,883,1330,958,17,75,person
42974,68,traffic light,69,0,16869,27,1304,703,1367,963,63,260,traffic light
42975,69,motorbike,70,0,16869,61,141,880,257,970,116,90,motorcycle
42976,0,car,1,0,16870,17,425,935,1146,1271,721,336,car
42977,2,car,3,1,16870,23,4,951,284,1208,280,257,car
42978,6,person,7,0,16870,32,1109,982,1197,1265,88,283,person
42979,4,car,5,1,16871,23,2,875,536,1229,534,354,car
42980,9,person,10,0,16871,16,946,798,1100,922,154,124,person
42981,0,car,1,0,16872,39,156,1011,596,1286,440,275,car
42982,1,car,2,0,16872,25,1329,1026,1550,1249,221,223,car
42983,3,person,4,0,16872,25,983,993,1145,1342,162,349,person
42984,21,car,20,1,16872,21,541,1019,705,1254,164,235,car
42985,27,car,26,1,16872,15,1231,1021,1376,1149,145,128,car
42986,28,car,27,1,16872,15,1271,1031,1359,1189,88,158,car
42987,36,dog,35,0,16872,28,956,1184,1174,1341,218,157,dog
42988,55,car,54,1,16872,24,2,1036,194,1245,192,209,car
42989,68,traffic light,67,0,16872,21,1025,785,1308,1004,283,219,traffic light
42990,0,car,1,0,16873,18,705,966,1118,1111,413,145,car
42991,1,car,2,0,16873,27,1128,967,1463,1097,335,130,car
42992,11,car,10,0,16873,27,1644,968,1884,1069,240,101,car
42993,12,car,11,0,16873,28,1878,972,2046,1062,168,90,car
42994,13,car,12,1,16873,25,2,939,181,1128,179,189,car
42995,29,door,28,0,16873,18,1812,977,1864,1052,52,75,door
42996,0,car,1,0,16874,18,1116,922,1606,1079,490,157,car
42997,1,car,2,0,16874,42,0,794,908,1302,908,508,car
42998,5,car,6,1,16874,17,547,883,1086,1149,539,266,car
42999,41,window,41,0,16874,15,330,922,445,1023,115,101,window
43000,51,person,51,0,16874,20,1625,882,1658,1023,33,141,person
43001,52,person,52,0,16874,28,1583,896,1667,1050,84,154,person
43002,53,person,53,0,16874,33,1831,895,1916,1043,85,148,person
43003,56,person,56,0,16874,46,1909,895,1987,1094,78,199,person
43004,57,person,57,0,16874,21,912,868,948,972,36,104,person
43005,0,car,1,0,16875,24,947,848,1546,1076,599,228,car
43006,1,car,2,0,16875,21,169,828,915,1136,746,308,car
43007,2,car,3,0,16875,18,1557,837,1985,1014,428,177,car
43008,23,door,24,0,16875,16,512,842,756,1064,244,222,door
43009,41,door,42,0,16875,15,1185,852,1325,1034,140,182,door
43010,60,door,61,0,16875,15,1793,843,1918,975,125,132,door
43011,8,car,9,0,16876,19,667,640,822,720,155,80,car
43012,0,car,1,0,16878,18,603,1041,986,1287,383,246,car
43013,10,person,11,0,16878,29,1671,985,1745,1213,74,228,person
43014,11,person,12,0,16878,29,1552,998,1621,1230,69,232,person
43015,19,person,19,0,16878,17,979,979,1017,1121,38,142,person
43016,44,person,44,0,16878,28,1473,996,1545,1177,72,181,person
43017,45,person,45,0,16878,16,1060,1005,1102,1125,42,120,person
43018,46,person,46,0,16878,18,1020,985,1062,1115,42,130,person
43019,59,person,59,0,16878,20,594,992,633,1075,39,83,person
43020,64,person,64,0,16878,38,1100,1002,1212,1191,112,189,person
43021,65,bicycle,65,1,16878,46,1099,1098,1201,1260,102,162,bicycle
43022,71,door,71,0,16878,19,625,1055,702,1213,77,158,door
43023,74,door,74,0,16878,17,669,1055,745,1220,76,165,door
43024,77,person,77,0,16878,23,467,984,489,1057,22,73,person
43025,78,person,78,1,16878,25,415,996,447,1065,32,69,person
43026,79,bicycle,79,0,16878,25,420,1028,449,1082,29,54,bicycle
43027,81,person,81,0,16878,24,390,983,417,1051,27,68,person
43028,35,person,36,0,16879,17,1997,1273,2035,1337,38,64,person
43029,0,parking meter,1,0,16881,30,321,229,401,505,80,276,parking meter
43030,1,car,2,0,16881,22,371,267,1354,586,983,319,car
43031,38,door,36,0,16881,15,918,287,1135,523,217,236,door
43032,26,door,27,0,16882,15,234,720,565,1165,331,445,door
43033,7,car,8,1,16883,15,2,1045,194,1479,192,434,car
43034,26,car,27,1,16883,21,755,1071,857,1172,102,101,car
43035,27,car,28,1,16883,20,742,1081,802,1196,60,115,car
43036,28,car,29,1,16883,23,691,1078,779,1204,88,126,car
43037,29,car,30,1,16883,24,640,1070,725,1226,85,156,car
43038,30,car,31,1,16883,21,579,1067,682,1238,103,171,car
43039,31,car,32,1,16883,15,557,1069,625,1251,68,182,car
43040,34,car,35,1,16883,19,1140,1064,1222,1136,82,72,car
43041,68,door,68,0,16883,15,373,974,497,1201,124,227,door
43042,82,car,82,1,16883,20,10,1035,333,1401,323,366,car
43043,20,car,21,1,16884,15,1537,975,1583,1018,46,43,car
43044,21,car,22,1,16884,15,1490,976,1551,1024,61,48,car
43045,24,car,25,1,16884,19,1395,978,1481,1052,86,74,car
43046,25,car,26,1,16884,24,1307,983,1427,1068,120,85,car
43047,26,car,27,1,16884,21,1272,1002,1381,1089,109,87,car
43048,63,car,64,0,16884,24,1140,1003,1320,1111,180,108,car
43049,68,car,69,0,16884,42,777,964,1115,1162,338,198,car
43050,106,door,107,0,16884,19,1009,976,1082,1114,73,138,door
43051,3,car,4,0,16885,17,890,1020,1511,1294,621,274,car
43052,6,motorbike,7,0,16885,19,379,1076,493,1263,114,187,motorcycle
43053,7,motorbike,8,0,16885,18,260,1074,371,1250,111,176,motorcycle
43054,8,motorbike,9,0,16885,17,95,1076,247,1247,152,171,motorcycle
43055,34,traffic light,35,0,16886,55,178,776,1223,1386,1045,610,traffic light
43056,42,person,43,0,16886,25,1354,1226,1385,1308,31,82,person
43057,44,traffic light,45,0,16886,48,847,1120,960,1280,113,160,traffic light
43058,0,car,1,0,16887,56,77,749,581,898,504,149,car
43059,1,car,2,0,16887,32,1112,755,1448,897,336,142,car
43060,16,traffic light,16,0,16887,22,1636,540,2021,792,385,252,traffic light
43061,28,door,28,0,16887,15,290,755,437,870,147,115,door
43062,53,person,52,0,16887,28,1712,797,1752,881,40,84,person
43063,54,person,53,0,16887,21,1976,794,2002,859,26,65,person
43064,16,car,17,0,16888,17,635,663,674,692,39,29,car
43065,3,car,4,0,16889,27,1184,843,2198,1164,1014,321,car
43066,4,car,5,0,16889,37,47,789,999,1116,952,327,car
43067,11,door,12,0,16889,26,529,793,787,1041,258,248,door
43068,44,door,44,0,16889,16,1790,852,2035,1099,245,247,door
43069,0,person,1,0,16890,34,400,989,460,1164,60,175,person
43070,1,car,2,0,16890,40,239,1014,764,1166,525,152,car
43071,2,car,3,0,16890,35,799,1005,1379,1172,580,167,car
43072,3,flowerpot,4,0,16890,17,1583,1036,1658,1097,75,61,potted plant
43073,50,door,50,0,16890,16,455,1018,556,1138,101,120,door
43074,63,door,63,0,16890,15,951,1014,1093,1149,142,135,door
43075,66,door,66,0,16890,18,1072,1012,1180,1147,108,135,door
43076,72,person,72,1,16890,33,894,963,935,1070,41,107,person
43077,4,person,5,0,16891,26,581,1000,641,1151,60,151,person
43078,11,flowerpot,12,0,16891,22,208,497,301,677,93,180,potted plant
43079,13,flowerpot,14,0,16891,20,232,61,312,214,80,153,potted plant
43080,10,person,10,0,16892,48,671,1350,768,1608,97,258,person
43081,11,person,11,0,16892,39,550,1356,648,1609,98,253,person
43082,18,car,18,1,16892,23,1340,1379,1449,1461,109,82,car
43083,19,car,19,0,16892,26,1189,1385,1288,1440,99,55,car
43084,37,traffic light,37,0,16892,26,1198,1234,1447,1385,249,151,traffic light
43085,2,car,3,0,16893,29,528,736,1678,1240,1150,504,car
43086,6,car,7,1,16893,16,2,658,191,839,189,181,car
43087,7,car,8,0,16893,28,299,692,710,845,411,153,car
43088,16,car,17,1,16893,21,1551,711,1822,907,271,196,car
43089,17,car,18,1,16893,20,1698,815,2049,1098,351,283,car
43090,3,car,3,0,16895,15,678,1173,951,1286,273,113,car
43091,26,car,24,1,16895,23,599,1160,875,1259,276,99,car
43092,28,car,26,0,16895,20,961,1161,1116,1248,155,87,car
43093,29,person,27,0,16895,35,1330,1166,1366,1277,36,111,person
43094,33,car,31,1,16895,20,854,1159,981,1233,127,74,car
43095,4,person,3,0,16896,18,311,330,522,908,211,578,person
43096,5,person,4,0,16896,21,558,346,750,918,192,572,person
43097,6,person,5,0,16896,16,986,283,1249,1106,263,823,person
43098,14,car,12,0,16897,24,444,67,690,253,246,186,car
43099,25,car,22,1,16897,35,402,63,542,188,140,125,car
43100,26,car,23,1,16897,25,378,59,478,165,100,106,car
43101,37,person,34,0,16897,27,699,31,719,100,20,69,person
43102,38,person,35,0,16897,26,719,25,739,100,20,75,person
43103,39,person,36,0,16897,25,741,23,762,98,21,75,person
43104,0,bench,1,0,16898,23,394,408,504,505,110,97,bench
43105,5,bench,6,0,16898,24,93,401,212,497,119,96,bench
43106,6,bench,7,0,16898,17,591,408,689,504,98,96,bench
43107,19,person,18,0,16898,23,670,327,710,421,40,94,person
43108,0,car,1,0,16899,40,585,196,1121,434,536,238,car
43109,3,car,4,1,16899,18,1087,179,1389,372,302,193,car
43110,21,door,22,0,16899,17,670,212,808,369,138,157,door
43111,24,door,25,0,16899,16,766,213,873,377,107,164,door
43112,2,car,2,0,16900,22,152,719,986,1186,834,467,car
43113,11,motorbike,9,0,16900,39,927,816,1147,1180,220,364,motorcycle
43114,12,motorbike,10,0,16900,93,357,837,776,1402,419,565,motorcycle
43115,22,car,19,1,16900,17,1109,738,1345,934,236,196,car
43116,25,bicycle,21,1,16900,23,1198,804,1326,1026,128,222,bicycle
43117,26,car,22,1,16900,24,899,745,1187,1000,288,255,car
43118,29,person,25,0,16900,27,1798,699,1855,859,57,160,person
43119,30,person,26,0,16900,25,1726,690,1774,855,48,165,person
43120,31,person,27,0,16900,32,1889,703,1954,859,65,156,person
43121,3,person,4,0,16901,21,1378,1331,1434,1509,56,178,person
43122,5,person,6,0,16901,37,663,1339,752,1512,89,173,person
43123,6,person,7,0,16901,36,175,1350,256,1507,81,157,person
43124,7,person,8,0,16901,35,238,1340,300,1496,62,156,person
43125,22,person,23,0,16901,32,1137,1340,1263,1507,126,167,person
43126,33,bus,34,0,16901,16,678,1287,822,1408,144,121,bus
43127,35,person,36,0,16901,59,935,1353,1015,1496,80,143,person
43128,36,person,37,1,16901,35,997,1365,1028,1488,31,123,person
43129,37,person,38,0,16901,74,526,1343,598,1498,72,155,person
43130,38,person,39,0,16901,37,588,1333,658,1513,70,180,person
43131,42,car,43,1,16901,25,1874,1364,2200,1512,326,148,car
43132,49,person,50,0,16901,25,1807,1321,1858,1454,51,133,person
43133,1,car,2,0,16902,31,294,254,563,364,269,110,car
43134,6,car,7,1,16902,16,94,274,151,303,57,29,car
43135,7,car,8,0,16902,26,143,267,227,312,84,45,car
43136,11,traffic light,12,0,16902,22,310,190,322,286,12,96,traffic light
43137,22,car,23,1,16902,15,579,269,635,303,56,34,car
43138,7,person,8,0,16903,22,73,1179,102,1299,29,120,person
43139,9,car,10,1,16903,26,138,1202,347,1327,209,125,car
43140,10,car,11,0,16903,32,278,1207,542,1349,264,142,car
43141,39,person,40,0,16903,32,1812,1243,1915,1422,103,179,person
43142,40,person,41,0,16903,20,1569,1243,1647,1408,78,165,person
43143,41,person,42,0,16903,29,1439,1185,1515,1412,76,227,person
43144,43,car,44,0,16903,43,903,1228,1305,1409,402,181,car
43145,50,car,51,0,16903,34,609,1220,928,1378,319,158,car
43146,75,window,76,0,16903,15,423,1215,517,1253,94,38,window
43147,76,door,77,0,16903,16,306,1214,379,1318,73,104,door
43148,79,door,80,0,16903,19,353,1212,418,1319,65,107,door
43149,0,car,1,0,16905,28,231,1015,557,1110,326,95,car
43150,1,car,2,0,16905,17,1364,1024,1949,1209,585,185,car
43151,13,car,14,0,16905,21,1270,1005,1470,1084,200,79,car
43152,15,bench,16,0,16905,19,949,1035,1070,1082,121,47,bench
43153,32,car,33,1,16905,15,2,1005,195,1117,193,112,car
43154,39,traffic light,40,0,16905,33,569,226,891,1273,322,1047,traffic light
43155,49,person,50,0,16905,15,779,988,800,1067,21,79,person
43156,0,car,1,0,16907,30,1227,453,1824,699,597,246,car
43157,2,person,3,0,16907,15,216,431,275,539,59,108,person
43158,32,bus,29,1,16907,27,3,123,91,681,88,558,bus
43159,34,person,31,0,16907,18,185,428,216,507,31,79,person
43160,35,person,32,0,16907,19,163,424,198,508,35,84,person
43161,36,person,33,0,16907,22,139,429,171,505,32,76,person
43162,37,person,34,0,16907,24,65,429,111,508,46,79,person
43163,38,person,35,0,16907,23,341,426,374,516,33,90,person
43164,39,traffic light,36,0,16907,43,558,9,655,544,97,535,traffic light
43165,43,person,40,1,16907,16,962,440,992,487,30,47,person
43166,44,person,41,1,16907,18,1035,438,1069,485,34,47,person
43167,64,person,61,0,16907,20,106,416,138,484,32,68,person
43168,0,person,1,0,16908,49,836,1085,975,1341,139,256,person
43169,0,car,1,0,16909,26,1243,740,1692,1069,449,329,car
43170,2,car,3,0,16909,15,1815,729,2051,873,236,144,car
43171,27,car,28,1,16909,17,1149,721,1344,925,195,204,car
43172,0,car,1,0,16910,19,739,707,1150,879,411,172,car
43173,2,car,3,0,16910,15,2,716,314,862,312,146,car
43174,4,car,5,0,16910,17,1687,676,1980,846,293,170,car
43175,7,person,8,0,16910,30,636,684,700,867,64,183,person
43176,29,person,29,0,16910,27,251,639,282,738,31,99,person
43177,30,car,30,1,16910,24,559,706,835,854,276,148,car
43178,34,person,34,0,16910,23,1014,661,1061,727,47,66,person
43179,4,person,5,0,16911,22,1187,1634,1263,1972,76,338,person
43180,5,person,6,0,16911,24,1263,1610,1359,1988,96,378,person
43181,6,person,7,1,16911,31,1323,1558,1534,2048,211,490,person
43182,13,person,14,0,16911,19,28,1646,88,1829,60,183,person
43183,14,person,15,0,16911,22,219,1618,323,1932,104,314,person
43184,15,person,16,0,16911,24,574,1606,701,2016,127,410,person
43185,16,person,17,0,16911,20,693,1610,837,2008,144,398,person
43186,25,person,26,0,16912,24,986,1165,1026,1299,40,134,person
43187,28,person,29,0,16912,19,1039,1152,1097,1307,58,155,person
43188,0,car,1,0,16914,36,626,311,1814,810,1188,499,car
43189,2,car,3,1,16914,17,1772,294,2200,728,428,434,car
43190,16,door,16,0,16914,22,1213,317,1567,678,354,361,door
43191,20,door,20,0,16914,17,936,317,1277,688,341,371,door
43192,3,person,4,0,16916,18,819,492,970,865,151,373,person
43193,9,bicycle,10,1,16916,30,68,646,174,813,106,167,bicycle
43194,2,car,3,0,16917,18,422,734,827,1061,405,327,car
43195,7,car,8,1,16917,15,1786,729,2198,1325,412,596,car
43196,23,motorbike,24,0,16917,17,1566,851,1855,1086,289,235,motorcycle
43197,60,door,61,0,16917,18,1818,748,2006,1168,188,420,door
43198,63,car,64,1,16917,17,352,817,463,991,111,174,car
43199,0,person,1,0,16918,35,1391,953,1446,1096,55,143,person
43200,1,car,2,0,16918,29,582,975,806,1085,224,110,car
43201,3,car,4,0,16918,18,1768,933,2088,1202,320,269,car
43202,80,person,80,0,16918,22,1501,966,1537,1059,36,93,person
43203,83,car,83,0,16918,18,1238,989,1334,1046,96,57,car
43204,85,car,85,0,16918,21,1076,981,1201,1056,125,75,car
43205,87,car,87,0,16918,26,849,992,976,1072,127,80,car
43206,103,car,103,1,16918,42,1674,931,2142,1071,468,140,car
43207,0,person,1,0,16919,25,126,858,293,1294,167,436,person
43208,16,car,17,0,16919,23,1327,949,1824,1156,497,207,car
43209,17,car,18,0,16919,30,639,897,852,1052,213,155,car
43210,31,car,32,1,16919,20,1826,921,2200,1218,374,297,car
43211,41,car,42,1,16919,19,569,893,672,964,103,71,car
43212,52,door,53,0,16919,16,1388,959,1507,1097,119,138,door
43213,54,door,55,0,16919,15,1460,955,1564,1108,104,153,door
43214,63,car,64,1,16919,15,309,878,367,996,58,118,car
43215,64,person,65,0,16919,30,283,893,324,1018,41,125,person
43216,65,car,66,0,16919,22,278,873,374,934,96,61,car
43217,1,car,2,0,16920,32,837,1013,2048,1534,1211,521,car
43218,33,door,32,0,16920,15,1632,1034,1932,1394,300,360,door
43219,2,bicycle,3,1,16921,71,1862,1111,2046,1339,184,228,bicycle
43220,13,person,14,0,16921,31,523,992,560,1109,37,117,person
43221,14,person,15,0,16921,24,469,1007,492,1106,23,99,person
43222,15,person,16,0,16921,25,489,1017,512,1111,23,94,person
43223,17,person,18,0,16921,22,275,1003,305,1080,30,77,person
43224,18,person,19,0,16921,20,243,1017,270,1078,27,61,person
43225,4,car,5,1,16922,16,17,863,206,1065,189,202,car
43226,28,door,29,0,16922,15,693,787,963,1062,270,275,door
43227,2,person,2,0,16923,18,973,957,1211,1646,238,689,person
43228,3,person,3,0,16923,16,131,1034,341,1608,210,574,person
43229,4,person,4,0,16923,30,3,1025,192,1606,189,581,person
43230,9,person,9,1,16923,24,341,1114,410,1377,69,263,person
43231,23,backpack,23,0,16923,28,1042,1054,1193,1280,151,226,backpack
43232,24,person,24,0,16923,85,368,1001,661,1649,293,648,person
43233,3,person,4,0,16924,38,1643,484,1970,1192,327,708,person
43234,5,person,6,0,16924,66,1435,401,1700,1187,265,786,person
43235,13,traffic light,14,1,16925,24,1572,2,1836,1465,264,1463,traffic light
43236,14,traffic light,15,0,16925,37,1868,480,2038,1172,170,692,traffic light
43237,19,motorbike,20,0,16925,82,220,986,662,1277,442,291,motorcycle
43238,20,motorbike,21,1,16925,53,30,981,332,1258,302,277,motorcycle
43239,21,motorbike,22,1,16925,32,2,988,222,1145,220,157,motorcycle
43240,36,person,37,0,16927,38,1502,1290,1552,1440,50,150,person
43241,41,person,42,0,16927,34,133,1287,163,1359,30,72,person
43242,5,car,6,0,16928,16,1118,1024,1237,1089,119,65,car
43243,31,traffic light,32,0,16928,23,918,765,1252,1074,334,309,traffic light
43244,35,traffic light,36,0,16928,26,1044,865,1169,1044,125,179,traffic light
43245,2,person,3,0,16929,34,1601,1139,1733,1449,132,310,person
43246,3,traffic light,4,0,16929,18,1692,974,1806,1437,114,463,traffic light
43247,4,car,5,0,16929,17,1039,1200,1244,1329,205,129,car
43248,48,person,49,0,16929,29,711,1197,744,1279,33,82,person
43249,49,person,50,0,16929,23,629,1198,652,1285,23,87,person
43250,50,person,51,0,16929,23,658,1204,685,1281,27,77,person
43251,51,motorbike,52,0,16929,27,947,1211,1034,1283,87,72,motorcycle
43252,52,motorbikes,53,1,16929,36,845,1198,970,1276,125,78,motorcycle
43253,54,motorbike,55,1,16929,17,1022,1221,1069,1306,47,85,motorcycle
43254,18,person,19,0,16930,36,527,1216,572,1364,45,148,person
43255,19,person,20,0,16930,75,937,1204,1026,1429,89,225,person
43256,20,person,21,0,16930,39,1205,1222,1255,1354,50,132,person
43257,32,person,33,0,16930,32,834,1210,862,1307,28,97,person
43258,33,person,34,0,16930,24,859,1206,888,1306,29,100,person
43259,34,person,35,0,16930,25,886,1214,910,1307,24,93,person
43260,35,person,36,0,16930,29,1095,1216,1136,1323,41,107,person
43261,0,car,1,0,16931,17,923,1160,1904,1478,981,318,car
43262,1,car,2,0,16931,15,247,1168,941,1419,694,251,car
43263,16,person,16,1,16931,39,213,1143,295,1314,82,171,person
43264,29,door,29,0,16931,16,1088,1167,1282,1390,194,223,door
43265,0,car,1,0,16932,30,6,968,552,1167,546,199,car
43266,1,car,2,0,16932,30,590,929,1379,1244,789,315,car
43267,24,window,25,1,16932,19,455,868,655,1090,200,222,window
43268,66,door,67,0,16932,16,738,941,933,1153,195,212,door
43269,11,car,12,0,16933,22,1727,937,1976,1200,249,263,car
43270,28,person,25,0,16934,35,772,1350,828,1484,56,134,person
43271,29,person,26,0,16934,23,1083,1334,1123,1474,40,140,person
43272,30,person,27,1,16934,15,1214,1329,1251,1386,37,57,person
43273,31,traffic light,28,0,16934,91,822,867,1333,1491,511,624,traffic light
43274,0,car,1,0,16935,25,413,995,1296,1336,883,341,car
43275,0,car,1,0,16936,16,1190,1128,1624,1291,434,163,car
43276,27,car,28,1,16936,24,2025,1054,2199,1348,174,294,car
43277,28,car,29,1,16936,15,1965,1286,2198,1649,233,363,car
43278,30,car,31,1,16936,22,529,1072,592,1212,63,140,car
43279,4,person,5,0,16937,26,1353,905,1609,1488,256,583,person
43280,10,bicycle,11,0,16937,61,498,955,567,1075,69,120,bicycle
43281,11,bicycle,12,0,16937,61,660,932,718,1039,58,107,bicycle
43282,12,person,13,0,16937,19,1111,885,1137,974,26,89,person
43283,13,person,14,0,16937,26,1087,883,1109,974,22,91,person
43284,15,person,15,0,16937,28,1262,886,1326,981,64,95,person
43285,38,person,37,0,16937,30,1317,892,1345,979,28,87,person
43286,39,person,38,0,16937,36,1341,888,1371,982,30,94,person
43287,40,person,39,0,16937,40,1376,893,1410,980,34,87,person
43288,41,person,40,0,16937,35,949,888,983,974,34,86,person
43289,42,person,41,0,16937,27,979,894,1001,976,22,82,person
43290,43,person,42,0,16937,23,996,887,1020,976,24,89,person
43291,44,person,43,1,16937,29,1012,886,1039,972,27,86,person
43292,1,person,2,1,16938,21,235,855,382,1342,147,487,person
43293,12,dog,13,1,16938,19,141,1252,325,1326,184,74,dog
43294,13,person,14,1,16938,24,200,910,260,1087,60,177,person
43295,16,window,17,0,16938,15,1166,88,1339,405,173,317,window
43296,27,car,28,0,16938,19,2,934,164,1022,162,88,car
43297,37,person,38,0,16938,45,227,899,466,1377,239,478,person
43298,0,motorbike,1,0,16939,87,129,829,570,1236,441,407,motorcycle
43299,4,car,5,0,16939,16,962,819,1389,984,427,165,car
43300,11,car,12,1,16939,35,416,825,977,1000,561,175,car
43301,16,car,17,0,16939,29,1378,826,1804,977,426,151,car
43302,30,door,30,0,16939,21,1077,824,1193,953,116,129,door
43303,46,car,46,0,16939,49,1774,825,2158,964,384,139,car
43304,47,door,47,0,16939,16,1605,834,1721,944,116,110,door
43305,50,door,50,0,16939,16,1537,833,1631,943,94,110,door
43306,26,car,25,0,16940,24,704,957,902,1131,198,174,car
43307,28,car,27,1,16940,20,801,943,1076,1074,275,131,car
43308,29,car,28,1,16940,20,801,955,1018,1089,217,134,car
43309,35,car,34,1,16940,15,1101,925,1200,993,99,68,car
43310,36,car,35,1,16940,16,1143,942,1241,1001,98,59,car
43311,38,car,37,1,16940,17,1185,947,1323,1022,138,75,car
43312,39,car,38,1,16940,21,1279,956,1438,1038,159,82,car
43313,40,car,39,1,16940,24,1234,949,1378,1031,144,82,car
43314,41,car,40,1,16940,21,1624,960,1752,1084,128,124,car
43315,43,car,42,0,16940,36,1354,958,1722,1113,368,155,car
43316,45,motorbike,44,0,16940,19,665,933,723,1037,58,104,motorcycle
43317,46,motorbike,45,0,16940,33,582,956,669,1073,87,117,motorcycle
43318,5,person,6,0,16941,39,521,431,759,1121,238,690,person
43319,6,person,7,0,16941,20,845,484,952,745,107,261,person
43320,7,car,8,0,16941,19,1154,470,1308,550,154,80,car
43321,35,fire hydrant,36,0,16941,16,376,596,420,678,44,82,fire hydrant
43322,47,traffic light,46,0,16941,18,940,241,999,581,59,340,traffic light
43323,52,person,50,0,16941,15,285,484,338,562,53,78,person
43324,0,person,1,0,16942,101,786,840,894,1128,108,288,person
43325,1,person,2,0,16942,20,922,831,1015,1143,93,312,person
43326,7,bench,8,0,16942,27,1805,1029,1891,1147,86,118,bench
43327,8,bench,9,0,16942,56,1875,1108,2048,1369,173,261,bench
43328,19,car,20,1,16942,18,516,886,616,946,100,60,car
43329,20,car,21,1,16942,18,565,884,672,951,107,67,car
43330,26,person,27,0,16942,29,1447,902,1495,1014,48,112,person
43331,27,person,28,0,16942,27,1673,906,1707,1027,34,121,person
43332,45,car,46,1,16942,19,1161,909,1229,948,68,39,car
43333,46,car,47,1,16942,16,1226,909,1270,945,44,36,car
43334,51,bench,52,0,16942,25,1803,996,1869,1073,66,77,bench
43335,52,person,53,0,16942,33,1732,922,1759,995,27,73,person
43336,53,person,54,0,16942,29,1580,908,1609,979,29,71,person
43337,0,car,1,0,16943,18,248,1068,836,1280,588,212,car
43338,1,car,2,0,16943,15,930,1030,1400,1214,470,184,car
43339,72,door,69,0,16943,16,1661,1038,1726,1139,65,101,door
43340,78,car,75,1,16943,34,1748,1027,1965,1143,217,116,car
43341,94,car,91,1,16943,27,2001,1015,2200,1109,199,94,car
43342,5,car,6,0,16944,17,289,1053,972,1288,683,235,car
43343,38,truck,38,1,16944,20,1858,801,2200,1208,342,407,truck
43344,42,person,42,0,16944,22,1708,997,1761,1141,53,144,person
43345,43,person,43,0,16944,24,1744,1018,1796,1139,52,121,person
43346,44,person,44,1,16944,26,1770,975,1822,1126,52,151,person
43347,79,door,74,0,16944,16,692,1066,838,1233,146,167,door
43348,7,person,8,0,16946,18,635,1035,685,1137,50,102,person
43349,10,car,11,0,16946,16,906,980,1020,1060,114,80,car
43350,16,car,17,0,16946,23,1317,1029,1654,1316,337,287,car
43351,17,person,18,0,16946,27,1374,997,1496,1355,122,358,person
43352,29,person,30,1,16946,22,2129,957,2200,1305,71,348,person
43353,30,bicycle,31,1,16946,40,2094,1176,2200,1524,106,348,bicycle
43354,31,bicycle,32,0,16946,47,1893,1178,2073,1486,180,308,bicycle
43355,45,person,46,0,16946,20,1344,969,1372,1053,28,84,person
43356,11,car,12,0,16947,17,418,958,506,1010,88,52,car
43357,13,car,14,0,16947,19,589,963,674,1010,85,47,car
43358,18,person,18,0,16947,28,985,961,1035,1101,50,140,person
43359,19,person,19,0,16947,32,1028,945,1095,1129,67,184,person
43360,20,car,20,0,16947,23,1655,920,1871,1050,216,130,car
43361,21,car,21,1,16947,20,1286,945,1478,1050,192,105,car
43362,22,motorbikes,22,0,16947,39,1085,988,1417,1109,332,121,motorcycle
43363,23,person,23,0,16947,19,1229,958,1292,1108,63,150,person
43364,26,person,26,0,16947,29,356,1015,434,1154,78,139,person
43365,33,person,33,0,16947,17,702,937,740,1013,38,76,person
43366,63,car,63,1,16947,15,336,954,381,1003,45,49,car
43367,64,car,64,1,16947,19,180,956,251,1000,71,44,car
43368,0,car,1,0,16948,20,1402,782,2053,992,651,210,car
43369,20,car,21,1,16948,25,1951,744,2082,874,131,130,car
43370,22,traffic light,23,0,16948,32,2102,360,2200,893,98,533,traffic light
43371,25,person,26,1,16948,48,2041,744,2103,890,62,146,person
43372,26,person,27,1,16948,25,2123,742,2146,884,23,142,person
43373,27,person,28,1,16948,20,2131,742,2166,871,35,129,person
43374,29,person,30,1,16948,31,1468,734,1539,862,71,128,person
43375,30,person,31,1,16948,39,718,734,774,910,56,176,person
43376,31,person,32,0,16948,49,699,790,792,947,93,157,person
43377,35,person,36,0,16948,50,421,723,544,954,123,231,person
43378,45,flowerpot,46,0,16948,28,366,873,443,942,77,69,potted plant
43379,6,person,7,0,16950,45,716,264,953,1127,237,863,person
43380,0,car,1,0,16951,15,629,893,1181,1116,552,223,car
43381,2,car,2,0,16951,16,131,913,682,1101,551,188,car
43382,14,person,12,0,16951,19,69,885,138,1029,69,144,person
43383,15,motorbike,13,0,16951,15,85,948,138,1057,53,109,motorcycle
43384,17,person,15,0,16951,20,1984,884,2050,989,66,105,person
43385,18,motorbike,16,0,16951,23,1979,934,2063,1009,84,75,motorcycle
43386,31,traffic light,28,0,16951,15,1449,741,1595,823,146,82,traffic light
43387,33,traffic light,30,0,16951,26,1941,609,2093,885,152,276,traffic light
43388,38,person,35,1,16951,15,600,895,635,923,35,28,person
43389,39,car,36,1,16951,24,587,904,812,996,225,92,car
43390,42,person,39,1,16951,17,347,881,390,932,43,51,person
43391,43,car,40,1,16951,36,130,895,325,1012,195,117,car
43392,46,motorbike,43,1,16951,17,305,897,331,940,26,43,motorcycle
43393,47,motorbike,44,1,16951,16,322,900,351,935,29,35,motorcycle
43394,49,car,46,1,16951,18,174,890,228,912,54,22,car
43395,50,car,47,1,16951,39,1,901,163,992,162,91,car
43396,54,car,51,1,16951,15,1714,897,1737,938,23,41,car
43397,55,car,52,0,16951,39,1678,899,1948,1030,270,131,car
43398,56,person,53,1,16951,17,1733,884,1752,932,19,48,person
43399,62,person,59,0,16951,23,1941,886,1970,940,29,54,person
43400,63,person,60,1,16951,21,1932,881,1956,934,24,53,person
43401,66,traffic light,63,0,16951,118,1557,341,2186,996,629,655,traffic light
43402,72,traffic light,69,0,16951,38,39,723,270,899,231,176,traffic light
43403,100,door,97,0,16951,15,319,920,469,1061,150,141,door
43404,104,door,101,0,16951,16,454,921,593,1053,139,132,door
43405,0,car,1,0,16952,37,174,810,1016,1112,842,302,car
43406,24,car,25,1,16953,17,1058,930,1208,1097,150,167,car
43407,25,car,26,0,16953,28,1078,942,1469,1252,391,310,car
43408,0,pot,1,0,16954,23,1093,591,1239,697,146,106,potted plant
43409,1,pot,2,0,16954,23,740,592,885,699,145,107,potted plant
43410,2,pot,3,0,16954,23,252,596,401,704,149,108,potted plant
43411,14,person,15,0,16954,21,673,379,719,538,46,159,person
43412,16,person,17,0,16954,26,747,382,810,525,63,143,person
43413,4,person,5,0,16955,23,793,1073,892,1263,99,190,person
43414,6,person,7,1,16956,20,598,1361,698,1647,100,286,person
43415,0,car,1,0,16957,27,304,246,641,360,337,114,car
43416,1,parking meter,2,0,16957,20,193,236,215,321,22,85,parking meter
43417,22,door,23,0,16957,15,468,249,567,335,99,86,door
43418,24,door,25,0,16957,17,394,248,479,333,85,85,door
43419,0,car,1,0,16958,43,726,175,1560,594,834,419,car
43420,1,car,2,0,16958,38,253,131,665,287,412,156,car
43421,2,car,3,0,16958,32,1321,124,1480,198,159,74,car
43422,31,door,28,0,16958,18,1328,194,1495,458,167,264,door
43423,35,door,32,0,16958,22,1245,192,1397,482,152,290,door
43424,3,car,4,0,16959,33,462,985,1136,1258,674,273,car
43425,5,fire hydrant,6,0,16959,51,1143,1018,1182,1115,39,97,fire hydrant
43426,9,car,10,0,16959,24,1256,920,2197,1350,941,430,car
43427,10,car,11,1,16959,15,334,972,657,1123,323,151,car
43428,14,car,15,1,16959,25,1195,932,1561,1102,366,170,car
43429,30,door,31,0,16959,16,550,1000,709,1199,159,199,door
43430,34,door,35,0,16959,18,649,997,778,1204,129,207,door
43431,37,window,38,0,16959,15,803,993,1036,1061,233,68,window
43432,51,door,52,0,16959,18,1445,938,1742,1253,297,315,door
43433,55,door,56,0,16959,21,1657,937,1927,1263,270,326,door
43434,0,person,1,0,16960,17,881,489,971,727,90,238,person
43435,2,person,3,0,16960,15,117,477,293,893,176,416,person
43436,5,car,6,0,16960,24,1079,508,1255,646,176,138,car
43437,7,car,8,0,16960,32,360,495,519,621,159,126,car
43438,11,car,12,1,16960,22,994,518,1097,594,103,76,car
43439,16,car,17,1,16960,23,497,486,602,570,105,84,car
43440,17,car,18,0,16960,20,779,500,838,544,59,44,car
43441,33,person,34,0,16960,20,667,491,694,582,27,91,person
43442,34,person,35,0,16960,24,691,481,723,579,32,98,person
43443,35,person,36,0,16960,28,1303,506,1346,649,43,143,person
43444,36,person,37,0,16960,21,1372,500,1402,619,30,119,person
43445,39,person,40,0,16960,25,1520,514,1577,654,57,140,person
43446,2,motorbike,3,1,16961,26,287,801,406,911,119,110,motorcycle
43447,3,motorbike,4,1,16961,28,201,819,356,973,155,154,motorcycle
43448,4,motorbike,5,1,16961,25,255,812,375,957,120,145,motorcycle
43449,5,motorbike,6,1,16961,42,90,825,310,992,220,167,motorcycle
43450,6,motorbike,7,1,16961,28,92,886,289,1008,197,122,motorcycle
43451,7,motorbike,8,1,16961,33,63,878,206,1114,143,236,motorcycle
43452,8,motorbike,9,1,16961,47,2,856,174,1153,172,297,motorcycle
43453,19,person,20,1,16961,74,1064,738,1388,1534,324,796,person
43454,27,person,28,0,16961,26,422,785,471,912,49,127,person
43455,6,person,7,1,16962,30,989,169,1276,526,287,357,person
43456,7,car,8,1,16962,19,1451,622,2047,1534,596,912,car
43457,8,car,9,1,16962,40,1222,227,2049,829,827,602,car
43458,12,car,13,1,16962,25,181,266,561,482,380,216,car
43459,15,car,16,1,16962,26,2,309,416,734,414,425,car
43460,16,car,17,1,16962,66,381,342,1630,1470,1249,1128,car
43461,3,bench,4,0,16963,16,1922,1132,2151,1255,229,123,bench
43462,6,car,7,0,16963,15,1,1141,121,1641,120,500,car
43463,20,traffic light,19,0,16963,25,1576,633,1707,753,131,120,traffic light
43464,6,car,7,1,16964,32,1356,828,1836,1236,480,408,car
43465,12,window,13,0,16964,15,1418,799,1583,914,165,115,window
43466,24,traffic light,25,0,16964,17,765,601,838,959,73,358,traffic light
43467,0,car,1,0,16965,17,1294,929,1996,1246,702,317,car
43468,2,car,3,0,16965,15,316,883,459,1035,143,152,car
43469,5,car,6,0,16965,22,653,901,745,959,92,58,car
43470,10,motorbike,11,1,16965,21,3,861,163,1296,160,435,motorcycle
43471,11,motorbikes,12,0,16965,29,106,944,312,1249,206,305,motorcycle
43472,23,car,23,1,16965,15,1868,918,2135,1012,267,94,car
43473,26,person,26,1,16965,16,1386,893,1434,966,48,73,person
43474,27,person,27,0,16965,24,1147,906,1188,995,41,89,person
43475,42,person,42,0,16965,30,1990,916,2063,1043,73,127,person
43476,56,person,56,0,16965,28,1036,895,1057,975,21,80,person
43477,57,person,57,0,16965,28,1208,895,1236,1000,28,105,person
43478,58,person,58,0,16965,33,1172,885,1204,988,32,103,person
43479,59,person,59,0,16965,34,1244,893,1276,988,32,95,person
43480,60,bicycle,60,1,16965,46,1351,941,1437,1019,86,78,bicycle
43481,61,traffic light,61,0,16965,32,1935,756,2042,1087,107,331,traffic light
43482,62,traffic light,62,0,16965,25,1405,794,1462,979,57,185,traffic light
43483,66,door,66,0,16965,15,1464,943,1631,1173,167,230,door
43484,3,person,4,0,16966,17,1485,1002,1569,1247,84,245,person
43485,8,person,9,0,16966,28,860,951,990,1247,130,296,person
43486,9,person,10,0,16966,23,997,974,1089,1246,92,272,person
43487,10,person,11,0,16966,24,1803,1016,1904,1241,101,225,person
43488,11,person,12,0,16966,20,1936,1014,2027,1256,91,242,person
43489,12,person,13,0,16966,23,1581,997,1673,1259,92,262,person
43490,33,person,34,1,16966,19,1382,978,1437,1147,55,169,person
43491,51,person,52,0,16966,28,1731,1017,1812,1241,81,224,person
43492,0,car,1,0,16967,21,910,983,1046,1087,136,104,car
43493,16,motorbike,12,0,16968,47,1168,1036,1325,1140,157,104,motorcycle
43494,17,person,13,0,16968,34,1204,986,1297,1136,93,150,person
43495,18,motorbike,14,0,16968,51,1076,1030,1196,1137,120,107,motorcycle
43496,19,person,15,1,16968,28,1137,998,1180,1120,43,122,person
43497,20,person,16,1,16968,22,1104,994,1170,1082,66,88,person
43498,27,traffic light,23,0,16968,32,1877,838,1993,1028,116,190,traffic light
43499,38,traffic light,34,0,16968,28,584,858,618,1052,34,194,traffic light
43500,44,traffic light,40,0,16968,28,350,964,469,1096,119,132,traffic light
43501,50,traffic light,46,1,16968,17,1097,950,1119,998,22,48,traffic light
43502,60,traffic light,56,0,16968,33,1236,880,1290,1031,54,151,traffic light
43503,73,door,69,0,16968,16,785,1021,923,1147,138,126,door
43504,77,door,73,0,16968,17,692,1021,810,1149,118,128,door
43505,1,bus,2,0,16969,16,1051,621,2203,1350,1152,729,bus
43506,2,car,3,0,16969,25,346,1097,836,1271,490,174,car
43507,33,bus,34,1,16969,17,517,811,1064,1229,547,418,bus
43508,34,person,35,0,16969,38,968,1067,1041,1246,73,179,person
43509,35,bicycle,36,1,16969,45,946,1158,1071,1271,125,113,bicycle
43510,70,door,71,0,16969,16,422,1099,512,1236,90,137,door
43511,0,car,1,0,16971,28,1189,1048,1441,1140,252,92,car
43512,6,person,7,0,16971,32,1976,1043,2084,1329,108,286,person
43513,7,person,8,0,16971,26,1737,1030,1810,1216,73,186,person
43514,9,bicycle,10,0,16971,22,937,1112,996,1235,59,123,bicycle
43515,18,person,19,0,16971,16,460,1076,489,1129,29,53,person
43516,0,car,1,0,16972,34,488,886,769,990,281,104,car
43517,7,motorbike,8,0,16972,35,752,884,823,961,71,77,motorcycle
43518,14,traffic light,15,0,16972,31,1888,590,1955,999,67,409,traffic light
43519,19,motorbike,20,0,16972,25,1010,888,1077,944,67,56,motorcycle
43520,21,person,22,0,16972,46,1793,819,1884,1003,91,184,person
43521,22,motorbike,23,0,16972,22,853,877,898,953,45,76,motorcycle
43522,23,motorbike,24,0,16972,19,889,892,936,949,47,57,motorcycle
43523,25,person,25,0,16972,32,423,873,464,993,41,120,person
43524,26,person,26,0,16972,25,457,878,486,989,29,111,person
43525,41,door,41,0,16972,22,874,704,957,902,83,198,door
43526,45,person,45,1,16972,15,1010,854,1039,894,29,40,person
43527,50,person,50,0,16972,34,1079,847,1121,991,42,144,person
43528,51,person,51,0,16972,28,1121,854,1158,981,37,127,person
43529,58,person,58,0,16972,30,959,856,990,981,31,125,person
43530,59,person,59,0,16972,24,929,861,965,990,36,129,person
43531,76,person,75,1,16972,15,487,875,524,929,37,54,person
43532,1,clock,2,0,16973,18,676,372,806,544,130,172,clock
43533,3,bicycle,4,0,16973,63,45,1590,358,1841,313,251,bicycle
43534,4,person,5,1,16973,29,130,1500,266,1709,136,209,person
43535,1,car,2,0,16974,15,1371,755,1882,1002,511,247,car
43536,8,car,8,1,16974,21,628,760,984,991,356,231,car
43537,9,car,9,1,16974,17,1957,749,2201,943,244,194,car
43538,12,car,12,1,16974,16,1883,733,2038,837,155,104,car
43539,23,car,23,0,16974,36,162,729,777,1051,615,322,car
43540,4,car,5,0,16975,28,200,706,1321,1162,1121,456,car
43541,19,door,20,0,16975,15,329,730,556,1025,227,295,door
43542,22,traffic light,23,1,16975,60,1769,1,1987,858,218,857,traffic light
43543,0,person,1,0,16976,17,593,1273,820,1825,227,552,person
43544,16,car,15,0,16976,15,716,1159,842,1217,126,58,car
43545,23,person,21,0,16976,23,534,1168,606,1332,72,164,person
43546,24,person,22,0,16976,25,440,1170,492,1332,52,162,person
43547,25,person,23,0,16976,18,345,1148,396,1307,51,159,person
43548,27,person,25,1,16976,17,136,1140,180,1276,44,136,person
43549,31,person,29,0,16976,18,276,1138,323,1262,47,124,person
43550,37,person,35,0,16976,61,1039,1159,1192,1567,153,408,person
43551,59,traffic light,57,0,16976,50,37,664,659,1303,622,639,traffic light
43552,60,person,58,0,16976,21,1268,1166,1292,1243,24,77,person
43553,61,person,59,0,16976,22,1297,1167,1326,1240,29,73,person
43554,63,car,60,1,16976,15,636,1163,696,1200,60,37,car
43555,64,truck,61,1,16976,16,695,1112,819,1206,124,94,truck
43556,0,motorbike,1,0,16978,21,354,1052,738,1316,384,264,motorcycle
43557,1,car,2,0,16978,16,804,983,1324,1217,520,234,car
43558,8,car,9,0,16978,33,1491,959,1743,1104,252,145,car
43559,9,car,10,1,16978,21,1666,950,1841,1058,175,108,car
43560,27,car,28,0,16978,18,1881,936,1993,1025,112,89,car
43561,28,car,29,1,16978,17,1970,938,2062,1001,92,63,car
43562,9,car,10,0,16980,26,950,916,1796,1285,846,369,car
43563,10,car,11,0,16980,17,1766,877,2200,1128,434,251,car
43564,41,door,40,0,16980,15,1502,926,1686,1161,184,235,door
43565,53,person,52,0,16980,36,268,961,334,1128,66,167,person
43566,54,person,53,0,16980,28,229,964,276,1079,47,115,person
43567,55,car,54,1,16980,17,37,966,91,1006,54,40,car
43568,58,car,57,1,16980,15,0,996,59,1099,59,103,car
43569,0,car,1,0,16981,28,112,352,362,449,250,97,car
43570,4,car,5,0,16982,21,50,910,249,1005,199,95,car
43571,6,car,7,1,16982,16,242,917,394,1007,152,90,car
43572,10,person,11,0,16982,27,451,872,501,1059,50,187,person
43573,11,person,12,0,16982,28,396,880,456,1069,60,189,person
43574,27,motorbike,26,0,16982,48,655,916,783,1011,128,95,motorcycle
43575,58,car,56,1,16983,16,836,670,906,707,70,37,car
43576,59,car,57,1,16983,28,941,666,1082,708,141,42,car
43577,60,car,58,0,16983,26,977,670,1047,742,70,72,car
43578,0,car,1,0,16986,45,706,840,1236,1041,530,201,car
43579,6,car,5,0,16986,21,1221,901,1600,1039,379,138,car
43580,13,person,11,0,16986,49,270,825,365,1071,95,246,person
43581,15,person,13,0,16986,28,595,829,653,997,58,168,person
43582,16,person,14,0,16986,25,669,849,718,992,49,143,person
43583,17,person,15,0,16986,28,380,843,433,964,53,121,person
43584,18,traffic light,16,0,16986,61,208,480,592,948,384,468,traffic light
43585,22,car,20,1,16986,23,1,839,193,941,192,102,car
43586,29,car,27,1,16986,49,168,838,385,941,217,103,car
43587,30,car,28,0,16986,44,1499,903,2047,1096,548,193,car
43588,35,door,33,0,16986,15,1646,914,1798,1046,152,132,door
43589,39,door,37,0,16986,17,1770,914,1916,1051,146,137,door
43590,63,door,61,0,16986,17,803,881,931,1004,128,123,door
43591,67,door,65,0,16986,16,890,884,1002,1011,112,127,door
43592,73,person,71,1,16986,21,1257,862,1296,948,39,86,person
43593,74,person,72,1,16986,18,1296,853,1324,938,28,85,person
43594,0,person,1,0,16987,15,1129,822,1280,1177,151,355,person
43595,1,person,2,1,16987,25,1669,601,2048,1534,379,933,person
43596,2,person,3,0,16987,16,349,841,506,1264,157,423,person
43597,5,person,6,0,16987,15,1008,829,1069,961,61,132,person
43598,16,motorbikes,17,1,16987,50,1438,967,1777,1326,339,359,motorcycle
43599,44,truck,45,1,16987,16,1379,731,1527,877,148,146,truck
43600,46,car,47,1,16987,16,1517,862,1710,946,193,84,car
43601,0,car,1,0,16989,45,321,398,1022,715,701,317,car
43602,1,car,2,0,16989,27,913,418,1213,633,300,215,car
43603,3,car,4,1,16989,15,2,462,231,712,229,250,car
43604,5,car,6,1,16989,21,3,410,321,673,318,263,car
43605,10,traffic light,10,0,16989,35,4,122,101,308,97,186,traffic light
43606,11,traffic light,11,0,16989,31,487,169,575,397,88,228,traffic light
43607,2,car,3,0,16990,27,229,1048,463,1158,234,110,car
43608,3,car,4,0,16990,29,643,1053,1003,1195,360,142,car
43609,4,car,5,0,16990,28,959,1039,1447,1218,488,179,car
43610,10,car,11,0,16990,19,103,1046,277,1141,174,95,car
43611,2,traffic light,3,0,16991,27,1676,619,1841,1337,165,718,traffic light
43612,14,motorbike,15,0,16991,63,67,1081,455,1325,388,244,motorcycle
43613,15,motorbike,16,1,16991,46,19,984,279,1270,260,286,motorcycle
43614,23,umbrella,24,0,16991,37,381,781,881,924,500,143,umbrella
43615,25,umbrella,26,1,16991,15,4,824,308,955,304,131,umbrella
43616,4,person,5,0,16992,30,797,988,848,1153,51,165,person
43617,5,dog,6,0,16992,24,850,1097,937,1174,87,77,dog
43618,13,person,14,0,16992,21,1511,957,1541,1048,30,91,person
43619,9,truck,9,0,16993,18,0,345,360,1051,360,706,truck
43620,19,person,18,0,16993,46,889,706,988,948,99,242,person
43621,20,car,19,1,16993,17,1223,733,1270,781,47,48,car
43622,21,car,20,1,16993,18,1225,713,1292,774,67,61,car
43623,32,door,31,0,16993,17,376,755,467,889,91,134,door
43624,50,truck,49,1,16993,29,768,714,931,847,163,133,truck
43625,3,person,4,0,16994,27,1484,1572,1536,1773,52,201,person
43626,6,bicycle,7,0,16994,45,1050,1712,1283,1897,233,185,bicycle
43627,16,traffic light,16,0,16994,46,592,519,1040,1919,448,1400,traffic light
43628,0,car,1,0,16995,42,75,852,430,1024,355,172,car
43629,1,car,2,0,16995,20,768,872,1282,1094,514,222,car
43630,2,car,3,0,16995,16,1421,890,2048,1142,627,252,car
43631,67,door,68,0,16995,15,1606,895,1810,1087,204,192,door
43632,70,door,71,0,16995,18,1780,896,1972,1085,192,189,door
43633,72,door,73,0,16995,15,890,877,1041,1041,151,164,door
43634,1,bus,2,1,16996,24,525,669,834,977,309,308,bus
43635,3,person,4,0,16996,22,783,822,839,1029,56,207,person
43636,4,person,5,1,16996,49,863,679,1341,1646,478,967,person
43637,1,car,1,0,16997,16,1,455,389,680,388,225,car
43638,5,car,4,0,16997,20,515,456,1065,656,550,200,car
43639,8,car,7,1,16997,21,1110,450,1265,508,155,58,car
43640,16,bus,15,1,16997,22,784,387,1063,509,279,122,bus
43641,19,bus,18,1,16997,17,56,392,450,451,394,59,bus
43642,28,traffic light,27,0,16997,21,1539,188,1599,587,60,399,traffic light
43643,42,door,41,0,16997,16,336,461,473,599,137,138,door
43644,46,door,45,0,16997,15,450,461,557,599,107,138,door
43645,0,car,1,0,16998,28,286,1011,1118,1317,832,306,car
43646,1,car,2,0,16998,19,1354,1101,1694,1238,340,137,car
43647,2,motorbike,3,0,16998,22,369,1166,597,1376,228,210,motorcycle
43648,16,person,14,0,16998,40,405,1051,559,1327,154,276,person
43649,101,person,97,1,16998,56,1759,1091,1855,1280,96,189,person
43650,110,person,106,0,16998,58,1712,1099,1809,1289,97,190,person
43651,119,person,115,0,16998,24,2124,1058,2155,1161,31,103,person
43652,0,car,1,0,16999,28,514,861,1563,1274,1049,413,car
43653,8,person,9,0,16999,17,1490,780,1537,946,47,166,person
43654,10,person,11,0,16999,20,1394,808,1430,905,36,97,person
43655,11,person,12,0,16999,26,1315,793,1361,916,46,123,person
43656,13,person,14,0,16999,32,1199,794,1249,912,50,118,person
43657,16,person,17,1,16999,17,1033,776,1076,867,43,91,person
43658,17,person,18,1,16999,18,979,772,1034,867,55,95,person
43659,18,person,19,1,16999,15,940,783,978,858,38,75,person
43660,20,person,21,1,16999,18,823,766,864,862,41,96,person
43661,21,person,22,1,16999,18,847,774,918,860,71,86,person
43662,23,person,24,1,16999,26,652,772,708,918,56,146,person
43663,24,person,25,1,16999,23,575,768,626,960,51,192,person
43664,28,person,29,0,16999,15,501,799,522,858,21,59,person
43665,60,person,61,1,16999,17,1580,770,1635,833,55,63,person
43666,7,person,8,0,17000,34,1530,991,1653,1359,123,368,person
43667,8,person,9,0,17000,38,1658,1017,1766,1365,108,348,person
43668,0,car,1,0,17002,31,63,275,226,337,163,62,car
43669,1,car,2,0,17002,21,443,274,558,311,115,37,car
43670,66,traffic light,67,0,17002,55,55,87,265,306,210,219,traffic light
43671,0,car,1,1,17003,29,452,334,799,490,347,156,car
43672,1,car,2,0,17003,24,169,357,413,458,244,101,car
43673,59,door,58,0,17003,20,238,362,285,437,47,75,door
43674,67,door,66,0,17003,19,526,343,633,459,107,116,door
43675,71,door,70,0,17003,21,604,342,700,462,96,120,door
43676,0,car,1,0,17004,22,93,685,943,1095,850,410,car
43677,8,person,9,0,17004,26,912,710,1018,962,106,252,person
43678,19,person,20,0,17004,16,2098,712,2197,998,99,286,person
43679,23,person,24,0,17004,29,1757,676,1844,997,87,321,person
43680,24,person,25,0,17004,36,1670,698,1790,1020,120,322,person
43681,25,person,26,0,17004,35,986,699,1103,951,117,252,person
43682,26,person,27,1,17004,21,863,710,908,887,45,177,person
43683,27,person,28,1,17004,28,802,693,875,883,73,190,person
43684,28,person,29,1,17004,24,752,708,811,870,59,162,person
43685,29,person,30,1,17004,16,686,693,737,853,51,160,person
43686,30,person,31,1,17004,16,623,695,685,812,62,117,person
43687,10,person,11,0,17005,24,1055,1170,1104,1371,49,201,person
43688,11,person,12,0,17005,31,1102,1164,1150,1375,48,211,person
43689,12,person,13,0,17005,22,1345,1168,1378,1283,33,115,person
43690,12,bus,13,0,17006,24,1193,1432,1389,1551,196,119,bus
43691,13,car,14,1,17006,23,1041,1478,1178,1580,137,102,car
43692,15,car,16,0,17006,34,376,1465,810,1685,434,220,car
43693,16,car,17,1,17006,21,311,1484,557,1662,246,178,car
43694,18,car,19,1,17006,24,3,1532,342,1765,339,233,car
43695,45,car,46,0,17006,30,805,1499,1081,1630,276,131,car
43696,0,car,1,0,17007,22,1,825,677,1062,676,237,car
43697,4,person,5,0,17007,16,826,845,910,1002,84,157,person
43698,7,person,6,0,17007,15,2042,860,2084,968,42,108,person
43699,8,window,7,0,17007,21,104,130,475,429,371,299,window
43700,21,window,10,0,17007,21,614,160,943,451,329,291,window
43701,23,window,12,0,17007,19,1086,166,1374,468,288,302,window
43702,24,window,13,0,17007,15,1477,218,1697,480,220,262,window
43703,34,person,23,1,17007,28,695,873,740,981,45,108,person
43704,35,person,24,1,17007,21,783,853,815,979,32,126,person
43705,37,person,26,1,17007,27,811,847,845,990,34,143,person
43706,38,person,27,1,17007,22,539,849,582,936,43,87,person
43707,47,person,36,1,17007,21,404,816,455,910,51,94,person
43708,8,bicycle,9,1,17008,55,291,985,604,1183,313,198,bicycle
43709,10,person,11,1,17008,22,833,884,940,1055,107,171,person
43710,12,person,13,0,17008,42,592,979,717,1358,125,379,person
43711,13,person,14,0,17008,23,723,862,777,1084,54,222,person
43712,15,person,16,1,17008,17,126,888,181,1000,55,112,person
43713,16,person,17,1,17008,28,39,915,157,1235,118,320,person
43714,17,person,18,1,17008,17,2,944,76,1165,74,221,person
43715,19,person,20,1,17008,51,68,897,301,1536,233,639,person
43716,20,person,21,1,17008,48,1072,911,1323,1536,251,625,person
43717,21,person,22,0,17008,26,1822,841,1884,1018,62,177,person
43718,23,person,24,0,17008,20,1738,829,1775,948,37,119,person
43719,25,person,26,0,17008,19,1890,841,1944,961,54,120,person
43720,30,person,31,0,17008,18,1624,860,1672,1008,48,148,person
43721,0,pot,1,0,17009,22,1000,742,1153,854,153,112,potted plant
43722,1,pot,2,0,17009,22,496,747,650,858,154,111,potted plant
43723,2,person,3,0,17009,20,861,506,974,824,113,318,person
43724,3,person,4,0,17009,19,437,533,514,713,77,180,person
43725,4,pot,5,0,17009,16,1,742,144,862,143,120,potted plant
43726,3,person,4,0,17010,44,452,649,588,937,136,288,person
43727,5,person,6,0,17010,29,1761,623,1899,960,138,337,person
43728,12,traffic light,13,0,17010,44,1567,13,1777,838,210,825,traffic light
43729,13,person,14,0,17010,51,1339,624,1444,949,105,325,person
43730,14,person,15,0,17010,55,1222,628,1325,952,103,324,person
43731,15,person,16,0,17010,41,1119,653,1228,901,109,248,person
43732,16,person,17,0,17010,42,1471,673,1544,865,73,192,person
43733,17,person,18,0,17010,38,1043,642,1136,891,93,249,person
43734,18,person,19,0,17010,48,1006,647,1066,885,60,238,person
43735,51,car,51,1,17012,29,1265,1036,1435,1112,170,76,car
43736,52,car,52,0,17012,27,985,1025,1195,1111,210,86,car
43737,56,traffic light,56,0,17012,33,211,853,536,1062,325,209,traffic light
43738,57,traffic light,57,0,17012,68,2,471,912,1236,910,765,traffic light
43739,58,car,58,0,17012,30,799,1061,991,1119,192,58,car
43740,59,traffic light,59,0,17012,48,841,715,1258,1141,417,426,traffic light
43741,60,car,60,1,17012,15,1632,1008,1728,1054,96,46,car
43742,61,car,61,1,17012,15,1558,1016,1664,1059,106,43,car
43743,63,car,63,1,17012,17,1451,1020,1561,1073,110,53,car
43744,0,car,1,0,17013,21,814,732,1748,1131,934,399,car
43745,2,car,3,0,17013,22,360,715,921,980,561,265,car
43746,34,door,35,0,17013,15,510,722,632,909,122,187,door
43747,38,door,39,0,17013,17,948,749,1205,1005,257,256,door
43748,41,door,42,0,17013,17,1108,749,1367,1025,259,276,door
43749,0,car,1,0,17014,23,209,740,872,917,663,177,car
43750,7,car,8,1,17014,17,739,741,963,835,224,94,car
43751,67,person,68,0,17014,28,58,736,102,859,44,123,person
43752,68,person,69,0,17014,26,100,734,138,849,38,115,person
43753,69,person,70,0,17014,26,134,747,171,855,37,108,person
43754,70,person,71,1,17014,19,218,763,244,846,26,83,person
43755,134,person,135,0,17014,21,1013,757,1043,819,30,62,person
43756,135,person,136,0,17014,15,1073,751,1098,818,25,67,person
43757,136,person,137,0,17014,15,1095,755,1115,815,20,60,person
43758,137,person,138,0,17014,19,1200,747,1235,811,35,64,person
43759,142,person,143,0,17014,21,1572,740,1597,835,25,95,person
43760,143,person,144,0,17014,25,1960,730,1995,835,35,105,person
43761,144,person,145,0,17014,18,2102,734,2130,793,28,59,person
43762,145,person,146,0,17014,18,1531,736,1559,832,28,96,person
43763,170,door,171,0,17014,16,386,751,547,892,161,141,door
43764,171,door,172,0,17014,19,518,751,668,894,150,143,door
43765,1,person,2,0,17015,15,453,431,528,625,75,194,person
43766,3,car,4,0,17015,16,696,443,1030,551,334,108,car
43767,0,car,1,0,17016,25,718,495,1065,831,347,336,car
43768,1,clock,2,0,17016,27,1045,160,1169,676,124,516,clock
43769,2,car,3,0,17016,18,253,534,475,652,222,118,car
43770,11,car,12,1,17016,16,0,561,178,698,178,137,car
43771,13,person,14,0,17016,20,1165,507,1186,571,21,64,person
43772,17,car,18,1,17016,17,595,535,644,580,49,45,car
43773,18,car,19,1,17016,18,553,535,612,589,59,54,car
43774,19,car,20,1,17016,21,470,524,559,603,89,79,car
43775,31,person,32,1,17016,20,1136,501,1155,573,19,72,person
43776,38,traffic light,39,1,17016,16,984,2,1065,583,81,581,traffic light
43777,46,bicycle,47,0,17016,55,1369,708,1535,1007,166,299,bicycle
43778,20,car,21,0,17017,22,633,1095,916,1295,283,200,car
43779,0,car,1,0,17018,30,123,1077,303,1219,180,142,car
43780,1,car,2,0,17018,32,780,1054,1331,1256,551,202,car
43781,7,car,8,1,17018,17,1460,1039,2203,1515,743,476,car
43782,8,car,9,1,17018,22,1335,1042,1730,1205,395,163,car
43783,21,car,22,1,17018,16,1705,997,1874,1067,169,70,car
43784,22,car,23,1,17018,18,1726,1011,2040,1102,314,91,car
43785,23,car,24,1,17018,19,1565,1059,1926,1213,361,154,car
43786,24,person,25,1,17018,16,2033,973,2060,1044,27,71,person
43787,4,car,5,1,17019,16,1672,1113,1949,1224,277,111,car
43788,5,car,6,1,17019,19,1769,1147,2049,1245,280,98,car
43789,11,car,12,1,17019,18,1205,1121,1399,1204,194,83,car
43790,12,car,13,0,17019,35,1281,1121,1725,1324,444,203,car
43791,13,car,14,0,17019,34,930,1111,1244,1266,314,155,car
43792,22,car,20,1,17019,24,750,1106,892,1209,142,103,car
43793,23,car,21,1,17019,24,838,1107,1002,1232,164,125,car
43794,27,car,24,0,17019,23,1,1101,316,1392,315,291,car
43795,28,car,25,0,17019,21,536,1099,696,1206,160,107,car
43796,36,car,33,1,17019,20,510,1067,568,1108,58,41,car
43797,37,car,34,1,17019,22,532,1074,589,1122,57,48,car
43798,43,car,40,1,17019,16,731,1076,791,1101,60,25,car
43799,44,car,41,1,17019,18,803,1079,871,1108,68,29,car
43800,45,car,42,1,17019,19,874,1082,945,1112,71,30,car
43801,56,motorbike,53,0,17019,24,445,1061,475,1082,30,21,motorcycle
43802,80,window,77,0,17019,15,1554,1136,1700,1194,146,58,window
43803,92,door,89,0,17019,15,1419,1129,1520,1274,101,145,door
43804,24,car,17,0,17020,15,1755,1184,1861,1278,106,94,car
43805,26,person,19,0,17020,21,2095,1174,2121,1263,26,89,person
43806,27,car,20,1,17020,15,1989,1183,2037,1234,48,51,car
43807,28,person,21,0,17020,18,2138,1189,2163,1257,25,68,person
43808,29,person,22,0,17020,69,528,1071,763,1537,235,466,person
43809,30,person,23,1,17020,41,729,1103,829,1393,100,290,person
43810,31,person,24,0,17020,43,840,1124,930,1399,90,275,person
43811,32,person,25,0,17020,39,923,1134,1004,1311,81,177,person
43812,33,person,26,0,17020,31,1256,1139,1308,1316,52,177,person
43813,34,person,27,0,17020,29,1333,1150,1375,1322,42,172,person
43814,37,person,30,0,17020,28,1394,1169,1430,1292,36,123,person
43815,38,car,31,1,17020,20,982,1200,1135,1248,153,48,car
43816,43,person,36,0,17020,20,1558,1186,1589,1277,31,91,person
43817,44,person,37,0,17020,16,1651,1183,1670,1246,19,63,person
43818,1,clock,2,0,17022,16,248,250,361,355,113,105,clock
43819,6,traffic light,7,0,17022,19,605,320,721,1365,116,1045,traffic light
43820,8,person,9,0,17022,15,806,923,916,1134,110,211,person
43821,16,window,16,0,17022,15,275,455,310,489,35,34,window
43822,17,window,17,0,17022,16,263,671,302,707,39,36,window
43823,18,person,18,0,17022,52,901,943,984,1132,83,189,person
43824,43,person,43,0,17022,20,1131,954,1183,1023,52,69,person
43825,44,car,44,0,17022,15,676,930,721,963,45,33,car
43826,45,traffic light,45,0,17022,30,679,619,789,1077,110,458,traffic light
43827,46,traffic light,46,0,17022,21,331,716,367,1017,36,301,traffic light
43828,59,person,59,0,17022,17,295,925,328,1013,33,88,person
43829,61,person,61,0,17022,15,527,925,552,992,25,67,person
43830,13,car,10,0,17023,19,881,1066,1081,1211,200,145,car
43831,18,person,15,0,17023,58,193,1046,304,1268,111,222,person
43832,21,traffic light,18,0,17023,89,1,1,1144,1402,1143,1401,traffic light
43833,29,car,26,1,17023,22,1093,1073,1285,1153,192,80,car
43834,0,car,1,0,17025,17,110,807,522,937,412,130,car
43835,1,car,2,0,17025,17,836,771,1213,904,377,133,car
43836,13,person,14,1,17025,17,2,787,35,913,33,126,person
43837,94,door,93,0,17025,18,936,777,1032,873,96,96,door
43838,103,door,102,0,17025,15,286,814,390,912,104,98,door
43839,106,door,105,0,17025,19,196,813,290,912,94,99,door
43840,0,car,1,0,17026,23,24,363,153,419,129,56,car
43841,1,car,2,0,17026,24,159,381,293,419,134,38,car
43842,2,car,3,0,17026,24,322,375,484,427,162,52,car
43843,29,traffic light,29,0,17026,43,675,66,800,446,125,380,traffic light
43844,0,car,1,0,17028,25,774,934,1627,1277,853,343,car
43845,0,car,1,0,17029,38,135,861,1511,1348,1376,487,car
43846,14,door,15,0,17029,17,732,879,1105,1254,373,375,door
43847,16,mirror,17,0,17029,15,989,1002,1065,1050,76,48,mirror
43848,18,door,19,0,17029,25,426,878,743,1238,317,360,door
43849,0,car,1,0,17030,34,279,941,859,1166,580,225,car
43850,1,car,2,0,17030,27,921,922,1612,1197,691,275,car
43851,4,car,5,0,17031,33,1048,950,1415,1100,367,150,car
43852,5,car,6,1,17031,24,1393,940,1651,1066,258,126,car
43853,7,car,8,1,17031,23,1628,931,1830,1039,202,108,car
43854,8,car,9,1,17031,22,1810,926,1960,1018,150,92,car
43855,9,car,10,1,17031,18,1933,918,2054,1002,121,84,car
43856,10,car,11,1,17031,15,2034,907,2199,1341,165,434,car
43857,67,traffic light,68,0,17031,16,1928,615,2198,925,270,310,traffic light
43858,68,traffic light,69,0,17031,37,2033,699,2080,942,47,243,traffic light
43859,77,door,78,0,17031,15,1301,954,1373,1060,72,106,door
43860,0,car,1,0,17032,37,161,956,1348,1458,1187,502,car
43861,6,car,7,0,17033,35,1119,763,1587,936,468,173,car
43862,8,car,9,0,17033,15,134,792,321,882,187,90,car
43863,34,car,30,1,17033,25,88,797,173,859,85,62,car
43864,35,car,31,1,17033,21,48,789,115,828,67,39,car
43865,41,car,37,1,17033,15,695,783,768,824,73,41,car
43866,43,car,39,1,17033,30,1077,783,1147,899,70,116,car
43867,44,car,40,1,17033,16,982,801,1092,834,110,33,car
43868,49,car,45,1,17033,19,1451,782,1600,873,149,91,car
43869,52,traffic light,48,0,17033,19,1238,685,1335,761,97,76,traffic light
43870,54,traffic light,50,0,17033,33,811,706,831,823,20,117,traffic light
43871,44,car,44,0,17035,27,593,1137,786,1208,193,71,car
43872,0,car,1,0,17036,33,126,790,1178,1188,1052,398,car
43873,4,person,4,0,17036,22,1711,858,1776,1064,65,206,person
43874,23,window,23,0,17036,21,158,738,568,910,410,172,window
43875,33,traffic light,31,0,17036,64,1456,52,2197,1086,741,1034,traffic light
43876,34,door,32,0,17036,15,487,811,718,1098,231,287,door
43877,0,car,1,0,17037,20,1127,790,1701,1071,574,281,car
43878,18,bicycle,19,0,17037,36,1035,840,1134,941,99,101,bicycle
43879,30,person,30,0,17037,25,286,792,404,979,118,187,person
43880,32,motorbike,32,0,17037,16,1827,817,1892,878,65,61,motorcycle
43881,33,door,33,0,17037,15,1496,809,1591,1017,95,208,door
43882,37,door,37,0,17037,15,1565,812,1658,997,93,185,door
43883,42,person,42,1,17037,26,1676,795,1708,864,32,69,person
43884,43,person,43,1,17037,25,1635,776,1664,848,29,72,person
43885,44,person,44,1,17037,30,861,764,920,930,59,166,person
43886,5,person,6,0,17038,23,949,642,1014,745,65,103,person
43887,8,person,9,0,17038,22,981,761,1072,939,91,178,person
43888,9,person,10,0,17038,24,1074,727,1160,973,86,246,person
43889,10,person,11,0,17038,28,1208,704,1289,943,81,239,person
43890,11,umbrella,12,0,17038,15,1230,518,1674,747,444,229,umbrella
43891,12,person,13,0,17038,23,1289,704,1377,979,88,275,person
43892,13,person,14,1,17038,29,1351,694,1461,909,110,215,person
43893,14,person,15,0,17038,32,1594,700,1680,967,86,267,person
43894,18,person,19,0,17038,18,821,646,861,777,40,131,person
43895,21,person,22,0,17038,16,1912,797,1978,886,66,89,person
43896,13,person,14,0,17039,34,1302,1018,1418,1245,116,227,person
43897,19,person,20,0,17039,34,750,1025,848,1229,98,204,person
43898,20,person,21,0,17039,33,634,996,705,1156,71,160,person
43899,24,person,25,0,17039,22,1440,1002,1507,1240,67,238,person
43900,55,window,56,1,17039,30,1052,371,1351,663,299,292,window
43901,65,person,66,1,17039,23,828,1006,879,1215,51,209,person
43902,66,person,67,0,17039,37,947,993,1032,1208,85,215,person
43903,67,car,68,1,17039,20,536,1006,652,1142,116,136,car
43904,68,person,69,0,17039,17,551,1041,584,1162,33,121,person
43905,69,person,70,0,17039,23,496,1008,558,1162,62,154,person
43906,70,person,71,0,17039,27,435,1004,485,1145,50,141,person
43907,3,car,3,0,17040,15,300,818,892,1057,592,239,car
43908,11,motorbike,6,0,17040,68,44,851,157,1078,113,227,motorcycle
43909,12,car,7,0,17040,90,1425,840,1816,977,391,137,car
43910,15,person,10,1,17040,21,385,791,437,904,52,113,person
43911,77,car,72,1,17040,28,1805,791,2048,952,243,161,car
43912,8,car,9,0,17041,34,1329,840,1963,1350,634,510,car
43913,14,car,15,1,17041,18,1680,823,1956,1051,276,228,car
43914,15,car,16,1,17041,23,1830,813,2005,967,175,154,car
43915,8,car,9,1,17042,20,1631,1086,2197,1650,566,564,car
43916,11,car,12,1,17042,26,1404,1036,1739,1315,335,279,car
43917,12,car,13,1,17042,18,1336,1030,1511,1230,175,200,car
43918,13,person,14,0,17042,26,1140,999,1175,1109,35,110,person
43919,14,person,15,0,17042,24,1184,1001,1219,1109,35,108,person
43920,51,person,52,0,17042,19,1109,1008,1131,1094,22,86,person
43921,8,car,9,1,17043,25,1787,1032,2200,1276,413,244,car
43922,9,car,10,1,17043,26,1554,1049,1898,1184,344,135,car
43923,13,truck,14,0,17043,19,473,926,652,1128,179,202,truck
43924,14,car,15,0,17043,21,681,1031,810,1115,129,84,car
43925,16,car,17,1,17043,17,888,1033,1046,1119,158,86,car
43926,18,car,18,1,17043,30,1014,1029,1221,1143,207,114,car
43927,20,car,20,1,17043,21,1221,1043,1411,1138,190,95,car
43928,21,car,21,1,17043,16,1295,1028,1509,1146,214,118,car
43929,22,person,22,0,17043,40,54,1016,122,1200,68,184,person
43930,23,person,23,0,17043,43,167,1024,219,1153,52,129,person
43931,24,person,24,0,17043,25,125,988,151,1071,26,83,person
43932,55,person,55,1,17043,26,44,1020,78,1157,34,137,person
43933,124,motorbike,124,0,17043,56,1088,1071,1186,1189,98,118,motorcycle
43934,125,person,125,0,17043,39,1106,1023,1181,1154,75,131,person
43935,126,traffic light,126,0,17043,47,1164,750,1543,1133,379,383,traffic light
43936,127,traffic light,127,0,17043,74,268,437,1143,1253,875,816,traffic light
43937,129,car,129,1,17043,16,640,990,721,1041,81,51,car
43938,130,door,130,0,17043,19,1874,1042,2001,1201,127,159,door
43939,133,door,133,0,17043,19,1983,1038,2081,1203,98,165,door
43940,137,door,137,0,17043,17,1615,1058,1705,1163,90,105,door
43941,140,door,140,0,17043,20,1678,1055,1757,1166,79,111,door
43942,4,car,4,0,17044,21,141,714,661,876,520,162,car
43943,7,person,7,0,17044,19,805,630,965,1118,160,488,person
43944,19,traffic light,19,0,17044,17,637,4,783,960,146,956,traffic light
43945,1,person,2,0,17045,17,1744,890,2030,1647,286,757,person
43946,25,car,26,0,17045,20,129,994,1097,1397,968,403,car
43947,26,car,27,0,17045,23,1159,923,1701,1169,542,246,car
43948,39,person,39,0,17045,23,1639,1022,1803,1553,164,531,person
43949,40,car,40,0,17045,22,278,726,1295,1207,1017,481,car
43950,42,person,42,1,17045,18,2116,962,2199,1648,83,686,person
43951,54,car,54,1,17045,22,1507,929,1781,1059,274,130,car
43952,55,person,55,1,17045,18,1747,895,1851,1051,104,156,person
43953,56,person,56,1,17045,16,1939,898,1985,988,46,90,person
43954,59,person,59,0,17045,29,2015,914,2069,1049,54,135,person
43955,60,person,60,1,17045,28,2072,890,2125,1045,53,155,person
43956,61,person,61,0,17045,20,2091,936,2133,1051,42,115,person
43957,0,car,1,0,17046,27,924,1128,1708,1364,784,236,car
43958,1,traffic light,2,0,17046,16,354,606,398,711,44,105,traffic light
43959,2,traffic light,3,0,17046,15,761,806,810,917,49,111,traffic light
43960,40,door,41,0,17046,16,1118,1137,1318,1318,200,181,door
43961,42,door,43,0,17046,20,1295,1130,1495,1313,200,183,door
43962,2,person,3,0,17048,26,97,1343,224,1611,127,268,person
43963,9,person,10,0,17048,16,1194,1173,1229,1236,35,63,person
43964,8,truck,9,0,17049,28,562,830,1202,1173,640,343,truck
43965,16,person,14,0,17049,24,0,1025,51,1196,51,171,person
43966,17,person,15,0,17049,19,423,1027,453,1095,30,68,person
43967,18,person,16,0,17049,29,1268,978,1315,1121,47,143,person
43968,24,person,21,1,17049,24,1240,1000,1277,1113,37,113,person
43969,25,person,22,0,17049,25,1213,1004,1250,1127,37,123,person
43970,26,person,23,0,17049,17,1186,1010,1214,1128,28,118,person
43971,29,person,26,0,17049,27,198,1017,275,1160,77,143,person
43972,30,person,27,0,17049,35,114,1014,212,1192,98,178,person
43973,31,person,28,1,17049,23,107,1001,162,1181,55,180,person
43974,3,person,4,0,17050,53,324,1112,463,1448,139,336,person
43975,4,person,5,0,17050,46,433,1082,551,1434,118,352,person
43976,5,person,6,0,17050,26,317,1082,347,1200,30,118,person
43977,6,person,7,0,17050,19,80,1091,102,1158,22,67,person
43978,12,window,13,0,17051,18,452,348,611,683,159,335,window
43979,14,flowerpot,15,0,17051,21,1,1362,513,1533,512,171,potted plant
43980,24,person,25,1,17051,15,862,861,910,938,48,77,person
43981,25,person,26,0,17051,17,1738,889,1767,976,29,87,person
43982,54,car,44,0,17052,15,596,924,661,974,65,50,car
43983,0,parking meter,1,0,17053,17,770,991,787,1110,17,119,parking meter
43984,1,car,2,0,17053,36,70,991,547,1140,477,149,car
43985,2,parking meter,3,0,17053,16,1959,965,1976,1082,17,117,parking meter
43986,3,car,4,0,17053,26,775,975,1255,1132,480,157,car
43987,4,car,5,0,17053,33,1288,971,1730,1119,442,148,car
43988,72,door,72,0,17053,15,305,996,413,1108,108,112,door
43989,35,person,23,0,17054,27,530,1018,564,1122,34,104,person
43990,36,person,24,1,17054,18,894,998,916,1039,22,41,person
43991,37,car,25,1,17054,17,857,1039,911,1108,54,69,car
43992,38,car,26,1,17054,27,870,1042,980,1131,110,89,car
43993,39,car,27,1,17054,30,938,1056,1053,1160,115,104,car
43994,40,car,28,0,17054,39,999,1059,1203,1197,204,138,car
43995,41,car,29,1,17054,47,1268,1069,1603,1312,335,243,car
43996,42,car,30,0,17054,55,1521,1080,2168,1452,647,372,car
43997,47,door,35,0,17054,17,1574,1090,1739,1342,165,252,door
43998,51,door,39,0,17054,23,1666,1090,1809,1354,143,264,door
43999,59,window,47,0,17054,19,1828,1102,2101,1211,273,109,window
44000,70,door,58,0,17054,15,1344,1100,1413,1254,69,154,door
44001,17,person,18,0,17055,23,1527,1116,1587,1413,60,297,person
44002,33,person,32,1,17055,31,1604,1119,1663,1342,59,223,person
44003,34,person,33,1,17055,36,1694,1118,1794,1344,100,226,person
44004,35,person,34,1,17055,32,1671,1102,1722,1338,51,236,person
44005,36,person,35,0,17055,37,1810,1133,1890,1434,80,301,person
44006,37,person,36,1,17055,44,1155,1243,1280,1440,125,197,person
44007,39,person,38,1,17055,49,1227,1136,1299,1422,72,286,person
44008,40,person,39,0,17055,46,1084,1124,1152,1368,68,244,person
44009,1,car,2,0,17056,26,469,1075,1077,1393,608,318,car
44010,2,car,3,1,17056,18,2,1025,484,1542,482,517,car
44011,10,person,11,1,17056,17,1557,982,1610,1069,53,87,person
44012,11,person,12,0,17056,22,1041,981,1103,1163,62,182,person
44013,12,person,13,0,17056,35,1125,999,1197,1173,72,174,person
44014,46,door,47,0,17056,20,128,1055,368,1453,240,398,door
44015,18,car,14,0,17057,19,160,1149,256,1185,96,36,car
44016,19,car,15,1,17057,16,422,1131,485,1167,63,36,car
44017,21,car,17,1,17057,16,232,1140,308,1176,76,36,car
44018,36,car,32,1,17057,17,1958,1049,2047,1273,89,224,car
44019,0,car,1,0,17058,36,469,1512,845,1799,376,287,car
44020,1,car,2,0,17058,15,712,1439,782,1492,70,53,car
44021,10,truck,10,0,17058,22,954,1361,1240,1571,286,210,truck
44022,12,person,12,0,17058,41,245,1418,396,1911,151,493,person
44023,13,chair,13,0,17058,23,134,1774,343,2112,209,338,chair
44024,16,person,16,1,17058,19,144,1406,199,1511,55,105,person
44025,18,bench,18,0,17058,15,1309,1507,1395,1574,86,67,bench
44026,21,bench,21,0,17058,18,1507,1522,1643,1609,136,87,bench
44027,24,person,24,1,17058,17,1343,1432,1379,1518,36,86,person
44028,25,person,25,0,17058,21,1401,1440,1455,1561,54,121,person
44029,26,person,26,1,17058,18,1541,1434,1585,1518,44,84,person
44030,13,truck,14,1,17059,15,812,1058,1086,1249,274,191,truck
44031,14,truck,15,1,17059,31,3,923,634,1319,631,396,truck
44032,16,car,17,0,17059,33,647,1107,1030,1330,383,223,car
44033,18,car,18,0,17059,16,1426,1142,1549,1269,123,127,car
44034,19,person,19,0,17059,20,1664,1165,1692,1262,28,97,person
44035,20,person,20,0,17059,17,1731,1157,1774,1258,43,101,person
44036,30,car,30,1,17059,19,0,1105,328,1457,328,352,car
44037,14,truck,15,1,17060,16,1735,1054,1907,1234,172,180,truck
44038,15,car,16,1,17060,18,1640,1117,1792,1261,152,144,car
44039,17,car,18,1,17060,20,1503,1122,1703,1299,200,177,car
44040,18,car,19,0,17060,26,1197,1098,1571,1358,374,260,car
44041,0,person,1,0,17061,19,218,722,310,931,92,209,person
44042,1,person,2,1,17061,18,936,786,1095,960,159,174,person
44043,2,person,3,1,17061,17,648,745,825,960,177,215,person
44044,7,person,8,0,17061,23,493,740,547,867,54,127,person
44045,40,car,41,1,17061,31,1081,789,1202,921,121,132,car
44046,42,person,43,1,17061,29,909,769,1031,958,122,189,person
44047,1,fire hydrant,2,0,17062,20,658,1181,791,1439,133,258,fire hydrant
44048,4,car,4,0,17062,21,1464,869,2197,1174,733,305,car
44049,8,car,8,0,17062,25,961,839,1486,1060,525,221,car
44050,9,car,9,0,17062,21,614,825,920,975,306,150,car
44051,11,car,11,0,17062,26,411,813,631,928,220,115,car
44052,12,car,12,1,17062,25,315,794,468,896,153,102,car
44053,13,car,13,0,17062,19,213,779,340,855,127,76,car
44054,14,car,14,1,17062,18,157,762,267,834,110,72,car
44055,63,door,63,0,17062,21,1736,884,1899,1110,163,226,door
44056,64,door,64,0,17062,15,1589,884,1803,1103,214,219,door
44057,0,car,1,0,17063,23,862,1030,1569,1385,707,355,car
44058,2,car,3,0,17063,17,1543,1017,1938,1264,395,247,car
44059,3,car,4,0,17063,20,1945,996,2134,1137,189,141,car
44060,16,door,17,0,17063,19,1345,1055,1499,1296,154,241,door
44061,20,door,21,0,17063,15,1266,1055,1416,1310,150,255,door
44062,0,person,1,0,17064,35,1174,954,1292,1301,118,347,person
44063,1,car,2,1,17064,26,1538,1183,2048,1536,510,353,car
44064,16,person,15,0,17064,40,1347,936,1465,1297,118,361,person
44065,2,person,2,0,17065,19,527,470,671,798,144,328,person
44066,3,person,3,0,17065,24,701,420,870,887,169,467,person
44067,4,person,4,1,17065,32,199,489,496,1200,297,711,person
44068,27,person,25,1,17065,16,1010,397,1047,467,37,70,person
44069,72,person,66,1,17065,23,739,405,769,478,30,73,person
44070,73,person,67,0,17065,20,735,390,761,429,26,39,person
44071,74,person,68,0,17065,23,1547,388,1567,445,20,57,person
44072,75,person,69,1,17065,21,1556,393,1572,445,16,52,person
44073,10,person,11,0,17066,27,1351,1223,1430,1409,79,186,person
44074,11,person,12,0,17066,33,1447,1247,1508,1413,61,166,person
44075,14,door,15,0,17066,26,599,1215,1090,1537,491,322,door
44076,0,person,1,0,17067,26,716,385,1106,1122,390,737,person
44077,17,truck,18,1,17067,21,1389,252,1713,637,324,385,truck
44078,18,truck,19,1,17067,15,831,252,1264,518,433,266,truck
44079,25,fire hydrant,26,0,17067,36,55,744,254,1226,199,482,fire hydrant
44080,27,person,28,0,17067,25,70,411,129,608,59,197,person
44081,28,person,29,1,17067,20,2,361,52,754,50,393,person
44082,32,traffic light,33,0,17067,33,494,41,639,516,145,475,traffic light
44083,53,mirror,53,0,17067,17,121,463,176,510,55,47,mirror
44084,62,door,62,0,17067,26,1038,373,1122,593,84,220,door
44085,0,flowerpot,1,0,17068,15,426,652,530,739,104,87,potted plant
44086,1,person,2,0,17068,16,719,538,802,770,83,232,person
44087,7,bench,8,0,17068,17,239,653,349,767,110,114,bench
44088,8,bench,9,0,17068,15,169,666,301,800,132,134,bench
44089,9,bench,10,0,17068,17,81,684,218,833,137,149,bench
44090,10,bench,11,1,17068,15,2,708,125,888,123,180,bench
44091,12,plant pots,13,0,17068,19,523,613,626,721,103,108,potted plant
44092,19,fire hydrant,20,1,17068,18,998,645,1034,759,36,114,fire hydrant
44093,24,bird,25,0,17068,15,5,1093,65,1153,60,60,bird
44094,0,car,1,0,17069,18,196,899,581,1157,385,258,car
44095,16,bench,17,0,17069,17,913,914,1066,969,153,55,bench
44096,17,person,18,0,17069,24,1347,890,1393,975,46,85,person
44097,18,person,19,0,17069,28,1395,892,1440,977,45,85,person
44098,19,person,20,1,17069,17,1032,857,1075,966,43,109,person
44099,20,person,21,1,17069,15,1009,847,1042,914,33,67,person
44100,21,person,22,1,17069,15,518,851,546,915,28,64,person
44101,0,fire hydrant,1,0,17070,28,441,282,489,400,48,118,fire hydrant
44102,9,person,10,0,17071,24,1055,875,1096,991,41,116,person
44103,10,person,11,0,17071,24,1095,882,1136,983,41,101,person
44104,24,car,25,1,17071,17,2,993,259,1475,257,482,car
44105,1,motorbike,2,1,17072,45,575,945,716,1086,141,141,motorcycle
44106,7,traffic light,8,0,17072,39,919,168,1050,1364,131,1196,traffic light
44107,11,car,12,1,17072,36,1421,850,1938,1218,517,368,car
44108,12,person,13,1,17072,18,1716,836,1759,929,43,93,person
44109,13,person,14,1,17072,22,1757,831,1823,957,66,126,person
44110,17,person,18,0,17072,24,1981,826,2020,983,39,157,person
44111,18,person,19,0,17072,33,2012,819,2078,993,66,174,person
44112,19,car,20,1,17072,30,2,925,387,1109,385,184,car
44113,23,traffic light,24,0,17072,32,283,623,409,1131,126,508,traffic light
44114,0,car,1,0,17073,24,1341,950,1660,1047,319,97,car
44115,1,car,2,0,17073,22,703,970,1018,1060,315,90,car
44116,7,car,8,1,17073,15,1883,960,2200,1168,317,208,car
44117,10,fire hydrant,11,0,17073,30,499,1073,564,1199,65,126,fire hydrant
44118,13,person,14,0,17073,19,1745,928,1769,1018,24,90,person
44119,77,door,78,0,17073,17,1984,964,2157,1140,173,176,door
44120,86,parking meter,87,0,17073,18,1221,956,1247,1036,26,80,parking meter
44121,0,person,1,1,17074,22,304,308,1597,1647,1293,1339,person
44122,1,person,2,0,17074,22,138,613,334,1176,196,563,person
44123,2,person,3,0,17074,35,1552,514,2065,1444,513,930,person
44124,5,person,6,0,17074,15,379,704,488,1037,109,333,person
44125,13,person,14,0,17074,31,5,755,78,981,73,226,person
44126,30,person,31,0,17074,31,487,676,600,1041,113,365,person
44127,0,car,1,0,17076,35,668,344,793,401,125,57,car
44128,8,person,9,0,17076,24,87,341,117,440,30,99,person
44129,11,car,12,1,17076,18,111,343,173,417,62,74,car
44130,14,car,15,0,17076,24,300,352,393,406,93,54,car
44131,0,car,1,0,17077,15,23,783,1289,1423,1266,640,car
44132,4,bus,5,1,17077,21,594,606,1298,895,704,289,bus
44133,5,person,6,0,17077,27,131,667,214,873,83,206,person
44134,6,person,7,0,17077,25,214,684,288,869,74,185,person
44135,45,person,45,0,17077,25,1354,778,1409,909,55,131,person
44136,46,person,46,0,17077,27,1323,789,1368,906,45,117,person
44137,47,person,47,0,17077,26,1448,769,1490,911,42,142,person
44138,51,door,51,0,17077,15,744,814,1035,1242,291,428,door
44139,54,door,54,0,17077,22,977,815,1220,1187,243,372,door
44140,6,person,7,0,17078,22,1766,1154,1843,1369,77,215,person
44141,7,person,8,0,17078,27,1525,1156,1577,1354,52,198,person
44142,8,bicycle,9,0,17078,32,1496,1224,1641,1346,145,122,bicycle
44143,12,car,13,0,17078,17,1177,1179,1416,1393,239,214,car
44144,25,car,25,0,17078,23,167,1160,447,1340,280,180,car
44145,33,car,32,0,17078,21,775,1189,941,1310,166,121,car
44146,47,person,46,0,17078,19,0,1143,67,1264,67,121,person
44147,22,person,21,1,17079,15,1107,837,1149,1003,42,166,person
44148,24,person,23,0,17079,37,1062,838,1126,1018,64,180,person
44149,25,person,24,0,17079,30,1169,854,1243,1030,74,176,person
44150,0,person,1,0,17080,36,1551,931,1709,1534,158,603,person
44151,1,person,2,0,17080,33,1420,956,1630,1541,210,585,person
44152,2,person,3,0,17080,29,949,981,1086,1295,137,314,person
44153,26,person,27,0,17080,77,184,934,427,1417,243,483,person
44154,27,person,28,1,17080,67,263,955,472,1393,209,438,person
44155,29,person,30,0,17080,51,1361,1009,1460,1267,99,258,person
44156,31,person,32,1,17080,56,902,982,981,1238,79,256,person
44157,38,fire hydrant,39,1,17080,27,847,1093,888,1311,41,218,fire hydrant
44158,8,car,9,0,17082,29,1082,872,1629,1056,547,184,car
44159,9,car,10,0,17082,38,437,851,969,1072,532,221,car
44160,10,parking meter,11,0,17082,32,1009,874,1056,1024,47,150,parking meter
44161,30,car,31,1,17082,16,1848,857,2200,1038,352,181,car
44162,0,car,1,0,17083,44,1281,830,1712,1023,431,193,car
44163,18,truck,17,1,17083,17,501,832,605,877,104,45,truck
44164,19,truck,18,1,17083,25,421,820,522,877,101,57,truck
44165,20,truck,19,1,17083,17,486,821,558,879,72,58,truck
44166,26,truck,25,1,17083,17,43,803,72,821,29,18,truck
44167,44,truck,43,1,17083,19,1250,802,1430,938,180,136,truck
44168,1,car,2,0,17084,23,272,433,1244,731,972,298,car
44169,25,person,25,1,17084,17,1550,410,1597,550,47,140,person
44170,0,car,1,0,17086,19,836,1052,1377,1473,541,421,car
44171,1,car,2,0,17086,16,32,990,567,1248,535,258,car
44172,13,car,7,1,17086,20,859,992,1042,1117,183,125,car
44173,33,person,27,0,17086,20,1602,981,1616,1013,14,32,person
44174,34,fire hydrant,28,0,17086,23,1571,1019,1592,1074,21,55,fire hydrant
44175,38,person,32,0,17086,39,1614,972,1650,1071,36,99,person
44176,39,car,33,1,17086,37,1242,1022,1483,1221,241,199,car
44177,61,window,55,0,17086,16,1259,1041,1406,1099,147,58,window
44178,68,window,62,0,17086,18,895,1106,1213,1221,318,115,window
44179,4,person,5,0,17087,37,451,966,497,1103,46,137,person
44180,12,car,13,1,17087,16,1096,958,1159,1066,63,108,car
44181,13,car,14,1,17087,19,1134,952,1246,1071,112,119,car
44182,14,car,15,1,17087,22,1211,952,1278,1083,67,131,car
44183,15,car,16,1,17087,22,1356,949,1486,1103,130,154,car
44184,17,car,18,1,17087,44,1331,1016,1924,1626,593,610,car
44185,18,car,19,1,17087,19,1670,1076,2197,1648,527,572,car
44186,19,mirror,20,0,17087,15,1778,1366,1912,1457,134,91,mirror
44187,20,car,21,1,17087,16,1970,949,2196,1097,226,148,car
44188,21,car,22,1,17087,20,1707,926,2042,1106,335,180,car
44189,28,truck,29,0,17087,15,879,849,958,939,79,90,truck
44190,0,car,1,0,17088,22,1248,940,2013,1196,765,256,car
44191,1,car,2,0,17088,23,449,960,1219,1190,770,230,car
44192,12,person,13,0,17088,21,319,914,398,1135,79,221,person
44193,13,person,14,0,17088,34,360,920,464,1145,104,225,person
44194,16,person,17,1,17088,15,1739,893,1789,999,50,106,person
44195,64,door,63,0,17088,16,1549,950,1806,1143,257,193,door
44196,0,car,1,0,17090,39,812,661,1720,1073,908,412,car
44197,1,car,2,0,17090,32,164,714,851,1047,687,333,car
44198,9,door,10,0,17090,19,1224,703,1427,998,203,295,door
44199,13,door,14,0,17090,15,1012,700,1238,991,226,291,door
44200,14,window,15,0,17090,15,1041,720,1178,823,137,103,window
44201,30,window,31,0,17090,17,451,799,553,873,102,74,window
44202,3,car,4,0,17091,29,162,1054,1024,1596,862,542,car
44203,12,car,13,1,17091,25,736,1030,1086,1305,350,275,car
44204,13,car,14,1,17091,16,977,1015,1150,1178,173,163,car
44205,14,car,15,1,17091,22,1120,1023,1197,1152,77,129,car
44206,20,parking meter,21,0,17091,18,1129,1071,1171,1347,42,276,parking meter
44207,21,car,22,1,17091,21,365,1024,603,1151,238,127,car
44208,25,person,26,0,17091,35,1253,986,1298,1110,45,124,person
44209,43,person,44,0,17092,24,1511,1294,1545,1375,34,81,person
44210,44,person,45,0,17092,18,1439,1314,1464,1380,25,66,person
44211,45,person,46,0,17092,18,1488,1310,1509,1378,21,68,person
44212,46,person,47,0,17092,27,1345,1357,1381,1461,36,104,person
44213,47,person,48,0,17092,22,1242,1335,1274,1421,32,86,person
44214,50,person,51,0,17092,20,1190,1345,1216,1416,26,71,person
44215,108,person,109,1,17092,17,1952,1439,2030,1534,78,95,person
44216,19,motorbike,12,0,17093,25,955,987,1099,1112,144,125,motorcycle
44217,28,person,20,0,17093,26,1304,943,1352,1124,48,181,person
44218,29,person,21,0,17093,31,1394,936,1443,1126,49,190,person
44219,31,person,23,0,17093,38,1331,948,1387,1122,56,174,person
44220,32,person,24,0,17093,32,1265,948,1311,1129,46,181,person
44221,33,person,25,0,17093,44,1200,935,1266,1137,66,202,person
44222,34,person,26,0,17093,29,1145,938,1190,1109,45,171,person
44223,35,person,27,0,17093,28,1110,935,1154,1115,44,180,person
44224,36,person,28,0,17093,21,869,931,903,1023,34,92,person
44225,37,person,29,0,17093,18,924,935,947,1016,23,81,person
44226,38,person,30,0,17093,24,943,933,971,1016,28,83,person
44227,39,person,31,0,17093,23,967,936,992,1018,25,82,person
44228,40,motorbike,32,0,17093,32,1583,998,1650,1123,67,125,motorcycle
44229,41,traffic light,33,0,17093,25,1068,768,1161,1113,93,345,traffic light
44230,0,car,1,0,17094,21,1580,1007,1981,1141,401,134,car
44231,1,car,2,0,17094,21,965,1026,1406,1164,441,138,car
44232,13,person,13,1,17094,19,1636,963,1673,1066,37,103,person
44233,20,bicycle,20,0,17094,55,774,1051,931,1141,157,90,bicycle
44234,82,person,82,0,17094,53,1205,977,1281,1161,76,184,person
44235,13,car,14,0,17095,22,601,903,848,1093,247,190,car
44236,40,person,41,0,17095,25,1656,923,1701,1066,45,143,person
44237,0,person,1,0,17096,28,908,614,1213,1401,305,787,person
44238,38,person,39,1,17096,34,1441,811,1570,1124,129,313,person
44239,40,person,41,0,17096,31,1222,735,1277,919,55,184,person
44240,43,car,44,1,17096,19,2069,789,2192,946,123,157,car
44241,44,car,45,0,17096,17,1905,756,1973,805,68,49,car
44242,1,person,2,0,17097,53,1192,906,1333,1395,141,489,person
44243,3,person,4,0,17097,60,1464,919,1696,1435,232,516,person
44244,6,person,7,0,17097,53,1782,899,1963,1467,181,568,person
44245,22,car,22,1,17097,31,20,882,215,1006,195,124,car
44246,0,car,1,0,17098,29,1106,995,1832,1209,726,214,car
44247,42,traffic light,43,0,17098,34,418,520,1198,1034,780,514,traffic light
44248,48,traffic light,49,0,17098,26,435,435,524,1084,89,649,traffic light
44249,51,person,52,0,17098,30,570,957,615,1071,45,114,person
44250,52,person,53,1,17098,20,607,961,637,1064,30,103,person
44251,53,person,54,1,17098,16,649,961,671,1040,22,79,person
44252,54,person,55,0,17098,27,613,969,665,1075,52,106,person
44253,57,person,58,1,17098,21,693,975,727,1081,34,106,person
44254,58,person,59,0,17098,28,719,971,766,1099,47,128,person
44255,59,person,60,0,17098,25,774,968,811,1098,37,130,person
44256,60,person,61,1,17098,21,804,969,835,1082,31,113,person
44257,61,person,62,0,17098,21,918,974,954,1105,36,131,person
44258,63,person,64,0,17098,27,869,959,917,1105,48,146,person
44259,64,person,65,0,17098,32,828,963,878,1111,50,148,person
44260,65,person,66,0,17098,31,1056,971,1112,1092,56,121,person
44261,66,person,67,0,17098,37,1009,946,1067,1101,58,155,person
44262,67,person,68,1,17098,17,1237,946,1282,1024,45,78,person
44263,70,person,71,0,17098,16,89,955,115,1033,26,78,person
44264,71,person,72,0,17098,26,188,951,232,1048,44,97,person
44265,72,person,73,0,17098,17,59,950,87,1041,28,91,person
44266,74,person,75,1,17098,17,488,952,529,1071,41,119,person
44267,97,door,98,0,17098,15,1254,1005,1384,1154,130,149,door
44268,22,person,17,0,17099,19,288,921,328,1022,40,101,person
44269,25,person,20,0,17099,23,72,932,124,1071,52,139,person
44270,26,bench,21,1,17099,18,139,989,186,1067,47,78,bench
44271,27,person,22,0,17099,28,153,973,216,1077,63,104,person
44272,30,person,25,0,17099,32,223,977,361,1080,138,103,person
44273,36,person,31,0,17099,22,448,948,463,994,15,46,person
44274,37,person,32,0,17099,21,418,954,436,997,18,43,person
44275,4,person,5,0,17100,48,1144,1014,1316,1468,172,454,person
44276,5,person,6,0,17100,59,1705,957,2001,1647,296,690,person
44277,6,person,7,1,17100,28,2007,1040,2199,1649,192,609,person
44278,8,person,9,0,17100,33,1361,1104,1460,1390,99,286,person
44279,9,person,10,1,17100,32,1276,1090,1371,1386,95,296,person
44280,10,person,11,0,17100,26,1020,1076,1115,1315,95,239,person
44281,11,person,12,0,17100,29,981,1090,1049,1291,68,201,person
44282,12,person,13,0,17100,45,592,963,780,1454,188,491,person
44283,13,person,14,0,17100,36,821,1030,943,1294,122,264,person
44284,14,person,15,0,17100,22,774,1075,836,1270,62,195,person
44285,15,person,16,0,17100,20,553,1035,608,1171,55,136,person
44286,16,person,17,0,17100,47,265,978,418,1380,153,402,person
44287,18,traffic light,19,0,17100,24,573,246,739,1247,166,1001,traffic light
44288,24,car,23,0,17100,21,132,1019,269,1094,137,75,car
44289,25,car,24,1,17100,20,2,972,139,1105,137,133,car
44290,60,truck,59,1,17100,17,372,1013,420,1064,48,51,truck
44291,61,car,60,1,17100,15,414,1056,443,1092,29,36,car
44292,62,bus,61,1,17100,17,439,1034,496,1088,57,54,bus
44293,63,car,62,1,17100,15,469,1070,491,1110,22,40,car
44294,65,person,64,1,17100,24,594,1035,658,1116,64,81,person
44295,69,car,68,1,17100,17,512,1080,560,1137,48,57,car
44296,71,person,70,0,17100,49,934,1065,995,1237,61,172,person
44297,72,person,71,1,17100,49,1128,1075,1185,1333,57,258,person
44298,74,person,73,1,17100,19,777,1061,803,1119,26,58,person
44299,75,person,74,1,17100,26,800,1047,839,1090,39,43,person
44300,77,person,76,1,17100,20,838,1045,865,1088,27,43,person
44301,0,car,1,0,17101,24,699,1091,877,1237,178,146,car
44302,1,fire hydrant,2,0,17101,40,1702,1168,1738,1244,36,76,fire hydrant
44303,13,person,14,0,17102,17,1910,853,1935,925,25,72,person
44304,14,person,15,0,17102,26,1957,848,1981,924,24,76,person
44305,15,person,16,0,17102,23,2014,841,2058,928,44,87,person
44306,22,car,23,1,17102,15,1140,886,1240,997,100,111,car
44307,24,car,25,0,17102,45,1246,862,1624,1137,378,275,car
44308,25,fire hydrant,26,0,17102,48,1480,1219,1665,1552,185,333,fire hydrant
44309,14,person,15,0,17103,15,1243,962,1262,1018,19,56,person
44310,16,person,17,0,17103,17,1316,964,1333,1016,17,52,person
44311,35,bicycle,20,0,17105,75,1381,856,2031,1359,650,503,bicycle
44312,39,car,24,1,17105,25,0,586,210,849,210,263,car
44313,42,car,27,1,17105,39,154,625,594,837,440,212,car
44314,45,car,30,1,17105,91,882,542,1860,1151,978,609,car
44315,48,traffic light,33,0,17105,17,1382,434,1542,586,160,152,traffic light
44316,0,car,1,0,17106,27,483,981,1669,1369,1186,388,car
44317,25,traffic light,24,0,17106,40,446,2,698,1204,252,1202,traffic light
44318,53,person,52,0,17106,19,600,937,644,1053,44,116,person
44319,54,person,53,0,17106,23,645,938,694,1061,49,123,person
44320,0,car,1,0,17107,20,575,1005,1098,1307,523,302,car
44321,37,door,38,0,17107,17,931,1036,1040,1223,109,187,door
44322,40,door,41,0,17107,17,876,1031,963,1227,87,196,door
44323,3,car,4,1,17108,15,1216,322,1360,408,144,86,car
44324,5,person,6,1,17108,28,1268,379,1445,701,177,322,person
44325,11,car,12,1,17108,19,1439,367,1573,497,134,130,car
44326,13,car,14,1,17108,17,1748,383,1917,540,169,157,car
44327,14,car,15,1,17108,18,1837,388,2047,627,210,239,car
44328,15,car,16,0,17108,28,1496,369,1812,618,316,249,car
44329,22,car,23,0,17108,54,4,484,1589,1210,1585,726,car
44330,23,person,24,0,17108,15,572,575,852,761,280,186,person
44331,27,window,28,0,17108,15,936,589,1298,772,362,183,window
44332,32,door,33,0,17108,16,359,554,908,1069,549,515,door
44333,15,car,16,0,17109,28,776,817,937,933,161,116,car
44334,22,person,23,1,17109,15,1231,794,1255,895,24,101,person
44335,33,person,34,0,17109,19,1013,819,1034,871,21,52,person
44336,0,car,1,0,17111,19,515,889,979,1058,464,169,car
44337,4,car,4,0,17111,17,1414,902,1584,972,170,70,car
44338,5,car,5,0,17111,17,1581,902,1720,967,139,65,car
44339,11,bus,11,1,17111,16,707,830,1053,920,346,90,bus
44340,15,dog,15,0,17111,20,140,930,196,996,56,66,dog
44341,16,person,16,0,17111,22,213,863,255,995,42,132,person
44342,17,motorbike,17,0,17111,31,246,918,331,1003,85,85,motorcycle
44343,31,traffic light,31,0,17111,26,1751,683,1973,949,222,266,traffic light
44344,33,traffic light,33,0,17111,16,626,791,680,925,54,134,traffic light
44345,34,person,34,0,17111,28,449,893,485,982,36,89,person
44346,36,traffic light,36,0,17111,28,1267,602,1517,902,250,300,traffic light
44347,43,door,43,0,17111,15,814,908,912,1020,98,112,door
44348,67,person,67,0,17111,21,1023,873,1047,943,24,70,person
44349,68,person,68,0,17111,22,1175,875,1199,942,24,67,person
44350,69,person,69,0,17111,22,1065,871,1090,949,25,78,person
44351,4,car,5,0,17112,30,3,691,791,1328,788,637,car
44352,9,person,10,0,17112,45,917,671,1181,1273,264,602,person
44353,21,person,20,0,17112,30,1249,723,1304,849,55,126,person
44354,25,car,24,0,17112,23,758,766,956,1034,198,268,car
44355,37,person,33,0,17112,23,1455,710,1523,884,68,174,person
44356,38,person,34,0,17112,23,1384,736,1442,884,58,148,person
44357,43,traffic light,39,0,17112,15,1169,132,1272,767,103,635,traffic light
44358,16,person,17,0,17113,20,1351,1290,1373,1382,22,92,person
44359,28,car,29,0,17113,15,3,1300,70,1355,67,55,car
44360,18,person,18,0,17114,30,744,1804,850,2001,106,197,person
44361,19,person,19,1,17114,26,1487,1490,1557,1748,70,258,person
44362,23,person,23,0,17114,16,450,1534,562,1649,112,115,person
44363,28,person,28,0,17114,39,1410,1574,1586,1908,176,334,person
44364,44,person,42,0,17114,32,1184,1496,1281,1715,97,219,person
44365,16,person,16,1,17115,21,836,764,901,845,65,81,person
44366,17,motorbike,17,1,17115,20,848,814,901,898,53,84,motorcycle
44367,24,motorbike,24,0,17115,23,1338,795,1378,852,40,57,motorcycle
44368,26,motorbike,26,0,17115,23,1391,806,1430,873,39,67,motorcycle
44369,27,person,27,0,17115,18,1397,770,1430,812,33,42,person
44370,28,car,28,1,17115,22,1351,764,1468,817,117,53,car
44371,31,car,31,1,17115,19,1518,765,1570,832,52,67,car
44372,32,car,32,0,17115,16,1620,777,1692,828,72,51,car
44373,48,car,48,0,17115,31,466,774,888,1008,422,234,car
44374,0,parking meter,1,0,17116,20,249,497,267,618,18,121,parking meter
44375,1,fire hydrant,2,0,17116,38,1239,569,1291,701,52,132,fire hydrant
44376,2,truck,3,0,17116,32,847,390,1044,602,197,212,truck
44377,3,person,4,0,17116,16,1316,490,1436,799,120,309,person
44378,4,person,5,0,17116,17,85,505,178,742,93,237,person
44379,23,parking meter,24,0,17116,15,362,501,379,610,17,109,parking meter
44380,37,car,35,0,17116,16,499,505,585,580,86,75,car
44381,45,car,43,0,17116,28,1041,498,1159,584,118,86,car
44382,93,car,91,1,17116,18,37,461,311,611,274,150,car
44383,0,car,1,0,17117,17,476,916,1348,1235,872,319,car
44384,1,car,2,0,17117,16,1344,937,1961,1164,617,227,car
44385,22,motorbike,22,1,17117,17,352,870,518,1027,166,157,motorcycle
44386,52,motorbike,47,1,17117,20,1269,888,1380,1022,111,134,motorcycle
44387,59,door,54,0,17117,15,711,932,968,1166,257,234,door
44388,63,door,58,0,17117,17,938,935,1139,1170,201,235,door
44389,71,door,66,0,17117,17,56,890,219,1071,163,181,door
44390,0,traffic light,1,0,17118,18,1495,665,1571,1215,76,550,traffic light
44391,1,car,2,0,17118,21,750,966,1251,1142,501,176,car
44392,6,car,6,1,17118,15,1700,941,1849,1007,149,66,car
44393,9,traffic light,9,0,17118,21,1738,686,1835,1176,97,490,traffic light
44394,11,person,11,0,17118,27,312,934,368,1088,56,154,person
44395,18,car,16,1,17118,19,572,964,850,1125,278,161,car
44396,34,motorbike,29,0,17118,18,150,985,195,1080,45,95,motorcycle
44397,36,motorbike,31,0,17118,43,374,993,552,1102,178,109,motorcycle
44398,37,person,32,1,17118,24,454,946,491,1037,37,91,person
44399,38,person,33,0,17118,29,434,951,485,1104,51,153,person
44400,39,motorbike,34,0,17118,47,1325,990,1458,1103,133,113,motorcycle
44401,40,person,35,0,17118,30,1350,929,1416,1079,66,150,person
44402,47,door,42,0,17118,17,907,974,1028,1105,121,131,door
44403,60,door,55,0,17118,17,670,971,773,1092,103,121,door
44404,67,person,62,1,17118,24,373,927,418,1022,45,95,person
44405,68,traffic light,63,0,17118,37,557,816,630,991,73,175,traffic light
44406,72,person,67,1,17118,17,800,932,839,977,39,45,person
44407,73,car,68,1,17118,15,1105,949,1195,1016,90,67,car
44408,74,car,69,1,17118,23,1059,943,1181,1023,122,80,car
44409,75,car,70,1,17118,32,946,942,1159,1019,213,77,car
44410,76,person,71,1,17118,17,1029,931,1075,980,46,49,person
44411,77,person,72,0,17118,22,236,947,260,1028,24,81,person
44412,78,person,73,0,17118,27,199,943,230,1027,31,84,person
44413,79,car,74,1,17118,45,1398,936,1702,1084,304,148,car
44414,90,motorbike,85,0,17118,29,1862,968,1922,1039,60,71,motorcycle
44415,91,motorbike,86,0,17118,39,1912,963,1971,1040,59,77,motorcycle
44416,92,motorbike,87,0,17118,17,1964,969,1994,1041,30,72,motorcycle
44417,93,motorbike,88,1,17118,27,2042,960,2090,1043,48,83,motorcycle
44418,95,traffic light,90,0,17118,28,2024,809,2062,1042,38,233,traffic light
44419,9,car,10,1,17119,17,1176,1121,1333,1278,157,157,car
44420,11,car,12,0,17119,27,979,1167,1247,1353,268,186,car
44421,12,traffic light,13,0,17119,33,1183,646,1399,1372,216,726,traffic light
44422,17,person,18,0,17119,21,1592,1117,1664,1333,72,216,person
44423,18,person,19,0,17119,24,1541,1130,1635,1383,94,253,person
44424,22,person,22,1,17119,16,1896,1108,1945,1250,49,142,person
44425,23,person,23,1,17119,25,1636,1144,1829,1530,193,386,person
44426,24,person,24,1,17119,36,1553,1172,2150,1650,597,478,person
44427,27,car,27,1,17119,21,16,1125,205,1270,189,145,car
44428,28,car,28,1,17119,17,223,1144,422,1255,199,111,car
44429,29,car,29,1,17119,20,772,1130,924,1232,152,102,car
44430,31,car,31,0,17119,39,328,1103,766,1332,438,229,car
44431,32,person,32,0,17119,30,609,1114,682,1402,73,288,person
44432,60,person,58,1,17119,15,1707,1141,1757,1232,50,91,person
44433,1,parking meter,2,0,17120,31,832,776,884,951,52,175,parking meter
44434,2,car,3,0,17120,35,916,787,1613,1003,697,216,car
44435,0,car,1,0,17121,41,495,838,949,1046,454,208,car
44436,1,car,2,0,17121,34,1215,835,1832,1071,617,236,car
44437,48,door,49,0,17121,17,657,848,763,1001,106,153,door
44438,63,door,64,0,17121,15,1324,849,1467,1027,143,178,door
44439,7,car,8,0,17122,38,162,742,1556,1507,1394,765,car
44440,8,motorbikes,9,0,17124,44,1242,733,1451,973,209,240,motorcycle
44441,9,person,10,1,17124,18,1277,721,1329,791,52,70,person
44442,1,car,2,0,17125,15,1189,1071,1684,1250,495,179,car
44443,14,fire hydrant,15,0,17125,31,681,1109,720,1219,39,110,fire hydrant
44444,17,car,18,1,17126,21,18,835,133,934,115,99,car
44445,18,car,19,0,17126,31,32,851,185,978,153,127,car
44446,29,motorbike,30,0,17126,80,571,906,817,1220,246,314,motorcycle
44447,0,car,1,1,17127,23,148,769,407,953,259,184,car
44448,1,car,2,0,17127,38,352,779,714,986,362,207,car
44449,2,car,3,1,17127,19,925,797,1210,953,285,156,car
44450,3,car,4,1,17127,19,1230,805,1386,937,156,132,car
44451,4,car,5,1,17127,17,1477,783,1645,935,168,152,car
44452,5,car,6,1,17127,34,1548,860,2201,1374,653,514,car
44453,4,car,5,0,17128,23,1102,741,1756,1014,654,273,car
44454,5,car,6,0,17128,18,1738,763,2158,968,420,205,car
44455,14,door,15,0,17128,15,1394,749,1531,957,137,208,door
44456,15,window,16,0,17128,19,1416,759,1518,846,102,87,window
44457,19,door,20,0,17128,17,1522,750,1663,951,141,201,door
44458,1,car,2,0,17129,37,1184,913,1659,1076,475,163,car
44459,20,traffic light,16,0,17129,30,214,745,345,1062,131,317,traffic light
44460,26,traffic light,22,0,17129,84,981,2,1367,1126,386,1124,traffic light
44461,44,person,39,1,17129,15,1241,889,1300,975,59,86,person
44462,71,door,66,0,17129,15,1482,918,1570,1034,88,116,door
44463,5,traffic light,6,0,17130,27,1060,581,1206,1297,146,716,traffic light
44464,0,person,1,0,17131,18,17,1173,136,1551,119,378,person
44465,0,car,1,0,17132,36,1599,981,1946,1106,347,125,car
44466,1,car,2,0,17132,27,183,977,725,1191,542,214,car
44467,6,traffic light,7,0,17132,28,711,531,781,1048,70,517,traffic light
44468,8,person,9,0,17132,28,937,981,981,1094,44,113,person
44469,9,person,10,0,17132,19,975,1031,1009,1094,34,63,person
44470,74,door,74,0,17132,15,493,991,622,1144,129,153,door
44471,82,door,82,0,17132,15,1823,986,1888,1063,65,77,door
44472,8,person,7,0,17134,32,287,676,379,891,92,215,person
44473,22,person,20,1,17134,15,41,697,87,750,46,53,person
44474,24,person,22,1,17134,34,81,703,157,936,76,233,person
44475,25,person,23,1,17134,32,1,633,127,1421,126,788,person
44476,1,person,1,0,17135,15,729,529,793,677,64,148,person
44477,29,car,29,0,17135,31,2,550,287,703,285,153,car
44478,33,door,33,0,17135,18,169,556,240,674,71,118,door
44479,98,person,64,0,17136,36,646,1101,685,1204,39,103,person
44480,99,person,65,0,17136,31,675,1103,709,1200,34,97,person
44481,100,car,66,1,17136,31,932,1121,1354,1258,422,137,car
44482,110,person,76,0,17136,36,1782,1073,1828,1195,46,122,person
44483,112,person,78,1,17136,29,1859,1054,1898,1192,39,138,person
44484,113,person,79,0,17136,37,1871,1070,1924,1195,53,125,person
44485,114,person,80,0,17136,30,1998,1072,2047,1194,49,122,person
44486,7,person,8,0,17137,24,1274,940,1428,1142,154,202,person
44487,9,person,10,0,17137,34,768,1007,947,1199,179,192,person
44488,10,person,11,0,17137,32,982,845,1114,1256,132,411,person
44489,12,person,13,0,17137,30,586,877,668,1187,82,310,person
44490,13,person,14,0,17137,40,356,845,459,1137,103,292,person
44491,14,person,15,0,17137,56,70,823,239,1418,169,595,person
44492,15,person,16,1,17137,49,174,870,334,1386,160,516,person
44493,19,person,20,0,17137,24,690,850,763,1079,73,229,person
44494,20,chair,21,0,17137,16,1201,910,1269,982,68,72,chair
44495,22,person,23,0,17137,21,1845,840,1897,992,52,152,person
44496,3,person,4,0,17138,19,1510,747,1665,1235,155,488,person
44497,4,person,5,0,17138,19,1638,992,1759,1268,121,276,person
44498,5,person,6,0,17138,21,1379,785,1535,1216,156,431,person
44499,0,traffic light,1,0,17139,26,321,2,573,1040,252,1038,traffic light
44500,1,person,2,0,17139,20,722,440,846,779,124,339,person
44501,3,car,3,0,17139,16,359,496,563,619,204,123,car
44502,6,car,6,1,17139,15,2,515,249,673,247,158,car
44503,30,person,29,0,17139,28,948,480,996,628,48,148,person
44504,83,door,80,0,17139,16,87,521,158,632,71,111,door
44505,87,door,84,0,17139,20,130,519,202,622,72,103,door
44506,92,person,89,1,17139,29,1009,473,1024,513,15,40,person
44507,93,person,90,0,17139,34,1032,470,1047,511,15,41,person
44508,94,person,91,0,17139,93,882,450,947,689,65,239,person
44509,95,car,92,1,17139,20,723,481,768,512,45,31,car
44510,9,car,10,0,17140,17,1662,944,1909,1160,247,216,car
44511,22,person,23,1,17140,18,0,1035,87,1648,87,613,person
44512,32,person,29,0,17143,43,1137,354,1212,574,75,220,person
44513,41,person,38,0,17143,33,908,379,963,543,55,164,person
44514,49,person,46,0,17143,33,775,359,829,481,54,122,person
44515,57,backpack,54,0,17143,18,793,374,823,424,30,50,backpack
44516,58,person,55,0,17143,41,704,366,753,489,49,123,person
44517,0,car,1,0,17144,15,521,1030,829,1234,308,204,car
44518,1,car,2,0,17144,18,1430,915,2195,1333,765,418,car
44519,9,car,10,1,17144,25,1122,1015,1505,1235,383,220,car
44520,10,car,11,1,17144,28,924,993,1210,1194,286,201,car
44521,37,car,38,1,17144,17,750,1005,932,1096,182,91,car
44522,38,car,39,1,17144,22,822,1036,970,1167,148,131,car
44523,0,car,1,0,17145,22,131,447,1256,773,1125,326,car
44524,12,door,13,0,17145,17,554,454,864,693,310,239,door
44525,3,person,4,0,17146,28,84,97,118,199,34,102,person
44526,9,car,10,1,17146,15,715,109,799,174,84,65,car
44527,0,car,1,0,17147,28,17,373,810,991,793,618,car
44528,1,car,2,0,17147,22,711,305,1019,525,308,220,car
44529,3,car,4,0,17147,36,1124,313,1544,541,420,228,car
44530,20,car,21,1,17147,17,708,267,848,389,140,122,car
44531,21,car,22,1,17147,19,666,282,731,384,65,102,car
44532,29,bicycle,30,1,17147,30,117,319,183,417,66,98,bicycle
44533,40,window,41,0,17147,16,88,395,706,550,618,155,window
44534,13,bicycle,13,0,17148,38,733,980,804,1090,71,110,bicycle
44535,14,bicycle,14,0,17148,24,803,970,852,1094,49,124,bicycle
44536,17,car,17,0,17148,41,1024,954,1304,1159,280,205,car
44537,19,truck,19,0,17148,26,1333,928,1464,1005,131,77,truck
44538,21,car,21,0,17148,15,1238,950,1338,1003,100,53,car
44539,22,car,22,0,17148,21,1641,939,1780,1001,139,62,car
44540,28,car,28,0,17148,26,1944,962,2199,1087,255,125,car
44541,30,car,30,0,17148,18,1824,926,1972,1007,148,81,car
44542,31,person,31,1,17148,25,920,919,969,1092,49,173,person
44543,37,car,37,0,17148,23,1683,951,1843,1042,160,91,car
44544,30,bench,20,0,17149,17,1352,995,1453,1033,101,38,bench
44545,33,bus,23,1,17149,29,1300,915,1553,1013,253,98,bus
44546,40,person,30,1,17149,15,1713,941,1734,1013,21,72,person
44547,42,person,32,0,17149,22,460,998,499,1076,39,78,person
44548,10,car,11,1,17150,30,203,971,891,1371,688,400,car
44549,11,car,12,1,17150,38,715,789,2048,1532,1333,743,car
44550,28,door,29,0,17150,16,315,986,468,1260,153,274,door
44551,0,car,1,0,17151,18,388,582,717,778,329,196,car
44552,1,car,2,0,17151,18,730,573,1005,764,275,191,car
44553,2,car,3,0,17151,15,1072,603,1274,763,202,160,car
44554,25,truck,23,1,17151,15,1310,490,1469,700,159,210,truck
44555,27,car,25,1,17151,15,978,582,1086,682,108,100,car
44556,0,car,1,0,17152,22,719,849,1680,1177,961,328,car
44557,42,door,43,0,17152,22,929,862,1165,1112,236,250,door
44558,43,door,44,0,17152,16,1140,862,1406,1109,266,247,door
44559,0,car,1,0,17153,50,688,696,1135,940,447,244,car
44560,2,car,3,0,17153,18,176,645,494,769,318,124,car
44561,12,person,13,0,17153,23,139,636,176,739,37,103,person
44562,48,door,49,0,17153,20,997,704,1099,866,102,162,door
44563,50,door,51,0,17153,17,959,702,1047,876,88,174,door
44564,0,person,1,0,17154,32,937,942,991,1090,54,148,person
44565,8,car,9,0,17154,30,471,1009,981,1173,510,164,car
44566,9,car,10,0,17154,29,1609,980,2130,1166,521,186,car
44567,6,person,6,0,17155,46,491,896,662,1194,171,298,person
44568,15,person,15,0,17155,28,1149,881,1225,1081,76,200,person
44569,25,car,25,1,17155,24,1868,870,1926,916,58,46,car
44570,26,person,26,0,17155,26,1870,893,1899,961,29,68,person
44571,30,traffic light,30,0,17155,20,1986,848,2034,1030,48,182,traffic light
44572,32,person,32,0,17155,29,1927,907,1969,1009,42,102,person
44573,34,traffic light,34,0,17155,30,1430,811,1477,1021,47,210,traffic light
44574,35,person,35,0,17155,47,1225,902,1294,1088,69,186,person
44575,36,person,36,0,17155,47,1289,908,1343,1075,54,167,person
44576,37,person,37,1,17155,25,1332,912,1370,1022,38,110,person
44577,40,person,40,1,17155,36,446,874,545,1188,99,314,person
44578,3,bicycle,3,0,17156,32,1508,860,1694,1000,186,140,bicycle
44579,4,parking meter,4,0,17156,15,1549,826,1597,982,48,156,parking meter
44580,5,car,5,0,17156,30,863,833,1529,1039,666,206,car
44581,6,person,6,0,17156,27,120,756,231,980,111,224,person
44582,23,door,20,0,17156,16,1236,841,1381,1004,145,163,door
44583,0,car,1,0,17157,34,731,739,1776,1380,1045,641,car
44584,32,door,31,0,17157,19,1357,777,1579,1238,222,461,door
44585,1,bicycle,2,0,17158,16,1055,651,1143,807,88,156,bicycle
44586,2,traffic light,3,0,17158,24,1258,88,1352,869,94,781,traffic light
44587,4,motorbike,5,0,17158,20,242,621,447,804,205,183,motorcycle
44588,5,truck,6,1,17158,15,1083,440,1326,691,243,251,truck
44589,6,car,7,0,17158,17,1301,571,1439,656,138,85,car
44590,19,person,20,0,17158,17,808,634,934,1023,126,389,person
44591,21,truck,22,1,17158,17,1415,378,1600,741,185,363,truck
44592,0,car,1,0,17159,24,813,914,1776,1223,963,309,car
44593,1,car,2,1,17159,20,3,914,784,1240,781,326,car
44594,37,door,38,0,17159,18,1199,919,1513,1152,314,233,door
44595,44,car,42,0,17160,30,288,165,451,270,163,105,car
44596,0,car,1,0,17161,56,243,979,1636,1490,1393,511,car
44597,6,motorbike,7,0,17161,24,1496,998,1724,1171,228,173,motorcycle
44598,8,traffic light,8,0,17161,27,2004,702,2070,1114,66,412,traffic light
44599,10,traffic light,10,1,17161,64,1128,11,1282,1097,154,1086,traffic light
44600,11,motorbike,11,1,17161,39,2,1104,199,1475,197,371,motorcycle
44601,12,car,12,0,17161,42,2,935,389,1279,387,344,car
44602,13,car,13,0,17161,21,289,952,609,1076,320,124,car
44603,6,person,7,0,17162,30,1219,1146,1323,1338,104,192,person
44604,8,person,9,1,17162,27,1468,1008,1542,1362,74,354,person
44605,10,person,11,0,17162,30,1480,1022,1635,1478,155,456,person
44606,20,person,21,0,17162,23,1138,1035,1181,1251,43,216,person
44607,21,person,22,0,17162,32,1051,1031,1123,1255,72,224,person
44608,24,person,25,0,17162,21,138,1068,206,1274,68,206,person
44609,25,person,26,0,17162,17,204,1057,254,1268,50,211,person
44610,27,dog,28,1,17162,19,823,1157,861,1216,38,59,dog
44611,30,person,31,1,17162,22,690,1074,744,1157,54,83,person
44612,31,person,32,1,17162,20,879,1052,921,1200,42,148,person
44613,32,person,33,0,17162,45,720,1065,830,1385,110,320,person
44614,34,person,35,1,17162,19,594,1060,635,1146,41,86,person
44615,35,person,36,0,17162,46,502,1052,597,1337,95,285,person
44616,37,person,38,1,17162,25,397,1064,463,1257,66,193,person
44617,38,person,39,0,17162,52,387,1100,536,1455,149,355,person
44618,39,person,40,0,17162,64,219,1054,412,1497,193,443,person
44619,41,person,42,0,17162,71,579,1054,741,1525,162,471,person
44620,57,person,58,1,17162,15,259,1072,303,1177,44,105,person
44621,6,person,7,0,17163,47,1150,983,1204,1116,54,133,person
44622,13,bicycle,14,0,17163,62,583,1057,715,1194,132,137,bicycle
44623,16,person,17,0,17163,22,958,995,992,1103,34,108,person
44624,0,car,1,0,17164,30,832,755,1682,1414,850,659,car
44625,1,truck,2,0,17164,30,1253,514,1887,1041,634,527,truck
44626,2,person,3,0,17164,34,449,709,623,1250,174,541,person
44627,3,person,4,0,17164,34,257,729,442,1233,185,504,person
44628,29,car,30,1,17164,22,737,752,1032,1084,295,332,car
44629,30,car,31,1,17164,20,712,743,864,915,152,172,car
44630,31,car,32,1,17164,17,686,732,864,865,178,133,car
44631,0,car,1,0,17165,24,745,1439,1222,1698,477,259,car
44632,9,car,10,0,17165,19,519,1490,693,1606,174,116,car
44633,12,car,13,1,17165,18,1134,1450,1367,1591,233,141,car
44634,13,person,14,0,17165,21,1231,1434,1284,1611,53,177,person
44635,14,person,15,0,17165,24,1349,1428,1411,1618,62,190,person
44636,17,person,18,0,17165,23,1569,1432,1647,1602,78,170,person
44637,30,window,31,0,17165,15,98,785,210,1045,112,260,window
44638,10,person,11,0,17166,30,605,783,669,974,64,191,person
44639,12,person,13,0,17166,28,875,802,955,970,80,168,person
44640,14,person,15,1,17166,17,1195,802,1255,871,60,69,person
44641,52,flowerpot,53,0,17166,16,1014,594,1098,634,84,40,potted plant
44642,82,person,83,0,17166,23,852,801,888,960,36,159,person
44643,84,person,85,0,17166,22,1126,813,1180,953,54,140,person
44644,3,car,4,0,17167,18,478,988,622,1118,144,130,car
44645,4,car,5,0,17167,16,803,1013,912,1096,109,83,car
44646,7,car,8,1,17167,20,896,1006,1003,1152,107,146,car
44647,9,motorbike,10,1,17167,39,1193,1056,1397,1258,204,202,motorcycle
44648,10,car,11,1,17167,37,1359,965,2048,1509,689,544,car
44649,45,door,46,0,17167,20,1452,980,1645,1362,193,382,door
44650,3,car,3,1,17168,19,1963,812,2201,1026,238,214,car
44651,5,car,5,1,17168,22,1712,799,1995,1010,283,211,car
44652,9,motorbike,9,1,17168,15,1550,840,1605,935,55,95,motorcycle
44653,12,motorbikes,12,1,17168,24,253,864,384,1008,131,144,motorcycle
44654,14,car,14,0,17168,31,500,831,759,993,259,162,car
44655,15,motorbike,15,0,17168,22,403,868,468,998,65,130,motorcycle
44656,29,motorbike,29,1,17168,17,1205,941,1349,1081,144,140,motorcycle
44657,30,person,30,0,17168,22,1211,823,1326,1011,115,188,person
44658,0,car,1,1,17169,22,1620,966,2048,1283,428,317,car
44659,1,person,2,0,17169,22,959,1005,1047,1218,88,213,person
44660,33,person,34,0,17169,19,1529,967,1575,1112,46,145,person
44661,0,car,1,0,17170,20,726,1130,1500,1359,774,229,car
44662,1,car,2,0,17170,16,1654,1117,2200,1329,546,212,car
44663,5,person,6,1,17171,31,531,1254,618,1483,87,229,person
44664,7,person,8,0,17171,35,648,1262,727,1485,79,223,person
44665,8,person,9,0,17171,45,966,1262,1079,1487,113,225,person
44666,9,person,10,0,17171,43,1095,1263,1207,1483,112,220,person
44667,10,person,11,0,17171,37,354,1268,432,1448,78,180,person
44668,11,person,12,0,17171,21,794,1260,835,1388,41,128,person
44669,12,person,13,0,17171,34,62,1277,146,1477,84,200,person
44670,13,person,14,0,17171,32,1,1265,73,1481,72,216,person
44671,15,person,16,0,17171,32,1506,1197,1607,1416,101,219,person
44672,56,person,57,0,17171,29,165,1281,194,1376,29,95,person
44673,2,person,3,0,17172,24,57,944,137,1129,80,185,person
44674,3,bench,4,0,17172,16,520,1088,663,1124,143,36,bench
44675,6,person,7,1,17172,17,200,994,233,1114,33,120,person
44676,20,person,21,0,17172,15,1682,1076,1702,1140,20,64,person
44677,28,car,29,1,17172,17,2,1100,529,1534,527,434,car
44678,2,car,3,0,17173,38,93,352,860,660,767,308,car
44679,13,truck,14,1,17173,25,1411,309,1600,430,189,121,truck
44680,18,person,19,0,17173,17,1097,362,1128,465,31,103,person
44681,20,car,21,1,17173,15,821,360,980,444,159,84,car
44682,0,car,1,0,17174,31,597,839,1724,1294,1127,455,car
44683,4,fire hydrant,5,0,17174,27,290,1067,373,1218,83,151,fire hydrant
44684,26,motorbike,27,1,17174,21,4,1011,104,1161,100,150,motorcycle
44685,0,person,1,0,17176,17,1107,756,1268,1263,161,507,person
44686,1,person,2,0,17176,48,151,728,413,1431,262,703,person
44687,3,person,4,0,17176,39,793,746,949,1244,156,498,person
44688,4,person,5,0,17176,34,871,913,991,1290,120,377,person
44689,6,person,7,0,17176,38,1512,859,1701,1323,189,464,person
44690,7,person,8,1,17176,26,1689,853,1859,1117,170,264,person
44691,20,person,21,1,17176,28,1830,850,1946,1058,116,208,person
44692,0,person,1,0,17177,26,744,442,853,800,109,358,person
44693,1,car,2,0,17177,16,1160,456,1355,621,195,165,car
44694,14,bicycle,15,1,17177,30,1210,642,1372,847,162,205,bicycle
44695,15,bicycle,16,1,17177,48,1333,638,1530,873,197,235,bicycle
44696,0,car,1,0,17178,25,1202,1038,1819,1231,617,193,car
44697,1,car,2,0,17178,29,560,1027,1159,1209,599,182,car
44698,44,door,45,0,17178,16,1383,1050,1510,1203,127,153,door
44699,58,door,59,0,17178,18,702,1037,849,1180,147,143,door
44700,61,door,62,0,17178,23,818,1038,935,1183,117,145,door
44701,11,person,8,0,17179,31,1782,890,1883,1096,101,206,person
44702,12,traffic light,9,0,17179,16,1603,782,1640,840,37,58,traffic light
44703,17,person,14,0,17179,16,687,907,724,1035,37,128,person
44704,33,person,30,0,17179,17,1164,930,1216,1032,52,102,person
44705,66,person,63,0,17179,15,1287,916,1309,1009,22,93,person
44706,79,person,75,0,17179,45,522,928,573,1044,51,116,person
44707,80,person,76,1,17179,31,562,905,594,1038,32,133,person
44708,81,person,77,0,17179,39,583,903,626,1051,43,148,person
44709,83,motorbike,79,0,17179,76,758,940,946,1060,188,120,motorcycle
44710,84,person,80,0,17179,41,841,901,911,1033,70,132,person
44711,85,car,81,1,17179,16,919,948,981,1008,62,60,car
44712,1,person,1,0,17180,17,1824,907,1936,1260,112,353,person
44713,14,person,2,0,17180,17,1,972,123,1406,122,434,person
44714,52,person,36,0,17180,43,1300,976,1338,1086,38,110,person
44715,53,person,37,0,17180,65,1366,958,1424,1125,58,167,person
44716,54,person,38,0,17180,110,1480,938,1604,1302,124,364,person
44717,55,person,39,0,17180,51,1715,930,1768,1119,53,189,person
44718,56,person,40,1,17180,46,1763,972,1826,1176,63,204,person
44719,57,person,41,0,17180,32,1339,990,1367,1087,28,97,person
44720,58,person,42,0,17180,31,1259,979,1289,1060,30,81,person
44721,59,person,43,0,17180,30,1241,977,1266,1062,25,85,person
44722,60,person,44,0,17180,31,1210,981,1245,1057,35,76,person
44723,61,person,45,0,17180,43,1156,984,1194,1092,38,108,person
44724,62,person,46,0,17180,38,1096,987,1142,1092,46,105,person
44725,63,person,47,0,17180,52,887,973,945,1153,58,180,person
44726,64,person,48,0,17180,61,788,968,862,1151,74,183,person
44727,65,chair,49,0,17180,19,530,1054,575,1114,45,60,chair
44728,66,chair,50,0,17180,21,578,1060,624,1120,46,60,chair
44729,67,chair,51,0,17180,18,626,1056,660,1117,34,61,chair
44730,68,chair,52,0,17180,20,688,1066,740,1128,52,62,chair
44731,70,chair,54,0,17180,18,737,1064,783,1126,46,62,chair
44732,71,chair,55,1,17180,17,668,1062,700,1123,32,61,chair
44733,72,chair,56,0,17180,24,463,1141,575,1304,112,163,chair
44734,73,chair,57,0,17180,18,364,1163,478,1336,114,173,chair
44735,74,chair,58,1,17180,23,243,1172,392,1371,149,199,chair
44736,75,chair,59,0,17180,21,92,1201,252,1425,160,224,chair
44737,76,person,60,1,17180,46,199,1057,307,1236,108,179,person
44738,77,table,61,1,17180,18,296,1169,389,1205,93,36,dining table
44739,78,person,62,1,17180,35,283,1054,404,1178,121,124,person
44740,79,person,63,1,17180,28,129,1061,214,1161,85,100,person
44741,81,bicycle,65,0,17180,53,367,1020,447,1116,80,96,bicycle
44742,2,car,3,0,17181,35,940,615,1513,1016,573,401,car
44743,5,car,6,0,17181,36,1513,646,2017,1008,504,362,car
44744,6,car,7,0,17181,29,366,673,924,1018,558,345,car
44745,8,car,9,1,17181,27,2,703,271,1025,269,322,car
44746,0,car,1,0,17182,38,58,456,1427,1042,1369,586,car
44747,5,car,6,1,17182,26,1135,303,1592,614,457,311,car
44748,7,car,8,1,17182,15,-2,416,189,761,191,345,car
44749,46,window,47,1,17182,15,1341,211,1540,368,199,157,window
44750,24,motorbike,25,0,17183,27,4,1029,161,1229,157,200,motorcycle
44751,25,motorbike,26,0,17183,32,398,1020,518,1226,120,206,motorcycle
44752,26,motorbike,27,0,17183,34,528,1056,676,1226,148,170,motorcycle
44753,27,motorbike,28,0,17183,30,685,1096,832,1232,147,136,motorcycle
44754,28,motorbike,29,0,17183,40,840,1087,1068,1238,228,151,motorcycle
44755,29,motorbike,30,0,17183,37,1120,1064,1290,1238,170,174,motorcycle
44756,30,motorbike,31,1,17183,42,1263,1039,1410,1229,147,190,motorcycle
44757,31,motorbike,32,1,17183,24,1410,1096,1552,1223,142,127,motorcycle
44758,32,motorbike,33,1,17183,28,1625,1072,1764,1227,139,155,motorcycle
44759,33,motorbike,34,1,17183,19,1715,1089,1845,1229,130,140,motorcycle
44760,34,motorbike,35,1,17183,24,1814,1066,1938,1226,124,160,motorcycle
44761,35,motorbike,36,0,17183,27,1912,1102,2078,1223,166,121,motorcycle
44762,36,motorbike,37,1,17183,20,2034,1083,2166,1217,132,134,motorcycle
44763,38,motorbike,39,1,17183,42,1832,1280,2197,1650,365,370,motorcycle
44764,39,motorbike,40,1,17183,58,1159,1075,1914,1650,755,575,motorcycle
44765,0,person,1,0,17184,30,931,933,978,1045,47,112,person
44766,1,car,2,0,17184,30,1140,988,1975,1262,835,274,car
44767,3,car,4,0,17184,31,216,969,656,1126,440,157,car
44768,66,street sign,67,0,17184,16,837,713,921,1131,84,418,street sign
44769,8,person,9,0,17185,50,1428,595,1611,1112,183,517,person
44770,10,backpack,11,0,17185,17,1470,671,1563,825,93,154,backpack
44771,14,car,15,1,17185,16,37,612,364,865,327,253,car
44772,15,car,16,0,17185,43,2,570,1056,1406,1054,836,car
44773,18,car,19,1,17185,27,980,622,1187,1052,207,430,car
44774,19,car,20,1,17185,19,1150,695,1282,909,132,214,car
44775,20,bicycle,21,0,17185,36,1200,821,1303,1058,103,237,bicycle
44776,32,person,33,1,17185,16,1580,656,1628,756,48,100,person
44777,6,traffic light,7,0,17187,17,1473,593,1596,1315,123,722,traffic light
44778,16,person,17,0,17187,29,140,1028,217,1238,77,210,person
44779,20,car,21,1,17187,18,1042,1052,1220,1245,178,193,car
44780,21,car,22,0,17187,27,1115,1073,1382,1238,267,165,car
44781,25,car,26,0,17187,26,277,1084,579,1262,302,178,car
44782,13,car,12,1,17188,19,956,1079,1192,1200,236,121,car
44783,14,car,13,1,17188,19,1406,1056,1546,1136,140,80,car
44784,15,car,14,0,17188,17,1637,1046,1720,1097,83,51,car
44785,49,flowerpot,48,0,17188,21,1527,893,1554,939,27,46,potted plant
44786,53,car,52,0,17188,34,1712,1059,1872,1158,160,99,car
44787,78,car,74,0,17188,58,1104,1094,1525,1329,421,235,car
44788,83,door,79,0,17188,19,1407,1109,1493,1259,86,150,door
44789,87,door,83,0,17188,17,1368,1109,1451,1268,83,159,door
44790,91,window,87,0,17188,15,1124,1115,1320,1187,196,72,window
44791,101,car,97,0,17188,19,1916,1031,1938,1060,22,29,car
44792,102,car,98,1,17188,17,1928,1030,1946,1058,18,28,car
44793,103,car,99,0,17188,21,1938,1030,1964,1056,26,26,car
44794,104,person,100,1,17188,18,1959,1019,1970,1043,11,24,person
44795,109,door,105,0,17188,18,722,1102,793,1227,71,125,door
44796,114,door,110,0,17188,19,775,1099,845,1217,70,118,door
44797,120,car,116,0,17188,54,502,1092,882,1269,380,177,car
44798,124,door,120,0,17188,17,53,1129,242,1388,189,259,door
44799,4,person,5,0,17189,23,810,844,845,946,35,102,person
44800,16,car,17,1,17189,20,964,845,1062,932,98,87,car
44801,17,car,18,1,17189,18,1012,852,1090,938,78,86,car
44802,18,car,19,1,17189,24,1052,849,1161,951,109,102,car
44803,19,car,20,0,17189,24,1121,847,1298,974,177,127,car
44804,20,car,21,1,17189,39,1375,850,1728,1104,353,254,car
44805,21,car,22,1,17189,37,1582,831,2048,1323,466,492,car
44806,1,car,2,1,17190,42,3,633,451,1274,448,641,car
44807,0,car,1,0,17191,23,790,1038,1195,1201,405,163,car
44808,5,car,6,0,17191,16,243,995,423,1063,180,68,car
44809,26,window,25,0,17191,17,1893,345,2032,558,139,213,window
44810,40,traffic light,39,0,17191,15,1956,842,1991,1096,35,254,traffic light
44811,42,motorbike,41,0,17191,35,132,989,183,1060,51,71,motorcycle
44812,43,person,42,0,17191,31,173,979,218,1063,45,84,person
44813,44,traffic light,43,0,17191,80,1447,297,1718,1174,271,877,traffic light
44814,45,traffic light,44,0,17191,64,1778,664,1932,1085,154,421,traffic light
44815,55,person,54,1,17191,19,125,973,146,1034,21,61,person
44816,3,car,4,0,17192,22,354,248,632,458,278,210,car
44817,30,traffic light,31,0,17192,25,421,60,679,270,258,210,traffic light
44818,45,traffic light,46,0,17192,15,134,30,357,292,223,262,traffic light
44819,0,car,1,0,17193,26,1512,862,2157,1030,645,168,car
44820,4,person,5,0,17193,17,688,766,784,1003,96,237,person
44821,6,person,7,1,17193,17,657,780,735,951,78,171,person
44822,7,bicycle,8,1,17193,17,600,875,674,983,74,108,bicycle
44823,7,person,8,0,17194,17,841,839,884,1023,43,184,person
44824,8,person,9,0,17194,17,922,820,1019,1024,97,204,person
44825,9,person,10,0,17194,15,1043,828,1111,1003,68,175,person
44826,10,person,11,0,17194,16,1352,802,1419,987,67,185,person
44827,11,person,12,0,17194,16,1904,800,1973,1013,69,213,person
44828,12,person,13,0,17194,17,2058,805,2115,998,57,193,person
44829,0,car,1,0,17195,20,1010,952,1346,1059,336,107,car
44830,38,car,39,0,17196,23,688,1300,812,1404,124,104,car
44831,44,car,45,0,17196,18,275,1338,398,1426,123,88,car
44832,45,car,46,1,17196,23,2,1333,279,1522,277,189,car
44833,0,person,1,0,17197,17,1365,1004,1482,1300,117,296,person
44834,6,person,6,0,17197,25,1515,1003,1634,1302,119,299,person
44835,9,car,9,0,17197,19,1011,1013,1191,1071,180,58,car
44836,11,person,11,0,17197,22,1335,1000,1382,1129,47,129,person
44837,16,person,16,0,17197,19,1498,1007,1525,1073,27,66,person
44838,35,car,33,1,17197,20,1759,1011,1866,1111,107,100,car
44839,36,car,34,1,17197,20,1705,1013,1782,1095,77,82,car
44840,47,person,45,0,17197,23,921,978,948,1041,27,63,person
44841,48,person,46,0,17197,25,958,978,979,1039,21,61,person
44842,49,person,47,0,17197,22,979,978,1002,1040,23,62,person
44843,5,motorbike,6,0,17198,29,305,1132,435,1266,130,134,motorcycle
44844,11,vase,12,0,17198,24,1457,932,1558,1066,101,134,vase
44845,15,vase,16,0,17198,21,1836,984,1890,1044,54,60,vase
44846,21,bench,22,1,17198,17,1292,1089,1457,1163,165,74,bench
44847,22,person,23,0,17198,32,1298,1016,1368,1200,70,184,person
44848,23,person,24,0,17198,31,1327,1009,1411,1198,84,189,person
44849,37,person,38,0,17198,32,838,1028,884,1150,46,122,person
44850,39,vase,40,0,17198,19,1034,1003,1072,1053,38,50,vase
44851,43,door,44,1,17198,17,1365,992,1427,1061,62,69,door
44852,49,motorbike,50,0,17198,52,8,1099,146,1231,138,132,motorcycle
44853,53,bench,54,1,17198,31,319,1080,613,1141,294,61,bench
44854,58,person,59,0,17198,24,182,1046,207,1108,25,62,person
44855,8,bicycle,9,0,17199,74,1539,1037,1822,1346,283,309,bicycle
44856,9,bicycle,10,0,17199,31,1331,1061,1503,1290,172,229,bicycle
44857,11,bicycle,12,0,17199,48,1114,1027,1285,1223,171,196,bicycle
44858,12,person,13,0,17200,21,292,475,328,551,36,76,person
44859,13,bench,14,0,17200,15,12,529,168,578,156,49,bench
44860,14,person,15,0,17200,29,51,509,104,573,53,64,person
44861,19,car,20,1,17200,18,875,479,972,514,97,35,car
44862,21,motorbike,22,0,17200,16,914,491,959,532,45,41,motorcycle
44863,25,person,26,1,17200,65,1145,461,1280,958,135,497,person
44864,28,person,29,0,17200,26,750,473,774,558,24,85,person
44865,29,motorbike,30,0,17200,17,814,492,870,525,56,33,motorcycle
44866,31,person,32,0,17200,27,707,482,737,560,30,78,person
44867,36,person,37,0,17200,23,642,486,664,556,22,70,person
44868,40,person,41,1,17200,22,1150,464,1219,605,69,141,person
44869,41,person,42,0,17200,46,1086,461,1150,709,64,248,person
44870,78,door,77,0,17201,15,1796,1085,1894,1215,98,130,door
44871,8,person,8,0,17202,40,688,681,842,1119,154,438,person
44872,9,person,9,0,17202,58,861,669,1019,1128,158,459,person
44873,10,person,10,0,17202,55,1029,726,1182,1132,153,406,person
44874,11,person,11,0,17202,76,1187,704,1400,1369,213,665,person
44875,12,person,12,0,17202,65,1388,710,1558,1376,170,666,person
44876,13,person,13,0,17202,35,1508,674,1667,1343,159,669,person
44877,15,person,15,0,17202,35,267,667,367,1041,100,374,person
44878,16,bicycle,16,0,17202,33,367,813,494,1024,127,211,bicycle
44879,1,person,1,0,17203,21,1606,138,1776,718,170,580,person
44880,3,car,3,0,17203,22,1072,194,1304,342,232,148,car
44881,4,person,4,0,17203,18,952,157,1017,363,65,206,person
44882,25,car,19,1,17203,24,1278,163,1403,314,125,151,car
44883,27,person,21,0,17203,39,1511,143,1575,330,64,187,person
44884,28,person,22,0,17203,45,1569,165,1641,339,72,174,person
44885,29,bus,23,1,17203,36,1462,144,1667,200,205,56,bus
44886,34,person,28,0,17203,38,1916,170,1957,279,41,109,person
44887,35,person,29,0,17203,34,1979,182,2056,300,77,118,person
44888,36,truck,30,1,17203,35,2035,1,2200,482,165,481,truck
44889,37,person,31,1,17203,22,2016,224,2074,310,58,86,person
44890,43,bus,37,1,17203,16,1343,149,1440,218,97,69,bus
44891,48,person,42,1,17203,17,1644,185,1660,241,16,56,person
44892,49,person,43,1,17203,29,1623,182,1651,278,28,96,person
44893,62,person,56,0,17203,19,805,200,819,241,14,41,person
44894,63,person,57,0,17203,15,879,196,889,236,10,40,person
44895,64,person,58,0,17203,16,887,197,901,236,14,39,person
44896,65,traffic light,59,0,17203,16,1093,111,1191,192,98,81,traffic light
44897,66,traffic light,60,0,17203,36,1116,72,1221,193,105,121,traffic light
44898,69,traffic light,63,1,17203,35,114,3,415,968,301,965,traffic light
44899,6,car,7,0,17204,28,771,956,1230,1141,459,185,car
44900,7,fire hydrant,8,0,17204,39,1436,1024,1477,1108,41,84,fire hydrant
44901,7,motorbikes,8,0,17205,28,1005,686,1280,865,275,179,motorcycle
44902,12,motorbike,13,0,17205,17,1306,707,1438,847,132,140,motorcycle
44903,13,car,14,0,17205,17,2,775,410,1202,408,427,car
44904,20,person,21,1,17205,22,693,675,801,772,108,97,person
44905,21,motorbike,22,1,17205,22,719,753,874,888,155,135,motorcycle
44906,22,traffic light,23,0,17205,15,1324,529,1376,855,52,326,traffic light
44907,0,flowerpot,1,0,17208,20,1165,721,1233,772,68,51,potted plant
44908,1,car,2,0,17208,18,763,670,1051,897,288,227,car
44909,7,car,8,0,17208,15,383,642,533,734,150,92,car
44910,8,car,9,0,17208,17,33,646,239,749,206,103,car
44911,18,car,19,1,17208,26,295,642,415,709,120,67,car
44912,74,flowerpot,73,0,17208,22,1123,710,1173,755,50,45,potted plant
44913,0,car,1,0,17209,15,481,640,1302,1060,821,420,car
44914,1,car,2,1,17209,15,1262,633,1776,960,514,327,car
44915,2,car,3,1,17209,17,1700,604,2090,893,390,289,car
44916,32,person,33,1,17209,49,485,539,626,832,141,293,person
44917,57,door,57,0,17209,23,975,650,1161,948,186,298,door
44918,66,door,66,0,17209,16,1552,643,1674,879,122,236,door
44919,0,person,1,0,17210,27,182,925,411,1523,229,598,person
44920,16,umbrella,16,1,17210,15,184,770,411,975,227,205,umbrella
44921,19,traffic light,19,0,17210,25,558,631,668,1119,110,488,traffic light
44922,30,motorbike,30,0,17210,23,1835,905,1969,987,134,82,motorcycle
44923,46,motorbike,46,0,17210,29,1583,978,1681,1145,98,167,motorcycle
44924,47,person,47,1,17210,24,1594,898,1678,1079,84,181,person
44925,48,person,48,1,17210,21,1567,899,1608,1089,41,190,person
44926,5,car,6,1,17211,18,3,977,369,1270,366,293,car
44927,6,car,7,1,17211,18,3,1047,317,1513,314,466,car
44928,28,motorbike,28,1,17211,15,247,1046,372,1142,125,96,motorcycle
44929,29,person,29,1,17211,25,152,913,278,1059,126,146,person
44930,0,person,1,0,17212,39,1169,742,1465,1405,296,663,person
44931,15,car,15,1,17212,16,1685,815,2047,1022,362,207,car
44932,21,person,21,0,17212,37,1441,737,1660,1419,219,682,person
44933,49,traffic light,46,0,17212,31,331,484,542,828,211,344,traffic light
44934,50,traffic light,47,1,17212,16,1146,655,1169,725,23,70,traffic light
44935,51,car,48,1,17212,37,1400,783,1846,920,446,137,car
44936,61,car,58,1,17212,20,727,765,788,814,61,49,car
44937,1,person,2,0,17213,28,527,658,613,987,86,329,person
44938,14,car,14,1,17213,16,1435,664,1598,832,163,168,car
44939,16,traffic light,16,0,17213,26,1005,230,1092,930,87,700,traffic light
44940,19,traffic light,19,0,17213,21,401,3,534,969,133,966,traffic light
44941,21,person,21,1,17213,21,2,694,41,962,39,268,person
44942,23,motorbike,23,0,17213,30,70,703,252,875,182,172,motorcycle
44943,49,person,49,0,17213,42,1384,683,1493,848,109,165,person
44944,0,person,1,0,17214,22,895,520,1019,888,124,368,person
44945,6,person,6,0,17214,16,753,525,899,875,146,350,person
44946,24,traffic light,24,0,17214,29,459,2,677,967,218,965,traffic light
44947,2,car,3,0,17215,32,1309,899,1907,1106,598,207,car
44948,3,car,4,0,17215,42,674,913,1166,1086,492,173,car
44949,4,car,5,0,17215,37,189,935,654,1070,465,135,car
44950,6,person,7,0,17215,18,108,905,140,1039,32,134,person
44951,8,person,9,0,17215,18,648,915,690,1046,42,131,person
44952,10,person,11,0,17215,28,1142,934,1208,1083,66,149,person
44953,11,person,12,0,17215,26,1200,929,1255,1058,55,129,person
44954,12,person,13,0,17215,20,1250,929,1291,1060,41,131,person
44955,13,person,14,0,17215,23,1913,902,1969,1048,56,146,person
44956,18,umbrella,18,0,17215,16,534,881,624,949,90,68,umbrella
44957,19,person,19,0,17215,18,46,911,78,1012,32,101,person
44958,40,door,38,0,17215,16,793,948,915,1057,122,109,door
44959,44,door,42,0,17215,19,892,945,1000,1055,108,110,door
44960,65,door,63,0,17215,19,1585,945,1719,1067,134,122,door
44961,70,door,68,0,17215,15,292,940,405,1047,113,107,door
44962,73,door,71,0,17215,16,373,937,471,1046,98,109,door
44963,85,person,83,1,17215,23,612,911,651,982,39,71,person
44964,86,person,84,0,17215,26,144,918,172,1034,28,116,person
44965,89,person,87,1,17215,24,1894,907,1922,1031,28,124,person
44966,90,person,88,1,17215,17,1879,907,1899,1018,20,111,person
44967,10,car,8,0,17216,16,1284,1943,1650,2200,366,257,car
44968,16,car,14,1,17216,18,243,1900,429,2022,186,122,car
44969,17,car,15,1,17216,15,311,1906,472,1991,161,85,car
44970,18,car,16,1,17216,23,300,1902,654,2077,354,175,car
44971,19,car,17,1,17216,20,233,1907,1331,2197,1098,290,car
44972,25,person,23,0,17216,23,1507,1871,1543,1935,36,64,person
44973,26,clock,24,0,17216,15,421,1569,475,1630,54,61,clock
44974,17,motorbike,18,1,17217,36,1012,1552,1244,1767,232,215,motorcycle
44975,18,motorbike,19,1,17217,17,1058,1722,1229,1802,171,80,motorcycle
44976,19,motorbike,20,1,17217,21,1072,1739,1234,1883,162,144,motorcycle
44977,20,motorbike,21,1,17217,54,1131,1628,1492,1957,361,329,motorcycle
44978,21,person,22,0,17217,33,1247,1568,1369,1837,122,269,person
44979,22,motorbike,23,1,17217,51,1268,1625,1535,1945,267,320,motorcycle
44980,23,motorbike,24,1,17217,33,1288,1771,1535,2048,247,277,motorcycle
44981,24,motorbike,25,1,17217,28,1034,1651,1262,1805,228,154,motorcycle
44982,28,window,29,0,17217,24,900,1002,1215,1331,315,329,window
44983,1,bicycle,2,0,17218,25,1041,1095,1327,1413,286,318,bicycle
44984,3,person,4,0,17218,47,1863,938,2147,1385,284,447,person
44985,6,person,6,0,17218,50,1602,920,1790,1362,188,442,person
44986,9,person,8,0,17218,76,1074,954,1305,1362,231,408,person
44987,14,person,10,0,17218,56,620,1027,693,1176,73,149,person
44988,15,person,11,0,17218,43,929,1038,992,1189,63,151,person
44989,16,person,12,0,17218,18,697,1042,778,1194,81,152,person
44990,24,person,19,0,17218,37,837,1016,908,1200,71,184,person
44991,36,traffic light,31,0,17218,74,102,789,216,1192,114,403,traffic light
44992,40,car,35,1,17218,22,1535,1024,1616,1143,81,119,car
44993,41,person,36,0,17218,38,282,1030,327,1166,45,136,person
44994,42,person,37,0,17218,39,374,1016,476,1185,102,169,person
44995,43,person,38,0,17218,43,458,1014,519,1167,61,153,person
44996,46,person,41,0,17218,42,1434,1038,1495,1200,61,162,person
44997,47,person,42,0,17218,35,1300,1031,1367,1202,67,171,person
44998,50,person,45,1,17218,21,1793,1016,1821,1092,28,76,person
44999,51,person,46,0,17218,20,1767,1015,1800,1080,33,65,person
45000,52,person,47,1,17218,30,1844,996,1867,1165,23,169,person
45001,53,person,48,0,17218,54,1800,1011,1864,1193,64,182,person
45002,54,person,49,1,17218,34,1849,995,1922,1164,73,169,person
45003,55,truck,50,1,17218,27,1008,937,1223,1131,215,194,truck
45004,85,person,80,1,17218,35,759,1042,796,1191,37,149,person
45005,17,person,18,0,17219,36,290,1003,423,1324,133,321,person
45006,18,bicycle,19,0,17219,24,338,1184,394,1365,56,181,bicycle
45007,22,person,23,0,17219,25,1918,971,1979,1165,61,194,person
45008,0,umbrella,1,0,17220,17,1319,797,1682,955,363,158,umbrella
45009,1,traffic light,2,0,17220,15,1208,394,1288,869,80,475,traffic light
45010,2,fire hydrant,3,0,17220,16,644,1061,752,1338,108,277,fire hydrant
45011,3,person,4,1,17220,26,1264,926,1552,1566,288,640,person
45012,5,car,5,0,17220,50,0,855,857,1260,857,405,car
45013,10,umbrella,9,0,17220,29,1600,749,1986,957,386,208,umbrella
45014,14,car,12,1,17220,38,845,877,1636,1118,791,241,car
45015,16,person,14,1,17220,16,1149,828,1208,923,59,95,person
45016,17,person,15,1,17220,67,1540,925,1801,1514,261,589,person
45017,20,person,18,1,17220,24,1813,940,1874,1041,61,101,person
45018,21,person,19,1,17220,26,1921,920,1973,1038,52,118,person
45019,22,person,20,0,17220,25,1995,864,2039,984,44,120,person
45020,23,person,21,0,17220,39,2034,870,2082,994,48,124,person
45021,26,bus,24,1,17220,15,2074,836,2175,919,101,83,bus
45022,37,car,35,1,17220,17,1,792,525,980,524,188,car
45023,42,door,40,0,17220,17,1102,891,1312,1083,210,192,door
45024,3,person,4,0,17221,16,994,1154,1038,1268,44,114,person
45025,4,person,5,0,17221,20,1081,1156,1122,1269,41,113,person
45026,22,person,23,0,17221,19,551,1157,583,1245,32,88,person
45027,0,car,1,0,17222,27,174,1043,1018,1361,844,318,car
45028,8,car,9,0,17222,16,226,1056,404,1138,178,82,car
45029,53,door,53,0,17222,16,311,1058,529,1291,218,233,door
45030,56,door,56,0,17222,18,483,1058,665,1289,182,231,door
45031,1,car,2,0,17223,22,394,308,523,348,129,40,car
45032,2,car,3,0,17223,25,240,298,376,354,136,56,car
45033,3,car,4,0,17223,24,89,311,231,358,142,47,car
45034,4,person,5,0,17224,15,817,491,890,712,73,221,person
45035,13,car,14,0,17224,28,246,531,519,621,273,90,car
45036,27,person,28,1,17224,20,874,505,937,706,63,201,person
45037,0,car,1,0,17225,35,1048,973,1678,1181,630,208,car
45038,1,car,2,0,17225,23,12,901,587,1141,575,240,car
45039,2,car,3,0,17225,19,1649,990,2200,1188,551,198,car
45040,13,car,14,1,17225,29,580,933,920,1121,340,188,car
45041,92,door,90,0,17225,17,1344,977,1493,1130,149,153,door
45042,107,door,105,0,17225,15,1793,996,1956,1134,163,138,door
45043,113,car,111,1,17225,21,996,991,1271,1137,275,146,car
45044,2,car,3,0,17226,34,162,547,575,695,413,148,car
45045,3,car,4,0,17226,30,871,568,1445,758,574,190,car
45046,20,person,21,0,17226,16,782,499,830,660,48,161,person
45047,55,door,56,0,17226,17,312,551,395,663,83,112,door
45048,65,door,66,0,17226,20,1158,573,1304,718,146,145,door
45049,17,car,18,1,17227,29,193,865,527,1053,334,188,car
45050,18,car,19,1,17227,32,445,884,889,1128,444,244,car
45051,19,car,20,0,17227,33,807,918,1662,1283,855,365,car
45052,25,car,26,1,17227,20,1701,1128,2049,1455,348,327,car
45053,38,door,39,0,17227,17,228,873,317,995,89,122,door
45054,69,door,70,0,17227,15,920,927,1150,1163,230,236,door
45055,0,person,1,0,17228,35,522,120,590,222,68,102,person
45056,1,car,2,0,17228,27,41,112,246,187,205,75,car
45057,4,car,5,0,17228,20,548,131,772,218,224,87,car
45058,6,person,6,0,17229,28,915,1417,1084,1861,169,444,person
45059,14,person,14,0,17229,38,757,1443,797,1571,40,128,person
45060,15,person,15,0,17229,23,887,1439,911,1507,24,68,person
45061,16,person,16,0,17229,20,856,1447,870,1491,14,44,person
45062,17,person,17,0,17229,28,715,1443,742,1518,27,75,person
45063,18,person,18,1,17229,29,789,1445,812,1535,23,90,person
45064,19,person,19,1,17229,26,734,1439,755,1517,21,78,person
45065,20,person,20,1,17229,17,748,1437,773,1517,25,80,person
45066,0,motorbike,1,0,17230,95,123,679,604,1092,481,413,motorcycle
45067,1,motorbike,2,0,17230,89,706,691,1261,1261,555,570,motorcycle
45068,3,motorbike,4,0,17230,66,1360,855,1798,1426,438,571,motorcycle
45069,0,car,1,0,17231,18,1037,755,2028,1212,991,457,car
45070,4,car,5,1,17231,17,4,946,736,1356,732,410,car
45071,28,door,29,0,17231,15,1428,766,1809,1080,381,314,door
45072,0,car,1,0,17232,27,792,1024,1488,1233,696,209,car
45073,66,door,67,0,17232,15,944,1030,1101,1189,157,159,door
45074,0,person,1,0,17233,48,1556,1123,1667,1451,111,328,person
45075,14,car,15,1,17233,20,569,1195,985,1446,416,251,car
45076,15,car,16,1,17233,21,383,1228,841,1536,458,308,car
45077,31,window,32,0,17233,17,147,1249,494,1389,347,140,window
45078,3,car,4,0,17234,49,339,1082,1730,1641,1391,559,car
45079,12,car,13,1,17234,18,1720,1125,2204,1503,484,378,car
45080,21,door,22,0,17234,17,886,1146,1208,1511,322,365,door
45081,27,door,28,0,17234,17,1194,1138,1469,1485,275,347,door
45082,0,person,1,0,17235,25,428,846,541,1209,113,363,person
45083,1,person,2,0,17235,15,691,854,831,1199,140,345,person
45084,5,person,5,0,17235,21,558,856,673,1208,115,352,person
45085,6,person,6,0,17235,22,71,974,210,1280,139,306,person
45086,36,bench,33,0,17235,19,291,973,411,1156,120,183,bench
45087,37,person,34,0,17235,18,372,955,430,1102,58,147,person
45088,38,bench,35,0,17235,17,1178,910,1360,968,182,58,bench
45089,39,person,36,0,17235,15,1252,884,1282,966,30,82,person
45090,40,person,37,0,17235,25,882,856,930,996,48,140,person
45091,41,person,38,0,17235,16,1293,884,1332,968,39,84,person
45092,42,person,39,0,17235,27,942,841,992,990,50,149,person
45093,44,person,41,1,17235,17,1,1047,136,1289,135,242,person
45094,46,person,43,0,17235,18,1104,846,1132,942,28,96,person
45095,50,person,46,0,17235,23,1011,857,1050,979,39,122,person
45096,51,person,47,0,17235,22,1042,859,1080,983,38,124,person
45097,62,person,55,1,17235,17,1,1158,112,1330,111,172,person
45098,80,car,70,1,17235,15,211,871,252,903,41,32,car
45099,82,car,72,1,17235,16,204,873,237,906,33,33,car
45100,103,person,93,0,17235,27,1158,860,1186,940,28,80,person
45101,0,car,1,0,17236,41,991,622,1310,745,319,123,car
45102,12,car,12,1,17236,16,1286,616,1501,723,215,107,car
45103,18,person,18,0,17236,24,548,564,599,727,51,163,person
45104,23,fire hydrant,23,0,17236,36,516,660,556,756,40,96,fire hydrant
45105,33,door,33,0,17236,15,1165,625,1243,723,78,98,door
45106,25,parking meter,23,0,17237,25,38,607,151,1199,113,592,parking meter
45107,34,car,32,1,17237,15,1483,562,1588,687,105,125,car
45108,36,person,34,0,17237,30,1001,564,1033,656,32,92,person
45109,37,parking meter,35,0,17237,28,1049,582,1072,662,23,80,parking meter
45110,55,car,52,0,17237,47,1142,561,1422,670,280,109,car
45111,59,window,56,0,17237,17,1142,318,1307,477,165,159,window
45112,4,car,5,0,17238,19,411,1100,632,1276,221,176,car
45113,9,car,10,0,17238,17,978,1119,1221,1294,243,175,car
45114,10,car,11,0,17238,23,1233,1110,1540,1293,307,183,car
45115,11,car,12,1,17238,19,1524,1123,1772,1286,248,163,car
45116,12,car,13,1,17238,21,1745,1119,1975,1280,230,161,car
45117,0,bicycle,1,0,17239,26,732,447,1560,1166,828,719,bicycle
45118,4,car,5,0,17239,28,282,114,1054,352,772,238,car
45119,5,car,6,1,17239,21,976,132,1397,325,421,193,car
45120,7,car,8,1,17239,19,930,228,2047,906,1117,678,car
45121,2,person,3,0,17240,28,2153,980,2188,1100,35,120,person
45122,31,traffic light,32,0,17240,18,1698,849,1755,1191,57,342,traffic light
45123,0,car,1,0,17241,23,1159,893,1781,1103,622,210,car
45124,1,car,2,0,17241,28,250,912,863,1104,613,192,car
45125,29,window,30,1,17241,15,1672,807,1937,1017,265,210,window
45126,0,car,1,0,17242,19,704,928,1086,1086,382,158,car
45127,3,car,4,1,17242,19,1470,883,2050,1366,580,483,car
45128,47,door,48,0,17242,20,1512,902,1712,1222,200,320,door
45129,70,door,70,0,17242,16,14,978,358,1534,344,556,door
45130,72,window,72,0,17242,15,86,1013,295,1367,209,354,window
45131,73,mirror,73,0,17242,20,59,1317,212,1502,153,185,mirror
45132,74,door,74,0,17242,19,202,965,475,1522,273,557,door
45133,14,person,15,0,17243,17,1334,1699,1416,1905,82,206,person
45134,15,person,16,0,17243,17,390,1609,456,1814,66,205,person
45135,16,person,17,0,17243,19,288,1613,349,1831,61,218,person
45136,18,person,19,0,17243,32,1078,1771,1170,1908,92,137,person
45137,20,person,21,0,17243,43,558,1663,621,1803,63,140,person
45138,21,person,22,0,17243,34,679,1671,772,1804,93,133,person
45139,0,person,1,0,17244,38,1938,873,1979,993,41,120,person
45140,7,car,8,0,17244,32,391,933,846,1065,455,132,car
45141,8,car,9,0,17244,22,970,931,1390,1061,420,130,car
45142,9,car,10,0,17244,34,1499,888,1941,1054,442,166,car
45143,10,parking meter,11,0,17244,35,932,920,967,1039,35,119,parking meter
45144,11,parking meter,12,0,17244,27,1960,908,1994,1024,34,116,parking meter
45145,6,clock,7,0,17245,16,2063,432,2162,552,99,120,clock
45146,14,person,15,0,17245,24,693,984,768,1146,75,162,person
45147,15,person,16,0,17245,23,642,995,716,1144,74,149,person
45148,17,person,18,0,17245,30,369,973,482,1153,113,180,person
45149,18,person,19,0,17245,16,277,973,353,1083,76,110,person
45150,3,person,4,0,17246,17,1676,801,1761,1012,85,211,person
45151,4,person,5,0,17246,20,1804,803,1888,1010,84,207,person
45152,5,person,6,0,17246,18,1921,796,2004,1006,83,210,person
45153,6,person,7,0,17246,21,2023,783,2097,1016,74,233,person
45154,24,traffic light,24,0,17246,20,389,586,670,887,281,301,traffic light
45155,12,car,12,0,17247,20,663,1150,1004,1343,341,193,car
45156,13,car,13,0,17247,23,226,1143,455,1306,229,163,car
45157,17,car,17,1,17247,17,401,1134,580,1243,179,109,car
45158,18,car,18,1,17247,20,628,1136,798,1232,170,96,car
45159,20,car,20,1,17247,18,581,1122,676,1179,95,57,car
45160,24,car,24,0,17247,25,92,1109,237,1152,145,43,car
45161,30,car,30,0,17247,25,1531,1122,1747,1223,216,101,car
45162,31,car,31,1,17247,17,1346,1120,1501,1204,155,84,car
45163,32,car,32,1,17247,18,1730,1104,1861,1183,131,79,car
45164,33,car,33,1,17247,17,1817,1110,1968,1183,151,73,car
45165,44,person,44,0,17247,33,47,1129,101,1370,54,241,person
45166,51,person,51,1,17247,22,1965,1096,2011,1269,46,173,person
45167,131,traffic light,127,0,17247,17,1802,918,1856,1238,54,320,traffic light
45168,132,traffic light,128,0,17247,47,167,506,916,699,749,193,traffic light
45169,146,door,142,0,17247,16,685,1159,743,1286,58,127,door
45170,151,car,147,0,17247,57,1061,1112,1372,1269,311,157,car
45171,152,door,148,0,17247,16,1105,1124,1171,1238,66,114,door
45172,161,door,157,0,17247,19,1141,1123,1204,1240,63,117,door
45173,170,door,166,0,17247,15,1405,1123,1462,1188,57,65,door
45174,179,door,175,0,17247,15,1927,1113,1963,1164,36,51,door
45175,182,door,178,0,17247,19,1901,1113,1941,1165,40,52,door
45176,200,door,196,0,17247,15,1667,1134,1720,1206,53,72,door
45177,202,door,198,0,17247,17,1639,1133,1686,1207,47,74,door
45178,5,person,6,0,17248,20,406,1534,439,1634,33,100,person
45179,6,person,7,1,17248,15,463,1501,494,1588,31,87,person
45180,7,person,8,1,17248,33,523,1501,714,2047,191,546,person
45181,8,backpack,9,0,17248,19,572,1599,712,1814,140,215,backpack
45182,13,car,14,1,17248,19,920,1541,1060,1650,140,109,car
45183,16,car,17,1,17248,33,663,1585,940,1865,277,280,car
45184,27,person,28,1,17248,15,1235,1489,1270,1553,35,64,person
45185,30,car,31,1,17248,19,929,1562,1533,2046,604,484,car
45186,16,person,6,0,17249,28,623,853,693,1026,70,173,person
45187,17,person,7,0,17249,28,678,845,729,1015,51,170,person
45188,24,truck,13,0,17249,40,298,659,721,1000,423,341,truck
45189,25,car,14,1,17249,23,227,832,312,957,85,125,car
45190,26,car,15,1,17249,20,135,850,253,934,118,84,car
45191,27,car,16,1,17249,20,78,845,177,922,99,77,car
45192,28,car,17,0,17249,24,2,797,149,907,147,110,car
45193,34,person,23,0,17249,30,971,853,1038,1019,67,166,person
45194,38,car,27,0,17249,42,1237,868,2199,1232,962,364,car
45195,46,person,35,1,17249,16,1187,855,1237,957,50,102,person
45196,47,person,36,1,17249,17,1117,866,1166,985,49,119,person
45197,48,person,37,0,17249,19,1059,861,1114,1023,55,162,person
45198,50,bicycle,39,0,17249,34,1091,947,1226,1072,135,125,bicycle
45199,0,car,1,0,17250,26,32,735,783,1058,751,323,car
45200,1,car,2,1,17250,18,1059,733,1600,1059,541,326,car
45201,14,door,15,0,17250,22,255,759,510,1020,255,261,door
45202,15,car,16,1,17251,18,266,945,366,1048,100,103,car
45203,8,chair,9,0,17252,15,177,1793,223,1853,46,60,chair
45204,10,person,11,1,17252,19,720,1733,760,1900,40,167,person
45205,16,person,17,1,17252,16,1318,1719,1355,1805,37,86,person
45206,17,car,18,1,17252,15,991,1751,1137,1857,146,106,car
45207,19,car,20,1,17252,26,1020,1771,1403,1948,383,177,car
45208,23,person,24,1,17252,17,687,1728,717,1830,30,102,person
45209,32,car,33,1,17252,16,1393,1761,1534,2042,141,281,car
45210,35,car,36,1,17252,17,366,1789,738,2049,372,260,car
45211,37,car,38,1,17252,16,215,1772,388,1971,173,199,car
45212,38,person,39,0,17252,19,165,1729,184,1807,19,78,person
45213,13,car,14,1,17253,24,1142,700,1441,912,299,212,car
45214,21,car,22,1,17253,32,1521,773,2044,1214,523,441,car
45215,7,car,8,1,17254,32,1283,959,2049,1280,766,321,car
45216,8,person,9,1,17254,15,1708,887,1786,959,78,72,person
45217,9,person,10,1,17254,19,1483,905,1559,1024,76,119,person
45218,11,person,12,0,17254,18,1656,901,1676,972,20,71,person
45219,14,traffic light,15,0,17254,45,1322,647,1431,1042,109,395,traffic light
45220,22,car,23,0,17254,30,1109,886,1332,1056,223,170,car
45221,24,car,25,1,17254,17,980,865,1107,929,127,64,car
45222,26,car,27,0,17254,33,530,849,809,1016,279,167,car
45223,28,car,29,0,17254,31,231,828,600,993,369,165,car
45224,29,car,30,0,17254,26,17,864,264,973,247,109,car
45225,30,person,31,0,17254,25,6,824,43,935,37,111,person
45226,64,car,65,1,17254,19,999,909,1129,1012,130,103,car
45227,65,car,66,0,17254,31,727,886,1007,1042,280,156,car
45228,0,car,1,0,17255,46,588,929,1589,1383,1001,454,car
45229,1,car,2,0,17255,23,233,878,724,1181,491,303,car
45230,17,car,18,1,17255,24,2,867,299,1076,297,209,car
45231,14,car,10,1,17256,16,1165,1036,1218,1079,53,43,car
45232,15,car,11,0,17256,21,1093,1036,1185,1089,92,53,car
45233,16,car,12,0,17256,23,954,1042,1059,1105,105,63,car
45234,23,car,19,1,17256,17,326,1020,402,1078,76,58,car
45235,24,car,20,1,17256,16,284,1018,352,1085,68,67,car
45236,25,car,21,1,17256,34,62,1006,264,1096,202,90,car
45237,29,traffic light,25,0,17256,54,233,651,730,1169,497,518,traffic light
45238,31,traffic light,27,0,17256,50,498,782,631,1121,133,339,traffic light
45239,41,traffic light,37,0,17256,32,1282,810,1613,1096,331,286,traffic light
45240,42,traffic light,38,0,17256,61,1618,737,1744,1128,126,391,traffic light
45241,48,person,44,0,17256,45,1512,1015,1592,1202,80,187,person
45242,49,person,45,0,17256,51,1369,1013,1451,1205,82,192,person
45243,51,car,47,1,17256,16,1331,1030,1374,1058,43,28,car
45244,56,person,52,0,17256,30,1631,1010,1660,1069,29,59,person
45245,58,car,54,1,17256,24,1455,1034,1533,1098,78,64,car
45246,64,person,60,1,17256,29,80,1020,127,1158,47,138,person
45247,7,car,8,1,17257,28,579,1397,836,1616,257,219,car
45248,8,car,9,1,17257,34,710,1404,1177,1756,467,352,car
45249,9,car,10,1,17257,30,976,1483,1534,2044,558,561,car
45250,1,person,1,0,17258,27,66,486,272,957,206,471,person
45251,4,person,4,1,17258,23,561,481,761,960,200,479,person
45252,5,person,5,1,17258,27,346,490,575,959,229,469,person
45253,6,person,6,1,17258,29,900,559,1194,960,294,401,person
45254,7,person,7,1,17258,25,755,523,934,960,179,437,person
45255,8,person,8,1,17258,30,269,505,393,960,124,455,person
45256,39,person,38,0,17258,39,555,68,581,166,26,98,person
45257,40,person,39,0,17258,35,583,71,609,165,26,94,person
45258,41,person,40,0,17258,33,606,60,627,164,21,104,person
45259,9,car,10,0,17259,28,492,1105,933,1244,441,139,car
45260,13,person,14,1,17259,21,553,1031,600,1152,47,121,person
45261,20,person,21,0,17259,18,2124,1027,2164,1164,40,137,person
45262,71,bicycle,72,0,17259,22,1976,1145,2104,1183,128,38,bicycle
45263,0,car,1,0,17260,19,580,718,1977,1362,1397,644,car
45264,13,door,14,0,17260,19,812,763,1162,1185,350,422,door
45265,15,mirror,16,0,17260,15,850,878,925,961,75,83,mirror
45266,17,door,18,0,17260,19,1091,757,1476,1213,385,456,door
45267,40,car,41,0,17261,24,1935,1230,2103,1338,168,108,car
45268,67,bicycle,68,1,17261,60,337,1479,714,1645,377,166,bicycle
45269,0,car,1,0,17262,35,520,1008,1224,1235,704,227,car
45270,12,car,13,1,17262,15,2,973,415,1254,413,281,car
45271,17,parking meter,18,0,17262,36,1711,1003,1748,1146,37,143,parking meter
45272,18,chair,19,0,17262,19,1337,1081,1427,1177,90,96,chair
45273,20,parking meter,21,0,17262,16,260,1018,284,1066,24,48,parking meter
45274,21,parking meter,22,0,17262,16,223,1016,253,1062,30,46,parking meter
45275,27,door,28,0,17262,24,1097,888,1179,994,82,106,door
45276,59,person,60,1,17262,21,724,956,798,1013,74,57,person
45277,1,car,2,0,17263,24,675,853,786,970,111,117,car
45278,2,person,3,0,17263,32,1237,823,1296,1012,59,189,person
45279,8,person,9,0,17263,26,599,802,640,1000,41,198,person
45280,9,person,10,0,17263,20,539,814,587,991,48,177,person
45281,25,person,26,0,17263,23,1182,826,1237,1024,55,198,person
45282,26,person,27,0,17263,17,887,834,928,945,41,111,person
45283,27,bicycle,28,1,17263,44,222,1037,575,1324,353,287,bicycle
45284,1,car,2,0,17264,35,362,484,1610,1299,1248,815,car
45285,4,window,5,0,17264,15,1131,549,1588,822,457,273,window
45286,18,door,19,0,17264,15,431,575,601,1020,170,445,door
45287,0,person,1,0,17266,35,923,908,973,1057,50,149,person
45288,1,person,2,0,17266,43,1241,925,1288,1057,47,132,person
45289,19,traffic light,9,0,17266,62,1081,415,1181,1042,100,627,traffic light
45290,23,person,13,0,17266,25,1347,911,1396,1039,49,128,person
45291,24,person,14,0,17266,34,1469,918,1543,1053,74,135,person
45292,27,car,17,1,17266,18,585,935,641,979,56,44,car
45293,28,person,18,0,17266,26,628,935,659,1026,31,91,person
45294,30,person,20,0,17266,33,799,930,834,1033,35,103,person
45295,56,person,46,0,17266,30,1020,903,1059,1056,39,153,person
45296,57,person,47,0,17266,35,1055,906,1100,1053,45,147,person
45297,58,person,48,0,17266,27,842,925,865,983,23,58,person
45298,59,person,49,0,17266,39,1148,922,1193,1052,45,130,person
45299,60,person,50,0,17266,28,1126,914,1153,1045,27,131,person
45300,61,person,51,1,17266,33,1180,917,1205,1039,25,122,person
45301,63,person,53,0,17266,36,773,935,796,1021,23,86,person
45302,66,traffic light,56,1,17266,35,2013,642,2046,835,33,193,traffic light
45303,0,fire hydrant,1,0,17267,32,1013,655,1038,706,25,51,fire hydrant
45304,2,person,3,0,17267,24,881,524,1020,835,139,311,person
45305,26,traffic light,27,0,17267,21,1322,435,1383,719,61,284,traffic light
45306,29,traffic light,30,0,17267,40,357,83,503,842,146,759,traffic light
45307,13,person,14,0,17270,20,493,1767,579,1889,86,122,person
45308,15,person,16,0,17270,15,739,1743,801,1867,62,124,person
45309,118,person,118,0,17270,15,872,1722,898,1805,26,83,person
45310,49,car,36,1,17271,19,0,1168,141,1228,141,60,car
45311,50,car,37,1,17271,31,0,1179,185,1275,185,96,car
45312,51,car,38,1,17271,33,111,1180,309,1292,198,112,car
45313,52,car,39,1,17271,36,284,1185,510,1312,226,127,car
45314,53,car,40,1,17271,39,423,1197,662,1333,239,136,car
45315,54,car,41,1,17271,39,631,1197,904,1353,273,156,car
45316,55,car,42,1,17271,48,861,1214,1217,1384,356,170,car
45317,56,car,43,1,17271,55,1201,1216,1641,1417,440,201,car
45318,57,bus,44,1,17271,61,1186,1035,1679,1282,493,247,bus
45319,58,person,45,1,17271,28,1660,1160,1710,1274,50,114,person
45320,61,car,48,1,17271,44,1629,1225,2047,1447,418,222,car
45321,62,bus,49,1,17271,52,1024,1034,1489,1230,465,196,bus
45322,66,person,53,1,17271,22,403,1144,448,1185,45,41,person
45323,67,person,54,1,17271,21,452,1135,483,1188,31,53,person
45324,68,person,55,1,17271,19,480,1135,504,1196,24,61,person
45325,69,person,56,1,17271,20,507,1138,533,1198,26,60,person
45326,70,person,57,1,17271,20,546,1143,569,1196,23,53,person
45327,71,person,58,1,17271,19,565,1131,590,1194,25,63,person
45328,72,person,59,1,17271,17,558,1145,583,1196,25,51,person
45329,73,person,60,1,17271,17,612,1145,629,1196,17,51,person
45330,74,person,61,0,17271,33,873,1136,907,1235,34,99,person
45331,75,person,62,0,17271,27,907,1138,939,1236,32,98,person
45332,126,door,113,0,17271,15,574,1202,655,1309,81,107,door
45333,2,car,3,0,17272,24,105,1115,625,1360,520,245,car
45334,16,traffic light,15,0,17272,44,77,648,428,1083,351,435,traffic light
45335,34,traffic light,28,0,17272,40,1212,719,1843,1212,631,493,traffic light
45336,51,car,45,1,17272,15,1256,1131,1306,1176,50,45,car
45337,58,person,52,0,17272,26,1523,1115,1561,1218,38,103,person
45338,4,person,5,0,17273,24,476,911,529,1042,53,131,person
45339,5,person,6,0,17273,24,807,937,855,1079,48,142,person
45340,6,car,7,0,17273,32,807,1016,1438,1283,631,267,car
45341,7,person,8,0,17273,18,1379,953,1414,1040,35,87,person
45342,8,car,9,1,17273,23,1714,1031,2049,1211,335,180,car
45343,41,person,42,0,17273,15,1826,988,1845,1049,19,61,person
45344,13,car,10,1,17274,20,936,834,1098,1017,162,183,car
45345,14,car,11,1,17274,27,743,843,1006,1091,263,248,car
45346,15,car,12,1,17274,39,270,817,797,1273,527,456,car
45347,16,motorbike,13,1,17274,24,302,1056,572,1336,270,280,motorcycle
45348,17,car,14,1,17274,17,1,867,344,1536,343,669,car
45349,25,person,22,0,17274,21,1296,841,1347,932,51,91,person
45350,26,person,23,0,17274,23,1249,820,1287,931,38,111,person
45351,28,car,25,1,17274,16,1126,827,1197,930,71,103,car
45352,31,car,28,1,17274,17,1167,820,1232,898,65,78,car
45353,11,traffic light,12,0,17275,54,1384,683,2176,1357,792,674,traffic light
45354,15,person,16,0,17275,21,1241,1220,1283,1368,42,148,person
45355,16,person,17,0,17275,24,2129,1177,2197,1351,68,174,person
45356,0,car,1,0,17277,18,925,772,1399,1056,474,284,car
45357,3,person,2,0,17278,20,673,1009,771,1268,98,259,person
45358,12,person,9,0,17278,31,1436,1001,1525,1204,89,203,person
45359,13,person,10,0,17278,25,1501,1006,1553,1175,52,169,person
45360,16,bus,13,0,17278,16,243,988,491,1060,248,72,bus
45361,28,truck,23,1,17278,26,2,948,243,1069,241,121,truck
45362,47,car,42,1,17278,15,962,1036,1017,1075,55,39,car
45363,52,bench,47,0,17278,19,786,1057,870,1109,84,52,bench
45364,53,person,48,1,17278,18,126,1067,208,1120,82,53,person
45365,54,person,49,0,17278,63,1003,1017,1103,1293,100,276,person
45366,55,person,50,0,17278,42,1180,1007,1227,1127,47,120,person
45367,56,person,51,0,17278,45,1606,1010,1680,1180,74,170,person
45368,57,person,52,0,17278,44,1786,981,1848,1181,62,200,person
45369,59,car,54,1,17278,18,762,1028,859,1073,97,45,car
45370,0,car,1,0,17279,42,124,710,1646,1290,1522,580,car
45371,2,car,3,0,17279,23,1375,643,1839,820,464,177,car
45372,3,car,4,0,17279,17,729,631,1180,772,451,141,car
45373,28,traffic light,27,0,17279,32,111,278,580,397,469,119,traffic light
45374,31,car,30,1,17279,23,2,632,125,742,123,110,car
45375,32,car,31,0,17279,27,103,641,250,730,147,89,car
45376,34,car,33,1,17279,20,409,649,535,737,126,88,car
45377,35,fire hydrant,34,0,17279,15,411,686,441,749,30,63,fire hydrant
45378,54,person,53,1,17279,15,1491,626,1528,682,37,56,person
45379,55,person,54,1,17279,20,1309,652,1370,721,61,69,person
45380,29,car,30,1,17280,21,1700,982,1879,1121,179,139,car
45381,30,car,31,1,17280,20,1529,999,1771,1145,242,146,car
45382,31,car,32,0,17280,28,1259,979,1600,1185,341,206,car
45383,34,window,35,0,17280,15,1288,993,1450,1045,162,52,window
45384,46,door,47,0,17280,20,1460,995,1523,1135,63,140,door
45385,0,car,1,0,17281,29,849,880,1760,1134,911,254,car
45386,2,person,3,0,17281,17,64,740,211,1174,147,434,person
45387,12,car,11,1,17281,19,1758,901,2049,1132,291,231,car
45388,13,person,12,0,17281,22,1730,865,1770,1050,40,185,person
45389,14,person,13,0,17281,19,1491,821,1533,998,42,177,person
45390,33,car,31,1,17281,18,466,806,550,926,84,120,car
45391,34,traffic light,32,1,17281,37,211,0,701,1066,490,1066,traffic light
45392,47,umbrella,45,0,17281,18,28,961,84,1045,56,84,umbrella
45393,48,person,46,0,17281,39,234,802,332,1027,98,225,person
45394,50,person,48,0,17281,27,422,829,481,1028,59,199,person
45395,52,person,50,1,17281,21,1775,846,1830,974,55,128,person
45396,13,fire hydrant,13,0,17282,39,1995,1128,2034,1201,39,73,fire hydrant
45397,14,car,14,0,17282,25,437,1080,901,1233,464,153,car
45398,15,car,15,0,17282,24,1148,1081,1665,1238,517,157,car
45399,16,parking meter,16,0,17282,35,1109,1083,1150,1208,41,125,parking meter
45400,8,car,9,1,17283,21,148,1175,451,1280,303,105,car
45401,9,person,10,0,17283,27,251,1105,336,1315,85,210,person
45402,10,bench,11,0,17283,27,8,1313,451,1416,443,103,bench
45403,0,motorbike,1,0,17284,50,854,694,1465,1299,611,605,motorcycle
45404,5,motorbike,6,0,17284,21,213,494,326,581,113,87,motorcycle
45405,8,motorbike,9,0,17284,46,295,525,450,656,155,131,motorcycle
45406,9,car,10,1,17284,19,522,489,668,621,146,132,car
45407,10,motorbike,11,1,17284,17,631,537,714,648,83,111,motorcycle
45408,11,person,12,0,17284,29,637,480,716,637,79,157,person
45409,12,car,13,0,17284,32,677,479,1092,760,415,281,car
45410,14,car,15,1,17284,25,1064,495,1415,727,351,232,car
45411,22,car,23,1,17284,25,1280,475,1587,699,307,224,car
45412,28,car,29,1,17284,35,1605,536,2200,989,595,453,car
45413,7,person,8,0,17285,34,42,433,238,803,196,370,person
45414,12,car,13,1,17285,24,851,520,1327,866,476,346,car
45415,13,car,14,1,17285,15,1256,495,1601,645,345,150,car
45416,14,car,15,1,17285,24,1157,554,2042,1468,885,914,car
45417,0,car,1,0,17287,28,571,592,1622,974,1051,382,car
45418,1,car,2,1,17287,26,3,570,548,965,545,395,car
45419,3,bench,4,0,17287,18,1589,655,1703,776,114,121,bench
45420,10,car,11,1,17287,26,1769,589,2197,998,428,409,car
45421,3,car,2,0,17288,21,730,657,1315,937,585,280,car
45422,10,car,9,0,17288,23,2,620,141,709,139,89,car
45423,30,car,31,0,17289,15,28,1320,380,1519,352,199,car
45424,24,car,21,1,17290,27,1570,968,1880,1085,310,117,car
45425,7,car,8,0,17291,29,210,978,929,1204,719,226,car
45426,8,car,9,0,17291,37,1247,959,1598,1105,351,146,car
45427,14,car,15,0,17291,17,2017,941,2198,1047,181,106,car
45428,0,car,1,1,17292,23,522,1062,831,1230,309,168,car
45429,3,car,4,0,17292,22,1536,1038,1659,1115,123,77,car
45430,4,car,5,0,17292,21,1666,1026,1791,1117,125,91,car
45431,5,car,6,0,17292,24,1793,1026,1934,1111,141,85,car
45432,6,car,7,0,17292,20,1934,1020,2066,1109,132,89,car
45433,7,car,8,0,17292,19,2058,1022,2201,1109,143,87,car
45434,15,car,16,1,17292,19,649,1049,924,1179,275,130,car
45435,16,car,17,1,17292,16,811,1048,976,1144,165,96,car
45436,18,motorbike,19,1,17292,27,63,1152,229,1317,166,165,motorcycle
45437,19,car,20,0,17292,37,171,1050,720,1285,549,235,car
45438,20,motorbike,21,1,17292,30,1,1081,148,1343,147,262,motorcycle
45439,13,person,14,0,17293,50,1473,470,1807,1499,334,1029,person
45440,18,person,19,0,17293,26,1976,577,2033,727,57,150,person
45441,0,person,1,0,17294,29,929,656,1128,1448,199,792,person
45442,0,car,1,0,17295,24,3,886,886,1229,883,343,car
45443,1,car,2,0,17295,20,1181,865,1560,1054,379,189,car
45444,0,person,1,0,17296,18,832,1665,995,2112,163,447,person
45445,1,person,2,0,17296,19,1294,1660,1469,2192,175,532,person
45446,2,person,3,0,17296,20,1155,1714,1318,2182,163,468,person
45447,21,truck,20,0,17296,25,1254,1627,1428,1743,174,116,truck
45448,22,car,21,0,17296,19,1090,1690,1251,1846,161,156,car
45449,31,person,30,0,17296,26,996,1705,1047,1891,51,186,person
45450,0,car,1,0,17297,51,670,466,1519,1071,849,605,car
45451,5,car,6,0,17297,27,1501,399,1693,568,192,169,car
45452,7,car,8,0,17297,23,1908,428,2042,522,134,94,car
45453,8,car,9,1,17297,20,1878,411,1989,504,111,93,car
45454,27,car,26,0,17297,15,1822,396,1892,456,70,60,car
45455,29,window,28,0,17297,15,752,506,1256,702,504,196,window
45456,30,door,29,0,17297,20,1340,494,1489,869,149,375,door
45457,39,door,38,0,17297,78,3,249,684,935,681,686,door
45458,40,person,39,0,17297,41,1447,403,1492,554,45,151,person
45459,41,person,40,0,17297,34,1384,395,1451,548,67,153,person
45460,52,car,51,1,17297,17,1804,395,1836,430,32,35,car
45461,64,door,63,0,17297,34,1202,360,1294,470,92,110,door
45462,3,car,2,0,17299,26,752,170,1019,295,267,125,car
45463,14,car,8,0,17299,19,872,207,1327,482,455,275,car
45464,21,person,10,0,17299,68,1459,133,1611,568,152,435,person
45465,22,person,11,0,17299,93,1760,139,2052,898,292,759,person
45466,25,person,14,0,17299,62,2014,150,2148,502,134,352,person
45467,26,person,15,1,17299,40,1298,155,1368,443,70,288,person
45468,27,bus,16,1,17299,31,1089,98,1305,213,216,115,bus
45469,28,car,17,1,17299,20,1419,148,1468,189,49,41,car
45470,31,person,20,0,17299,34,461,164,510,273,49,109,person
45471,33,person,22,0,17299,21,655,169,682,261,27,92,person
45472,34,car,23,1,17299,33,495,177,626,244,131,67,car
45473,41,traffic light,30,0,17299,55,1664,1,1776,239,112,238,traffic light
45474,45,fire hydrant,34,0,17299,25,1611,236,1641,300,30,64,fire hydrant
45475,49,person,38,0,17299,20,1801,153,1816,201,15,48,person
45476,59,person,47,1,17299,27,761,166,794,223,33,57,person
45477,60,traffic light,48,0,17299,23,965,107,1007,204,42,97,traffic light
45478,61,person,49,0,17299,30,214,166,261,278,47,112,person
45479,62,person,50,0,17299,35,272,166,311,278,39,112,person
45480,63,person,51,0,17299,28,416,166,446,260,30,94,person
45481,65,person,53,0,17299,21,1816,179,1844,252,28,73,person
45482,1,car,2,0,17300,28,1598,1165,2199,1581,601,416,car
45483,2,truck,3,0,17300,18,1210,1127,1416,1339,206,212,truck
45484,7,car,8,0,17300,16,1060,1204,1159,1286,99,82,car
45485,8,person,9,0,17300,15,1024,1217,1053,1288,29,71,person
45486,10,person,11,0,17300,28,821,1223,878,1393,57,170,person
45487,2,car,3,0,17301,28,264,818,1013,1084,749,266,car
45488,4,bicycle,5,0,17301,35,1209,925,1410,1046,201,121,bicycle
45489,10,person,11,0,17302,36,215,406,338,691,123,285,person
45490,11,person,12,0,17302,37,300,428,401,696,101,268,person
45491,13,person,14,1,17302,15,1037,452,1092,541,55,89,person
45492,16,person,17,0,17302,17,1615,481,1643,579,28,98,person
45493,23,person,24,0,17302,32,1642,484,1671,580,29,96,person
45494,24,person,25,0,17302,37,1502,470,1526,562,24,92,person
45495,19,car,20,1,17303,25,1316,995,1596,1137,280,142,car
45496,21,motorbike,22,0,17303,42,1170,987,1282,1135,112,148,motorcycle
45497,41,car,41,1,17303,19,1993,1065,2055,1125,62,60,car
45498,42,car,42,1,17303,16,2024,1069,2074,1127,50,58,car
45499,43,car,43,1,17303,23,2060,1064,2126,1131,66,67,car
45500,44,car,44,1,17303,23,2107,1056,2164,1129,57,73,car
45501,45,car,45,1,17303,18,2163,1017,2200,1120,37,103,car
45502,47,car,47,1,17303,22,1748,1019,1836,1124,88,105,car
45503,48,car,48,1,17303,26,1590,1013,1779,1128,189,115,car
45504,65,door,65,0,17303,15,1466,1001,1545,1114,79,113,door
45505,22,door,15,0,17304,15,130,756,263,1144,133,388,door
45506,28,person,21,0,17304,27,413,857,443,938,30,81,person
45507,29,person,22,0,17304,23,443,853,470,936,27,83,person
45508,33,car,26,1,17304,15,482,864,531,901,49,37,car
45509,44,car,37,1,17304,15,849,860,904,904,55,44,car
45510,16,window,17,0,17305,20,271,512,570,848,299,336,window
45511,19,person,20,1,17305,15,1520,1160,1554,1327,34,167,person
45512,20,bicycle,21,0,17305,77,1351,1232,1459,1351,108,119,bicycle
45513,0,car,1,0,17306,34,1130,1094,1491,1297,361,203,car
45514,6,car,7,1,17306,30,587,1132,913,1260,326,128,car
45515,7,car,8,1,17306,28,831,1112,1178,1286,347,174,car
45516,8,car,9,1,17306,20,1909,1086,2049,1346,140,260,car
45517,19,person,20,1,17306,18,1983,1124,2047,1418,64,294,person
45518,24,person,25,0,17306,20,567,1122,601,1226,34,104,person
45519,30,car,31,1,17306,20,2,1060,208,1428,206,368,car
45520,16,car,14,1,17307,19,1274,1356,1404,1411,130,55,car
45521,17,car,15,1,17307,19,1339,1357,1460,1417,121,60,car
45522,21,person,19,0,17307,23,127,1355,186,1546,59,191,person
45523,29,car,27,0,17307,15,955,1369,1057,1413,102,44,car
45524,38,person,36,0,17307,24,1468,1332,1513,1459,45,127,person
45525,9,vase,10,0,17308,27,849,357,952,486,103,129,vase
45526,13,person,14,0,17308,22,712,490,744,572,32,82,person
45527,17,motorbike,18,0,17308,53,511,521,746,767,235,246,motorcycle
45528,21,bench,22,0,17308,35,954,548,1560,639,606,91,bench
45529,32,vase,33,0,17308,23,1944,350,2047,519,103,169,vase
45530,0,car,1,0,17309,28,1506,937,2196,1185,690,248,car
45531,1,car,2,0,17309,17,299,901,1068,1146,769,245,car
45532,77,door,78,0,17309,15,1911,947,2085,1130,174,183,door
45533,6,fire hydrant,6,0,17310,15,216,1305,340,1629,124,324,fire hydrant
45534,36,car,31,0,17310,57,1018,1198,2048,1575,1030,377,car
45535,37,door,32,0,17310,19,1525,1217,1807,1489,282,272,door
45536,41,door,36,0,17310,22,1331,1215,1576,1491,245,276,door
45537,3,car,3,0,17311,38,925,715,1158,878,233,163,car
45538,15,car,14,0,17311,43,307,741,806,971,499,230,car
45539,31,car,30,1,17311,31,1184,733,1330,843,146,110,car
45540,32,car,31,1,17311,26,1119,750,1253,857,134,107,car
45541,33,car,32,0,17311,25,1385,737,1482,817,97,80,car
45542,36,car,35,1,17311,15,1688,758,1724,784,36,26,car
45543,38,car,37,0,17311,16,1625,756,1678,796,53,40,car
45544,39,car,38,1,17311,26,1740,744,1853,840,113,96,car
45545,40,car,39,1,17311,16,1758,767,1856,802,98,35,car
45546,41,car,40,1,17311,28,1759,772,1855,896,96,124,car
45547,42,car,41,1,17311,36,1777,773,1882,953,105,180,car
45548,44,fire hydrant,43,1,17311,23,794,791,825,877,31,86,fire hydrant
45549,47,person,46,1,17311,20,1321,738,1350,813,29,75,person
45550,1,car,2,0,17312,32,449,568,1263,890,814,322,car
45551,23,door,24,0,17312,16,615,575,914,800,299,225,door
45552,47,car,43,1,17313,15,1024,792,1053,855,29,63,car
45553,48,car,44,1,17313,18,1040,779,1115,867,75,88,car
45554,49,car,45,1,17313,19,1462,852,1597,1157,135,305,car
45555,0,car,1,0,17315,80,382,1026,990,1304,608,278,car
45556,1,car,2,0,17315,15,2,1070,328,1280,326,210,car
45557,0,car,1,0,17316,20,1344,1118,1676,1262,332,144,car
45558,1,bus,2,0,17316,38,0,964,1152,1458,1152,494,bus
45559,2,truck,3,0,17316,28,1691,941,2027,1169,336,228,truck
45560,3,person,4,0,17317,18,1301,890,1330,971,29,81,person
45561,4,person,5,0,17317,21,1318,880,1344,974,26,94,person
45562,5,motorbike,6,0,17317,44,947,949,1139,1146,192,197,motorcycle
45563,15,car,16,1,17317,40,154,907,785,1291,631,384,car
45564,21,motorbike,22,1,17317,32,1050,900,1194,1072,144,172,motorcycle
45565,25,motorbikes,26,1,17317,19,1146,909,1251,1005,105,96,motorcycle
45566,4,car,5,0,17319,30,991,1385,1580,1587,589,202,car
45567,6,car,7,0,17319,30,518,1370,724,1526,206,156,car
45568,7,car,8,0,17319,26,72,1326,511,1649,439,323,car
45569,13,car,14,1,17319,22,603,1342,748,1461,145,119,car
45570,15,person,16,1,17319,19,1366,1317,1413,1392,47,75,person
45571,16,person,17,1,17319,16,1348,1320,1384,1388,36,68,person
45572,18,person,19,1,17319,21,1214,1303,1283,1388,69,85,person
45573,19,person,20,1,17319,18,1180,1317,1228,1390,48,73,person
45574,20,person,21,1,17319,17,1120,1312,1163,1370,43,58,person
45575,22,person,23,1,17319,22,1050,1321,1102,1457,52,136,person
45576,23,person,24,1,17319,18,1024,1329,1072,1468,48,139,person
45577,25,person,26,1,17319,21,1009,1323,1052,1474,43,151,person
45578,26,person,27,1,17319,23,987,1310,1036,1493,49,183,person
45579,27,person,28,1,17319,21,929,1311,959,1488,30,177,person
45580,28,person,29,1,17319,28,896,1329,942,1495,46,166,person
45581,29,person,30,1,17319,28,871,1310,910,1513,39,203,person
45582,30,person,31,1,17319,18,842,1325,879,1455,37,130,person
45583,32,person,33,1,17319,20,825,1326,848,1414,23,88,person
45584,33,person,34,1,17319,20,735,1328,765,1510,30,182,person
45585,34,person,35,1,17319,16,1825,1314,1856,1362,31,48,person
45586,35,person,36,1,17319,23,1814,1340,1882,1540,68,200,person
45587,4,person,5,0,17320,17,1538,727,1637,1076,99,349,person
45588,5,person,6,0,17320,28,256,748,358,978,102,230,person
45589,6,person,7,0,17320,26,38,755,131,949,93,194,person
45590,8,person,9,0,17320,45,2027,716,2160,1124,133,408,person
45591,9,bird,10,0,17320,17,1762,1109,1821,1157,59,48,bird
45592,10,person,11,0,17320,44,1793,698,1901,1065,108,367,person
45593,11,person,12,0,17320,27,1636,699,1718,1074,82,375,person
45594,12,person,13,0,17320,32,1366,711,1465,1019,99,308,person
45595,14,person,15,0,17320,31,1200,751,1313,1013,113,262,person
45596,15,person,16,1,17320,28,1128,733,1225,1059,97,326,person
45597,16,person,17,0,17320,42,1050,724,1155,1065,105,341,person
45598,22,person,23,0,17320,23,6,760,57,945,51,185,person
45599,13,person,13,0,17322,22,1576,891,1607,975,31,84,person
45600,43,window,40,0,17322,17,598,532,665,600,67,68,window
45601,56,person,53,0,17322,32,784,857,863,1002,79,145,person
45602,16,person,17,0,17323,22,885,1095,916,1209,31,114,person
45603,18,person,19,0,17323,22,973,1098,1007,1201,34,103,person
45604,20,person,21,0,17323,24,1114,1082,1163,1209,49,127,person
45605,30,person,31,0,17323,23,922,1087,954,1209,32,122,person
45606,6,car,7,0,17324,37,873,899,1901,1327,1028,428,car
45607,11,motorbike,12,0,17324,64,90,863,424,1139,334,276,motorcycle
45608,12,umbrella,13,0,17324,17,1905,667,2198,867,293,200,umbrella
45609,13,bicycle,14,1,17324,44,2014,988,2197,1170,183,182,bicycle
45610,15,motorbike,16,0,17324,28,1896,905,2045,1169,149,264,motorcycle
45611,16,person,17,1,17324,15,1643,916,1722,999,79,83,person
45612,19,person,20,1,17324,19,1449,826,1613,954,164,128,person
45613,1,car,1,0,17325,20,734,507,1120,818,386,311,car
45614,2,bench,2,0,17325,16,262,695,549,1145,287,450,bench
45615,13,person,13,0,17325,32,418,435,548,764,130,329,person
45616,18,car,18,1,17325,18,1180,460,1397,584,217,124,car
45617,21,car,21,1,17325,16,1090,449,1158,480,68,31,car
45618,31,person,30,1,17325,22,521,430,578,569,57,139,person
45619,33,person,32,0,17325,28,601,434,655,605,54,171,person
45620,34,bicycle,33,0,17325,26,565,528,623,655,58,127,bicycle
45621,38,person,37,0,17325,18,1429,435,1459,532,30,97,person
45622,0,person,1,0,17326,26,298,467,457,812,159,345,person
45623,1,truck,2,0,17326,19,936,243,1597,1018,661,775,truck
45624,6,parking meter,7,0,17326,17,1042,654,1117,1199,75,545,parking meter
45625,13,car,14,1,17326,15,767,569,963,762,196,193,car
45626,17,car,17,1,17326,16,581,535,637,665,56,130,car
45627,48,fire hydrant,48,0,17326,16,503,570,539,634,36,64,fire hydrant
45628,49,parking meter,49,0,17326,16,607,535,631,690,24,155,parking meter
45629,27,car,28,1,17327,22,259,635,602,870,343,235,car
45630,28,car,29,1,17327,24,1003,677,1206,887,203,210,car
45631,29,car,30,1,17327,28,846,701,1150,1008,304,307,car
45632,30,car,31,0,17327,58,114,747,1012,1368,898,621,car
45633,37,car,38,1,17327,22,5,677,283,971,278,294,car
45634,0,car,1,0,17328,30,136,541,930,882,794,341,car
45635,1,car,2,0,17328,27,1181,474,2051,912,870,438,car
45636,0,car,1,0,17329,33,981,1102,1285,1199,304,97,car
45637,6,bicycle,7,0,17329,19,614,1142,719,1305,105,163,bicycle
45638,33,car,34,1,17329,27,1844,1129,1950,1320,106,191,car
45639,34,car,35,1,17329,25,1807,1119,1905,1203,98,84,car
45640,35,car,36,1,17329,17,1771,1109,1845,1175,74,66,car
45641,36,car,37,1,17329,15,1771,1097,1831,1139,60,42,car
45642,0,car,1,0,17331,32,317,737,1305,1054,988,317,car
45643,33,person,17,0,17332,29,1210,1118,1271,1253,61,135,person
45644,34,person,18,0,17332,39,1162,1117,1221,1258,59,141,person
45645,35,person,19,0,17332,28,1134,1114,1172,1254,38,140,person
45646,36,person,20,0,17332,23,1110,1112,1137,1249,27,137,person
45647,37,person,21,0,17332,24,1084,1112,1123,1260,39,148,person
45648,39,person,23,1,17332,22,795,1120,839,1254,44,134,person
45649,40,person,24,0,17332,39,814,1116,883,1260,69,144,person
45650,41,person,25,0,17332,29,745,1113,805,1247,60,134,person
45651,42,person,26,0,17332,30,488,1115,525,1250,37,135,person
45652,44,person,28,0,17332,21,291,1135,323,1195,32,60,person
45653,45,person,29,0,17332,35,25,1114,103,1249,78,135,person
45654,51,traffic light,35,0,17332,49,1712,776,2073,1241,361,465,traffic light
45655,53,person,37,0,17332,17,1697,1129,1724,1187,27,58,person
45656,54,person,38,0,17332,17,1725,1120,1744,1191,19,71,person
45657,55,person,39,0,17332,20,1931,1117,1963,1193,32,76,person
45658,56,person,40,0,17332,15,2175,1125,2199,1209,24,84,person
45659,63,traffic light,47,0,17332,20,1182,985,1387,1052,205,67,traffic light
45660,16,car,17,1,17333,24,110,956,423,1244,313,288,car
45661,17,car,18,0,17333,37,552,1052,1331,1378,779,326,car
45662,12,car,13,0,17334,18,1251,1239,1534,1462,283,223,car
45663,1,bicycle,2,0,17335,56,416,441,1047,1333,631,892,bicycle
45664,2,car,3,0,17335,18,1649,226,2002,422,353,196,car
45665,16,car,17,1,17335,16,491,266,948,702,457,436,car
45666,0,car,1,0,17336,19,1605,1018,2190,1366,585,348,car
45667,53,car,49,1,17336,19,1297,995,1437,1140,140,145,car
45668,58,person,54,0,17336,16,1023,994,1045,1065,22,71,person
45669,3,car,4,0,17338,18,748,700,829,755,81,55,car
45670,3,car,4,0,17339,20,1192,999,1812,1254,620,255,car
45671,4,car,5,0,17339,22,469,975,1003,1183,534,208,car
45672,18,door,19,0,17339,18,568,984,740,1146,172,162,door
45673,31,door,32,0,17339,17,1335,1011,1525,1196,190,185,door
45674,35,door,36,0,17339,16,1495,1013,1650,1203,155,190,door
45675,0,car,1,0,17340,27,80,677,457,826,377,149,car
45676,23,car,13,1,17340,20,336,673,500,763,164,90,car
45677,24,car,14,1,17340,18,1,673,200,792,199,119,car
45678,26,car,16,1,17340,17,891,659,987,703,96,44,car
45679,27,car,17,0,17340,41,681,660,904,775,223,115,car
45680,28,car,18,1,17340,46,846,691,1077,863,231,172,car
45681,29,car,19,0,17340,46,881,706,1228,979,347,273,car
45682,30,car,20,1,17340,23,1014,667,1173,716,159,49,car
45683,31,car,21,1,17340,19,1156,650,1243,689,87,39,car
45684,14,door,15,0,17341,37,841,865,1097,1085,256,220,door
45685,26,car,27,1,17341,21,2,1082,534,1426,532,344,car
45686,27,car,28,1,17341,18,358,1015,713,1184,355,169,car
45687,28,motorbike,29,0,17341,26,626,1162,732,1353,106,191,motorcycle
45688,29,motorbike,30,1,17341,37,701,1029,896,1157,195,128,motorcycle
45689,30,car,31,0,17341,27,788,1078,1312,1312,524,234,car
45690,31,car,32,1,17341,18,1322,979,1614,1099,292,120,car
45691,32,car,33,0,17341,25,1380,1027,1786,1223,406,196,car
45692,33,car,34,1,17341,24,1745,1020,2018,1174,273,154,car
45693,46,door,47,0,17341,15,27,1124,249,1389,222,265,door
45694,68,door,69,0,17341,15,1165,1092,1267,1260,102,168,door
45695,74,door,75,0,17341,16,1538,1040,1667,1192,129,152,door
45696,98,door,99,0,17341,15,423,1026,572,1171,149,145,door
45697,43,bicycle,43,1,17342,65,995,1041,1307,1384,312,343,bicycle
45698,44,bicycle,44,0,17342,109,1076,1096,1369,1419,293,323,bicycle
45699,50,person,50,0,17342,26,1010,932,1047,1042,37,110,person
45700,51,bicycle,51,1,17342,16,1015,991,1042,1054,27,63,bicycle
45701,1,parking meter,2,0,17343,21,1803,951,1832,1033,29,82,parking meter
45702,2,parking meter,3,0,17343,26,248,900,279,997,31,97,parking meter
45703,3,parking meter,4,0,17343,18,61,995,88,1168,27,173,parking meter
45704,4,parking meter,5,0,17343,46,1966,1041,2017,1193,51,152,parking meter
45705,5,car,6,1,17343,31,2,910,208,1027,206,117,car
45706,6,car,7,1,17343,20,3,1014,134,1159,131,145,car
45707,7,car,8,0,17343,49,324,903,694,1041,370,138,car
45708,8,car,9,0,17343,58,737,918,1099,1052,362,134,car
45709,9,car,10,0,17343,41,1152,950,1486,1057,334,107,car
45710,10,car,11,0,17343,47,1322,1016,1838,1198,516,182,car
45711,11,car,12,1,17343,24,1855,984,2198,1200,343,216,car
45712,70,window,68,0,17343,16,1548,644,1610,774,62,130,window
45713,71,window,69,0,17343,17,1226,583,1298,755,72,172,window
45714,85,door,83,0,17343,15,1570,1033,1712,1170,142,137,door
45715,91,door,89,0,17343,23,1467,1032,1588,1168,121,136,door
45716,106,door,104,0,17343,17,937,925,1012,1019,75,94,door
45717,119,door,117,0,17343,16,1348,952,1427,1038,79,86,door
45718,132,door,130,0,17343,15,435,912,529,1007,94,95,door
45719,136,door,134,0,17343,17,520,911,602,1007,82,96,door
45720,154,door,152,0,17343,21,14,916,102,1003,88,87,door
45721,0,parking meter,1,0,17344,16,918,676,958,1032,40,356,parking meter
45722,6,car,7,0,17344,31,2,581,714,1183,712,602,car
45723,7,car,8,1,17344,18,628,650,855,903,227,253,car
45724,6,car,7,0,17345,21,1595,404,1723,493,128,89,car
45725,7,person,8,0,17345,30,1882,370,1938,529,56,159,person
45726,8,person,9,0,17345,24,1981,377,2047,522,66,145,person
45727,6,car,6,1,17346,15,3,484,295,994,292,510,car
45728,9,person,9,0,17346,38,532,348,651,777,119,429,person
45729,15,person,15,1,17346,31,627,369,714,741,87,372,person
45730,16,table,16,0,17346,18,943,508,1067,615,124,107,dining table
45731,1,car,2,0,17347,27,1617,929,1825,1046,208,117,car
45732,6,car,7,1,17347,34,4,949,372,1198,368,249,car
45733,8,car,9,0,17347,34,310,955,688,1174,378,219,car
45734,10,car,11,0,17347,41,628,959,988,1155,360,196,car
45735,13,car,14,0,17347,20,1360,921,1471,1002,111,81,car
45736,18,person,19,0,17347,27,1146,939,1183,1093,37,154,person
45737,20,car,21,1,17347,25,1304,917,1402,997,98,80,car
45738,24,car,24,1,17347,16,1114,917,1172,964,58,47,car
45739,25,car,25,1,17347,15,1076,917,1130,959,54,42,car
45740,36,person,36,0,17347,25,1874,887,1894,999,20,112,person
45741,43,person,43,0,17347,25,1840,894,1880,1003,40,109,person
45742,55,window,55,0,17347,21,285,534,362,689,77,155,window
45743,56,window,56,0,17347,18,25,509,111,674,86,165,window
45744,0,car,1,0,17349,30,72,201,515,410,443,209,car
45745,1,car,2,0,17349,31,609,233,1412,611,803,378,car
45746,4,car,5,0,17349,25,1134,188,1694,449,560,261,car
45747,7,car,7,0,17349,19,2,206,120,309,118,103,car
45748,14,traffic light,14,0,17349,17,1922,151,2072,258,150,107,traffic light
45749,15,car,15,1,17349,30,1715,274,2198,491,483,217,car
45750,16,traffic light,16,0,17349,21,1525,53,1569,188,44,135,traffic light
45751,19,person,19,0,17349,18,1771,238,1793,303,22,65,person
45752,22,traffic light,22,0,17349,24,1850,1,1992,311,142,310,traffic light
45753,29,door,29,0,17349,17,1310,207,1434,390,124,183,door
45754,32,door,32,0,17349,18,1211,210,1343,383,132,173,door
45755,36,door,36,0,17349,16,1842,281,2015,435,173,154,door
45756,40,door,40,0,17349,18,1971,281,2110,443,139,162,door
45757,47,door,47,0,17349,21,682,246,843,497,161,251,door
45758,51,door,51,0,17349,17,800,248,964,531,164,283,door
45759,70,door,70,0,17349,15,104,216,187,362,83,146,door
45760,4,car,4,0,17350,18,242,693,559,816,317,123,car
45761,33,person,33,0,17350,38,818,679,880,792,62,113,person
45762,11,person,10,0,17351,17,1383,961,1502,1176,119,215,person
45763,14,person,13,0,17351,15,560,951,608,1142,48,191,person
45764,24,bicycle,22,0,17351,32,1587,1043,1742,1156,155,113,bicycle
45765,25,person,23,0,17351,20,1629,986,1706,1131,77,145,person
45766,26,traffic light,24,0,17351,57,266,725,379,1133,113,408,traffic light
45767,28,person,26,0,17351,28,350,963,399,1100,49,137,person
45768,32,person,30,0,17351,40,1807,974,1883,1159,76,185,person
45769,0,car,1,0,17352,22,469,1071,989,1343,520,272,car
45770,28,door,29,0,17352,17,837,1085,931,1268,94,183,door
45771,33,person,34,1,17352,15,696,1019,761,1071,65,52,person
45772,0,person,1,0,17353,39,560,869,632,1099,72,230,person
45773,1,person,2,0,17353,44,1396,891,1461,1089,65,198,person
45774,5,car,6,0,17353,28,691,907,1365,1153,674,246,car
45775,6,car,7,0,17353,31,1451,918,2147,1138,696,220,car
45776,35,person,35,1,17353,21,602,890,647,1087,45,197,person
45777,36,person,36,1,17353,15,1126,873,1182,976,56,103,person
45778,38,person,38,1,17353,20,1488,871,1535,976,47,105,person
45779,39,person,39,1,17353,25,1378,876,1430,1081,52,205,person
45780,72,door,71,0,17353,18,1783,926,1985,1088,202,162,door
45781,73,door,72,0,17353,19,1641,925,1817,1091,176,166,door
45782,76,person,75,0,17353,28,677,882,730,1053,53,171,person
45783,0,car,1,0,17354,31,1180,986,1640,1147,460,161,car
45784,6,person,7,0,17355,29,539,772,660,1108,121,336,person
45785,19,person,19,0,17355,42,1998,762,2047,920,49,158,person
45786,0,motorbike,1,0,17356,36,62,905,483,1250,421,345,motorcycle
45787,1,person,2,0,17356,17,1313,905,1454,1241,141,336,person
45788,11,car,12,0,17356,17,434,922,643,1000,209,78,car
45789,20,person,21,0,17356,39,1176,915,1258,1169,82,254,person
45790,22,person,23,0,17356,23,1289,903,1329,1038,40,135,person
45791,23,person,24,0,17356,35,1442,905,1520,1093,78,188,person
45792,27,car,28,0,17356,19,1823,923,1956,993,133,70,car
45793,32,car,33,1,17356,15,1614,928,1720,1003,106,75,car
45794,33,person,34,0,17356,35,1575,913,1627,1086,52,173,person
45795,36,traffic light,37,0,17356,45,1465,491,1667,1304,202,813,traffic light
45796,48,traffic light,49,0,17356,26,1415,318,1573,490,158,172,traffic light
45797,50,person,51,1,17356,27,1507,912,1546,1057,39,145,person
45798,51,traffic light,52,0,17356,31,1323,805,1394,956,71,151,traffic light
45799,2,car,3,0,17357,29,713,1123,1085,1343,372,220,car
45800,15,car,16,1,17358,17,354,1801,445,1889,91,88,car
45801,16,car,17,1,17358,18,337,1818,413,1944,76,126,car
45802,18,car,19,1,17358,17,3,1793,116,1906,113,113,car
45803,7,parking meter,8,0,17359,18,1589,930,1643,1152,54,222,parking meter
45804,9,car,10,0,17359,38,1626,975,1952,1193,326,218,car
45805,34,person,35,1,17359,20,847,1000,882,1125,35,125,person
45806,36,person,37,0,17359,27,812,1008,864,1152,52,144,person
45807,37,person,38,0,17359,43,713,1029,816,1369,103,340,person
45808,38,motorbike,39,0,17359,25,556,1029,606,1125,50,96,motorcycle
45809,39,motorbike,40,0,17359,23,636,1020,695,1117,59,97,motorcycle
45810,46,person,47,0,17359,37,1337,965,1443,1223,106,258,person
45811,2,car,3,0,17361,27,164,1033,969,1378,805,345,car
45812,24,person,24,0,17361,32,908,1017,964,1171,56,154,person
45813,29,car,29,1,17361,25,1928,1006,2062,1095,134,89,car
45814,30,car,30,1,17361,17,2050,1011,2137,1074,87,63,car
45815,31,truck,31,1,17361,17,2074,950,2197,1065,123,115,truck
45816,12,car,12,0,17362,34,295,1224,639,1399,344,175,car
45817,13,car,13,0,17362,33,365,1293,1188,1573,823,280,car
45818,24,car,24,1,17362,20,94,1218,371,1367,277,149,car
45819,58,person,58,0,17362,23,1180,1182,1214,1288,34,106,person
45820,59,person,59,0,17362,18,1140,1183,1170,1288,30,105,person
45821,63,car,63,1,17362,20,856,1208,947,1270,91,62,car
45822,64,car,64,1,17362,15,925,1217,1039,1307,114,90,car
45823,100,door,100,0,17362,23,651,1311,914,1515,263,204,door
45824,5,umbrella,5,0,17363,28,677,710,1035,856,358,146,umbrella
45825,10,person,10,0,17363,17,1645,935,1760,1165,115,230,person
45826,11,person,11,0,17363,25,683,937,863,1350,180,413,person
45827,23,person,23,0,17363,32,0,848,331,1646,331,798,person
45828,31,person,31,1,17363,16,30,858,113,999,83,141,person
45829,37,person,37,0,17363,38,340,894,392,1012,52,118,person
45830,38,person,38,0,17363,25,300,890,331,968,31,78,person
45831,40,person,40,0,17363,22,269,896,294,978,25,82,person
45832,13,person,14,0,17364,26,1232,957,1307,1200,75,243,person
45833,22,parking meter,23,1,17364,22,584,1154,771,1648,187,494,parking meter
45834,0,car,1,0,17365,20,930,994,2050,1534,1120,540,car
45835,1,motorbike,2,0,17365,65,430,907,801,1186,371,279,motorcycle
45836,52,door,51,0,17365,21,1060,1016,1438,1388,378,372,door
45837,63,person,62,0,17365,26,854,852,933,1128,79,276,person
45838,64,person,63,1,17365,27,772,871,829,1123,57,252,person
45839,65,person,64,1,17365,21,733,863,804,989,71,126,person
45840,66,car,65,1,17365,43,259,899,534,1116,275,217,car
45841,77,car,76,1,17365,43,161,878,396,1046,235,168,car
45842,78,window,77,0,17365,15,272,891,377,940,105,49,window
45843,86,car,85,1,17365,28,85,865,255,1002,170,137,car
45844,92,car,91,1,17365,25,37,855,175,972,138,117,car
45845,93,car,92,1,17365,19,0,843,122,950,122,107,car
45846,95,person,94,1,17365,20,1458,923,1524,996,66,73,person
45847,25,person,26,0,17367,22,1575,1041,1622,1133,47,92,person
45848,30,person,31,0,17367,22,1831,979,1893,1147,62,168,person
45849,12,car,13,0,17368,29,1042,1397,1426,1563,384,166,car
45850,13,person,14,1,17368,15,1091,1361,1122,1441,31,80,person
45851,16,car,17,1,17368,25,2,1342,690,1641,688,299,car
45852,4,car,5,0,17369,23,1294,752,1466,857,172,105,car
45853,6,person,7,0,17369,27,1265,721,1321,846,56,125,person
45854,21,car,22,1,17369,20,402,728,556,808,154,80,car
45855,32,person,33,0,17369,16,1057,736,1089,800,32,64,person
45856,1,motorbike,2,0,17370,27,1073,1007,1310,1189,237,182,motorcycle
45857,8,motorbike,9,0,17370,34,5,1029,202,1256,197,227,motorcycle
45858,21,car,22,1,17370,18,1094,1034,2049,1533,955,499,car
45859,2,car,3,0,17371,26,1471,1050,1869,1383,398,333,car
45860,3,car,4,1,17371,19,1353,1060,1549,1270,196,210,car
45861,5,car,6,1,17371,15,1293,1040,1409,1148,116,108,car
45862,8,car,9,1,17371,17,530,1060,668,1224,138,164,car
45863,9,car,10,1,17371,22,578,1036,793,1190,215,154,car
45864,13,car,14,1,17371,17,755,1050,875,1154,120,104,car
45865,34,car,27,1,17372,20,405,716,531,835,126,119,car
45866,35,car,28,1,17372,26,459,736,662,937,203,201,car
45867,36,car,29,1,17372,32,511,755,798,1043,287,288,car
45868,37,car,30,0,17372,58,572,778,1342,1366,770,588,car
45869,15,car,13,0,17373,30,1030,843,1303,1005,273,162,car
45870,30,car,26,0,17373,23,1419,846,1561,911,142,65,car
45871,31,car,27,1,17373,29,1578,825,1721,935,143,110,car
45872,33,car,29,1,17373,17,1687,855,1755,951,68,96,car
45873,34,person,30,0,17373,31,1740,829,1815,1008,75,179,person
45874,35,person,31,0,17373,29,1851,858,1905,1009,54,151,person
45875,46,person,42,1,17373,28,2022,846,2061,992,39,146,person
45876,47,person,43,0,17373,43,2056,807,2145,1075,89,268,person
45877,49,person,45,1,17373,15,2161,837,2199,1020,38,183,person
45878,50,person,46,1,17373,20,2153,831,2194,985,41,154,person
45879,54,flowerpot,50,0,17373,22,882,948,1119,1144,237,196,potted plant
45880,64,bicycle,60,0,17373,79,33,986,208,1314,175,328,bicycle
45881,73,person,69,0,17373,20,1401,841,1419,895,18,54,person
45882,74,person,70,0,17373,19,1377,835,1397,893,20,58,person
45883,75,person,71,0,17373,16,1272,835,1290,894,18,59,person
45884,76,person,72,0,17373,20,914,813,934,895,20,82,person
45885,77,person,73,1,17373,16,901,821,918,882,17,61,person
45886,80,person,76,1,17373,15,109,801,138,841,29,40,person
45887,81,person,77,1,17373,15,1204,830,1218,851,14,21,person
45888,82,person,78,1,17373,17,1218,826,1231,854,13,28,person
45889,83,person,79,1,17373,20,1258,829,1275,877,17,48,person
45890,84,person,80,1,17373,15,1445,839,1461,864,16,25,person
45891,18,person,19,0,17374,24,393,938,426,1049,33,111,person
45892,19,truck,20,1,17374,34,622,795,994,1200,372,405,truck
45893,22,car,23,0,17374,45,860,927,1595,1443,735,516,car
45894,32,car,33,1,17374,23,1673,1004,2045,1308,372,304,car
45895,33,car,34,1,17374,15,1911,1233,2046,1500,135,267,car
45896,0,car,1,0,17375,24,254,756,609,1032,355,276,car
45897,3,person,4,0,17375,15,1092,675,1214,908,122,233,person
45898,19,traffic light,20,0,17375,26,735,5,957,1116,222,1111,traffic light
45899,25,car,26,1,17375,15,370,687,617,827,247,140,car
45900,0,car,1,0,17376,25,1138,840,1578,1098,440,258,car
45901,1,car,2,0,17376,23,1604,841,2055,1125,451,284,car
45902,4,car,5,0,17376,25,662,740,1218,1108,556,368,car
45903,5,car,6,1,17376,24,263,781,678,1094,415,313,car
45904,7,person,8,0,17376,33,536,835,755,1212,219,377,person
45905,8,person,9,0,17376,30,455,917,641,1232,186,315,person
45906,11,person,12,1,17376,34,155,817,321,1191,166,374,person
45907,12,person,13,0,17376,47,85,843,272,1225,187,382,person
45908,0,car,1,0,17377,19,553,762,1386,1087,833,325,car
45909,17,car,17,1,17377,20,1,789,281,906,280,117,car
45910,18,car,18,1,17377,16,277,813,433,896,156,83,car
45911,19,car,19,1,17377,15,404,788,712,918,308,130,car
45912,25,person,25,0,17377,24,1428,789,1478,912,50,123,person
45913,39,traffic light,39,1,17377,55,1497,0,1598,988,101,988,traffic light
45914,41,traffic light,41,0,17377,36,1258,621,1328,822,70,201,traffic light
45915,42,traffic light,42,0,17377,16,1312,678,1343,837,31,159,traffic light
45916,43,person,43,0,17377,27,1377,800,1416,900,39,100,person
45917,44,traffic light,44,0,17377,35,955,98,1165,765,210,667,traffic light
45918,52,door,52,0,17377,15,751,777,983,1029,232,252,door
45919,53,door,53,0,17377,15,931,773,1148,1031,217,258,door
45920,70,door,70,0,17377,17,455,794,548,904,93,110,door
45921,73,door,73,0,17377,15,530,793,609,900,79,107,door
45922,80,door,80,0,17377,15,35,797,125,877,90,80,door
45923,83,door,83,0,17377,15,109,794,170,887,61,93,door
45924,10,car,11,0,17378,36,174,1080,779,1339,605,259,car
45925,11,car,12,1,17378,27,758,1079,1012,1244,254,165,car
45926,12,car,13,1,17378,22,946,1066,1103,1192,157,126,car
45927,27,car,28,1,17378,18,1577,1043,1738,1160,161,117,car
45928,28,car,29,1,17378,15,1682,1053,1788,1166,106,113,car
45929,29,car,30,1,17378,18,1761,1012,1973,1179,212,167,car
45930,30,car,31,0,17378,17,1791,1036,2103,1282,312,246,car
45931,10,car,11,0,17379,18,1170,1044,1272,1084,102,40,car
45932,17,car,18,0,17379,22,1325,1036,1441,1128,116,92,car
45933,19,car,20,0,17379,31,578,1046,853,1166,275,120,car
45934,20,car,21,0,17379,31,2,1054,753,1475,751,421,car
45935,21,person,22,0,17379,15,887,1046,915,1116,28,70,person
45936,34,person,35,0,17379,16,1117,1043,1144,1097,27,54,person
45937,35,person,36,0,17379,19,996,1035,1019,1103,23,68,person
45938,23,person,24,1,17380,16,182,1019,276,1110,94,91,person
45939,9,person,10,0,17381,23,293,942,370,1114,77,172,person
45940,10,car,11,0,17381,31,822,975,1119,1097,297,122,car
45941,11,car,12,0,17381,20,1062,954,1286,1067,224,113,car
45942,12,car,13,0,17381,23,1374,954,1530,1036,156,82,car
45943,13,car,14,0,17381,18,1608,958,1716,1015,108,57,car
45944,25,person,26,1,17381,24,1788,954,1825,1051,37,97,person
45945,0,car,1,0,17382,35,960,755,1561,1034,601,279,car
45946,0,car,1,0,17383,21,306,1018,1090,1280,784,262,car
45947,1,car,2,0,17383,24,1237,1034,2121,1287,884,253,car
45948,10,parking meter,11,0,17383,21,1128,1020,1195,1232,67,212,parking meter
45949,14,person,15,1,17383,23,418,965,474,1058,56,93,person
45950,46,door,45,0,17383,20,1494,1045,1674,1244,180,199,door
45951,50,door,49,0,17383,17,480,1033,650,1214,170,181,door
45952,9,person,10,0,17384,33,109,1119,230,1380,121,261,person
45953,10,bicycle,11,0,17384,32,104,1249,222,1433,118,184,bicycle
45954,26,person,27,1,17384,21,1230,1150,1319,1399,89,249,person
45955,27,person,28,0,17384,37,1136,1136,1300,1433,164,297,person
45956,29,person,30,0,17384,35,1452,1148,1539,1442,87,294,person
45957,0,car,1,0,17385,18,508,822,853,937,345,115,car
45958,1,car,2,0,17385,15,895,826,1272,943,377,117,car
45959,2,car,3,0,17385,16,1277,828,1730,963,453,135,car
45960,7,car,8,0,17386,30,2,1125,195,1380,193,255,car
45961,0,person,1,0,17387,29,1424,800,1499,1017,75,217,person
45962,2,umbrella,3,0,17387,17,1196,682,1380,850,184,168,umbrella
45963,45,car,42,0,17387,38,289,763,887,1014,598,251,car
45964,53,car,50,1,17387,18,1998,704,2199,1040,201,336,car
45965,54,person,51,0,17387,33,1572,793,1652,1010,80,217,person
45966,55,person,52,1,17387,15,718,781,762,856,44,75,person
45967,56,person,53,1,17387,22,242,779,323,856,81,77,person
45968,0,motorbike,1,0,17388,38,399,639,1209,1274,810,635,motorcycle
45969,1,bench,2,0,17388,20,1599,757,2003,1065,404,308,bench
45970,12,car,13,1,17388,35,916,659,1383,865,467,206,car
45971,13,car,14,1,17388,31,1326,619,1652,814,326,195,car
45972,14,car,15,1,17388,29,1562,617,1787,781,225,164,car
45973,16,car,17,1,17388,41,324,630,974,947,650,317,car
45974,17,car,18,1,17388,24,2,689,402,1021,400,332,car
45975,21,motorbike,22,1,17388,21,1835,636,1924,753,89,117,motorcycle
45976,22,person,23,1,17388,20,1914,634,2013,772,99,138,person
45977,25,person,26,1,17388,24,291,588,351,801,60,213,person
45978,26,person,27,1,17388,17,388,577,454,659,66,82,person
45979,27,person,28,1,17388,15,1212,583,1261,680,49,97,person
45980,28,person,29,1,17388,20,1282,581,1330,691,48,110,person
45981,36,motorbike,37,1,17388,32,1739,642,1839,760,100,118,motorcycle
45982,38,person,39,1,17388,17,1360,582,1400,644,40,62,person
45983,39,person,40,1,17388,21,1334,574,1371,671,37,97,person
45984,40,person,41,1,17388,19,1709,584,1754,654,45,70,person
45985,41,person,42,1,17388,15,1686,590,1717,630,31,40,person
45986,44,person,45,1,17388,16,1906,576,1933,657,27,81,person
45987,47,person,48,1,17388,17,1959,601,1999,650,40,49,person
45988,6,bicycle,7,0,17389,24,662,991,1020,1239,358,248,bicycle
45989,0,car,1,0,17390,16,0,917,559,1524,559,607,car
45990,1,car,2,0,17390,16,572,872,983,1141,411,269,car
45991,0,car,1,0,17391,21,281,796,1281,1141,1000,345,car
45992,35,car,36,1,17391,20,1176,831,1523,1044,347,213,car
45993,37,car,38,1,17391,20,1470,831,1707,965,237,134,car
45994,17,person,18,0,17392,18,1459,1046,1483,1137,24,91,person
45995,21,truck,22,0,17392,28,1099,963,1289,1174,190,211,truck
45996,27,car,28,1,17392,24,800,1024,1019,1249,219,225,car
45997,34,car,35,0,17392,18,1726,1058,1878,1181,152,123,car
45998,3,car,4,0,17393,19,209,1165,417,1242,208,77,car
45999,17,car,18,1,17393,16,1041,1125,1158,1192,117,67,car
46000,18,car,19,1,17393,19,1195,1123,1281,1183,86,60,car
46001,1,car,2,0,17394,17,488,961,1106,1257,618,296,car
46002,9,car,10,0,17395,30,1275,1034,1693,1187,418,153,car
46003,18,car,16,1,17396,21,867,1108,993,1143,126,35,car
46004,19,car,17,1,17396,17,983,1097,1123,1133,140,36,car
46005,21,car,19,1,17396,16,1008,1109,1121,1134,113,25,car
46006,22,car,20,1,17396,15,1099,1110,1222,1132,123,22,car
46007,23,bench,21,0,17396,22,953,1144,1044,1201,91,57,bench
46008,44,person,42,0,17396,45,1365,1070,1433,1287,68,217,person
46009,48,flowerpot,11,0,17397,15,785,1244,1079,1513,294,269,potted plant
46010,11,traffic light,12,0,17398,30,745,545,835,1159,90,614,traffic light
46011,16,car,17,1,17398,16,941,1078,1031,1144,90,66,car
46012,18,car,19,0,17398,20,1048,1069,1186,1152,138,83,car
46013,21,car,22,0,17398,19,1210,1041,1363,1144,153,103,car
46014,22,car,23,0,17398,19,1361,1061,1497,1133,136,72,car
46015,23,car,24,0,17398,18,1533,1044,1691,1125,158,81,car
46016,62,car,61,0,17399,20,1065,1008,1177,1079,112,71,car
46017,5,truck,6,0,17401,17,1467,1003,1562,1114,95,111,truck
46018,6,person,7,0,17401,29,1547,1044,1579,1157,32,113,person
46019,8,person,9,0,17401,28,1576,1046,1610,1156,34,110,person
46020,9,person,10,0,17401,28,1599,1038,1651,1191,52,153,person
46021,11,person,12,1,17401,28,1984,1074,2048,1417,64,343,person
46022,13,person,14,0,17401,39,1655,1047,1692,1191,37,144,person
46023,14,person,15,0,17401,32,1697,1040,1733,1155,36,115,person
46024,27,person,28,1,17401,40,956,1048,1017,1220,61,172,person
46025,28,person,29,0,17401,33,998,1051,1050,1236,52,185,person
46026,29,person,30,0,17401,44,1068,1044,1129,1241,61,197,person
46027,30,person,31,0,17401,31,1328,1046,1373,1171,45,125,person
46028,33,bicycle,34,1,17401,25,24,1317,99,1523,75,206,bicycle
46029,37,person,38,0,17401,50,725,1021,806,1242,81,221,person
46030,65,person,66,1,17401,22,1032,1029,1082,1165,50,136,person
46031,66,person,67,1,17401,19,1186,1044,1238,1177,52,133,person
46032,0,car,1,0,17402,23,291,822,1504,1523,1213,701,car
46033,2,car,3,1,17402,17,1174,878,2200,1446,1026,568,car
46034,22,door,23,0,17402,17,484,855,832,1364,348,509,door
46035,23,mirror,24,0,17402,15,690,1020,816,1093,126,73,mirror
46036,2,car,2,0,17403,26,2,1204,805,1534,803,330,car
46037,4,person,4,0,17403,23,1390,1228,1427,1334,37,106,person
46038,5,person,5,0,17403,25,1438,1219,1482,1331,44,112,person
46039,6,car,6,0,17403,24,1479,1239,1646,1295,167,56,car
46040,21,car,19,1,17403,31,1282,1229,1444,1295,162,66,car
46041,23,car,21,1,17403,15,1111,1242,1259,1292,148,50,car
46042,27,person,25,1,17403,18,77,1216,111,1271,34,55,person
46043,28,person,26,1,17403,20,52,1239,132,1303,80,64,person
46044,35,door,33,0,17403,15,450,1222,622,1458,172,236,door
46045,50,traffic light,48,0,17403,20,188,1082,365,1248,177,166,traffic light
46046,1,person,2,0,17404,15,1663,789,1771,1136,108,347,person
46047,3,bus,4,0,17404,33,508,653,1148,994,640,341,bus
46048,4,car,5,0,17404,22,153,817,423,945,270,128,car
46049,25,person,26,0,17404,53,1377,812,1441,1012,64,200,person
46050,26,person,27,0,17404,30,2029,827,2115,1060,86,233,person
46051,46,person,43,0,17404,25,1178,811,1249,942,71,131,person
46052,47,bicycle,44,1,17404,17,1179,888,1229,991,50,103,bicycle
46053,50,car,47,1,17404,34,1142,806,1273,892,131,86,car
46054,0,car,1,0,17405,32,542,1102,1089,1275,547,173,car
46055,5,person,6,0,17405,21,88,1087,117,1179,29,92,person
46056,6,person,7,0,17405,21,33,1075,83,1166,50,91,person
46057,7,bicycle,8,0,17405,22,29,1127,91,1199,62,72,bicycle
46058,9,person,10,0,17405,21,256,1070,296,1199,40,129,person
46059,16,person,17,0,17405,20,1060,1075,1109,1245,49,170,person
46060,17,person,18,0,17405,28,1145,1074,1191,1246,46,172,person
46061,18,person,19,0,17405,30,1202,1083,1258,1243,56,160,person
46062,19,person,20,0,17405,31,1318,1065,1378,1249,60,184,person
46063,20,person,21,0,17405,36,1377,1069,1453,1258,76,189,person
46064,21,bus,22,1,17405,24,1429,1003,1662,1246,233,243,bus
46065,22,person,23,0,17405,31,1927,1083,2020,1326,93,243,person
46066,27,bicycle,28,1,17405,17,2003,1143,2047,1254,44,111,bicycle
46067,33,bicycle,34,0,17405,48,121,1224,291,1534,170,310,bicycle
46068,4,door,5,0,17406,19,1077,524,1697,1393,620,869,door
46069,10,bicycle,11,0,17407,42,457,1064,562,1147,105,83,bicycle
46070,54,motorbike,48,1,17408,17,798,1544,993,1649,195,105,motorcycle
46071,55,motorbike,49,1,17408,26,968,1486,1087,1649,119,163,motorcycle
46072,56,motorbike,50,1,17408,22,1046,1509,1205,1649,159,140,motorcycle
46073,57,motorbike,51,1,17408,27,1124,1473,1315,1649,191,176,motorcycle
46074,58,motorbike,52,1,17408,19,1234,1494,1372,1649,138,155,motorcycle
46075,59,motorbike,53,1,17408,29,1284,1452,1465,1648,181,196,motorcycle
46076,60,motorbike,54,1,17408,33,1394,1449,1543,1631,149,182,motorcycle
46077,61,motorbike,55,1,17408,24,1495,1470,1604,1616,109,146,motorcycle
46078,62,person,56,1,17408,19,1465,1326,1524,1464,59,138,person
46079,63,person,57,1,17408,24,1451,1351,1508,1469,57,118,person
46080,70,chair,64,0,17408,15,2078,1328,2116,1386,38,58,chair
46081,0,car,1,0,17409,24,950,897,1838,1164,888,267,car
46082,2,traffic light,3,0,17410,17,1276,708,1566,1335,290,627,traffic light
46083,8,traffic light,9,0,17410,16,72,1048,120,1329,48,281,traffic light
46084,12,person,13,0,17410,53,1085,1185,1143,1374,58,189,person
46085,13,person,14,0,17410,47,938,1185,1007,1365,69,180,person
46086,18,person,19,0,17410,37,1325,1180,1387,1308,62,128,person
46087,19,person,20,0,17410,31,1035,1169,1073,1342,38,173,person
46088,20,person,21,0,17410,39,1131,1177,1192,1351,61,174,person
46089,21,person,22,0,17410,30,1002,1190,1035,1362,33,172,person
46090,10,car,10,1,17411,30,942,774,1329,1006,387,232,car
46091,11,car,11,0,17411,34,480,832,1054,1106,574,274,car
46092,16,car,16,0,17411,34,1194,855,1840,1317,646,462,car
46093,27,door,27,0,17411,17,830,840,995,1024,165,184,door
46094,43,window,43,0,17411,18,968,797,1127,860,159,63,window
46095,44,door,44,0,17411,17,1178,787,1253,946,75,159,door
46096,47,door,47,0,17411,16,1211,787,1292,943,81,156,door
46097,51,car,51,1,17411,20,1350,800,1513,903,163,103,car
46098,52,car,52,1,17411,18,1497,813,1606,862,109,49,car
46099,53,car,53,1,17411,25,1534,797,1651,860,117,63,car
46100,54,car,54,1,17411,16,1640,793,1740,829,100,36,car
46101,57,person,57,1,17411,21,1741,783,1768,829,27,46,person
46102,58,truck,58,1,17411,21,1796,761,1981,940,185,179,truck
46103,65,window,65,0,17411,21,1299,885,1683,1013,384,128,window
46104,1,car,2,0,17412,25,468,1158,1592,1630,1124,472,car
46105,21,door,22,0,17412,19,624,1178,876,1504,252,326,door
46106,1,car,2,0,17413,29,2,935,432,1401,430,466,car
46107,2,car,3,0,17413,18,868,1051,1092,1172,224,121,car
46108,3,car,4,0,17413,21,479,1058,736,1209,257,151,car
46109,4,car,5,0,17413,23,408,1065,555,1260,147,195,car
46110,9,car,10,0,17413,31,1438,1044,1860,1319,422,275,car
46111,3,person,3,0,17414,29,0,1187,156,1775,156,588,person
46112,4,person,4,0,17414,33,240,1223,335,1482,95,259,person
46113,7,person,5,0,17414,21,468,1214,571,1577,103,363,person
46114,9,person,7,0,17414,23,387,1207,460,1410,73,203,person
46115,12,person,10,0,17414,16,750,1213,844,1461,94,248,person
46116,32,flowerpot,27,0,17414,15,864,1329,1099,1472,235,143,potted plant
46117,34,person,29,1,17414,15,902,1214,942,1309,40,95,person
46118,36,person,31,1,17414,24,695,1231,756,1392,61,161,person
46119,38,person,33,0,17414,46,593,1222,726,1591,133,369,person
46120,39,umbrella,34,0,17414,15,699,1413,721,1475,22,62,umbrella
46121,41,backpack,36,0,17414,16,771,1239,823,1323,52,84,backpack
46122,43,person,38,1,17414,22,578,1207,637,1391,59,184,person
46123,44,person,39,1,17414,20,453,1215,499,1369,46,154,person
46124,45,person,40,1,17414,15,300,1213,356,1321,56,108,person
46125,47,person,42,1,17414,41,103,1194,196,1550,93,356,person
46126,48,person,43,1,17414,36,148,1208,223,1467,75,259,person
46127,51,traffic light,46,0,17414,25,972,805,1479,1258,507,453,traffic light
46128,21,person,22,1,17415,22,1845,956,1922,1087,77,131,person
46129,28,person,29,0,17415,20,594,957,628,1073,34,116,person
46130,10,bicycle,11,0,17416,43,314,905,419,1211,105,306,bicycle
46131,11,car,12,1,17416,20,5,833,356,1117,351,284,car
46132,12,car,13,1,17416,19,304,810,528,1024,224,214,car
46133,16,person,17,0,17416,21,695,778,738,937,43,159,person
46134,0,car,1,0,17417,32,48,995,768,1309,720,314,car
46135,1,car,2,0,17417,17,616,952,971,1165,355,213,car
46136,2,car,3,0,17417,16,901,936,1141,1077,240,141,car
46137,4,person,5,0,17417,17,1502,958,1554,1072,52,114,person
46138,23,person,23,0,17417,15,1566,964,1609,1069,43,105,person
46139,0,person,1,0,17419,27,802,820,855,969,53,149,person
46140,1,car,2,0,17419,26,1061,854,1356,1103,295,249,car
46141,9,car,7,1,17419,16,1407,490,2041,1532,634,1042,car
46142,19,car,15,1,17419,27,981,835,1146,1009,165,174,car
46143,25,person,21,1,17419,24,837,801,869,932,32,131,person
46144,27,person,23,1,17419,18,874,805,892,868,18,63,person
46145,34,flowerpot,30,0,17419,21,2,1205,203,1443,201,238,potted plant
46146,0,car,1,0,17420,22,1227,652,2054,1050,827,398,car
46147,1,car,2,0,17420,20,602,617,1274,995,672,378,car
46148,20,door,21,0,17420,19,995,647,1171,922,176,275,door
46149,23,window,24,0,17420,17,660,646,972,742,312,96,window
46150,24,window,25,0,17420,18,1286,666,1634,757,348,91,window
46151,27,door,28,0,17420,18,1665,677,1836,970,171,293,door
46152,30,door,31,0,17420,19,1769,682,1947,974,178,292,door
46153,36,traffic light,37,0,17420,17,272,353,338,541,66,188,traffic light
46154,7,car,8,1,17421,30,322,62,563,165,241,103,car
46155,8,car,9,1,17421,16,1,46,230,177,229,131,car
46156,5,car,6,0,17422,26,1658,552,1841,702,183,150,car
46157,15,car,16,1,17422,16,1559,553,1622,619,63,66,car
46158,16,person,17,1,17422,30,1490,536,1524,665,34,129,person
46159,17,person,18,0,17422,52,1503,535,1574,714,71,179,person
46160,19,car,20,1,17422,19,1645,560,1692,662,47,102,car
46161,20,bicycle,21,0,17422,40,1573,608,1635,709,62,101,bicycle
46162,21,person,22,0,17422,43,1416,538,1482,708,66,170,person
46163,22,person,23,0,17422,19,1614,550,1638,597,24,47,person
46164,23,person,24,1,17422,19,1808,527,1848,592,40,65,person
46165,24,person,25,0,17422,22,1851,546,1875,611,24,65,person
46166,25,person,26,0,17422,49,1880,542,1921,670,41,128,person
46167,26,person,27,0,17422,44,1928,531,1986,670,58,139,person
46168,27,bicycle,28,0,17422,31,1962,594,1992,674,30,80,bicycle
46169,29,flowerpot,30,0,17422,34,739,1131,1106,1533,367,402,potted plant
46170,30,flowerpot,31,1,17422,31,1057,1013,1219,1204,162,191,potted plant
46171,0,car,1,0,17423,22,234,212,347,276,113,64,car
46172,1,car,2,0,17423,21,318,219,530,316,212,97,car
46173,3,person,4,0,17423,15,29,179,71,313,42,134,person
46174,16,car,14,0,17424,19,1174,1001,1348,1064,174,63,car
46175,31,car,29,1,17424,19,1141,991,1263,1055,122,64,car
46176,32,car,30,1,17424,15,1074,1016,1150,1057,76,41,car
46177,38,car,36,0,17424,16,452,1044,496,1069,44,25,car
46178,41,traffic light,39,0,17424,30,357,993,532,1012,175,19,traffic light
46179,24,car,24,0,17425,24,575,1116,1291,1436,716,320,car
46180,29,car,29,0,17425,20,4,1114,490,1350,486,236,car
46181,43,door,42,0,17425,16,642,1128,786,1345,144,217,door
46182,6,person,7,0,17426,18,78,1091,130,1220,52,129,person
46183,9,window,10,0,17427,25,19,357,218,695,199,338,window
46184,20,person,21,0,17427,18,845,1092,899,1275,54,183,person
46185,22,person,23,0,17427,29,495,1123,550,1263,55,140,person
46186,14,traffic light,11,0,17428,35,78,510,834,1164,756,654,traffic light
46187,21,person,18,0,17428,33,639,1027,692,1150,53,123,person
46188,7,car,8,0,17429,15,873,1015,935,1069,62,54,car
46189,8,person,9,0,17429,26,931,999,954,1072,23,73,person
46190,9,person,10,0,17429,21,953,1001,972,1068,19,67,person
46191,10,person,11,0,17429,20,981,1002,998,1068,17,66,person
46192,0,car,1,0,17430,18,864,785,1589,1060,725,275,car
46193,2,car,3,0,17430,15,3,774,140,857,137,83,car
46194,3,car,4,0,17430,22,145,762,310,862,165,100,car
46195,14,person,15,1,17430,19,1733,713,1803,901,70,188,person
46196,15,person,16,1,17430,31,1676,724,1762,991,86,267,person
46197,24,car,25,1,17430,17,717,704,1181,917,464,213,car
46198,25,car,26,1,17430,23,767,738,1183,1007,416,269,car
46199,1,car,2,0,17431,22,718,580,1415,907,697,327,car
46200,12,door,12,0,17431,17,953,594,1157,836,204,242,door
46201,16,door,16,0,17431,20,794,591,972,807,178,216,door
46202,26,door,26,0,17431,17,255,544,414,729,159,185,door
46203,28,window,28,0,17431,20,281,554,389,632,108,78,window
46204,2,car,3,0,17432,28,1446,1242,2167,1482,721,240,car
46205,13,car,14,0,17432,17,741,1231,944,1334,203,103,car
46206,28,car,29,1,17432,20,594,1206,725,1296,131,90,car
46207,29,car,30,1,17432,20,657,1217,784,1310,127,93,car
46208,3,car,3,0,17433,23,1080,1029,1559,1324,479,295,car
46209,9,car,9,0,17433,23,1884,968,2120,1067,236,99,car
46210,10,car,10,0,17433,23,1173,980,1268,1032,95,52,car
46211,11,person,11,0,17433,38,1818,914,1907,1112,89,198,person
46212,16,car,16,1,17433,19,1307,977,1445,1045,138,68,car
46213,24,car,24,1,17433,19,625,972,690,1024,65,52,car
46214,25,person,25,0,17433,25,703,981,732,1052,29,71,person
46215,29,car,29,1,17433,15,769,986,833,1045,64,59,car
46216,30,car,30,1,17433,15,824,981,878,1083,54,102,car
46217,32,car,32,1,17433,16,1128,979,1195,1013,67,34,car
46218,34,person,34,0,17433,17,1525,953,1549,1016,24,63,person
46219,36,person,36,0,17433,19,1731,950,1758,1024,27,74,person
46220,22,traffic light,17,0,17434,41,779,761,974,1045,195,284,traffic light
46221,0,truck,1,0,17435,22,352,919,985,1237,633,318,truck
46222,1,person,2,0,17435,23,1614,983,1688,1153,74,170,person
46223,12,flowerpot,13,0,17435,15,1384,1107,1511,1206,127,99,potted plant
46224,12,car,13,0,17436,22,494,1089,726,1239,232,150,car
46225,0,person,1,0,17437,19,839,786,1006,1238,167,452,person
46226,2,person,3,0,17437,17,401,804,538,1149,137,345,person
46227,4,person,5,0,17437,18,537,811,662,1153,125,342,person
46228,2,car,3,0,17438,22,59,957,363,1070,304,113,car
46229,3,car,4,0,17438,21,363,942,559,1035,196,93,car
46230,4,car,5,0,17438,21,611,940,740,1007,129,67,car
46231,5,car,6,1,17438,16,748,931,842,992,94,61,car
46232,8,bus,9,0,17438,27,1663,826,2016,997,353,171,bus
46233,15,car,16,1,17438,15,835,932,920,981,85,49,car
46234,16,car,17,1,17438,20,908,932,976,975,68,43,car
46235,17,car,18,1,17438,18,973,928,1028,970,55,42,car
46236,18,car,19,1,17438,15,1026,926,1072,964,46,38,car
46237,45,person,43,1,17439,18,1567,1021,1619,1163,52,142,person
46238,46,person,44,0,17439,20,1465,1022,1574,1203,109,181,person
46239,50,bicycle,48,0,17439,15,1210,1082,1250,1206,40,124,bicycle
46240,51,person,49,0,17439,32,1191,999,1258,1187,67,188,person
46241,52,bicycle,50,0,17439,17,1361,1070,1407,1209,46,139,bicycle
46242,53,person,51,0,17439,51,1344,992,1413,1193,69,201,person
46243,55,person,53,0,17439,28,1460,1006,1492,1129,32,123,person
46244,0,car,1,0,17440,23,360,795,1293,1152,933,357,car
46245,1,car,2,0,17440,27,1385,783,2065,1075,680,292,car
46246,13,door,14,0,17440,22,787,805,1084,1096,297,291,door
46247,28,door,29,0,17440,19,1723,799,1950,1026,227,227,door
46248,35,flowerpot,36,0,17440,23,244,946,295,996,51,50,potted plant
46249,0,car,1,0,17441,41,193,538,464,739,271,201,car
46250,1,car,2,0,17441,33,935,521,1048,585,113,64,car
46251,2,car,3,0,17441,38,1050,524,1225,620,175,96,car
46252,7,car,8,1,17441,21,1321,539,1600,694,279,155,car
46253,18,car,14,1,17441,22,1315,513,1451,570,136,57,car
46254,21,car,17,1,17441,17,1008,493,1092,528,84,35,car
46255,24,car,20,1,17441,17,827,501,855,533,28,32,car
46256,25,person,21,0,17441,17,841,509,852,539,11,30,person
46257,54,traffic light,50,0,17441,34,715,383,886,548,171,165,traffic light
46258,0,person,1,0,17442,20,1675,816,1808,1194,133,378,person
46259,1,person,2,0,17442,20,1495,836,1627,1182,132,346,person
46260,17,truck,18,1,17442,20,257,710,669,914,412,204,truck
46261,18,bus,19,1,17442,28,638,678,1479,944,841,266,bus
46262,19,car,20,0,17442,35,559,847,1064,1075,505,228,car
46263,20,car,21,1,17442,18,175,809,448,962,273,153,car
46264,22,car,23,1,17442,25,0,860,590,1271,590,411,car
46265,24,person,25,1,17442,26,1820,849,1889,1086,69,237,person
46266,25,person,26,0,17442,49,1873,809,1998,1219,125,410,person
46267,43,door,44,0,17442,17,869,870,962,1020,93,150,door
46268,57,door,58,0,17442,26,187,886,435,1164,248,278,door
46269,59,mirror,60,0,17442,15,369,957,407,993,38,36,mirror
46270,61,door,62,0,17442,31,12,879,266,1197,254,318,door
46271,65,traffic light,66,1,17442,31,383,2,479,966,96,964,traffic light
46272,74,traffic light,75,0,17442,30,460,482,930,578,470,96,traffic light
46273,9,car,10,1,17443,22,376,1052,568,1140,192,88,car
46274,7,chair,8,0,17444,19,1628,1046,1699,1134,71,88,chair
46275,8,chair,9,0,17444,16,1573,1041,1643,1128,70,87,chair
46276,9,chair,10,0,17444,17,1511,1044,1576,1122,65,78,chair
46277,12,chair,13,0,17444,23,990,1081,1081,1175,91,94,chair
46278,16,car,17,0,17444,31,799,1011,1088,1094,289,83,car
46279,26,car,27,1,17444,22,409,1002,624,1090,215,88,car
46280,17,car,18,0,17445,18,195,874,286,944,91,70,car
46281,19,car,20,1,17445,23,570,852,656,978,86,126,car
46282,62,traffic light,63,0,17445,38,1249,378,1383,1007,134,629,traffic light
46283,1,person,2,0,17446,17,550,550,659,818,109,268,person
46284,24,car,25,1,17446,21,845,585,917,699,72,114,car
46285,25,car,26,1,17446,15,799,573,904,656,105,83,car
46286,5,car,6,0,17447,33,260,1028,1261,1508,1001,480,car
46287,0,parking meter,1,0,17448,16,152,885,179,1079,27,194,parking meter
46288,1,car,2,0,17448,33,1415,868,2132,1075,717,207,car
46289,2,parking meter,3,0,17448,37,1381,852,1436,1052,55,200,parking meter
46290,3,car,4,0,17448,35,543,840,1326,1105,783,265,car
46291,10,person,11,1,17448,29,1898,784,1988,933,90,149,person
46292,0,car,1,0,17449,26,915,624,1686,946,771,322,car
46293,2,car,3,1,17449,15,2023,792,2200,1230,177,438,car
46294,12,person,13,0,17449,23,32,558,118,756,86,198,person
46295,17,traffic light,18,0,17449,16,702,508,742,716,40,208,traffic light
46296,0,person,1,0,17450,15,930,551,1045,841,115,290,person
46297,8,traffic light,9,0,17450,40,348,2,672,1034,324,1032,traffic light
46298,0,car,1,0,17451,44,409,1039,757,1377,348,338,car
46299,13,bicycle,14,0,17452,30,2,1225,279,1536,277,311,bicycle
46300,19,bicycle,20,0,17452,23,781,901,873,1058,92,157,bicycle
46301,20,motorbike,21,0,17452,44,1362,873,1478,1058,116,185,motorcycle
46302,21,motorbike,22,0,17452,36,1322,867,1428,1013,106,146,motorcycle
46303,0,car,1,0,17453,32,151,351,308,435,157,84,car
46304,1,car,2,0,17453,33,257,386,614,584,357,198,car
46305,2,person,3,0,17453,20,1079,310,1182,613,103,303,person
46306,24,car,25,1,17453,15,1,441,345,829,344,388,car
46307,33,door,34,0,17453,21,108,452,283,696,175,244,door
46308,37,door,38,0,17453,23,32,452,193,727,161,275,door
46309,50,car,50,1,17453,21,701,363,768,473,67,110,car
46310,51,truck,51,1,17453,20,687,326,827,434,140,108,truck
46311,12,car,13,0,17454,18,633,1011,1266,1238,633,227,car
46312,15,car,16,0,17454,20,1389,1030,1825,1201,436,171,car
46313,16,car,17,0,17454,16,1765,1025,2093,1172,328,147,car
46314,64,parking meter,62,0,17454,26,272,1016,338,1223,66,207,parking meter
46315,72,person,70,1,17454,16,1490,1001,1537,1046,47,45,person
46316,4,motorbike,5,0,17455,60,1206,1092,1549,1357,343,265,motorcycle
46317,5,motorbike,6,1,17455,40,1523,1121,1814,1341,291,220,motorcycle
46318,11,motorbike,12,0,17455,49,1793,1092,1972,1343,179,251,motorcycle
46319,12,motorbike,13,0,17455,32,1977,1095,2170,1320,193,225,motorcycle
46320,6,person,7,0,17456,27,1922,957,2023,1189,101,232,person
46321,0,car,1,0,17457,42,825,554,1845,896,1020,342,car
46322,6,person,7,0,17457,31,631,498,710,761,79,263,person
46323,7,person,8,1,17457,17,1195,493,1257,596,62,103,person
46324,10,person,11,1,17457,19,1147,501,1204,626,57,125,person
46325,0,car,1,0,17458,17,928,595,1561,802,633,207,car
46326,23,car,24,0,17459,37,343,951,1040,1225,697,274,car
46327,20,car,21,1,17460,22,1392,916,1580,1034,188,118,car
46328,21,motorbike,22,1,17460,28,1329,923,1447,1063,118,140,motorcycle
46329,24,car,25,1,17460,28,998,887,1365,1194,367,307,car
46330,25,car,26,1,17460,52,179,935,1041,1503,862,568,car
46331,1,car,2,0,17461,17,446,1078,603,1188,157,110,car
46332,0,person,1,0,17462,32,687,306,751,437,64,131,person
46333,1,person,2,0,17462,23,721,304,780,432,59,128,person
46334,2,car,3,0,17462,38,2,248,284,459,282,211,car
46335,3,car,4,0,17462,46,442,309,673,405,231,96,car
46336,4,car,5,1,17462,17,608,304,738,377,130,73,car
46337,0,person,1,0,17463,20,1611,759,1827,1483,216,724,person
46338,1,person,2,0,17463,15,210,884,307,1092,97,208,person
46339,2,person,3,0,17463,18,373,897,448,1078,75,181,person
46340,3,person,4,0,17463,19,814,883,897,1086,83,203,person
46341,4,person,5,0,17463,17,547,879,610,1075,63,196,person
46342,14,backpack,15,0,17463,19,1601,860,1779,1187,178,327,backpack
46343,21,person,22,0,17463,22,867,887,916,1067,49,180,person
46344,23,person,24,0,17463,19,1086,860,1140,978,54,118,person
46345,24,person,25,0,17463,20,1153,856,1188,990,35,134,person
46346,25,person,26,1,17463,27,585,890,627,1064,42,174,person
46347,29,person,30,1,17463,15,437,881,478,1028,41,147,person
46348,39,car,40,1,17463,27,1170,904,1398,1053,228,149,car
46349,40,truck,41,1,17463,44,1377,707,1824,1070,447,363,truck
46350,46,car,47,0,17463,27,1810,869,2013,1069,203,200,car
46351,1,person,2,0,17464,54,239,735,409,1282,170,547,person
46352,2,person,3,0,17464,47,376,719,515,1263,139,544,person
46353,3,person,4,0,17464,36,111,721,216,1074,105,353,person
46354,4,person,5,1,17464,26,210,743,293,1069,83,326,person
46355,5,person,6,0,17464,37,631,789,766,1267,135,478,person
46356,6,person,7,0,17464,57,617,743,882,1255,265,512,person
46357,7,person,8,1,17464,18,626,695,743,849,117,154,person
46358,10,person,11,1,17464,15,3,797,54,1000,51,203,person
46359,11,traffic light,12,0,17464,18,5,184,114,463,109,279,traffic light
46360,14,car,15,0,17464,39,1189,674,1759,1170,570,496,car
46361,19,car,20,1,17464,16,1847,768,2197,1099,350,331,car
46362,25,person,26,0,17464,34,506,728,603,986,97,258,person
46363,0,car,1,0,17465,52,395,888,1421,1304,1026,416,car
46364,2,motorbike,3,0,17465,17,1597,890,1784,1153,187,263,motorcycle
46365,7,person,8,0,17465,53,2,769,228,1438,226,669,person
46366,11,motorbike,12,0,17465,62,218,858,437,1058,219,200,motorcycle
46367,21,motorbike,22,0,17465,66,1406,875,1625,1140,219,265,motorcycle
46368,22,motorbike,23,0,17465,24,1258,907,1397,994,139,87,motorcycle
46369,23,motorbike,24,0,17465,45,515,851,667,1003,152,152,motorcycle
46370,26,door,27,0,17465,24,579,908,879,1202,300,294,door
46371,30,door,31,0,17465,27,809,909,1075,1219,266,310,door
46372,41,person,42,1,17465,16,1545,831,1582,878,37,47,person
46373,2,car,3,0,17466,20,45,1068,273,1196,228,128,car
46374,4,car,5,1,17466,25,1381,1073,1646,1199,265,126,car
46375,21,person,22,0,17466,42,1115,1060,1200,1231,85,171,person
46376,22,person,23,0,17466,38,1031,1051,1079,1198,48,147,person
46377,63,person,64,1,17466,15,248,1051,280,1143,32,92,person
46378,67,person,68,1,17466,16,791,1034,854,1115,63,81,person
46379,69,person,70,0,17466,23,1435,1040,1497,1218,62,178,person
46380,70,person,71,0,17466,26,1513,1031,1580,1224,67,193,person
46381,71,person,72,0,17466,26,1690,987,1770,1224,80,237,person
46382,72,person,73,1,17466,17,1747,1006,1786,1173,39,167,person
46383,73,person,74,0,17466,30,1751,998,1835,1215,84,217,person
46384,74,person,75,0,17466,25,1911,989,1986,1226,75,237,person
46385,75,person,76,0,17466,30,2027,1004,2153,1235,126,231,person
46386,22,person,21,0,17467,38,113,399,150,464,37,65,person
46387,23,person,22,0,17467,30,154,398,168,461,14,63,person
46388,29,person,28,1,17467,22,132,397,161,462,29,65,person
46389,0,car,1,0,17468,16,930,1043,1392,1441,462,398,car
46390,3,person,3,0,17468,17,1666,943,1758,1190,92,247,person
46391,15,car,15,1,17468,19,752,979,928,1129,176,150,car
46392,16,car,16,1,17468,23,449,976,775,1183,326,207,car
46393,20,car,20,1,17468,15,1309,1002,1453,1131,144,129,car
46394,26,person,26,0,17468,33,144,963,210,1142,66,179,person
46395,51,person,51,0,17468,17,1510,974,1543,1073,33,99,person
46396,60,person,60,1,17468,27,298,965,416,1262,118,297,person
46397,61,motorbike,61,0,17468,49,197,1034,462,1329,265,295,motorcycle
46398,5,car,6,0,17470,44,503,1412,1503,1913,1000,501,car
46399,6,car,7,0,17470,28,89,1426,548,1721,459,295,car
46400,6,car,7,1,17471,29,0,421,636,1155,636,734,car
46401,13,person,14,0,17471,30,591,514,659,702,68,188,person
46402,18,bicycle,19,0,17471,32,851,570,1051,697,200,127,bicycle
46403,19,person,20,0,17471,43,1115,488,1183,679,68,191,person
46404,37,person,37,0,17471,23,924,494,975,669,51,175,person
46405,9,car,9,1,17472,20,675,292,800,414,125,122,car
46406,36,car,34,1,17472,23,226,265,369,340,143,75,car
46407,38,car,36,1,17472,26,119,289,275,379,156,90,car
46408,39,car,37,1,17472,21,90,298,169,391,79,93,car
46409,42,car,40,1,17472,27,622,272,676,325,54,53,car
46410,43,car,41,1,17472,27,640,276,710,340,70,64,car
46411,4,car,5,1,17474,17,100,923,213,956,113,33,car
46412,10,car,11,0,17474,21,306,919,445,970,139,51,car
46413,14,motorbike,15,0,17474,23,550,920,618,990,68,70,motorcycle
46414,15,person,16,0,17474,18,571,916,601,990,30,74,person
46415,16,car,17,0,17474,32,97,937,313,1050,216,113,car
46416,21,car,22,1,17474,26,673,931,787,991,114,60,car
46417,22,motorbike,23,0,17474,33,750,946,835,997,85,51,motorcycle
46418,23,person,24,0,17474,22,793,910,818,987,25,77,person
46419,25,car,26,1,17474,19,955,926,1054,985,99,59,car
46420,26,car,27,1,17474,25,826,925,985,995,159,70,car
46421,27,car,28,0,17474,20,1033,927,1213,991,180,64,car
46422,29,car,30,0,17474,35,984,979,1677,1235,693,256,car
46423,30,bus,31,1,17474,27,1523,850,1853,983,330,133,bus
46424,33,person,34,1,17474,20,1926,782,1980,868,54,86,person
46425,35,person,36,0,17474,22,1967,891,2028,991,61,100,person
46426,37,person,37,0,17474,23,2038,870,2080,1016,42,146,person
46427,38,person,38,0,17474,42,2076,884,2130,1052,54,168,person
46428,42,car,41,1,17474,24,1392,925,1580,985,188,60,car
46429,43,person,42,0,17474,25,1484,894,1520,994,36,100,person
46430,44,person,43,0,17474,39,1580,887,1634,1013,54,126,person
46431,45,person,44,0,17474,32,1638,901,1676,1012,38,111,person
46432,46,person,45,0,17474,33,1661,889,1720,1007,59,118,person
46433,47,person,46,1,17474,18,2063,883,2085,983,22,100,person
46434,57,door,56,0,17474,15,1217,988,1377,1183,160,195,door
46435,59,mirror,58,0,17474,15,1304,1052,1353,1079,49,27,mirror
46436,61,door,60,0,17474,19,1085,990,1227,1170,142,180,door
46437,87,person,86,1,17474,22,596,912,617,975,21,63,person
46438,89,person,88,1,17474,27,2100,891,2124,994,24,103,person
46439,90,person,89,0,17474,54,2124,897,2194,1058,70,161,person
46440,91,person,90,1,17474,31,2167,891,2200,1052,33,161,person
46441,93,person,92,1,17474,19,2122,946,2147,1049,25,103,person
46442,96,traffic light,95,0,17474,25,3,665,124,719,121,54,traffic light
46443,98,person,97,0,17474,21,1992,812,2019,881,27,69,person
46444,122,person,121,0,17474,33,1957,886,2006,985,49,99,person
46445,123,person,122,0,17474,38,1925,865,1976,940,51,75,person
46446,124,person,123,0,17474,27,1956,862,1984,932,28,70,person
46447,8,person,9,0,17475,43,356,323,438,515,82,192,person
46448,0,car,1,0,17476,37,655,615,2029,1169,1374,554,car
46449,0,car,1,0,17477,15,516,913,863,1066,347,153,car
46450,8,fire hydrant,9,0,17477,21,1799,993,1858,1142,59,149,fire hydrant
46451,1,horse,2,0,17478,38,1428,923,1724,1153,296,230,horse
46452,2,person,3,0,17478,18,721,963,802,1136,81,173,person
46453,33,traffic light,23,0,17478,116,290,415,992,1119,702,704,traffic light
46454,34,car,24,1,17478,39,399,930,596,1066,197,136,car
46455,35,car,25,1,17478,18,286,978,434,1052,148,74,car
46456,37,car,27,1,17478,22,586,969,653,1047,67,78,car
46457,38,bus,28,1,17478,46,663,874,828,1022,165,148,bus
46458,43,car,33,0,17478,19,968,965,1054,1009,86,44,car
46459,60,car,50,1,17478,27,860,961,937,1007,77,46,car
46460,9,person,10,0,17479,29,718,1572,798,1805,80,233,person
46461,14,person,15,0,17479,26,398,1544,441,1670,43,126,person
46462,15,person,16,0,17479,26,438,1565,472,1670,34,105,person
46463,0,car,1,0,17480,22,82,299,165,326,83,27,car
46464,1,car,2,0,17480,23,185,300,279,330,94,30,car
46465,23,car,15,1,17480,24,16,292,90,325,74,33,car
46466,26,car,18,0,17480,15,606,277,640,308,34,31,car
46467,31,car,23,0,17480,21,495,286,540,316,45,30,car
46468,38,person,30,0,17480,16,439,283,447,309,8,26,person
46469,39,person,31,0,17480,15,453,282,461,310,8,28,person
46470,44,person,36,0,17480,16,481,283,489,310,8,27,person
46471,12,car,13,0,17481,47,389,1061,1184,1505,795,444,car
46472,0,car,1,0,17482,32,1,834,484,984,483,150,car
46473,1,car,2,0,17482,31,1685,815,2201,981,516,166,car
46474,2,parking meter,3,0,17482,17,1488,834,1506,967,18,133,parking meter
46475,3,car,4,0,17482,24,760,834,1270,985,510,151,car
46476,13,person,14,0,17482,36,1527,794,1576,944,49,150,person
46477,0,flowerpot,1,0,17483,16,877,953,1017,1078,140,125,potted plant
46478,13,car,14,0,17483,24,1726,836,1978,928,252,92,car
46479,14,car,15,0,17483,21,1227,826,1428,921,201,95,car
46480,16,car,17,0,17483,25,1051,832,1227,917,176,85,car
46481,20,car,21,1,17483,15,853,840,1034,951,181,111,car
46482,22,person,23,0,17483,17,2029,840,2078,940,49,100,person
46483,28,person,29,0,17483,24,465,815,516,968,51,153,person
46484,29,person,30,1,17483,23,518,830,554,949,36,119,person
46485,30,person,31,0,17483,22,547,832,590,987,43,155,person
46486,32,person,33,0,17483,17,598,836,641,942,43,106,person
46487,34,person,35,0,17483,26,293,815,346,968,53,153,person
46488,35,person,36,1,17483,19,416,842,450,955,34,113,person
46489,37,person,38,1,17483,24,384,856,420,967,36,111,person
46490,38,umbrella,39,0,17483,15,363,814,446,878,83,64,umbrella
46491,39,person,40,1,17483,17,218,848,261,969,43,121,person
46492,42,traffic light,43,0,17483,24,191,675,261,931,70,256,traffic light
46493,65,traffic light,66,0,17483,20,747,424,874,849,127,425,traffic light
46494,0,car,1,0,17484,55,1145,741,2201,1123,1056,382,car
46495,10,car,11,0,17484,43,468,738,1174,1044,706,306,car
46496,15,car,16,1,17484,26,2,738,375,995,373,257,car
46497,8,car,9,1,17485,15,1234,1056,1385,1203,151,147,car
46498,9,car,10,1,17485,19,1073,1080,1326,1220,253,140,car
46499,10,car,11,1,17485,19,856,1079,1136,1252,280,173,car
46500,11,car,12,1,17485,22,642,1094,1053,1305,411,211,car
46501,12,car,13,1,17485,25,488,1097,824,1350,336,253,car
46502,13,car,14,1,17485,28,137,1115,623,1420,486,305,car
46503,35,car,28,0,17486,17,733,597,930,783,197,186,car
46504,36,person,29,0,17486,50,577,518,751,985,174,467,person
46505,37,person,30,0,17486,40,1031,535,1220,929,189,394,person
46506,38,person,31,0,17486,48,1379,549,1477,799,98,250,person
46507,39,person,32,0,17486,54,903,691,1042,927,139,236,person
46508,45,car,38,1,17486,35,861,550,1086,739,225,189,car
46509,58,person,51,0,17486,27,1290,580,1323,685,33,105,person
46510,62,traffic light,55,0,17486,29,567,365,692,627,125,262,traffic light
46511,64,fire hydrant,57,0,17486,26,442,697,517,912,75,215,fire hydrant
46512,66,person,59,1,17486,27,0,598,89,1157,89,559,person
46513,67,traffic light,60,0,17486,31,166,300,376,469,210,169,traffic light
46514,0,flowerpot,1,0,17487,19,1067,981,1234,1131,167,150,potted plant
46515,2,person,3,0,17487,41,837,800,883,921,46,121,person
46516,3,car,4,0,17487,46,1588,823,1847,967,259,144,car
46517,32,car,23,1,17487,24,1882,860,2046,981,164,121,car
46518,33,car,24,1,17487,29,1443,842,1603,942,160,100,car
46519,34,car,25,1,17487,26,1362,814,1513,914,151,100,car
46520,35,car,26,1,17487,19,1237,833,1330,894,93,61,car
46521,36,car,27,1,17487,19,1208,831,1266,883,58,52,car
46522,37,car,28,1,17487,21,1169,818,1253,881,84,63,car
46523,38,car,29,0,17487,18,1095,824,1156,868,61,44,car
46524,39,car,30,1,17487,17,1076,821,1122,859,46,38,car
46525,40,car,31,0,17487,15,1051,819,1098,854,47,35,car
46526,44,person,35,0,17487,25,720,801,754,910,34,109,person
46527,45,person,36,0,17487,40,747,805,797,917,50,112,person
46528,46,person,37,1,17487,31,777,807,797,909,20,102,person
46529,47,person,38,1,17487,32,808,811,840,918,32,107,person
46530,48,person,39,1,17487,26,872,800,899,920,27,120,person
46531,0,car,1,0,17488,31,1111,947,1954,1460,843,513,car
46532,4,car,5,1,17488,24,996,845,1323,1132,327,287,car
46533,19,car,20,1,17488,17,1612,867,1955,1054,343,187,car
46534,28,window,28,0,17488,16,1330,970,1755,1099,425,129,window
46535,2,car,3,0,17489,22,416,274,629,339,213,65,car
46536,3,car,4,0,17489,27,175,280,369,344,194,64,car
46537,4,parking meter,5,0,17489,21,389,273,406,328,17,55,parking meter
46538,8,person,9,1,17489,16,232,258,247,279,15,21,person
46539,9,person,10,0,17489,22,304,258,315,289,11,31,person
46540,11,person,12,0,17489,20,346,260,357,285,11,25,person
46541,5,person,6,0,17490,15,681,973,699,1051,18,78,person
46542,1,car,2,1,17491,19,2,1254,424,2048,422,794,car
46543,2,car,3,0,17492,21,453,284,577,337,124,53,car
46544,3,car,4,0,17492,27,274,295,422,353,148,58,car
46545,4,car,5,0,17492,29,77,297,282,365,205,68,car
46546,5,parking meter,6,0,17492,16,6,294,26,356,20,62,parking meter
46547,23,person,24,1,17492,16,229,272,246,315,17,43,person
46548,0,car,1,0,17493,20,840,529,1227,850,387,321,car
46549,1,person,2,0,17493,20,329,547,452,892,123,345,person
46550,41,person,39,0,17493,34,225,552,263,671,38,119,person
46551,42,person,40,0,17493,22,276,524,302,602,26,78,person
46552,43,person,41,0,17493,42,305,531,359,643,54,112,person
46553,0,person,1,0,17494,30,301,832,570,1324,269,492,person
46554,2,person,3,0,17494,15,717,921,830,1141,113,220,person
46555,18,person,18,0,17494,19,1434,925,1525,1141,91,216,person
46556,9,person,10,0,17495,20,1480,1107,1529,1278,49,171,person
46557,10,person,11,1,17495,16,1400,1088,1459,1200,59,112,person
46558,12,person,13,1,17495,16,1575,1099,1610,1233,35,134,person
46559,13,person,14,0,17495,26,1606,1062,1668,1272,62,210,person
46560,23,traffic light,24,0,17495,17,1257,746,1340,1173,83,427,traffic light
46561,33,traffic light,34,0,17495,16,703,584,1281,752,578,168,traffic light
46562,58,traffic light,59,0,17495,23,153,993,313,1142,160,149,traffic light
46563,61,traffic light,62,0,17495,27,1109,957,1203,1158,94,201,traffic light
46564,62,traffic light,63,0,17495,15,1832,1010,1877,1156,45,146,traffic light
46565,0,motorbike,1,0,17496,19,1278,978,1665,1247,387,269,motorcycle
46566,5,bus,6,1,17496,25,1204,783,1781,967,577,184,bus
46567,8,person,9,0,17496,29,96,849,138,963,42,114,person
46568,11,person,12,0,17496,21,183,862,206,928,23,66,person
46569,12,motorbike,13,0,17496,23,240,891,313,940,73,49,motorcycle
46570,16,car,17,1,17496,18,543,889,683,997,140,108,car
46571,17,car,18,1,17496,19,621,887,816,1028,195,141,car
46572,18,motorbike,19,1,17496,34,741,931,881,1075,140,144,motorcycle
46573,19,motorbike,20,0,17496,34,799,951,964,1114,165,163,motorcycle
46574,20,motorbike,21,0,17496,41,1072,961,1204,1178,132,217,motorcycle
46575,21,car,22,1,17496,38,1014,889,1327,1099,313,210,car
46576,22,car,23,1,17496,15,1359,887,1584,952,225,65,car
46577,23,car,24,1,17496,37,1256,908,1860,1186,604,278,car
46578,25,person,26,1,17496,31,2041,837,2199,1084,158,247,person
46579,26,car,27,1,17496,21,1716,872,2059,1066,343,194,car
46580,32,car,33,1,17496,15,810,897,964,961,154,64,car
46581,0,person,1,1,17499,28,558,1127,798,1650,240,523,person
46582,11,car,6,1,17499,30,446,1060,839,1275,393,215,car
46583,12,motorbike,7,1,17499,18,551,1165,669,1324,118,159,motorcycle
46584,13,person,8,0,17499,23,551,1088,668,1282,117,194,person
46585,22,car,15,0,17499,23,227,1057,407,1172,180,115,car
46586,25,person,18,0,17499,15,406,1035,429,1122,23,87,person
46587,30,person,22,0,17499,20,1620,1104,1687,1210,67,106,person
46588,31,bench,23,0,17499,16,1537,1130,1584,1187,47,57,bench
46589,32,person,24,0,17499,20,1507,1101,1557,1184,50,83,person
46590,34,car,26,0,17499,20,1961,1110,2184,1218,223,108,car
46591,42,bench,34,0,17499,20,1169,1121,1355,1209,186,88,bench
46592,44,car,36,1,17499,15,94,1036,165,1091,71,55,car
46593,55,car,47,1,17499,25,1845,1093,1975,1191,130,98,car
46594,59,car,51,1,17499,23,1697,1096,1826,1172,129,76,car
46595,61,car,53,1,17499,29,1606,1090,1708,1156,102,66,car
46596,62,car,54,1,17499,15,1561,1088,1633,1158,72,70,car
46597,64,person,56,1,17499,19,1516,1074,1543,1127,27,53,person
46598,65,person,57,1,17499,21,1639,1075,1676,1148,37,73,person
46599,66,person,58,1,17499,24,1611,1107,1667,1193,56,86,person
46600,1,car,2,0,17500,24,710,970,1312,1245,602,275,car
46601,2,car,3,0,17500,23,327,910,732,1168,405,258,car
46602,13,person,14,1,17500,22,1294,918,1374,1078,80,160,person
46603,18,car,19,1,17500,16,3,956,246,1095,243,139,car
46604,19,motorbike,20,0,17500,19,210,960,334,1078,124,118,motorcycle
46605,32,door,33,0,17500,18,1550,1000,1759,1243,209,243,door
46606,33,window,34,0,17500,15,1567,1011,1714,1109,147,98,window
46607,35,door,36,0,17500,18,1403,997,1554,1223,151,226,door
46608,51,door,52,0,17500,17,803,980,925,1165,122,185,door
46609,6,car,7,0,17501,20,242,923,368,1010,126,87,car
46610,0,car,1,0,17502,21,808,988,1452,1299,644,311,car
46611,12,car,11,1,17502,19,1,1008,73,1066,72,58,car
46612,132,door,131,0,17502,16,945,1005,1107,1225,162,220,door
46613,135,person,134,0,17502,27,289,998,305,1053,16,55,person
46614,136,person,135,0,17502,71,1458,1032,1555,1253,97,221,person
46615,137,door,136,0,17502,17,1896,1108,2176,1439,280,331,door
46616,138,door,137,0,17502,21,1695,1107,1928,1415,233,308,door
46617,1,truck,2,1,17504,19,1081,2,1600,533,519,531,truck
46618,6,truck,7,0,17504,18,947,175,1018,276,71,101,truck
46619,11,person,12,0,17504,31,639,224,682,346,43,122,person
46620,12,person,13,0,17504,31,689,225,735,351,46,126,person
46621,14,person,15,0,17504,34,1030,227,1074,326,44,99,person
46622,19,mirror,20,0,17504,21,1282,61,1367,209,85,148,mirror
46623,26,mirror,27,0,17504,20,1409,171,1517,308,108,137,mirror
46624,6,fire hydrant,7,0,17505,21,734,252,762,316,28,64,fire hydrant
46625,7,bicycle,8,0,17505,39,508,234,590,325,82,91,bicycle
46626,10,bench,11,0,17505,16,2,270,87,380,85,110,bench
46627,11,bench,12,0,17505,15,75,284,172,350,97,66,bench
46628,15,bench,16,0,17505,16,2,241,140,294,138,53,bench
46629,5,person,5,0,17506,62,1524,566,1724,1214,200,648,person
46630,6,person,6,0,17506,60,1320,619,1467,1214,147,595,person
46631,7,person,7,0,17506,74,1157,634,1385,1244,228,610,person
46632,8,backpack,8,0,17506,17,1210,696,1335,884,125,188,backpack
46633,18,person,18,1,17506,23,669,657,760,939,91,282,person
46634,19,person,19,0,17506,24,650,671,724,956,74,285,person
46635,22,car,22,1,17506,18,2,665,227,884,225,219,car
46636,23,car,23,1,17506,17,2,849,200,1027,198,178,car
46637,28,person,27,0,17506,26,1070,678,1097,795,27,117,person
46638,32,person,31,1,17506,15,1177,681,1212,740,35,59,person
46639,33,person,32,0,17506,23,1037,686,1065,791,28,105,person
46640,57,umbrella,55,0,17506,20,102,540,334,961,232,421,umbrella
46641,60,person,58,1,17506,21,746,685,789,794,43,109,person
46642,3,car,3,0,17507,19,1118,970,1849,1307,731,337,car
46643,17,bicycle,17,0,17507,26,1694,5,1903,145,209,140,bicycle
46644,20,car,20,1,17509,15,615,555,696,611,81,56,car
46645,22,car,22,0,17509,30,133,590,314,673,181,83,car
46646,1,car,2,0,17510,29,202,562,487,642,285,80,car
46647,26,person,23,0,17510,42,130,557,203,752,73,195,person
46648,27,car,24,0,17510,16,1,571,146,643,145,72,car
46649,35,person,32,1,17510,17,587,542,610,616,23,74,person
46650,36,person,33,0,17510,35,735,539,769,629,34,90,person
46651,37,person,34,0,17510,33,762,543,794,632,32,89,person
46652,38,person,35,0,17510,29,950,544,977,619,27,75,person
46653,39,person,36,0,17510,112,1129,462,1262,834,133,372,person
46654,40,fire hydrant,37,0,17510,25,1003,575,1026,621,23,46,fire hydrant
46655,62,door,59,0,17510,15,33,575,88,632,55,57,door
46656,2,car,2,0,17511,26,339,781,1009,1030,670,249,car
46657,23,door,23,0,17511,19,667,792,823,979,156,187,door
46658,26,door,26,0,17511,16,508,794,694,981,186,187,door
46659,5,car,6,1,17512,17,2,417,338,575,336,158,car
46660,6,car,7,0,17512,32,410,415,871,605,461,190,car
46661,16,traffic light,17,0,17513,81,1267,2,1516,1049,249,1047,traffic light
46662,24,person,25,0,17513,29,702,845,751,1023,49,178,person
46663,25,person,26,0,17513,39,547,846,622,1086,75,240,person
46664,26,person,27,1,17513,30,504,858,560,1041,56,183,person
46665,28,person,29,0,17513,31,357,877,418,982,61,105,person
46666,29,person,30,0,17513,22,282,873,324,981,42,108,person
46667,31,person,32,0,17513,42,2,827,72,1001,70,174,person
46668,35,person,36,0,17513,24,462,841,503,946,41,105,person
46669,38,car,39,0,17513,38,1091,864,1503,1064,412,200,car
46670,7,car,8,0,17514,25,148,859,505,981,357,122,car
46671,11,chair,12,0,17514,17,1907,862,1995,953,88,91,chair
46672,13,chair,14,0,17514,18,1814,881,1898,972,84,91,chair
46673,0,motorbike,1,0,17515,46,451,940,969,1295,518,355,motorcycle
46674,2,person,3,1,17515,27,22,781,485,1525,463,744,person
46675,9,motorbikes,10,1,17515,41,399,795,788,1104,389,309,motorcycle
46676,24,person,25,1,17515,26,57,830,192,1104,135,274,person
46677,5,car,6,0,17516,33,586,835,1309,1127,723,292,car
46678,7,car,8,0,17516,26,35,830,359,1003,324,173,car
46679,25,door,26,0,17516,19,685,846,881,1050,196,204,door
46680,29,door,30,0,17516,18,817,847,1008,1058,191,211,door
46681,2,person,3,1,17517,15,1910,861,1973,955,63,94,person
46682,3,car,4,0,17517,29,1508,878,1977,1085,469,207,car
46683,6,person,7,0,17517,20,1969,829,2019,980,50,151,person
46684,7,person,8,0,17517,23,2111,812,2155,968,44,156,person
46685,15,car,16,0,17517,33,731,936,1420,1179,689,243,car
46686,36,car,37,1,17517,18,2,976,427,1263,425,287,car
46687,0,car,1,0,17518,34,653,1034,2016,1477,1363,443,car
46688,48,door,49,0,17518,16,1045,1050,1411,1389,366,339,door
46689,49,door,50,0,17518,18,1385,1051,1683,1385,298,334,door
46690,57,window,58,0,17518,20,94,1027,279,1132,185,105,window
46691,0,car,1,0,17519,29,342,722,1058,1208,716,486,car
46692,9,door,10,0,17519,23,2069,631,2195,1588,126,957,door
46693,14,person,15,0,17519,16,1552,861,1579,947,27,86,person
46694,17,car,18,0,17519,18,1335,874,1434,936,99,62,car
46695,22,car,23,1,17519,20,964,871,1207,1071,243,200,car
46696,29,car,30,1,17519,16,0,816,260,1023,260,207,car
46697,36,parking meter,37,0,17519,19,845,911,904,1230,59,319,parking meter
46698,3,person,4,0,17520,20,724,190,759,283,35,93,person
46699,0,car,1,0,17521,17,926,828,1193,1009,267,181,car
46700,7,car,8,0,17521,22,341,847,473,887,132,40,car
46701,8,car,9,0,17521,15,503,848,612,887,109,39,car
46702,10,car,11,0,17521,16,714,845,844,886,130,41,car
46703,19,bus,15,1,17521,26,977,778,1319,871,342,93,bus
46704,32,traffic light,28,0,17521,24,888,675,920,872,32,197,traffic light
46705,35,car,31,1,17521,27,1405,819,1555,867,150,48,car
46706,38,person,34,0,17521,19,125,839,141,881,16,42,person
46707,39,person,35,0,17521,19,145,835,170,881,25,46,person
46708,0,car,1,0,17523,28,691,870,929,986,238,116,car
46709,24,car,17,1,17523,28,135,888,382,1010,247,122,car
46710,25,car,18,1,17523,47,333,861,657,999,324,138,car
46711,26,traffic light,19,0,17523,38,476,539,551,898,75,359,traffic light
46712,27,traffic light,20,0,17523,107,786,1,1555,1124,769,1123,traffic light
46713,29,person,22,1,17523,16,211,861,255,915,44,54,person
46714,30,person,23,1,17523,32,475,848,630,1199,155,351,person
46715,32,car,25,1,17523,17,1386,870,1503,953,117,83,car
46716,37,person,30,0,17523,28,1165,853,1196,940,31,87,person
46717,38,person,31,1,17523,17,1050,847,1086,874,36,27,person
46718,40,traffic light,33,0,17523,27,1261,665,1314,974,53,309,traffic light
46719,44,person,37,1,17523,62,1261,884,1425,1199,164,315,person
46720,47,person,40,1,17523,24,903,842,945,908,42,66,person
46721,5,person,4,0,17524,16,1179,775,1268,1028,89,253,person
46722,18,person,17,0,17524,32,1266,779,1337,1039,71,260,person
46723,2,car,3,0,17525,21,271,908,699,1109,428,201,car
46724,11,car,12,0,17525,29,1233,964,1728,1293,495,329,car
46725,12,car,13,1,17525,25,793,963,1160,1182,367,219,car
46726,22,car,23,1,17525,20,739,967,897,1111,158,144,car
46727,23,car,24,1,17525,18,1015,914,1266,1033,251,119,car
46728,4,car,5,1,17526,17,358,757,602,880,244,123,car
46729,5,car,6,1,17526,29,403,745,832,917,429,172,car
46730,18,person,19,0,17526,23,247,720,286,819,39,99,person
46731,19,person,20,0,17526,19,209,716,246,817,37,101,person
46732,47,person,47,1,17526,16,848,719,870,752,22,33,person
46733,48,person,48,1,17526,20,816,712,840,768,24,56,person
46734,49,person,49,1,17526,21,590,721,626,757,36,36,person
46735,50,person,50,1,17526,20,797,711,828,767,31,56,person
46736,51,person,51,1,17526,17,767,722,800,761,33,39,person
46737,52,person,52,1,17526,19,751,716,779,752,28,36,person
46738,53,person,53,1,17526,21,542,725,585,757,43,32,person
46739,54,person,54,0,17526,45,171,750,204,816,33,66,person
46740,58,person,58,1,17526,22,1217,696,1244,766,27,70,person
46741,59,person,59,1,17526,18,1198,711,1215,769,17,58,person
46742,4,person,5,0,17527,38,1437,975,1642,1344,205,369,person
46743,10,person,11,0,17527,69,212,961,491,1457,279,496,person
46744,16,person,17,0,17527,43,777,965,923,1258,146,293,person
46745,17,person,18,1,17527,57,1214,936,1356,1342,142,406,person
46746,23,backpack,24,0,17527,16,329,1040,444,1199,115,159,backpack
46747,1,car,2,0,17528,19,1567,830,1983,974,416,144,car
46748,8,car,9,0,17528,16,1442,810,1568,912,126,102,car
46749,9,person,10,0,17528,25,98,775,155,882,57,107,person
46750,15,car,16,0,17528,15,326,805,447,900,121,95,car
46751,16,traffic light,17,0,17528,17,286,650,318,872,32,222,traffic light
46752,17,traffic light,18,0,17528,40,1800,596,1865,808,65,212,traffic light
46753,18,traffic light,19,0,17528,19,1128,683,1169,855,41,172,traffic light
46754,19,motorbike,20,0,17528,37,1056,839,1158,919,102,80,motorcycle
46755,20,person,21,0,17528,27,981,808,1042,916,61,108,person
46756,22,motorbike,23,0,17528,32,827,827,910,914,83,87,motorcycle
46757,23,person,24,0,17528,29,1480,807,1532,916,52,109,person
46758,24,motorbike,25,1,17528,27,1248,838,1305,916,57,78,motorcycle
46759,25,person,26,1,17528,32,1261,819,1313,914,52,95,person
46760,27,motorbike,28,1,17528,18,1351,818,1387,913,36,95,motorcycle
46761,28,person,29,1,17528,32,1338,809,1392,913,54,104,person
46762,30,car,31,1,17528,23,205,785,297,843,92,58,car
46763,31,person,32,0,17528,19,247,794,270,867,23,73,person
46764,34,person,35,0,17528,21,723,779,771,903,48,124,person
46765,35,person,36,0,17528,23,1176,808,1212,927,36,119,person
46766,37,person,38,0,17528,24,405,776,477,900,72,124,person
46767,38,person,39,0,17528,19,374,779,406,897,32,118,person
46768,0,car,1,0,17529,23,1113,841,1664,1148,551,307,car
46769,11,car,11,1,17529,16,343,835,562,978,219,143,car
46770,18,person,18,1,17529,15,1180,803,1212,870,32,67,person
46771,30,person,30,1,17529,18,370,803,409,858,39,55,person
46772,31,person,31,1,17529,17,352,793,379,839,27,46,person
46773,34,traffic light,34,0,17529,16,70,682,106,810,36,128,traffic light
46774,43,door,41,0,17529,20,1535,858,1631,1071,96,213,door
46775,48,door,46,0,17529,18,1472,861,1559,1079,87,218,door
46776,49,window,47,0,17529,17,1488,867,1544,957,56,90,window
46777,0,car,1,0,17530,18,476,864,1029,1072,553,208,car
46778,1,car,2,0,17530,21,1422,867,2182,1109,760,242,car
46779,7,bus,8,1,17530,27,1551,676,2200,1002,649,326,bus
46780,8,car,9,1,17530,18,2,891,406,1148,404,257,car
46781,16,person,17,1,17530,18,1459,856,1511,959,52,103,person
46782,17,person,18,1,17530,18,1010,855,1043,959,33,104,person
46783,61,door,62,0,17530,17,767,872,892,1015,125,143,door
46784,21,motorbike,22,1,17531,29,1160,967,1339,1115,179,148,motorcycle
46785,22,motorbike,23,0,17531,29,1236,959,1420,1123,184,164,motorcycle
46786,27,car,28,1,17531,15,1941,783,2115,1196,174,413,car
46787,31,bear,32,0,17531,17,1455,1174,1585,1329,130,155,bear
46788,33,car,34,1,17531,22,925,923,1095,1042,170,119,car
46789,38,traffic light,39,0,17531,16,1012,759,1058,1038,46,279,traffic light
46790,7,bicycle,8,0,17534,70,1889,1007,1995,1112,106,105,bicycle
46791,8,person,9,0,17534,50,1985,954,2075,1175,90,221,person
46792,9,person,10,1,17534,36,2052,956,2115,1165,63,209,person
46793,14,traffic light,15,0,17534,33,1409,788,1459,1152,50,364,traffic light
46794,19,car,20,0,17534,44,682,990,1126,1153,444,163,car
46795,21,car,22,0,17534,35,445,984,696,1110,251,126,car
46796,24,car,25,0,17534,34,104,942,309,1068,205,126,car
46797,26,car,27,1,17534,25,4,968,108,1051,104,83,car
46798,16,person,17,0,17535,23,886,942,986,1258,100,316,person
46799,17,person,18,0,17535,17,876,1032,949,1195,73,163,person
46800,18,person,19,0,17535,15,794,1080,888,1185,94,105,person
46801,37,person,38,0,17535,20,1894,907,1927,1002,33,95,person
46802,39,person,40,0,17535,16,1965,894,1994,1002,29,108,person
46803,41,window,42,0,17535,23,737,806,1066,1126,329,320,window
46804,7,person,8,0,17536,32,1709,956,1813,1161,104,205,person
46805,19,traffic light,20,0,17536,18,999,7,1116,182,117,175,traffic light
46806,27,person,22,1,17537,16,265,1679,311,1805,46,126,person
46807,28,horse,23,0,17537,46,298,1655,508,1838,210,183,horse
46808,30,person,25,0,17537,27,629,1702,675,1846,46,144,person
46809,31,person,26,0,17537,24,446,1768,492,1865,46,97,person
46810,32,person,27,0,17537,41,390,1701,461,1865,71,164,person
46811,37,person,32,1,17537,20,1368,1929,1481,2048,113,119,person
46812,39,person,34,0,17537,29,1148,1698,1204,1848,56,150,person
46813,40,person,35,1,17537,18,1139,1719,1167,1836,28,117,person
46814,41,person,36,0,17537,27,1071,1749,1106,1849,35,100,person
46815,42,person,37,1,17537,21,1068,1699,1103,1780,35,81,person
46816,43,person,38,0,17537,30,1014,1691,1063,1814,49,123,person
46817,44,person,39,0,17537,37,902,1702,960,1870,58,168,person
46818,45,person,40,0,17537,31,812,1712,870,1867,58,155,person
46819,48,person,43,1,17537,22,26,1736,120,1812,94,76,person
46820,12,car,12,1,17538,15,1915,1084,2047,1191,132,107,car
46821,17,umbrella,17,0,17538,21,1499,1026,1645,1113,146,87,umbrella
46822,18,umbrella,18,0,17538,21,1656,1021,1830,1112,174,91,umbrella
46823,19,umbrella,19,0,17538,20,1846,1029,2022,1066,176,37,umbrella
46824,21,person,21,1,17538,21,1622,1097,1646,1142,24,45,person
46825,22,chair,22,0,17538,17,1611,1116,1639,1166,28,50,chair
46826,23,chair,23,1,17538,16,1582,1116,1611,1168,29,52,chair
46827,24,chair,24,0,17538,18,1666,1118,1698,1168,32,50,chair
46828,25,chair,25,0,17538,19,1706,1120,1742,1170,36,50,chair
46829,33,car,33,1,17538,23,1400,1076,1471,1159,71,83,car
46830,35,person,35,0,17538,38,1370,1077,1413,1180,43,103,person
46831,36,traffic light,36,0,17538,23,1448,935,1491,1171,43,236,traffic light
46832,39,car,39,1,17538,31,226,1083,345,1151,119,68,car
46833,41,person,41,0,17538,44,1305,1075,1345,1194,40,119,person
46834,42,person,42,0,17538,44,1208,1061,1272,1192,64,131,person
46835,43,person,43,0,17538,53,1183,1061,1244,1185,61,124,person
46836,44,person,44,0,17538,39,1164,1061,1200,1184,36,123,person
46837,45,person,45,0,17538,18,1276,1069,1288,1115,12,46,person
46838,46,person,46,0,17538,51,1104,1061,1166,1198,62,137,person
46839,47,backpack,47,0,17538,20,1113,1082,1154,1131,41,49,backpack
46840,48,person,48,0,17538,43,1065,1071,1110,1186,45,115,person
46841,49,person,49,0,17538,45,1032,1062,1070,1191,38,129,person
46842,50,backpack,50,0,17538,15,1022,1085,1055,1134,33,49,backpack
46843,51,person,51,0,17538,40,997,1079,1028,1159,31,80,person
46844,52,person,52,0,17538,44,911,1077,955,1172,44,95,person
46845,53,person,53,0,17538,49,815,1057,892,1198,77,141,person
46846,54,person,54,0,17538,45,684,1046,780,1192,96,146,person
46847,55,person,55,0,17538,28,687,1057,717,1163,30,106,person
46848,56,person,56,0,17538,49,438,1052,493,1205,55,153,person
46849,59,person,59,0,17538,40,315,1070,395,1199,80,129,person
46850,60,person,60,1,17538,32,147,1032,198,1182,51,150,person
46851,72,traffic light,72,0,17538,32,815,946,860,1070,45,124,traffic light
46852,0,person,1,0,17539,17,993,534,1058,705,65,171,person
46853,10,car,11,0,17539,34,418,570,668,640,250,70,car
46854,34,car,34,1,17539,16,308,556,441,616,133,60,car
46855,56,traffic light,56,0,17539,25,392,2,655,665,263,663,traffic light
46856,0,person,1,0,17540,31,64,1010,192,1347,128,337,person
46857,1,car,2,0,17540,39,1257,1009,1754,1175,497,166,car
46858,2,traffic light,3,0,17540,16,201,704,223,760,22,56,traffic light
46859,22,car,23,1,17540,19,1621,989,1869,1123,248,134,car
46860,44,person,45,0,17540,20,678,997,700,1067,22,70,person
46861,2,car,3,0,17541,38,347,1128,1282,1441,935,313,car
46862,0,person,1,0,17542,19,583,401,750,803,167,402,person
46863,3,person,4,0,17542,37,771,388,950,801,179,413,person
46864,16,bicycle,17,0,17542,35,493,461,589,536,96,75,bicycle
46865,20,car,21,1,17542,20,140,422,321,595,181,173,car
46866,21,car,22,1,17542,18,16,471,209,650,193,179,car
46867,23,car,24,1,17542,15,2,481,97,707,95,226,car
46868,24,person,25,1,17542,16,721,392,786,528,65,136,person
46869,25,person,26,1,17542,27,739,406,826,729,87,323,person
46870,17,car,18,0,17543,18,903,1177,1043,1247,140,70,car
46871,18,car,19,1,17543,20,451,1156,678,1259,227,103,car
46872,19,car,20,0,17543,19,635,1163,829,1274,194,111,car
46873,20,car,21,1,17543,16,208,1144,470,1253,262,109,car
46874,21,car,22,1,17543,15,2,1140,227,1255,225,115,car
46875,24,traffic light,25,0,17543,24,297,695,451,1410,154,715,traffic light
46876,17,bicycle,18,0,17544,29,1790,1018,1860,1088,70,70,bicycle
46877,3,car,4,0,17546,30,578,1122,1034,1287,456,165,car
46878,4,car,5,0,17546,33,65,1156,493,1287,428,131,car
46879,14,traffic light,15,0,17546,31,1333,584,1935,1194,602,610,traffic light
46880,15,person,16,1,17546,15,1963,1057,1990,1162,27,105,person
46881,16,person,17,0,17546,16,1989,1070,2019,1164,30,94,person
46882,17,traffic light,11,0,17547,58,604,435,1696,1299,1092,864,traffic light
46883,21,person,15,1,17547,24,1625,1079,1671,1286,46,207,person
46884,31,car,25,0,17547,25,1190,1097,1336,1195,146,98,car
46885,33,person,27,1,17547,17,1546,1086,1573,1234,27,148,person
46886,34,person,28,0,17547,30,1500,1097,1564,1286,64,189,person
46887,35,person,29,1,17547,25,1479,1083,1520,1265,41,182,person
46888,36,person,30,0,17547,30,1391,1086,1479,1296,88,210,person
46889,37,person,31,0,17547,30,1340,1069,1400,1281,60,212,person
46890,38,car,32,0,17547,32,879,1113,1092,1212,213,99,car
46891,39,car,33,0,17547,43,0,1093,603,1314,603,221,car
46892,40,person,34,1,17547,17,74,1072,125,1144,51,72,person
46893,41,person,35,1,17547,15,115,1055,171,1115,56,60,person
46894,44,person,38,1,17547,17,407,1058,447,1120,40,62,person
46895,45,person,39,1,17547,17,446,1074,508,1164,62,90,person
46896,46,person,40,1,17547,20,525,1080,566,1166,41,86,person
46897,49,person,42,0,17547,23,622,1084,662,1204,40,120,person
46898,50,person,43,0,17547,26,719,1076,768,1195,49,119,person
46899,51,person,44,0,17547,19,820,1083,856,1190,36,107,person
46900,52,person,45,1,17547,22,772,1084,801,1183,29,99,person
46901,53,person,46,1,17547,23,1069,1088,1099,1146,30,58,person
46902,54,person,47,1,17547,19,801,1088,823,1185,22,97,person
46903,56,person,49,1,17547,28,857,1086,885,1181,28,95,person
46904,57,person,50,1,17547,16,1007,1085,1032,1116,25,31,person
46905,59,person,52,1,17547,18,853,1048,873,1086,20,38,person
46906,60,person,53,1,17547,15,778,1054,800,1080,22,26,person
46907,61,person,54,1,17547,18,909,1086,933,1140,24,54,person
46908,62,person,55,1,17547,16,929,1086,948,1118,19,32,person
46909,63,person,56,1,17547,22,1040,1084,1069,1139,29,55,person
46910,64,person,57,1,17547,24,712,1079,744,1184,32,105,person
46911,0,car,1,0,17548,21,740,1147,1381,1418,641,271,car
46912,3,car,4,0,17548,23,106,1084,709,1333,603,249,car
46913,0,car,1,0,17549,23,544,1052,768,1134,224,82,car
46914,1,bus,2,0,17549,21,695,898,1300,1111,605,213,bus
46915,11,car,12,1,17549,17,2,1042,217,1117,215,75,car
46916,13,car,14,1,17549,15,256,1016,411,1095,155,79,car
46917,15,car,16,0,17549,19,278,1031,531,1121,253,90,car
46918,25,car,26,1,17549,15,1164,1046,1293,1130,129,84,car
46919,26,bicycle,27,0,17549,22,1155,1145,1194,1276,39,131,bicycle
46920,6,motorbike,7,0,17550,22,679,1024,780,1122,101,98,motorcycle
46921,7,motorbike,8,0,17550,20,782,1029,865,1118,83,89,motorcycle
46922,8,motorbike,9,0,17550,24,986,1022,1112,1114,126,92,motorcycle
46923,9,car,10,0,17550,15,1035,982,1235,1059,200,77,car
46924,11,car,12,0,17550,19,1293,995,1527,1099,234,104,car
46925,14,car,15,0,17550,18,1565,1003,1804,1086,239,83,car
46926,16,car,17,0,17550,15,1857,990,2047,1082,190,92,car
46927,20,traffic light,21,0,17550,17,530,748,592,1127,62,379,traffic light
46928,12,car,13,0,17551,17,1545,1100,1695,1177,150,77,car
46929,62,car,56,0,17551,16,1037,1094,1181,1201,144,107,car
46930,63,car,57,1,17551,15,1902,1066,2047,1176,145,110,car
46931,64,traffic light,58,0,17551,33,1666,916,1735,1187,69,271,traffic light
46932,65,traffic light,59,0,17551,45,1272,780,1445,1203,173,423,traffic light
46933,66,car,60,1,17551,16,452,1141,556,1223,104,82,car
46934,0,motorbike,1,0,17552,26,62,276,128,363,66,87,motorcycle
46935,3,car,4,0,17552,37,287,278,467,375,180,97,car
46936,4,car,5,1,17552,29,399,238,539,333,140,95,car
46937,0,person,1,0,17553,25,1579,848,1752,1264,173,416,person
46938,9,person,10,0,17553,47,10,826,217,1334,207,508,person
46939,19,table,17,0,17553,15,1074,989,1523,1206,449,217,dining table
46940,17,car,15,0,17554,22,1565,918,1690,992,125,74,car
46941,19,car,17,0,17554,21,1963,923,2055,985,92,62,car
46942,20,car,18,0,17554,18,1844,912,1913,961,69,49,car
46943,24,car,22,1,17554,20,363,912,632,1030,269,118,car
46944,28,bus,26,1,17554,18,1528,867,1724,946,196,79,bus
46945,32,person,30,1,17554,17,340,889,382,986,42,97,person
46946,38,person,36,1,17554,30,2081,844,2199,1434,118,590,person
46947,94,traffic light,92,0,17554,17,1552,737,1768,870,216,133,traffic light
46948,124,traffic light,122,0,17554,23,1673,793,1724,878,51,85,traffic light
46949,125,person,123,1,17554,16,115,901,153,959,38,58,person
46950,133,car,131,1,17554,30,910,903,1094,1018,184,115,car
46951,144,car,142,0,17554,40,1132,895,1338,1014,206,119,car
46952,158,door,156,0,17554,15,775,920,851,1043,76,123,door
46953,162,door,160,0,17554,20,837,920,910,1037,73,117,door
46954,165,car,163,0,17554,40,559,914,956,1078,397,164,car
46955,7,car,8,0,17555,21,574,714,793,865,219,151,car
46956,42,person,43,1,17555,18,572,699,621,774,49,75,person
46957,43,person,44,1,17555,17,255,718,296,818,41,100,person
46958,46,car,47,1,17555,15,1201,648,1243,687,42,39,car
46959,10,car,11,1,17556,15,1245,1085,1333,1153,88,68,car
46960,16,car,17,0,17556,17,749,1067,870,1176,121,109,car
46961,18,fire hydrant,19,0,17556,19,328,1177,385,1291,57,114,fire hydrant
46962,47,traffic light,46,0,17557,20,555,342,958,405,403,63,traffic light
46963,48,person,47,0,17557,25,567,567,588,618,21,51,person
46964,31,person,27,1,17558,24,1584,873,1644,971,60,98,person
46965,56,door,52,0,17558,15,1264,993,1326,1120,62,127,door
46966,10,car,11,1,17559,16,330,912,513,1037,183,125,car
46967,11,car,12,0,17559,29,1126,927,1902,1211,776,284,car
46968,88,car,89,0,17559,28,479,923,779,1070,300,147,car
46969,104,car,105,0,17559,26,168,916,321,1000,153,84,car
46970,122,door,123,0,17559,15,1348,933,1495,1145,147,212,door
46971,123,door,124,0,17559,17,1244,933,1382,1126,138,193,door
46972,17,motorbike,18,0,17560,20,573,1177,633,1226,60,49,motorcycle
46973,18,car,19,0,17560,15,645,1153,735,1232,90,79,car
46974,19,car,20,0,17560,16,740,1145,852,1227,112,82,car
46975,20,car,21,0,17560,20,852,1139,971,1226,119,87,car
46976,21,car,22,0,17560,22,974,1148,1084,1218,110,70,car
46977,22,car,23,0,17560,22,1074,1127,1206,1220,132,93,car
46978,23,car,24,0,17560,19,1210,1146,1313,1212,103,66,car
46979,24,car,25,0,17560,21,1311,1133,1425,1210,114,77,car
46980,25,motorbike,26,0,17560,23,1430,1143,1491,1200,61,57,motorcycle
46981,27,traffic light,28,0,17560,27,1570,909,1783,1190,213,281,traffic light
46982,46,car,47,0,17560,23,164,1137,328,1226,164,89,car
46983,47,car,48,1,17560,20,69,1167,205,1275,136,108,car
46984,10,car,11,1,17561,21,452,1368,614,1466,162,98,car
46985,11,car,12,1,17561,20,286,1379,472,1479,186,100,car
46986,12,car,13,1,17561,34,38,1412,426,1641,388,229,car
46987,13,car,14,1,17561,17,2,1450,144,1694,142,244,car
46988,0,car,1,0,17562,17,101,856,839,1164,738,308,car
46989,1,car,2,0,17562,17,976,817,1793,1218,817,401,car
46990,34,door,34,0,17562,19,243,874,453,1131,210,257,door
46991,38,door,38,0,17562,16,413,873,581,1117,168,244,door
46992,51,door,51,0,17562,20,1197,845,1469,1119,272,274,door
46993,55,window,55,0,17562,15,1499,839,1676,958,177,119,window
46994,17,traffic light,18,0,17563,36,1408,667,1983,1002,575,335,traffic light
46995,24,car,25,0,17563,28,1205,951,1738,1134,533,183,car
46996,30,car,31,0,17563,30,819,913,1195,1061,376,148,car
46997,40,traffic light,41,0,17563,33,360,585,786,982,426,397,traffic light
46998,46,car,47,0,17563,25,20,929,364,1059,344,130,car
46999,0,car,1,0,17564,16,88,587,547,931,459,344,car
47000,9,motorbike,10,0,17564,78,850,684,1153,1124,303,440,motorcycle
47001,20,person,20,0,17564,31,875,651,1085,1022,210,371,person
47002,21,person,21,1,17564,26,848,654,913,1008,65,354,person
47003,26,person,26,0,17564,33,553,583,593,715,40,132,person
47004,27,person,27,1,17564,26,510,582,540,692,30,110,person
47005,28,person,28,1,17564,23,435,583,473,662,38,79,person
47006,0,motorbike,1,0,17566,24,489,735,698,1241,209,506,motorcycle
47007,1,motorbike,2,0,17566,26,1145,668,1428,1129,283,461,motorcycle
47008,2,motorbike,3,0,17566,29,1536,698,1808,1093,272,395,motorcycle
47009,3,person,4,1,17566,25,1272,451,1390,726,118,275,person
47010,0,car,1,0,17567,25,1059,1018,1847,1264,788,246,car
47011,1,car,2,0,17567,26,361,971,971,1228,610,257,car
47012,23,parking meter,24,0,17567,21,987,1026,1037,1201,50,175,parking meter
47013,86,door,84,0,17567,16,1219,1024,1378,1202,159,178,door
47014,91,door,89,0,17567,15,461,984,590,1152,129,168,door
47015,0,person,1,0,17568,56,502,385,632,799,130,414,person
47016,1,person,2,0,17568,91,903,401,1077,823,174,422,person
47017,4,car,5,0,17568,49,86,410,244,508,158,98,car
47018,10,bench,11,0,17568,24,609,589,736,745,127,156,bench
47019,20,person,21,1,17568,15,835,415,866,541,31,126,person
47020,25,bench,26,1,17568,16,783,549,844,651,61,102,bench
47021,45,person,46,0,17568,21,1187,413,1207,460,20,47,person
47022,2,car,3,0,17569,19,1592,1094,1970,1272,378,178,car
47023,4,car,5,0,17569,19,724,976,1185,1152,461,176,car
47024,22,car,23,1,17569,22,455,957,706,1105,251,148,car
47025,23,car,24,1,17569,22,247,925,547,1105,300,180,car
47026,24,car,25,0,17569,36,1221,1034,1672,1176,451,142,car
47027,30,car,31,1,17569,21,1712,1058,2045,1208,333,150,car
47028,42,door,43,0,17569,15,1629,1099,1723,1234,94,135,door
47029,45,door,46,0,17569,18,1681,1101,1773,1239,92,138,door
47030,13,car,14,0,17572,49,103,1731,1058,2057,955,326,car
47031,14,car,15,1,17572,20,1252,1777,1650,2119,398,342,car
47032,7,car,8,1,17573,16,1087,406,1280,957,193,551,car
47033,1,car,2,0,17574,17,1671,869,2164,1099,493,230,car
47034,18,person,13,1,17574,16,929,784,957,919,28,135,person
47035,19,person,14,0,17574,24,942,777,1004,919,62,142,person
47036,0,person,1,0,17575,23,618,501,744,876,126,375,person
47037,1,person,2,0,17575,24,1024,498,1200,830,176,332,person
47038,4,traffic light,4,0,17575,19,170,3,370,873,200,870,traffic light
47039,5,car,6,1,17576,15,1406,957,1703,1131,297,174,car
47040,6,car,7,0,17576,23,1653,946,2143,1134,490,188,car
47041,11,car,12,1,17577,17,253,526,424,597,171,71,car
47042,12,car,13,1,17577,22,360,520,482,593,122,73,car
47043,13,car,14,1,17577,17,442,521,544,586,102,65,car
47044,0,car,1,0,17578,22,491,510,1295,767,804,257,car
47045,1,car,2,0,17578,21,1327,512,1928,710,601,198,car
47046,9,traffic light,10,0,17578,23,55,8,255,734,200,726,traffic light
47047,0,car,1,1,17579,26,1369,850,1619,985,250,135,car
47048,4,person,5,0,17579,28,288,757,423,1170,135,413,person
47049,22,car,21,1,17579,27,1616,829,1952,1010,336,181,car
47050,23,car,22,1,17579,28,154,816,318,891,164,75,car
47051,24,car,23,1,17579,23,101,814,197,882,96,68,car
47052,25,car,24,1,17579,30,43,811,144,878,101,67,car
47053,26,car,25,1,17579,21,2,812,80,872,78,60,car
47054,29,car,28,1,17579,19,1173,846,1379,967,206,121,car
47055,5,car,6,0,17580,27,345,333,651,466,306,133,car
47056,6,car,7,0,17580,21,625,320,800,414,175,94,car
47057,15,person,16,0,17580,15,97,348,120,410,23,62,person
47058,13,person,14,0,17581,36,1274,978,1319,1103,45,125,person
47059,14,person,15,0,17581,29,1325,981,1354,1090,29,109,person
47060,15,person,16,0,17581,47,1359,981,1421,1176,62,195,person
47061,16,person,17,0,17581,57,1636,995,1717,1220,81,225,person
47062,17,person,18,0,17581,40,1548,999,1603,1153,55,154,person
47063,26,person,27,0,17581,30,1514,992,1553,1102,39,110,person
47064,27,person,28,0,17581,27,1451,974,1496,1100,45,126,person
47065,29,person,30,0,17581,24,1717,1005,1751,1120,34,115,person
47066,32,car,33,1,17581,20,1924,990,2098,1159,174,169,car
47067,33,car,34,1,17581,22,2002,1013,2198,1202,196,189,car
47068,46,person,47,1,17581,19,1411,983,1433,1097,22,114,person
47069,2,person,2,0,17582,50,155,214,580,1194,425,980,person
47070,8,person,8,1,17582,17,846,235,943,369,97,134,person
47071,14,person,14,0,17582,19,1061,259,1103,382,42,123,person
47072,15,person,15,1,17582,18,1187,257,1222,394,35,137,person
47073,22,car,22,1,17582,15,1393,275,1550,435,157,160,car
47074,40,person,39,0,17582,56,1096,235,1190,496,94,261,person
47075,6,car,6,0,17583,32,948,942,1189,1050,241,108,car
47076,7,car,7,1,17583,22,504,936,727,1032,223,96,car
47077,11,person,11,0,17583,21,238,940,268,1028,30,88,person
47078,13,car,13,1,17583,16,2,942,101,1011,99,69,car
47079,15,traffic light,15,0,17583,45,133,195,762,1180,629,985,traffic light
47080,26,car,26,1,17583,30,1265,979,1551,1174,286,195,car
47081,27,car,27,0,17583,41,1504,1015,1991,1257,487,242,car
47082,28,traffic light,28,0,17583,20,1792,764,1833,1036,41,272,traffic light
47083,29,car,29,1,17583,18,1871,964,2049,1075,178,111,car
47084,39,traffic light,39,0,17583,21,824,697,946,993,122,296,traffic light
47085,77,car,73,1,17583,47,1179,967,1314,1045,135,78,car
47086,78,person,74,0,17583,52,1202,957,1253,1127,51,170,person
47087,4,car,5,0,17584,33,555,1249,1229,1491,674,242,car
47088,5,car,6,0,17584,29,1322,1242,2197,1573,875,331,car
47089,49,door,50,0,17584,15,791,1251,914,1428,123,177,door
47090,55,door,56,0,17584,21,1743,1254,1967,1499,224,245,door
47091,0,car,1,0,17585,18,688,1053,896,1206,208,153,car
47092,3,car,4,0,17585,27,1299,1065,1621,1236,322,171,car
47093,4,car,5,0,17585,24,1590,1084,2046,1272,456,188,car
47094,7,car,8,0,17585,23,3,1042,455,1255,452,213,car
47095,8,person,9,1,17585,18,3,985,69,1126,66,141,person
47096,17,car,18,0,17585,21,1541,1023,1678,1064,137,41,car
47097,18,car,19,0,17585,19,1680,1024,1803,1069,123,45,car
47098,0,car,1,0,17586,28,1090,1033,1725,1286,635,253,car
47099,1,car,2,0,17586,18,1721,981,2174,1198,453,217,car
47100,9,person,10,0,17587,16,212,861,233,960,21,99,person
47101,10,person,11,0,17587,21,250,866,272,960,22,94,person
47102,11,person,12,1,17587,19,424,828,477,975,53,147,person
47103,15,person,16,1,17587,20,600,822,689,905,89,83,person
47104,16,person,17,1,17587,16,558,843,616,920,58,77,person
47105,17,person,18,1,17587,19,908,855,952,945,44,90,person
47106,22,traffic light,23,0,17587,62,756,12,1020,899,264,887,traffic light
47107,23,car,24,0,17587,36,292,902,1030,1139,738,237,car
47108,25,car,26,1,17587,26,1051,910,1634,1083,583,173,car
47109,26,car,27,0,17587,58,843,931,2130,1451,1287,520,car
47110,79,person,80,0,17587,33,1226,869,1249,947,23,78,person
47111,8,car,9,1,17588,19,123,845,508,954,385,109,car
47112,9,car,10,1,17588,23,615,881,1012,1069,397,188,car
47113,11,car,12,0,17588,18,1760,945,2020,1119,260,174,car
47114,14,car,15,1,17588,15,1493,915,1637,1051,144,136,car
47115,15,car,16,0,17588,25,1255,894,1508,1080,253,186,car
47116,16,car,17,1,17588,17,140,870,459,1056,319,186,car
47117,17,car,18,1,17588,27,224,908,841,1298,617,390,car
47118,23,car,24,1,17588,18,4,894,242,1371,238,477,car
47119,2,chair,3,0,17589,19,435,1026,604,1262,169,236,chair
47120,7,table,8,0,17589,18,602,1023,808,1241,206,218,dining table
47121,12,chair,13,0,17589,22,626,1056,783,1270,157,214,chair
47122,18,person,19,0,17589,16,688,793,723,880,35,87,person
47123,19,person,20,0,17589,71,808,812,976,1293,168,481,person
47124,27,person,27,0,17589,29,757,785,783,873,26,88,person
47125,28,person,28,0,17589,27,740,789,764,866,24,77,person
47126,0,person,1,0,17590,26,322,933,374,1107,52,174,person
47127,1,person,2,0,17590,24,389,914,445,1113,56,199,person
47128,2,person,3,1,17590,22,2,955,229,1463,227,508,person
47129,8,motorbikes,9,0,17590,21,1698,949,1964,1045,266,96,motorcycle
47130,13,car,14,1,17590,16,867,897,947,967,80,70,car
47131,14,pot,15,0,17590,30,1286,1310,1622,1463,336,153,potted plant
47132,16,car,17,0,17590,17,797,906,872,981,75,75,car
47133,19,motorbikes,20,0,17590,38,1374,924,1571,995,197,71,motorcycle
47134,25,flowerpot,26,0,17590,22,951,1172,1152,1280,201,108,potted plant
47135,26,flowerpot,27,1,17590,22,1111,1247,1322,1374,211,127,potted plant
47136,29,flowerpot,30,0,17590,25,770,1133,950,1223,180,90,potted plant
47137,9,car,10,0,17591,16,1982,1254,2197,1443,215,189,car
47138,30,person,31,0,17591,27,247,1215,295,1355,48,140,person
47139,31,person,32,1,17591,16,276,1199,305,1288,29,89,person
47140,32,person,33,0,17591,25,474,1204,504,1279,30,75,person
47141,6,car,7,0,17592,25,1042,1032,1443,1167,401,135,car
47142,7,car,8,0,17592,26,689,1035,1062,1157,373,122,car
47143,8,car,9,0,17592,25,411,1037,695,1152,284,115,car
47144,9,car,10,0,17592,23,156,1030,428,1139,272,109,car
47145,10,car,11,1,17592,16,5,1027,157,1127,152,100,car
47146,21,traffic light,22,0,17592,21,1850,810,1982,1211,132,401,traffic light
47147,28,motorbike,29,0,17592,42,1624,1025,1731,1147,107,122,motorcycle
47148,29,person,30,1,17592,16,752,1017,788,1073,36,56,person
47149,31,person,32,1,17592,16,799,1014,831,1055,32,41,person
47150,0,car,1,0,17593,23,830,768,1174,1190,344,422,car
47151,1,car,2,0,17593,23,1488,964,1677,1139,189,175,car
47152,2,car,3,0,17593,21,1216,966,1436,1144,220,178,car
47153,5,traffic light,6,0,17593,54,305,514,514,1257,209,743,traffic light
47154,10,person,11,1,17593,33,3,910,121,1305,118,395,person
47155,11,car,12,1,17593,15,1760,937,2048,1208,288,271,car
47156,27,person,24,1,17593,41,242,914,342,1208,100,294,person
47157,31,traffic light,28,0,17593,21,596,782,650,1075,54,293,traffic light
47158,33,person,30,0,17593,25,650,978,688,1080,38,102,person
47159,39,person,36,1,17593,20,680,977,698,1067,18,90,person
47160,42,person,39,1,17593,17,1190,942,1218,1036,28,94,person
47161,46,traffic light,43,0,17593,16,1242,858,1273,1005,31,147,traffic light
47162,48,car,45,1,17593,20,1433,963,1678,1037,245,74,car
47163,49,car,46,1,17593,17,1397,969,1449,1104,52,135,car
47164,50,car,47,1,17593,15,1655,962,1788,1045,133,83,car
47165,52,person,49,1,17593,22,697,947,730,1078,33,131,person
47166,53,person,50,0,17593,22,750,950,793,1081,43,131,person
47167,54,person,51,1,17593,24,777,946,804,1061,27,115,person
47168,0,car,1,0,17594,31,1282,772,1769,994,487,222,car
47169,5,car,5,1,17594,22,4,721,681,1411,677,690,car
47170,0,car,1,0,17595,28,1699,992,2020,1087,321,95,car
47171,4,traffic light,5,1,17595,36,4,236,357,406,353,170,traffic light
47172,7,traffic light,8,0,17595,34,571,734,620,1104,49,370,traffic light
47173,12,traffic light,13,0,17595,67,1681,165,2051,1270,370,1105,traffic light
47174,81,person,82,0,17595,28,397,990,445,1103,48,113,person
47175,12,car,13,1,17596,15,1191,990,1452,1165,261,175,car
47176,0,car,1,0,17597,34,1231,995,1705,1335,474,340,car
47177,13,person,13,0,17597,29,383,972,438,1138,55,166,person
47178,14,fire hydrant,14,0,17597,24,460,1041,495,1121,35,80,fire hydrant
47179,19,car,19,1,17597,28,1146,991,1378,1235,232,244,car
47180,20,car,20,1,17597,24,1085,984,1261,1147,176,163,car
47181,96,car,96,1,17597,18,1027,975,1095,1079,68,104,car
47182,5,car,6,0,17598,30,98,1178,937,1537,839,359,car
47183,6,car,7,1,17598,29,1254,1123,1561,1325,307,202,car
47184,7,car,8,1,17598,33,1403,1080,1667,1276,264,196,car
47185,0,person,1,0,17599,16,769,1095,855,1296,86,201,person
47186,9,person,10,0,17599,16,1044,1112,1109,1288,65,176,person
47187,10,person,11,0,17599,15,1098,1136,1161,1317,63,181,person
47188,33,window,34,0,17599,15,979,356,1231,602,252,246,window
47189,42,person,43,0,17599,24,1679,1044,1707,1125,28,81,person
47190,43,person,44,0,17599,26,1646,1041,1674,1120,28,79,person
47191,45,person,46,1,17599,26,1131,1101,1180,1298,49,197,person
47192,46,person,47,1,17599,22,1190,1087,1224,1272,34,185,person
47193,47,person,48,0,17599,18,1616,1048,1636,1131,20,83,person
47194,0,fire hydrant,1,0,17601,38,708,877,779,1038,71,161,fire hydrant
47195,2,car,3,0,17601,26,1299,732,1590,948,291,216,car
47196,25,car,26,1,17601,18,985,712,1116,857,131,145,car
47197,26,car,27,1,17601,21,1028,730,1141,870,113,140,car
47198,27,car,28,1,17601,17,1114,728,1200,888,86,160,car
47199,31,traffic light,32,0,17601,52,754,6,936,1116,182,1110,traffic light
47200,14,traffic light,12,0,17602,16,1339,995,1475,1179,136,184,traffic light
47201,40,car,37,1,17602,19,474,1132,597,1201,123,69,car
47202,41,car,38,1,17602,17,340,1141,418,1195,78,54,car
47203,66,traffic light,63,0,17602,24,1589,1072,1654,1145,65,73,traffic light
47204,74,car,71,1,17602,18,1354,1144,1389,1178,35,34,car
47205,2,car,3,0,17603,24,547,986,892,1128,345,142,car
47206,3,car,4,0,17603,24,313,955,553,1100,240,145,car
47207,4,car,5,1,17603,19,172,964,320,1076,148,112,car
47208,6,fire hydrant,7,0,17603,25,70,1398,303,1649,233,251,fire hydrant
47209,17,car,18,0,17604,24,1428,940,2049,1452,621,512,car
47210,0,car,1,0,17605,20,833,653,2081,1252,1248,599,car
47211,1,car,2,1,17605,22,4,604,669,976,665,372,car
47212,19,person,20,1,17605,32,2003,796,2124,1030,121,234,person
47213,21,chair,22,1,17605,24,2114,906,2200,1031,86,125,chair
47214,22,person,23,1,17605,17,2113,804,2198,922,85,118,person
47215,23,door,24,0,17605,24,1431,676,1782,1091,351,415,door
47216,26,door,27,0,17605,18,1111,675,1529,1069,418,394,door
47217,5,car,6,0,17606,24,979,1139,1651,1486,672,347,car
47218,6,car,7,1,17606,16,0,1147,767,1648,767,501,car
47219,15,person,16,0,17606,16,2153,1102,2191,1254,38,152,person
47220,44,window,45,0,17606,15,1673,245,1830,874,157,629,window
47221,63,door,52,0,17606,15,456,1182,619,1598,163,416,door
47222,64,door,53,0,17606,15,538,1181,714,1560,176,379,door
47223,4,bus,5,0,17607,16,471,1044,1032,1227,561,183,bus
47224,11,person,12,0,17607,20,105,1138,157,1289,52,151,person
47225,25,motorbike,26,0,17607,34,1756,1140,1861,1222,105,82,motorcycle
47226,1,bus,2,0,17608,18,145,560,1292,933,1147,373,bus
47227,2,car,3,0,17608,22,0,839,732,1385,732,546,car
47228,3,bus,4,0,17608,36,1289,642,1886,877,597,235,bus
47229,4,car,5,0,17608,29,722,823,1578,1265,856,442,car
47230,20,car,21,0,17609,16,139,1547,318,1623,179,76,car
47231,28,person,29,0,17609,23,636,1511,800,1957,164,446,person
47232,29,person,30,0,17609,28,1148,1492,1339,1948,191,456,person
47233,30,person,31,0,17609,26,1349,1535,1479,1948,130,413,person
47234,38,truck,38,0,17609,19,833,1506,947,1602,114,96,truck
47235,41,car,41,0,17609,16,285,1544,394,1612,109,68,car
47236,50,person,50,0,17609,15,1109,1557,1129,1622,20,65,person
47237,4,car,5,1,17610,15,1940,925,2048,1051,108,126,car
47238,5,car,6,1,17610,16,1836,933,1958,1028,122,95,car
47239,6,car,7,1,17610,18,1763,920,1875,1000,112,80,car
47240,11,car,11,1,17610,16,1557,940,1720,1051,163,111,car
47241,12,person,12,0,17610,21,1582,927,1619,1083,37,156,person
47242,14,person,14,0,17610,35,1379,908,1439,1096,60,188,person
47243,15,person,15,0,17610,35,1258,915,1334,1100,76,185,person
47244,17,car,17,1,17610,21,22,887,181,990,159,103,car
47245,18,car,18,1,17610,23,175,925,467,1063,292,138,car
47246,21,car,21,0,17610,41,366,941,895,1179,529,238,car
47247,23,person,23,0,17610,23,940,905,973,1051,33,146,person
47248,24,person,24,0,17610,24,888,888,933,1048,45,160,person
47249,25,person,25,0,17610,28,1108,938,1164,1091,56,153,person
47250,54,traffic light,54,1,17610,29,1545,471,2047,1081,502,610,traffic light
47251,79,person,79,0,17610,28,967,903,997,1044,30,141,person
47252,89,person,89,0,17610,17,1426,918,1465,1059,39,141,person
47253,92,person,92,1,17610,15,1250,904,1290,1027,40,123,person
47254,2,car,3,0,17611,20,1214,1081,1623,1298,409,217,car
47255,33,person,34,0,17611,43,7,1069,155,1508,148,439,person
47256,34,person,35,0,17611,56,155,1097,305,1481,150,384,person
47257,35,person,36,1,17611,24,296,1128,355,1282,59,154,person
47258,36,person,37,1,17611,24,353,1035,433,1247,80,212,person
47259,37,bicycle,38,0,17611,81,285,1191,596,1420,311,229,bicycle
47260,51,person,52,0,17611,31,1914,1048,1939,1136,25,88,person
47261,52,person,53,0,17611,18,1947,1048,1973,1136,26,88,person
47262,53,person,54,0,17611,17,1979,1037,2009,1144,30,107,person
47263,72,car,73,1,17611,30,1531,1048,1841,1236,310,188,car
47264,79,door,78,0,17611,15,1423,1083,1524,1243,101,160,door
47265,0,car,1,0,17612,34,1002,1138,1445,1320,443,182,car
47266,0,car,1,0,17613,20,1274,783,2141,1094,867,311,car
47267,7,car,8,1,17613,15,106,702,249,797,143,95,car
47268,9,motorbike,10,0,17613,22,581,756,804,901,223,145,motorcycle
47269,14,motorbike,15,0,17613,35,1019,714,1086,850,67,136,motorcycle
47270,27,mirror,28,0,17613,22,1075,466,1175,574,100,108,mirror
47271,0,car,1,0,17614,16,488,403,1255,721,767,318,car
47272,7,car,7,1,17614,21,0,358,420,740,420,382,car
47273,23,door,23,0,17614,16,990,392,1154,626,164,234,door
47274,34,door,34,0,17614,17,10,378,216,636,206,258,door
47275,37,person,37,1,17614,21,592,391,652,503,60,112,person
47276,11,motorbike,11,1,17615,59,1878,1187,2199,1558,321,371,motorcycle
47277,19,car,19,1,17615,19,1264,1049,1363,1142,99,93,car
47278,20,car,20,1,17615,16,1535,1047,1590,1146,55,99,car
47279,21,car,21,1,17615,24,1196,1071,1292,1237,96,166,car
47280,25,car,25,1,17615,28,1563,1044,1690,1187,127,143,car
47281,26,car,26,0,17615,41,1586,1058,1872,1310,286,252,car
47282,38,car,38,1,17615,26,618,1134,1055,1488,437,354,car
47283,5,bicycle,6,0,17616,61,292,1007,455,1165,163,158,bicycle
47284,16,person,17,0,17616,31,806,1006,864,1128,58,122,person
47285,19,person,20,0,17616,31,1589,965,1649,1211,60,246,person
47286,20,person,21,0,17616,36,1300,979,1350,1109,50,130,person
47287,31,person,32,1,17616,18,629,1002,676,1051,47,49,person
47288,32,person,33,1,17616,18,662,1004,698,1068,36,64,person
47289,36,person,37,0,17616,50,28,934,113,1130,85,196,person
47290,42,person,43,1,17616,20,862,1010,915,1072,53,62,person
47291,44,person,45,1,17616,16,757,1005,787,1076,30,71,person
47292,45,person,46,1,17616,24,856,970,902,1038,46,68,person
47293,46,person,47,0,17616,26,1239,982,1277,1090,38,108,person
47294,47,person,48,1,17616,28,1211,975,1244,1087,33,112,person
47295,49,person,50,0,17616,17,712,963,743,1036,31,73,person
47296,5,car,6,0,17617,39,286,264,1048,647,762,383,car
47297,19,car,20,1,17617,21,1288,212,1479,373,191,161,car
47298,20,car,21,1,17617,23,1187,249,1384,418,197,169,car
47299,21,car,22,1,17617,24,957,263,1246,478,289,215,car
47300,11,motorbike,12,1,17618,47,2,785,360,1210,358,425,motorcycle
47301,12,car,13,1,17618,46,78,689,589,998,511,309,car
47302,13,motorbike,14,1,17618,58,293,810,602,1153,309,343,motorcycle
47303,14,car,15,1,17618,36,505,720,964,1080,459,360,car
47304,15,car,16,1,17618,28,821,722,1094,1013,273,291,car
47305,16,car,17,1,17618,29,1054,730,1286,958,232,228,car
47306,17,car,18,1,17618,28,1170,704,1394,922,224,218,car
47307,18,car,19,1,17618,16,1354,711,1465,896,111,185,car
47308,20,person,20,0,17618,83,1634,682,1857,1141,223,459,person
47309,21,person,21,1,17618,44,1863,686,1958,1061,95,375,person
47310,22,person,22,0,17618,38,1777,669,1901,1124,124,455,person
47311,23,person,23,0,17618,60,1955,691,2088,1061,133,370,person
47312,26,person,26,1,17618,43,2106,681,2154,1046,48,365,person
47313,30,person,30,0,17618,33,2115,691,2201,1065,86,374,person
47314,33,person,32,1,17618,16,1061,663,1100,728,39,65,person
47315,34,person,33,1,17618,16,789,670,843,716,54,46,person
47316,36,person,35,1,17618,20,653,651,703,720,50,69,person
47317,43,car,42,1,17618,18,1997,672,2118,736,121,64,car
47318,78,door,77,0,17618,18,819,745,908,998,89,253,door
47319,92,door,91,0,17618,15,990,729,1062,949,72,220,door
47320,110,car,109,1,17618,21,1929,662,1977,716,48,54,car
47321,112,car,111,1,17618,25,1545,709,1633,858,88,149,car
47322,113,car,112,1,17618,22,1569,709,1656,844,87,135,car
47323,0,car,1,0,17619,24,565,885,761,988,196,103,car
47324,1,car,2,0,17619,31,925,873,1090,960,165,87,car
47325,2,car,3,0,17619,25,1106,886,1218,950,112,64,car
47326,3,car,4,0,17619,36,756,887,919,974,163,87,car
47327,24,car,25,0,17619,19,2,896,297,1035,295,139,car
47328,25,car,26,0,17619,26,290,891,580,1002,290,111,car
47329,27,car,28,0,17619,15,1204,882,1279,944,75,62,car
47330,28,car,29,0,17619,21,1491,875,1586,936,95,61,car
47331,29,car,30,0,17619,16,1641,885,1714,928,73,43,car
47332,31,person,32,0,17619,28,1855,847,1911,1043,56,196,person
47333,34,person,35,1,17619,15,1820,852,1861,934,41,82,person
47334,0,car,1,0,17620,17,799,707,1395,1005,596,298,car
47335,1,car,2,0,17620,27,1294,710,1758,950,464,240,car
47336,2,car,3,1,17620,19,1930,701,2192,869,262,168,car
47337,5,truck,6,0,17621,25,773,753,1145,1163,372,410,truck
47338,0,car,1,0,17622,16,784,738,1238,918,454,180,car
47339,13,person,14,0,17623,44,1007,925,1114,1222,107,297,person
47340,15,person,16,0,17623,24,1204,946,1253,1077,49,131,person
47341,16,person,17,0,17623,61,1105,927,1235,1224,130,297,person
47342,18,person,19,1,17623,38,1313,940,1388,1191,75,251,person
47343,19,person,20,0,17623,47,1277,954,1367,1204,90,250,person
47344,21,car,22,0,17623,30,1606,955,1782,1075,176,120,car
47345,22,car,23,0,17623,34,1885,949,2115,1080,230,131,car
47346,47,truck,48,1,17623,38,1018,883,1236,1018,218,135,truck
47347,57,motorbikes,58,0,17623,17,1514,964,1559,988,45,24,motorcycle
47348,0,car,1,0,17624,16,246,388,393,434,147,46,car
47349,1,car,2,1,17624,20,475,374,627,429,152,55,car
47350,2,car,3,1,17624,20,646,380,789,426,143,46,car
47351,0,person,1,0,17625,19,712,568,773,838,61,270,person
47352,1,person,2,0,17625,22,507,577,580,856,73,279,person
47353,2,bus,3,0,17625,22,143,489,583,659,440,170,bus
47354,52,traffic light,48,0,17625,32,1143,265,1760,429,617,164,traffic light
47355,0,car,1,0,17626,30,339,988,1178,1286,839,298,car
47356,8,traffic light,8,0,17626,30,1745,335,1865,1235,120,900,traffic light
47357,14,bicycle,14,1,17626,32,1623,956,1792,1152,169,196,bicycle
47358,47,person,47,1,17626,30,1704,871,1855,1147,151,276,person
47359,0,car,1,0,17627,17,808,808,954,860,146,52,car
47360,27,person,27,0,17627,18,681,806,696,839,15,33,person
47361,0,car,1,0,17628,23,1613,887,2199,1259,586,372,car
47362,1,car,2,0,17628,20,1356,950,1577,1120,221,170,car
47363,2,car,3,0,17628,19,417,917,1068,1450,651,533,car
47364,14,car,11,1,17628,18,1170,984,1231,1050,61,66,car
47365,2,car,3,1,17629,18,3,1002,359,1165,356,163,car
47366,4,car,5,0,17629,29,967,1000,1360,1147,393,147,car
47367,10,person,11,0,17629,24,839,991,906,1109,67,118,person
47368,11,car,12,1,17629,16,1610,1000,1717,1109,107,109,car
47369,12,car,13,1,17629,24,1686,998,1937,1125,251,127,car
47370,15,person,16,0,17629,26,1928,957,1995,1198,67,241,person
47371,9,motorbike,10,0,17630,31,892,656,1518,1133,626,477,motorcycle
47372,10,motorbike,11,0,17630,22,617,502,1047,953,430,451,motorcycle
47373,26,motorbikes,27,0,17630,30,1239,491,1438,598,199,107,motorcycle
47374,19,car,19,1,17631,16,652,1096,837,1135,185,39,car
47375,28,car,28,1,17631,15,345,1108,449,1195,104,87,car
47376,29,car,29,0,17631,26,648,1120,852,1258,204,138,car
47377,49,car,49,1,17631,17,810,1114,886,1195,76,81,car
47378,0,car,1,0,17632,26,1,896,834,1176,833,280,car
47379,1,car,2,0,17632,28,1021,875,1891,1161,870,286,car
47380,39,door,35,0,17632,20,1317,888,1533,1103,216,215,door
47381,41,door,37,0,17632,17,1529,884,1714,1091,185,207,door
47382,52,door,48,0,17632,20,378,904,582,1129,204,225,door
47383,54,door,50,0,17632,16,174,904,413,1135,239,231,door
47384,6,door,7,0,17634,33,430,771,614,1020,184,249,door
47385,24,door,25,0,17634,62,1817,708,2047,1174,230,466,door
47386,28,motorbike,29,0,17634,97,1331,981,2013,1392,682,411,motorcycle
47387,29,car,30,0,17634,48,2,945,1351,1508,1349,563,car
47388,41,door,42,0,17634,21,344,981,838,1402,494,421,door
47389,0,car,1,0,17635,30,35,844,1119,1341,1084,497,car
47390,1,car,2,0,17635,25,963,861,1607,1207,644,346,car
47391,0,person,1,0,17636,15,1572,734,1722,1137,150,403,person
47392,1,person,2,0,17636,23,1764,676,2048,1478,284,802,person
47393,4,car,4,0,17636,15,3,793,769,1433,766,640,car
47394,5,car,5,0,17636,21,781,811,1366,1114,585,303,car
47395,7,bus,7,0,17636,23,302,612,825,889,523,277,bus
47396,82,car,79,1,17636,17,1045,762,1242,824,197,62,car
47397,88,door,85,0,17636,21,147,854,518,1317,371,463,door
47398,89,window,86,0,17636,19,197,867,484,1007,287,140,window
47399,0,car,1,0,17637,30,323,1084,1047,1316,724,232,car
47400,97,door,98,0,17637,15,607,1092,743,1257,136,165,door
47401,5,person,5,0,17638,43,1239,990,1309,1144,70,154,person
47402,6,person,6,0,17638,34,1291,975,1344,1121,53,146,person
47403,17,person,12,0,17638,28,49,984,107,1109,58,125,person
47404,18,person,13,1,17638,29,949,974,987,1084,38,110,person
47405,19,person,14,0,17638,38,1709,982,1799,1155,90,173,person
47406,20,person,15,0,17638,38,1806,1001,1888,1163,82,162,person
47407,21,person,16,1,17638,33,1861,980,1916,1155,55,175,person
47408,22,person,17,0,17638,45,1925,1003,2017,1237,92,234,person
47409,23,person,18,1,17638,32,1466,978,1542,1147,76,169,person
47410,24,person,19,0,17638,22,703,989,745,1130,42,141,person
47411,25,person,20,0,17638,23,740,985,790,1139,50,154,person
47412,26,person,21,1,17638,21,803,999,841,1127,38,128,person
47413,27,person,22,0,17638,22,784,1034,808,1133,24,99,person
47414,28,person,23,0,17638,27,605,983,646,1123,41,140,person
47415,29,person,24,0,17638,23,525,992,561,1101,36,109,person
47416,30,person,25,0,17638,27,197,974,238,1107,41,133,person
47417,31,person,26,0,17638,25,380,970,428,1088,48,118,person
47418,32,person,27,1,17638,22,486,982,522,1102,36,120,person
47419,33,person,28,0,17638,23,234,986,268,1096,34,110,person
47420,34,person,29,1,17638,26,560,966,592,1086,32,120,person
47421,35,person,30,1,17638,24,583,970,609,1081,26,111,person
47422,36,person,31,1,17638,33,834,982,869,1120,35,138,person
47423,37,person,32,1,17638,22,302,988,331,1086,29,98,person
47424,38,person,33,1,17638,30,277,985,307,1088,30,103,person
47425,29,car,30,0,17639,31,1182,1285,1608,1433,426,148,car
47426,0,person,1,0,17640,40,67,1018,123,1164,56,146,person
47427,8,car,9,0,17640,28,842,1038,1339,1190,497,152,car
47428,9,car,10,0,17640,25,149,1042,708,1214,559,172,car
47429,10,car,11,0,17640,33,1477,997,1879,1157,402,160,car
47430,13,traffic light,14,0,17640,23,321,688,400,1198,79,510,traffic light
47431,54,car,55,1,17640,21,1379,1039,1589,1161,210,122,car
47432,103,door,104,0,17640,17,327,1048,471,1188,144,140,door
47433,14,car,15,0,17642,27,455,1352,734,1507,279,155,car
47434,16,car,17,1,17642,24,730,1415,1500,2047,770,632,car
47435,0,car,1,0,17643,24,376,813,1149,1149,773,336,car
47436,11,bench,12,0,17645,30,220,1014,383,1088,163,74,bench
47437,16,bicycle,17,0,17645,41,397,1010,518,1114,121,104,bicycle
47438,17,motorbike,18,1,17645,32,641,972,800,1132,159,160,motorcycle
47439,20,person,21,0,17645,25,1206,899,1270,1123,64,224,person
47440,22,person,23,0,17645,17,1272,979,1320,1099,48,120,person
47441,28,person,29,0,17645,28,2067,915,2147,1119,80,204,person
47442,29,car,30,1,17645,17,1835,957,2079,1088,244,131,car
47443,30,motorbike,31,0,17645,53,1856,977,2048,1298,192,321,motorcycle
47444,33,bench,34,0,17645,18,1041,996,1221,1076,180,80,bench
47445,0,car,1,0,17646,20,198,1161,620,1313,422,152,car
47446,1,car,2,0,17646,20,1528,1170,1936,1303,408,133,car
47447,2,car,3,1,17646,23,3,1165,347,1290,344,125,car
47448,10,person,11,0,17646,17,844,1138,892,1254,48,116,person
47449,11,person,12,0,17646,15,936,1133,963,1234,27,101,person
47450,12,person,13,0,17646,22,1089,1140,1149,1257,60,117,person
47451,23,person,24,1,17646,17,597,1139,623,1221,26,82,person
47452,31,door,32,0,17646,16,447,1171,539,1285,92,114,door
47453,44,door,45,0,17646,17,1747,1178,1846,1277,99,99,door
47454,49,person,50,0,17646,26,1976,1140,2026,1239,50,99,person
47455,50,person,51,0,17646,28,1911,1133,1952,1238,41,105,person
47456,51,person,52,1,17646,28,1138,1145,1183,1255,45,110,person
47457,54,person,55,1,17646,17,110,1123,143,1193,33,70,person
47458,2,car,3,0,17647,32,929,923,1188,1035,259,112,car
47459,3,fire hydrant,4,0,17647,38,1218,1125,1306,1329,88,204,fire hydrant
47460,4,car,5,0,17647,33,268,957,616,1072,348,115,car
47461,38,car,39,1,17647,19,2,963,276,1119,274,156,car
47462,46,person,47,0,17647,17,1384,920,1407,992,23,72,person
47463,49,person,50,0,17647,20,2164,899,2191,970,27,71,person
47464,0,person,1,0,17648,17,1543,496,1685,850,142,354,person
47465,13,person,14,0,17648,21,1302,541,1341,664,39,123,person
47466,7,bicycle,5,0,17649,15,912,1148,1018,1313,106,165,bicycle
47467,39,person,36,0,17649,31,1191,1055,1230,1203,39,148,person
47468,40,person,37,0,17649,41,1108,1090,1173,1252,65,162,person
47469,41,person,38,1,17649,29,1085,1088,1131,1241,46,153,person
47470,2,bus,3,1,17650,23,1087,667,1450,1012,363,345,bus
47471,3,person,4,0,17650,23,1302,843,1372,1066,70,223,person
47472,12,bicycle,13,0,17650,56,1331,1039,1735,1488,404,449,bicycle
47473,13,bicycle,14,1,17650,42,1667,1167,2044,1534,377,367,bicycle
47474,4,person,5,0,17651,46,643,99,745,331,102,232,person
47475,6,car,7,1,17651,17,717,175,799,273,82,98,car
47476,15,car,16,1,17651,23,48,175,206,252,158,77,car
47477,16,car,17,1,17651,43,2,235,341,587,339,352,car
47478,23,person,22,0,17652,25,94,263,107,312,13,49,person
47479,24,person,23,0,17652,25,102,266,120,310,18,44,person
47480,20,person,12,1,17653,21,1362,1466,1410,1658,48,192,person
47481,21,person,13,0,17653,24,1322,1475,1377,1671,55,196,person
47482,23,car,15,1,17653,20,741,1475,815,1537,74,62,car
47483,24,car,16,0,17653,25,663,1474,772,1545,109,71,car
47484,25,traffic light,17,0,17653,22,210,1154,245,1476,35,322,traffic light
47485,26,person,18,0,17653,28,261,1441,337,1598,76,157,person
47486,27,person,19,0,17653,27,231,1428,286,1596,55,168,person
47487,28,person,20,1,17653,20,191,1458,225,1597,34,139,person
47488,29,person,21,0,17653,27,142,1433,203,1603,61,170,person
47489,30,person,22,0,17653,27,63,1421,122,1592,59,171,person
47490,31,person,23,0,17653,32,16,1425,69,1604,53,179,person
47491,32,person,24,0,17653,22,491,1456,522,1537,31,81,person
47492,33,car,25,1,17653,40,824,1458,949,1548,125,90,car
47493,34,person,26,0,17653,32,867,1441,911,1624,44,183,person
47494,35,person,27,0,17653,36,1254,1461,1310,1614,56,153,person
47495,38,traffic light,30,0,17653,69,764,766,1509,1663,745,897,traffic light
47496,40,person,32,0,17653,28,1088,1471,1139,1618,51,147,person
47497,41,person,33,0,17653,29,1023,1472,1076,1629,53,157,person
47498,42,car,34,1,17653,36,991,1470,1097,1574,106,104,car
47499,46,fire hydrant,38,0,17653,17,1133,1545,1166,1610,33,65,fire hydrant
47500,11,car,12,1,17654,20,1542,961,1726,1048,184,87,car
47501,12,car,13,0,17654,20,1072,944,1451,1062,379,118,car
47502,19,car,20,0,17654,20,3,987,285,1077,282,90,car
47503,33,parking meter,34,0,17654,16,925,956,933,1046,8,90,parking meter
47504,0,car,1,1,17655,20,524,982,805,1070,281,88,car
47505,7,person,8,0,17655,15,364,963,385,1026,21,63,person
47506,8,person,9,0,17655,18,411,953,448,1026,37,73,person
47507,25,traffic light,26,0,17655,16,467,789,524,1116,57,327,traffic light
47508,36,person,37,0,17655,19,785,936,821,1012,36,76,person
47509,7,car,8,0,17656,34,1350,890,1729,1152,379,262,car
47510,19,car,20,1,17657,23,823,918,1183,1103,360,185,car
47511,20,car,21,1,17657,22,1127,938,1496,1163,369,225,car
47512,15,car,16,1,17658,17,1881,954,2133,1104,252,150,car
47513,16,car,17,1,17658,15,2063,1091,2197,1319,134,228,car
47514,17,car,18,1,17658,15,1832,1309,2199,1649,367,340,car
47515,18,car,19,1,17658,40,1276,964,2063,1485,787,521,car
47516,19,car,20,1,17658,16,1775,1001,2063,1231,288,230,car
47517,24,car,25,1,17658,19,1036,993,1249,1151,213,158,car
47518,32,person,33,0,17658,20,851,952,886,1075,35,123,person
47519,33,person,34,0,17658,15,818,948,849,1054,31,106,person
47520,3,pot,4,0,17659,18,1028,1080,2037,1438,1009,358,potted plant
47521,6,person,7,0,17659,18,1476,870,1532,1024,56,154,person
47522,8,person,9,0,17659,17,452,929,487,1084,35,155,person
47523,9,person,10,0,17659,15,396,961,435,1084,39,123,person
47524,11,car,12,0,17661,35,1189,1015,1610,1146,421,131,car
47525,12,car,13,0,17661,26,689,1016,1128,1156,439,140,car
47526,13,parking meter,14,0,17661,17,621,1005,639,1131,18,126,parking meter
47527,1,car,2,0,17662,17,614,1066,1176,1328,562,262,car
47528,18,car,10,1,17662,16,1727,1078,2192,1483,465,405,car
47529,27,person,17,1,17662,16,1079,1053,1130,1126,51,73,person
47530,30,car,20,1,17662,17,840,1056,1201,1219,361,163,car
47531,89,car,76,0,17662,33,164,1055,482,1213,318,158,car
47532,94,person,81,0,17662,47,1268,1001,1363,1192,95,191,person
47533,95,person,82,0,17662,50,1554,978,1639,1222,85,244,person
47534,96,person,83,0,17662,42,1676,1010,1750,1232,74,222,person
47535,97,person,84,0,17662,43,1761,963,1821,1190,60,227,person
47536,98,person,85,1,17662,35,1809,969,1884,1180,75,211,person
47537,100,person,87,1,17662,29,1891,973,1956,1172,65,199,person
47538,101,person,88,1,17662,26,1934,979,1977,1138,43,159,person
47539,102,person,89,1,17662,26,1975,969,2036,1108,61,139,person
47540,103,person,90,1,17662,26,1160,996,1200,1115,40,119,person
47541,104,person,91,1,17662,26,1134,1029,1184,1146,50,117,person
47542,105,person,92,1,17662,17,795,1018,829,1065,34,47,person
47543,106,person,93,1,17662,18,834,1010,870,1061,36,51,person
47544,10,car,11,1,17663,31,1253,1097,1519,1296,266,199,car
47545,11,car,12,1,17663,22,964,1092,1154,1193,190,101,car
47546,13,car,14,1,17663,20,661,1111,826,1230,165,119,car
47547,14,car,15,1,17663,22,753,1127,974,1350,221,223,car
47548,15,car,16,1,17663,34,787,1165,1155,1491,368,326,car
47549,18,car,19,1,17663,21,1745,1127,2045,1444,300,317,car
47550,33,window,33,0,17663,16,1666,1122,1866,1201,200,79,window
47551,7,person,7,1,17664,15,1197,586,1279,740,82,154,person
47552,8,person,8,0,17664,27,304,537,387,738,83,201,person
47553,15,motorbike,16,0,17665,31,1768,817,1869,971,101,154,motorcycle
47554,19,person,20,1,17665,20,1262,753,1329,917,67,164,person
47555,20,person,21,0,17665,33,1407,739,1507,961,100,222,person
47556,25,car,26,0,17665,19,869,769,981,813,112,44,car
47557,26,car,27,1,17665,18,393,765,556,853,163,88,car
47558,27,car,28,0,17665,24,201,779,409,867,208,88,car
47559,28,car,29,0,17665,18,12,780,207,883,195,103,car
47560,31,car,32,1,17665,16,1134,757,1238,877,104,120,car
47561,53,door,53,0,17665,17,318,781,362,840,44,59,door
47562,57,person,57,0,17665,46,685,750,720,848,35,98,person
47563,58,person,58,0,17665,39,869,753,898,830,29,77,person
47564,59,person,59,0,17665,25,1541,758,1563,807,22,49,person
47565,60,person,60,0,17665,23,1589,753,1605,804,16,51,person
47566,66,door,66,0,17665,15,468,769,509,833,41,64,door
47567,9,car,10,1,17666,16,728,944,858,1019,130,75,car
47568,13,car,14,1,17666,18,529,982,674,1213,145,231,car
47569,15,car,16,1,17666,17,2,936,420,1263,418,327,car
47570,16,car,17,1,17666,19,4,855,419,978,415,123,car
47571,19,car,20,1,17666,17,2087,949,2198,1218,111,269,car
47572,20,car,21,1,17666,34,1230,846,1812,1102,582,256,car
47573,21,car,22,1,17666,42,855,836,1633,1079,778,243,car
47574,22,car,23,0,17666,57,727,936,1813,1391,1086,455,car
47575,57,door,58,0,17666,18,1045,975,1392,1306,347,331,door
47576,6,person,7,0,17667,18,1112,387,1156,542,44,155,person
47577,7,person,8,0,17667,22,1401,373,1457,584,56,211,person
47578,8,person,9,0,17667,25,1465,375,1539,588,74,213,person
47579,0,person,1,0,17669,18,1104,828,1325,1274,221,446,person
47580,6,person,6,0,17669,31,1759,870,1827,999,68,129,person
47581,17,traffic light,17,0,17669,17,7,585,149,1120,142,535,traffic light
47582,26,person,26,0,17669,35,650,833,766,1054,116,221,person
47583,27,person,27,1,17669,28,620,852,703,1046,83,194,person
47584,18,person,19,0,17670,26,563,1043,635,1245,72,202,person
47585,19,person,20,0,17670,35,629,1039,693,1239,64,200,person
47586,25,motorbike,26,1,17670,28,1433,1065,1563,1223,130,158,motorcycle
47587,33,person,34,1,17670,16,1616,1048,1705,1128,89,80,person
47588,34,motorbike,35,1,17670,25,1617,1127,1831,1181,214,54,motorcycle
47589,41,person,42,1,17670,22,70,1073,172,1483,102,410,person
47590,42,person,43,1,17670,20,4,1045,147,1518,143,473,person
47591,23,car,24,0,17671,16,295,979,425,1078,130,99,car
47592,14,car,15,1,17672,15,1554,971,2048,1532,494,561,car
47593,16,car,17,0,17672,21,1129,1066,1525,1336,396,270,car
47594,20,car,21,1,17672,18,11,1013,463,1385,452,372,car
47595,22,car,23,1,17672,18,810,1016,949,1154,139,138,car
47596,23,car,24,1,17672,19,858,1057,978,1176,120,119,car
47597,24,car,25,1,17672,25,940,1052,1154,1226,214,174,car
47598,1,person,2,0,17673,22,462,576,561,858,99,282,person
47599,9,person,10,0,17674,38,776,1041,870,1327,94,286,person
47600,10,person,11,0,17674,32,942,1055,1024,1291,82,236,person
47601,11,person,12,0,17674,26,1024,1034,1094,1302,70,268,person
47602,12,person,13,0,17674,37,1070,1037,1172,1319,102,282,person
47603,40,person,37,0,17674,15,1964,1076,1998,1168,34,92,person
47604,42,bicycle,39,1,17674,22,1641,1131,1687,1232,46,101,bicycle
47605,70,person,67,0,17674,66,1378,1076,1426,1263,48,187,person
47606,72,person,69,0,17674,57,1440,1071,1501,1266,61,195,person
47607,74,person,71,1,17674,44,1494,1072,1530,1214,36,142,person
47608,75,person,72,0,17674,36,1530,1070,1575,1216,45,146,person
47609,81,person,78,0,17674,34,1766,1079,1788,1154,22,75,person
47610,14,person,15,0,17675,21,198,759,278,946,80,187,person
47611,15,person,16,0,17675,18,129,768,195,949,66,181,person
47612,16,person,17,0,17675,17,49,771,109,954,60,183,person
47613,0,car,1,0,17676,57,417,1884,892,2138,475,254,car
47614,17,car,11,1,17676,18,1005,1936,1648,2199,643,263,car
47615,18,person,12,0,17676,25,984,1920,1027,2085,43,165,person
47616,20,person,14,0,17676,31,911,1910,984,2079,73,169,person
47617,22,person,16,1,17676,19,1098,1923,1136,2023,38,100,person
47618,24,person,18,0,17676,18,1027,1843,1064,1966,37,123,person
47619,25,person,19,1,17676,17,954,1858,987,1975,33,117,person
47620,27,person,21,0,17676,16,878,1911,912,2036,34,125,person
47621,28,person,22,0,17676,22,409,1916,442,2006,33,90,person
47622,30,person,24,0,17676,28,368,1895,406,2003,38,108,person
47623,31,person,25,0,17676,23,328,1904,352,2011,24,107,person
47624,35,person,29,1,17676,26,306,1891,345,2003,39,112,person
47625,36,person,30,0,17676,24,345,1900,376,2012,31,112,person
47626,38,person,32,1,17676,18,192,1883,211,1933,19,50,person
47627,40,person,34,0,17676,22,210,1877,230,1939,20,62,person
47628,41,person,35,1,17676,23,417,1869,457,1920,40,51,person
47629,42,person,36,1,17676,22,839,1905,878,2012,39,107,person
47630,43,person,37,1,17676,19,1159,1930,1188,2020,29,90,person
47631,44,person,38,1,17676,24,1079,1927,1108,2030,29,103,person
47632,45,person,39,1,17676,23,1007,1848,1035,1963,28,115,person
47633,57,door,51,0,17676,16,531,1905,627,2090,96,185,door
47634,61,door,55,0,17676,18,466,1902,563,2080,97,178,door
47635,70,person,64,1,17676,19,739,1861,768,1919,29,58,person
47636,71,person,65,1,17676,15,670,1861,698,1894,28,33,person
47637,72,person,66,1,17676,17,905,1862,935,1932,30,70,person
47638,1,car,2,0,17678,25,142,748,301,864,159,116,car
47639,36,car,35,1,17678,19,300,782,361,835,61,53,car
47640,39,car,38,1,17678,17,1474,707,1672,749,198,42,car
47641,49,car,48,0,17678,23,355,768,419,824,64,56,car
47642,50,car,49,0,17678,18,425,776,468,808,43,32,car
47643,51,car,50,1,17678,15,436,768,478,803,42,35,car
47644,19,car,20,0,17679,17,550,831,720,890,170,59,car
47645,22,person,23,0,17679,22,399,804,455,949,56,145,person
47646,23,car,24,0,17679,28,769,844,883,918,114,74,car
47647,30,car,31,0,17679,17,1260,879,1388,979,128,100,car
47648,32,car,33,0,17679,19,1406,892,1591,997,185,105,car
47649,0,car,1,0,17680,20,1395,1011,1736,1197,341,186,car
47650,13,bus,14,1,17680,16,1177,940,1603,1057,426,117,bus
47651,0,person,1,0,17681,26,1335,721,1399,928,64,207,person
47652,25,car,25,0,17681,23,1388,748,1605,890,217,142,car
47653,36,person,36,0,17681,30,679,727,732,859,53,132,person
47654,37,fire hydrant,37,0,17681,16,671,805,700,873,29,68,fire hydrant
47655,38,motorbike,38,0,17681,42,1195,775,1351,906,156,131,motorcycle
47656,64,person,62,0,17681,32,1154,746,1232,931,78,185,person
47657,65,person,63,0,17681,34,1592,730,1696,957,104,227,person
47658,66,person,64,0,17681,45,1759,740,1872,995,113,255,person
47659,67,motorbike,65,1,17681,22,2119,837,2199,997,80,160,motorcycle
47660,69,car,66,1,17681,16,2007,778,2084,835,77,57,car
47661,81,window,78,0,17681,15,1500,761,1533,800,33,39,window
47662,90,car,87,1,17681,52,1589,744,1760,867,171,123,car
47663,93,car,90,1,17681,41,1747,757,1871,854,124,97,car
47664,94,car,91,1,17681,21,1866,777,1912,850,46,73,car
47665,97,car,94,0,17681,29,1882,766,1982,844,100,78,car
47666,102,car,99,1,17681,24,1974,781,2027,839,53,58,car
47667,4,person,5,0,17682,22,755,993,781,1095,26,102,person
47668,6,motorbike,7,0,17682,41,596,1035,750,1115,154,80,motorcycle
47669,8,car,9,0,17682,37,875,1007,1174,1135,299,128,car
47670,9,motorbike,10,1,17682,36,1162,1020,1236,1135,74,115,motorcycle
47671,10,motorbike,11,0,17682,29,1260,1005,1344,1138,84,133,motorcycle
47672,11,motorbike,12,1,17682,32,1329,1035,1407,1129,78,94,motorcycle
47673,12,motorbike,13,1,17682,27,1405,1040,1448,1138,43,98,motorcycle
47674,13,car,14,0,17682,44,1449,1006,1680,1140,231,134,car
47675,21,car,22,0,17682,28,1774,995,1967,1145,193,150,car
47676,22,car,23,0,17682,27,2009,1008,2196,1143,187,135,car
47677,37,person,38,1,17682,17,1268,974,1305,1038,37,64,person
47678,54,car,55,1,17682,27,249,1003,503,1152,254,149,car
47679,55,car,56,1,17682,39,123,994,446,1169,323,175,car
47680,57,car,58,1,17682,22,4,1006,109,1196,105,190,car
47681,60,traffic light,61,0,17682,16,99,799,149,994,50,195,traffic light
47682,65,traffic light,66,0,17682,17,1001,882,1051,1005,50,123,traffic light
47683,0,person,1,0,17683,38,686,1059,769,1335,83,276,person
47684,1,parking meter,2,0,17683,15,951,1157,1007,1596,56,439,parking meter
47685,2,person,3,0,17683,28,767,1056,845,1304,78,248,person
47686,3,car,4,0,17683,32,358,1030,724,1176,366,146,car
47687,6,car,7,0,17683,27,1093,1068,1469,1191,376,123,car
47688,21,car,18,1,17683,15,2,1038,125,1138,123,100,car
47689,93,person,89,0,17683,36,1501,1001,1593,1318,92,317,person
47690,94,car,90,0,17683,29,126,1049,382,1152,256,103,car
47691,112,door,108,0,17683,15,1163,1069,1250,1166,87,97,door
47692,118,car,114,1,17683,29,1431,1106,2199,1648,768,542,car
47693,121,person,117,1,17683,26,2166,995,2199,1281,33,286,person
47694,123,door,119,0,17683,18,2,1287,406,1647,404,360,door
47695,127,person,123,1,17683,70,883,1042,1022,1310,139,268,person
47696,0,car,1,0,17684,25,299,940,1068,1212,769,272,car
47697,6,car,7,1,17684,22,1028,943,1360,1089,332,146,car
47698,19,door,20,1,17684,20,492,708,635,939,143,231,door
47699,18,traffic light,16,0,17685,27,770,659,927,809,157,150,traffic light
47700,27,person,25,0,17685,21,1023,847,1052,938,29,91,person
47701,0,car,1,0,17686,20,700,1115,1567,1372,867,257,car
47702,1,person,2,0,17687,26,695,955,787,1264,92,309,person
47703,3,car,4,0,17687,21,428,1078,868,1243,440,165,car
47704,4,person,5,0,17687,26,871,967,976,1264,105,297,person
47705,5,car,6,0,17687,18,1273,1063,1533,1183,260,120,car
47706,14,traffic light,15,0,17687,28,988,725,1108,1219,120,494,traffic light
47707,27,traffic light,28,0,17687,37,451,582,697,1114,246,532,traffic light
47708,29,person,30,0,17687,24,1129,1069,1191,1180,62,111,person
47709,0,car,1,0,17688,23,457,928,1316,1394,859,466,car
47710,2,car,3,0,17688,18,1315,920,2200,1374,885,454,car
47711,11,car,7,0,17690,16,1327,885,1611,1002,284,117,car
47712,13,truck,9,1,17690,17,343,780,593,888,250,108,truck
47713,33,person,29,0,17690,28,126,837,178,984,52,147,person
47714,34,traffic light,30,0,17690,20,306,665,487,741,181,76,traffic light
47715,35,person,31,0,17690,39,340,861,417,1048,77,187,person
47716,38,traffic light,34,0,17690,25,493,721,667,896,174,175,traffic light
47717,39,traffic light,35,0,17690,35,794,716,856,873,62,157,traffic light
47718,44,person,40,0,17690,29,1107,858,1138,943,31,85,person
47719,45,person,41,0,17690,32,1136,867,1168,943,32,76,person
47720,46,car,42,1,17690,16,1229,862,1329,892,100,30,car
47721,50,car,46,1,17690,17,278,875,343,944,65,69,car
47722,51,car,47,1,17690,17,286,884,328,953,42,69,car
47723,52,car,48,1,17690,22,306,878,383,968,77,90,car
47724,0,person,1,0,17691,23,616,1136,721,1424,105,288,person
47725,2,person,3,0,17691,37,744,1169,848,1411,104,242,person
47726,21,person,22,0,17691,36,26,1122,114,1337,88,215,person
47727,33,person,34,0,17691,18,132,1130,174,1234,42,104,person
47728,35,person,36,0,17691,15,362,1152,393,1223,31,71,person
47729,0,car,1,0,17692,27,486,1041,960,1192,474,151,car
47730,40,person,41,0,17692,27,2136,1001,2195,1108,59,107,person
47731,0,person,1,0,17693,25,1612,1073,1728,1395,116,322,person
47732,1,person,2,0,17693,34,1471,1037,1619,1403,148,366,person
47733,5,person,6,1,17693,19,1442,1059,1511,1378,69,319,person
47734,14,person,15,0,17693,30,1698,1052,1781,1383,83,331,person
47735,6,person,7,0,17694,30,59,927,104,1079,45,152,person
47736,7,person,8,0,17694,35,203,912,254,1067,51,155,person
47737,8,person,9,0,17694,24,253,912,300,1012,47,100,person
47738,18,motorbike,19,0,17694,20,1497,936,1529,991,32,55,motorcycle
47739,38,car,39,0,17694,29,1219,929,1337,998,118,69,car
47740,40,car,41,1,17694,16,1168,914,1243,969,75,55,car
47741,41,motorbikes,42,0,17694,23,497,938,652,1010,155,72,motorcycle
47742,49,traffic light,50,0,17694,42,32,522,483,959,451,437,traffic light
47743,51,traffic light,52,0,17694,19,1188,712,1367,965,179,253,traffic light
47744,53,traffic light,54,0,17694,25,1747,759,1916,963,169,204,traffic light
47745,54,car,55,1,17694,18,1525,921,1576,974,51,53,car
47746,55,person,56,0,17694,20,410,898,444,992,34,94,person
47747,4,car,5,0,17695,15,224,1512,353,1563,129,51,car
47748,17,car,18,0,17695,29,973,1457,1321,1735,348,278,car
47749,25,person,26,0,17695,37,652,1448,794,1716,142,268,person
47750,0,car,1,0,17696,27,643,1417,1226,1634,583,217,car
47751,1,car,2,0,17696,23,1304,1365,1726,1546,422,181,car
47752,2,car,3,0,17696,22,1715,1361,2011,1496,296,135,car
47753,20,car,19,1,17696,20,724,1353,1191,1496,467,143,car
47754,21,car,20,1,17696,26,1209,1379,1459,1533,250,154,car
47755,22,car,21,1,17696,29,1973,1329,2152,1433,179,104,car
47756,23,truck,22,1,17696,17,1777,1272,2005,1383,228,111,truck
47757,19,car,20,1,17697,36,230,1148,815,1360,585,212,car
47758,0,car,1,0,17698,21,1096,705,1448,892,352,187,car
47759,2,flowerpot,3,0,17698,18,829,1122,1277,1536,448,414,potted plant
47760,30,flowerpot,30,0,17698,16,173,778,279,869,106,91,potted plant
47761,34,person,34,0,17698,18,58,660,104,791,46,131,person
47762,0,car,1,0,17699,17,795,1080,1368,1283,573,203,car
47763,1,car,2,0,17699,22,282,1075,746,1250,464,175,car
47764,2,person,3,0,17700,25,154,642,277,1017,123,375,person
47765,9,car,10,1,17700,16,1362,731,1678,902,316,171,car
47766,17,person,16,0,17700,25,501,676,579,882,78,206,person
47767,18,person,17,0,17700,25,963,702,1035,902,72,200,person
47768,26,person,22,0,17700,15,1052,688,1126,901,74,213,person
47769,29,car,25,1,17700,19,914,723,977,809,63,86,car
47770,30,car,26,1,17700,15,884,700,926,746,42,46,car
47771,31,person,27,0,17700,32,743,712,798,837,55,125,person
47772,32,person,28,0,17700,34,639,696,681,811,42,115,person
47773,33,person,29,0,17700,30,858,683,895,818,37,135,person
47774,34,person,30,0,17700,27,814,697,858,817,44,120,person
47775,35,person,31,1,17700,38,783,696,819,813,36,117,person
47776,36,person,32,0,17700,32,576,695,612,810,36,115,person
47777,38,person,34,0,17700,25,683,691,711,789,28,98,person
47778,39,person,35,1,17700,26,722,688,758,789,36,101,person
47779,41,vase,37,0,17700,15,1894,673,1924,729,30,56,vase
47780,55,vase,51,0,17700,15,1157,681,1174,710,17,29,vase
47781,57,motorbike,53,1,17700,37,1581,736,1683,814,102,78,motorcycle
47782,59,person,55,1,17700,28,1108,710,1145,881,37,171,person
47783,0,car,1,0,17701,22,555,827,1821,1264,1266,437,car
47784,24,traffic light,24,0,17701,20,1811,716,1876,917,65,201,traffic light
47785,34,traffic light,34,0,17701,24,53,665,177,1030,124,365,traffic light
47786,12,person,13,0,17702,44,1078,964,1174,1223,96,259,person
47787,13,person,14,0,17702,51,1160,928,1290,1230,130,302,person
47788,15,traffic light,8,0,17703,17,582,354,615,559,33,205,traffic light
47789,49,car,42,1,17703,36,571,502,704,561,133,59,car
47790,51,car,44,0,17703,37,673,500,796,600,123,100,car
47791,52,car,45,1,17703,32,837,478,1026,554,189,76,car
47792,53,car,46,0,17703,41,280,507,475,590,195,83,car
47793,1,motorbike,2,0,17704,15,232,750,381,838,149,88,motorcycle
47794,2,traffic light,3,0,17704,17,917,277,1523,861,606,584,traffic light
47795,4,car,5,0,17704,36,431,621,1528,998,1097,377,car
47796,6,car,7,0,17704,21,1662,781,2037,930,375,149,car
47797,16,car,16,0,17704,18,300,697,466,832,166,135,car
47798,19,person,19,0,17704,18,1517,732,1597,899,80,167,person
47799,39,car,38,1,17704,16,500,726,580,786,80,60,car
47800,40,car,39,1,17704,15,465,734,551,794,86,60,car
47801,41,car,40,1,17704,16,447,739,516,805,69,66,car
47802,1,car,2,0,17705,15,426,697,1487,1298,1061,601,car
47803,28,car,28,1,17705,28,1499,759,1692,854,193,95,car
47804,29,car,29,1,17705,16,1684,778,2047,853,363,75,car
47805,2,motorbike,3,0,17706,15,396,798,587,944,191,146,motorcycle
47806,9,person,10,0,17706,21,680,771,722,893,42,122,person
47807,10,truck,11,1,17706,22,1501,654,2012,940,511,286,truck
47808,11,car,12,1,17706,22,1205,826,1509,990,304,164,car
47809,13,car,14,1,17706,17,2074,877,2197,1090,123,213,car
47810,32,motorbike,33,0,17706,28,2009,851,2083,906,74,55,motorcycle
47811,0,person,1,0,17707,19,921,837,998,1107,77,270,person
47812,1,person,2,0,17707,15,1036,855,1135,1109,99,254,person
47813,3,car,4,0,17707,18,1736,923,2043,1222,307,299,car
47814,25,person,24,1,17707,31,767,852,817,953,50,101,person
47815,27,person,26,0,17707,45,847,851,895,970,48,119,person
47816,8,car,9,0,17708,22,1246,1067,2049,1533,803,466,car
47817,15,motorbike,16,0,17708,28,998,981,1301,1026,303,45,motorcycle
47818,16,traffic light,17,0,17708,34,1284,699,1609,1026,325,327,traffic light
47819,7,car,8,1,17709,25,525,852,986,1039,461,187,car
47820,9,bicycle,10,0,17709,37,518,1029,658,1326,140,297,bicycle
47821,10,parking meter,11,0,17709,16,408,934,474,1397,66,463,parking meter
47822,20,car,21,1,17709,36,2,906,507,1293,505,387,car
47823,24,car,25,1,17709,17,4,1169,191,1540,187,371,car
47824,1,car,2,0,17710,31,1172,1048,1426,1187,254,139,car
47825,5,person,6,0,17710,19,445,1018,480,1112,35,94,person
47826,22,car,23,0,17710,17,1042,1077,1094,1119,52,42,car
47827,26,car,27,1,17710,16,980,1074,1012,1112,32,38,car
47828,29,motorbike,30,0,17710,43,247,1034,345,1105,98,71,motorcycle
47829,0,parking meter,1,0,17711,18,884,895,900,1022,16,127,parking meter
47830,1,car,2,0,17711,33,1650,855,2102,1033,452,178,car
47831,2,car,3,0,17711,27,916,884,1444,1042,528,158,car
47832,3,car,4,0,17711,34,238,895,684,1049,446,154,car
47833,4,parking meter,5,0,17711,19,1543,887,1560,1018,17,131,parking meter
47834,39,car,40,1,17711,20,1422,848,1583,923,161,75,car
47835,24,person,25,0,17712,21,1986,1064,2010,1132,24,68,person
47836,30,person,31,0,17712,19,1014,1020,1043,1093,29,73,person
47837,8,car,9,0,17713,19,389,1136,701,1284,312,148,car
47838,12,person,13,0,17713,17,1298,1087,1354,1273,56,186,person
47839,14,person,15,0,17713,15,95,1115,130,1262,35,147,person
47840,47,car,48,1,17714,17,1138,996,1236,1079,98,83,car
47841,50,car,51,0,17714,52,1120,1018,1498,1279,378,261,car
47842,51,car,52,1,17714,28,1298,970,1520,1149,222,179,car
47843,56,car,57,0,17714,28,658,1005,950,1165,292,160,car
47844,5,car,6,0,17715,23,1131,984,1766,1199,635,215,car
47845,6,car,7,0,17715,26,369,1024,1001,1240,632,216,car
47846,1,person,1,0,17716,40,1195,1006,1322,1348,127,342,person
47847,36,person,35,0,17716,42,634,1031,862,1532,228,501,person
47848,42,person,41,0,17716,41,306,1031,383,1233,77,202,person
47849,43,person,42,0,17716,33,91,1032,166,1225,75,193,person
47850,44,person,43,0,17716,27,212,1017,260,1168,48,151,person
47851,45,car,44,1,17716,17,851,1033,973,1170,122,137,car
47852,46,traffic light,45,1,17716,16,793,860,865,1056,72,196,traffic light
47853,47,traffic light,46,0,17716,27,530,922,598,1181,68,259,traffic light
47854,48,person,47,1,17716,20,801,1043,880,1231,79,188,person
47855,49,person,48,0,17716,22,163,1035,210,1170,47,135,person
47856,50,person,49,1,17716,22,368,1017,409,1152,41,135,person
47857,69,person,68,0,17716,96,975,1040,1104,1379,129,339,person
47858,2,car,3,0,17717,15,989,704,1600,1115,611,411,car
47859,3,car,4,0,17717,23,453,660,1000,917,547,257,car
47860,5,car,5,0,17717,17,230,641,506,810,276,169,car
47861,20,bench,10,0,17717,34,7,687,131,782,124,95,bench
47862,29,bus,18,1,17717,29,611,597,782,649,171,52,bus
47863,30,car,19,1,17717,17,649,619,717,647,68,28,car
47864,32,car,21,1,17717,15,515,627,581,644,66,17,car
47865,37,truck,26,1,17717,26,212,570,343,655,131,85,truck
47866,38,car,27,1,17717,30,128,636,280,754,152,118,car
47867,39,car,28,1,17717,21,74,628,165,699,91,71,car
47868,81,person,70,1,17717,16,10,608,32,686,22,78,person
47869,96,door,85,0,17717,19,563,670,669,866,106,196,door
47870,98,mirror,87,0,17717,15,616,730,663,759,47,29,mirror
47871,100,door,89,0,17717,23,495,668,598,837,103,169,door
47872,0,person,1,0,17719,21,1001,761,1144,1202,143,441,person
47873,1,person,2,0,17719,18,1174,749,1304,1202,130,453,person
47874,37,chair,37,0,17719,18,126,1138,341,1439,215,301,chair
47875,38,person,38,0,17719,29,676,779,822,1178,146,399,person
47876,39,person,39,0,17719,29,843,765,997,1166,154,401,person
47877,40,person,40,0,17719,34,530,805,673,1247,143,442,person
47878,48,car,48,1,17719,22,113,771,299,871,186,100,car
47879,50,truck,50,1,17719,20,373,714,541,867,168,153,truck
47880,62,person,62,1,17719,26,980,794,1046,1084,66,290,person
47881,70,window,70,0,17719,21,1425,321,1512,647,87,326,window
47882,76,person,75,0,17719,36,794,790,879,1098,85,308,person
47883,79,traffic light,78,0,17719,33,494,421,848,800,354,379,traffic light
47884,11,door,11,0,17720,16,1609,1014,1883,1246,274,232,door
47885,22,car,22,1,17720,18,432,963,596,1078,164,115,car
47886,23,car,23,1,17720,22,1,1002,277,1277,276,275,car
47887,0,person,1,0,17721,21,8,545,232,1197,224,652,person
47888,0,car,1,0,17723,20,554,1055,1131,1283,577,228,car
47889,1,car,2,0,17723,20,1144,1063,1776,1304,632,241,car
47890,0,fire hydrant,1,0,17724,16,331,436,371,510,40,74,fire hydrant
47891,4,car,4,0,17724,33,92,335,309,544,217,209,car
47892,12,traffic light,12,0,17724,19,463,117,565,580,102,463,traffic light
47893,3,car,4,1,17725,36,1509,888,2080,1439,571,551,car
47894,6,car,7,1,17725,26,1720,826,2089,979,369,153,car
47895,7,person,8,1,17725,15,1922,844,1969,886,47,42,person
47896,8,motorbike,9,1,17725,21,1629,852,1688,957,59,105,motorcycle
47897,9,person,10,0,17725,31,1685,807,1752,945,67,138,person
47898,11,traffic light,12,0,17725,27,702,599,793,1024,91,425,traffic light
47899,18,bicycle,19,0,17725,33,635,846,733,923,98,77,bicycle
47900,19,bicycle,20,0,17725,27,763,862,834,917,71,55,bicycle
47901,0,person,1,0,17726,17,665,377,740,579,75,202,person
47902,1,person,2,0,17726,23,1094,368,1193,630,99,262,person
47903,2,person,3,0,17726,19,929,377,1003,621,74,244,person
47904,3,person,4,0,17726,19,869,389,941,613,72,224,person
47905,4,car,5,0,17726,39,190,356,652,628,462,272,car
47906,8,car,9,1,17726,16,80,391,280,514,200,123,car
47907,18,person,19,0,17726,19,2059,452,2192,619,133,167,person
47908,0,flowerpot,1,0,17727,21,1381,568,1525,672,144,104,potted plant
47909,1,person,2,0,17727,26,806,383,941,790,135,407,person
47910,2,pot,3,0,17727,17,456,562,573,665,117,103,potted plant
47911,3,person,4,0,17727,53,915,411,1060,808,145,397,person
47912,4,person,5,0,17727,44,341,354,502,806,161,452,person
47913,5,person,6,0,17727,18,637,391,757,779,120,388,person
47914,41,bottle,42,0,17727,17,1035,618,1057,659,22,41,bottle
47915,0,person,1,0,17728,23,1536,930,1769,1486,233,556,person
47916,9,person,10,0,17728,22,1087,988,1160,1165,73,177,person
47917,10,bicycle,11,1,17728,19,1095,1073,1150,1211,55,138,bicycle
47918,11,person,12,1,17728,27,1764,954,2049,1534,285,580,person
47919,15,person,16,0,17728,36,317,969,408,1285,91,316,person
47920,16,person,17,0,17728,35,406,959,507,1281,101,322,person
47921,18,person,19,0,17728,40,10,991,147,1363,137,372,person
47922,44,person,45,0,17728,28,1161,987,1225,1141,64,154,person
47923,45,person,46,1,17728,16,1296,1009,1338,1113,42,104,person
47924,46,person,47,0,17728,21,1428,1002,1470,1179,42,177,person
47925,12,traffic light,13,0,17729,36,1231,344,1452,1252,221,908,traffic light
47926,14,bicycle,14,0,17729,23,48,1014,208,1220,160,206,bicycle
47927,15,bicycle,15,1,17729,29,16,1008,249,1200,233,192,bicycle
47928,19,person,19,0,17729,31,2036,851,2151,1129,115,278,person
47929,20,person,20,0,17729,36,53,776,154,1046,101,270,person
47930,23,person,22,0,17729,22,1423,619,1518,856,95,237,person
47931,29,person,28,1,17729,24,1634,605,1743,798,109,193,person
47932,30,person,29,1,17729,49,715,890,809,1164,94,274,person
47933,31,person,30,0,17729,54,678,846,789,1171,111,325,person
47934,0,car,1,0,17730,24,464,314,535,346,71,32,car
47935,1,person,2,0,17730,21,106,282,150,372,44,90,person
47936,39,clock,39,0,17730,19,192,1,246,35,54,34,clock
47937,19,person,3,1,17731,21,2,694,41,898,39,204,person
47938,29,person,13,0,17731,44,1077,662,1207,943,130,281,person
47939,30,person,14,0,17731,41,1119,654,1210,934,91,280,person
47940,37,person,21,1,17731,39,1414,722,1459,844,45,122,person
47941,38,person,22,1,17731,24,1426,713,1483,842,57,129,person
47942,39,person,23,0,17731,16,1388,739,1402,792,14,53,person
47943,40,person,24,1,17731,15,1402,739,1416,794,14,55,person
47944,45,person,29,0,17731,15,605,720,621,794,16,74,person
47945,47,person,31,0,17731,18,718,737,734,789,16,52,person
47946,48,person,32,0,17731,21,734,737,752,789,18,52,person
47947,51,person,35,0,17731,29,188,709,250,867,62,158,person
47948,1,car,2,0,17732,18,742,857,1326,1114,584,257,car
47949,2,car,3,0,17732,21,1804,912,2074,1048,270,136,car
47950,3,person,4,0,17732,20,1657,915,1690,1010,33,95,person
47951,47,person,48,0,17732,31,278,878,348,1059,70,181,person
47952,48,person,49,0,17732,20,149,805,187,906,38,101,person
47953,49,person,50,0,17732,22,191,813,236,953,45,140,person
47954,50,person,51,0,17732,29,232,815,287,945,55,130,person
47955,51,person,52,1,17732,19,401,847,457,895,56,48,person
47956,52,person,53,0,17732,30,465,887,518,1061,53,174,person
47957,54,person,55,1,17732,19,558,887,605,1031,47,144,person
47958,57,person,58,0,17732,28,628,890,673,1059,45,169,person
47959,59,person,59,0,17732,16,1240,861,1271,951,31,90,person
47960,60,person,60,0,17732,18,1266,851,1293,955,27,104,person
47961,61,person,61,0,17732,22,1297,856,1329,959,32,103,person
47962,63,person,63,0,17732,18,1718,903,1749,989,31,86,person
47963,64,person,64,1,17732,16,1750,895,1771,980,21,85,person
47964,81,person,79,1,17732,17,1125,850,1159,885,34,35,person
47965,0,car,1,0,17733,29,1051,984,1757,1439,706,455,car
47966,1,car,2,0,17733,16,663,904,1033,1220,370,316,car
47967,2,person,3,0,17733,28,59,901,212,1325,153,424,person
47968,3,person,4,0,17733,19,216,940,252,1018,36,78,person
47969,21,person,21,0,17733,19,1059,983,1084,1060,25,77,person
47970,22,person,22,0,17733,20,1041,985,1060,1059,19,74,person
47971,24,car,24,1,17733,23,524,982,679,1103,155,121,car
47972,25,truck,25,1,17733,23,361,869,486,1036,125,167,truck
47973,26,car,26,1,17733,18,244,938,317,995,73,57,car
47974,35,person,35,0,17733,35,1866,1016,1931,1174,65,158,person
47975,0,person,1,0,17734,17,626,791,754,1122,128,331,person
47976,2,bicycle,3,0,17734,15,1192,922,1286,1022,94,100,bicycle
47977,22,bus,13,1,17734,30,128,752,370,944,242,192,bus
47978,23,traffic light,14,0,17734,70,141,150,789,1022,648,872,traffic light
47979,31,person,22,1,17734,20,313,810,362,883,49,73,person
47980,32,person,23,0,17734,38,271,820,354,1043,83,223,person
47981,33,person,24,1,17734,41,357,807,428,1005,71,198,person
47982,34,person,25,0,17734,36,350,829,416,1045,66,216,person
47983,35,person,26,0,17734,20,424,837,451,929,27,92,person
47984,36,person,27,0,17734,49,439,793,530,1051,91,258,person
47985,37,person,28,1,17734,27,496,797,535,969,39,172,person
47986,38,person,29,1,17734,20,525,816,554,942,29,126,person
47987,39,person,30,0,17734,40,525,807,591,1018,66,211,person
47988,40,person,31,0,17734,24,575,826,608,998,33,172,person
47989,41,person,32,1,17734,31,589,821,631,1037,42,216,person
47990,43,person,34,1,17734,32,600,830,654,1050,54,220,person
47991,44,person,35,0,17734,49,765,824,845,1096,80,272,person
47992,45,person,36,0,17734,44,834,802,946,1092,112,290,person
47993,46,person,37,1,17734,28,1064,824,1132,1007,68,183,person
47994,47,person,38,1,17734,23,1034,825,1089,917,55,92,person
47995,49,person,40,1,17734,22,958,826,1010,917,52,91,person
47996,51,person,42,1,17734,19,930,815,964,914,34,99,person
47997,53,person,44,1,17734,18,1325,823,1370,889,45,66,person
47998,55,person,46,0,17734,36,1552,841,1608,1025,56,184,person
47999,56,person,47,0,17734,34,1606,833,1669,1013,63,180,person
48000,57,person,48,0,17734,30,1649,845,1714,997,65,152,person
48001,58,person,49,1,17734,20,1701,852,1732,974,31,122,person
48002,59,person,50,0,17734,34,1718,837,1787,1022,69,185,person
48003,60,person,51,1,17734,26,1814,853,1854,995,40,142,person
48004,65,person,56,1,17734,30,1863,855,1933,984,70,129,person
48005,66,person,57,1,17734,23,1795,845,1826,992,31,147,person
48006,67,person,58,1,17734,18,1949,855,1993,951,44,96,person
48007,68,person,59,1,17734,23,1983,855,2036,933,53,78,person
48008,70,car,61,1,17734,16,33,855,81,884,48,29,car
48009,0,person,1,0,17735,20,1007,889,1064,1047,57,158,person
48010,1,person,2,0,17735,30,1940,915,2025,1098,85,183,person
48011,2,person,3,0,17735,20,2089,912,2184,1140,95,228,person
48012,12,person,13,1,17735,21,1102,901,1159,1041,57,140,person
48013,55,door,52,0,17735,16,149,832,256,1008,107,176,door
48014,56,door,53,0,17735,15,1181,883,1315,1058,134,175,door
48015,26,bicycle,27,0,17736,35,1106,1138,1224,1220,118,82,bicycle
48016,27,person,28,0,17736,20,1637,1082,1672,1165,35,83,person
48017,20,chair,21,0,17737,16,949,992,999,1072,50,80,chair
48018,21,chair,22,0,17737,16,890,990,968,1069,78,79,chair
48019,23,flowerpot,24,0,17737,15,826,1021,861,1073,35,52,potted plant
48020,27,window,28,0,17737,19,531,177,698,424,167,247,window
48021,30,door,31,0,17737,21,278,749,469,1076,191,327,door
48022,34,window,35,0,17737,16,532,3,695,110,163,107,window
48023,36,person,37,0,17737,28,1018,981,1066,1129,48,148,person
48024,37,person,38,0,17737,28,1178,954,1224,1076,46,122,person
48025,43,car,44,0,17737,61,1301,912,2197,1407,896,495,car
48026,44,person,45,0,17737,16,73,930,124,1081,51,151,person
48027,47,person,48,0,17737,27,218,917,291,1092,73,175,person
48028,6,person,7,1,17738,32,40,765,118,934,78,169,person
48029,7,person,8,1,17738,30,2,768,50,944,48,176,person
48030,8,car,9,0,17738,47,44,810,493,979,449,169,car
48031,12,parking meter,13,0,17738,32,1574,851,1641,1327,67,476,parking meter
48032,13,car,14,0,17738,48,1142,810,1667,1163,525,353,car
48033,16,bicycle,17,0,17738,44,1741,867,1849,1060,108,193,bicycle
48034,19,bicycle,20,0,17738,34,1831,845,1891,963,60,118,bicycle
48035,20,truck,21,1,17738,46,1469,592,1801,985,332,393,truck
48036,37,car,38,0,17738,21,1165,792,1294,864,129,72,car
48037,43,person,44,0,17738,15,1964,770,1986,845,22,75,person
48038,44,person,45,0,17738,16,1939,773,1968,854,29,81,person
48039,62,car,63,1,17738,19,1793,783,1863,861,70,78,car
48040,72,door,72,0,17738,19,351,814,431,931,80,117,door
48041,6,bus,7,0,17739,15,1,536,522,1086,521,550,bus
48042,19,person,19,0,17739,22,1100,864,1120,940,20,76,person
48043,20,person,20,0,17739,23,1125,866,1148,933,23,67,person
48044,21,person,21,1,17739,21,1121,867,1131,931,10,64,person
48045,0,car,1,0,17740,20,900,982,1199,1150,299,168,car
48046,1,car,2,0,17740,17,1291,964,1479,1085,188,121,car
48047,2,car,3,0,17740,19,1733,995,2028,1132,295,137,car
48048,14,car,11,1,17740,19,1456,965,1573,1061,117,96,car
48049,15,car,12,1,17740,16,1543,958,1630,1047,87,89,car
48050,16,car,13,1,17740,16,1615,959,1684,1033,69,74,car
48051,19,car,15,0,17740,15,1968,958,2078,999,110,41,car
48052,45,person,41,0,17740,40,2072,959,2135,1140,63,181,person
48053,46,person,42,0,17740,44,2128,935,2197,1138,69,203,person
48054,0,car,1,0,17741,23,67,998,579,1224,512,226,car
48055,35,person,36,1,17742,15,513,62,531,115,18,53,person
48056,1,car,1,0,17743,22,443,913,1609,1534,1166,621,car
48057,26,car,22,1,17743,17,1478,857,1622,932,144,75,car
48058,27,car,23,0,17743,20,1161,853,1418,926,257,73,car
48059,28,motorbike,24,1,17743,25,1150,853,1225,907,75,54,motorcycle
48060,29,traffic light,25,0,17743,24,1416,742,1449,915,33,173,traffic light
48061,36,person,32,0,17743,24,1075,830,1097,916,22,86,person
48062,37,person,33,0,17743,24,1030,826,1054,920,24,94,person
48063,38,person,34,1,17743,15,850,829,885,876,35,47,person
48064,40,person,36,1,17743,16,744,828,780,864,36,36,person
48065,41,traffic light,37,0,17743,51,568,414,821,935,253,521,traffic light
48066,48,car,44,1,17743,51,93,880,873,1207,780,327,car
48067,49,car,45,1,17743,18,408,823,626,885,218,62,car
48068,50,car,46,1,17743,25,222,819,605,941,383,122,car
48069,51,car,47,0,17743,16,182,833,260,920,78,87,car
48070,57,car,53,0,17743,28,5,824,142,904,137,80,car
48071,66,car,62,1,17743,21,1,911,104,1057,103,146,car
48072,1,car,2,0,17744,20,36,462,190,554,154,92,car
48073,1,traffic light,1,0,17745,27,1560,504,1681,1424,121,920,traffic light
48074,23,person,21,0,17745,35,163,1002,196,1104,33,102,person
48075,24,bus,22,1,17745,16,1206,934,1296,1056,90,122,bus
48076,25,bus,23,1,17745,26,1386,939,1514,1051,128,112,bus
48077,0,motorbike,1,0,17746,18,116,1100,453,1456,337,356,motorcycle
48078,2,motorbike,3,0,17746,56,440,1132,778,1386,338,254,motorcycle
48079,10,motorbikes,11,1,17746,35,755,1135,956,1381,201,246,motorcycle
48080,11,motorbike,12,0,17746,33,1592,1066,1647,1168,55,102,motorcycle
48081,12,motorbike,13,0,17746,21,1737,1079,1785,1142,48,63,motorcycle
48082,14,bicycle,15,0,17746,45,371,1025,618,1149,247,124,bicycle
48083,7,bicycle,8,0,17747,15,1428,1116,1603,1333,175,217,bicycle
48084,28,bicycle,29,1,17747,39,1106,1113,1210,1296,104,183,bicycle
48085,40,bicycle,41,1,17747,19,1030,1101,1090,1276,60,175,bicycle
48086,41,bicycle,42,1,17747,40,1628,1118,1867,1424,239,306,bicycle
48087,11,motorbike,12,0,17748,39,1465,914,1570,1125,105,211,motorcycle
48088,12,motorbike,13,0,17748,39,1560,925,1681,1133,121,208,motorcycle
48089,13,motorbike,14,0,17748,41,1673,931,1805,1141,132,210,motorcycle
48090,14,motorbike,15,1,17748,16,1992,942,2048,1158,56,216,motorcycle
48091,15,traffic light,16,0,17748,66,1417,175,1676,949,259,774,traffic light
48092,16,chair,17,0,17748,15,1184,942,1236,1015,52,73,chair
48093,36,motorbike,37,0,17748,49,1808,942,1954,1150,146,208,motorcycle
48094,49,car,50,0,17748,37,583,914,987,1076,404,162,car
48095,50,car,51,0,17748,39,232,898,529,1036,297,138,car
48096,51,person,52,0,17748,43,494,866,591,1093,97,227,person
48097,53,person,54,0,17748,44,1026,871,1126,1111,100,240,person
48098,55,person,56,0,17748,37,1099,883,1192,1120,93,237,person
48099,60,door,61,0,17748,15,625,917,733,1032,108,115,door
48100,69,person,70,1,17748,17,385,855,432,899,47,44,person
48101,0,car,1,0,17749,27,138,846,861,1124,723,278,car
48102,113,person,114,0,17749,33,1057,926,1091,1042,34,116,person
48103,114,person,115,0,17749,31,1085,917,1127,1049,42,132,person
48104,118,person,119,0,17749,30,1509,886,1556,993,47,107,person
48105,119,person,120,0,17749,52,1541,878,1595,1051,54,173,person
48106,120,person,121,1,17749,25,1819,873,1845,987,26,114,person
48107,121,person,122,0,17749,45,1961,868,2041,1008,80,140,person
48108,124,person,125,1,17749,28,1789,892,1840,1036,51,144,person
48109,125,person,126,0,17749,86,1611,796,1807,1173,196,377,person
48110,126,bicycle,127,0,17749,162,1527,980,1899,1200,372,220,bicycle
48111,154,door,154,0,17749,17,263,871,452,1072,189,201,door
48112,156,door,156,0,17749,20,415,864,583,1075,168,211,door
48113,6,car,7,0,17750,23,689,1109,970,1190,281,81,car
48114,7,car,8,1,17750,17,922,1083,1085,1164,163,81,car
48115,24,chair,25,0,17750,20,1490,1159,1605,1235,115,76,chair
48116,26,chair,27,0,17750,18,994,1175,1081,1279,87,104,chair
48117,1,car,2,0,17751,37,777,858,1086,1070,309,212,car
48118,3,person,4,0,17751,20,1168,820,1225,986,57,166,person
48119,4,person,5,0,17751,25,1224,811,1285,981,61,170,person
48120,33,traffic light,32,0,17751,17,588,808,673,909,85,101,traffic light
48121,44,person,43,0,17751,22,720,881,735,923,15,42,person
48122,45,person,44,0,17751,21,733,883,746,922,13,39,person
48123,0,person,1,0,17752,23,85,571,343,1282,258,711,person
48124,1,traffic light,2,0,17752,19,491,5,615,168,124,163,traffic light
48125,9,person,10,0,17752,23,602,636,696,834,94,198,person
48126,10,person,11,1,17752,20,553,651,636,834,83,183,person
48127,19,flowerpot,20,0,17752,15,1338,739,1399,791,61,52,potted plant
48128,45,umbrella,46,0,17752,16,706,648,789,731,83,83,umbrella
48129,48,traffic light,49,0,17752,37,1933,482,2047,721,114,239,traffic light
48130,9,car,10,1,17753,20,927,691,1181,868,254,177,car
48131,10,car,11,1,17753,19,685,695,1010,887,325,192,car
48132,11,car,12,1,17753,17,477,700,727,898,250,198,car
48133,12,car,13,1,17753,24,1,679,600,950,599,271,car
48134,16,person,17,0,17753,18,1268,697,1357,851,89,154,person
48135,18,bench,19,1,17753,15,1880,870,2027,1010,147,140,bench
48136,44,person,44,1,17753,16,901,665,939,704,38,39,person
48137,45,door,45,0,17753,19,44,695,245,888,201,193,door
48138,46,door,46,0,17753,20,214,692,374,886,160,194,door
48139,8,car,9,0,17754,28,854,787,1358,952,504,165,car
48140,10,person,11,0,17754,19,1390,776,1448,948,58,172,person
48141,16,car,17,0,17754,27,245,787,759,929,514,142,car
48142,21,person,22,0,17754,19,809,745,877,885,68,140,person
48143,77,person,75,0,17754,35,1648,772,1692,905,44,133,person
48144,78,person,76,0,17754,34,1660,757,1719,911,59,154,person
48145,84,door,82,0,17754,16,1134,796,1247,916,113,120,door
48146,92,door,90,0,17754,15,390,790,531,902,141,112,door
48147,96,door,94,0,17754,19,512,792,630,903,118,111,door
48148,0,car,1,0,17755,23,879,866,1584,1117,705,251,car
48149,8,car,9,1,17755,19,1974,908,2197,1176,223,268,car
48150,9,car,10,1,17755,24,28,866,298,1010,270,144,car
48151,10,motorbike,11,0,17755,33,279,861,435,1024,156,163,motorcycle
48152,11,person,12,0,17755,19,326,845,385,998,59,153,person
48153,14,motorbike,15,1,17755,27,1468,915,1684,1047,216,132,motorcycle
48154,15,person,16,0,17755,22,1544,875,1608,1014,64,139,person
48155,1,car,2,1,17756,15,2009,935,2197,1152,188,217,car
48156,2,person,3,0,17756,31,1891,963,1973,1112,82,149,person
48157,3,person,4,0,17756,29,1060,961,1116,1133,56,172,person
48158,6,car,7,1,17756,26,4,996,661,1237,657,241,car
48159,9,person,10,1,17756,24,364,946,451,1079,87,133,person
48160,10,person,11,0,17756,26,732,965,788,1173,56,208,person
48161,11,person,12,0,17756,21,786,958,853,1161,67,203,person
48162,12,person,13,0,17756,28,890,958,944,1128,54,170,person
48163,14,person,15,1,17756,22,534,949,604,1107,70,158,person
48164,16,person,17,0,17756,25,626,975,668,1138,42,163,person
48165,21,person,22,1,17756,15,474,961,528,1091,54,130,person
48166,2,car,1,0,17757,16,1038,455,1229,533,191,78,car
48167,8,car,4,0,17757,21,781,462,895,517,114,55,car
48168,14,person,7,0,17757,24,1903,418,1965,557,62,139,person
48169,15,car,8,0,17757,53,1523,428,1907,586,384,158,car
48170,16,car,9,0,17757,36,1226,437,1467,556,241,119,car
48171,30,person,23,0,17757,18,711,444,728,499,17,55,person
48172,32,traffic light,25,0,17757,33,167,289,706,372,539,83,traffic light
48173,35,car,28,1,17757,17,350,466,385,491,35,25,car
48174,46,person,39,0,17757,26,34,465,60,531,26,66,person
48175,0,car,1,0,17758,30,395,975,1109,1253,714,278,car
48176,3,car,4,1,17758,15,6,994,367,1215,361,221,car
48177,1,person,2,0,17759,27,1862,340,1997,705,135,365,person
48178,9,person,8,1,17759,29,2015,336,2088,729,73,393,person
48179,10,person,9,0,17759,24,2065,355,2196,772,131,417,person
48180,16,person,14,1,17759,39,606,409,841,1147,235,738,person
48181,19,person,17,1,17759,36,1586,374,1760,1131,174,757,person
48182,20,person,18,1,17759,40,1382,302,1667,1277,285,975,person
48183,21,person,19,1,17759,45,818,222,1559,1633,741,1411,person
48184,42,person,38,0,17759,98,65,264,477,1507,412,1243,person
48185,43,person,39,0,17759,84,334,435,760,1597,426,1162,person
48186,58,person,54,0,17759,24,727,398,781,547,54,149,person
48187,59,person,55,0,17759,28,840,384,907,536,67,152,person
48188,60,person,56,0,17759,22,920,416,955,533,35,117,person
48189,61,person,57,0,17759,21,799,389,836,509,37,120,person
48190,63,person,59,1,17759,29,437,405,496,595,59,190,person
48191,64,car,60,1,17759,42,1739,409,2023,547,284,138,car
48192,66,car,62,1,17759,17,1713,400,1865,467,152,67,car
48193,10,person,11,0,17760,19,665,992,695,1064,30,72,person
48194,11,person,12,0,17760,21,873,987,896,1072,23,85,person
48195,13,car,14,0,17760,20,330,989,501,1070,171,81,car
48196,15,car,16,1,17760,20,2,1013,398,1189,396,176,car
48197,21,person,22,0,17760,19,213,975,234,1030,21,55,person
48198,22,person,23,0,17760,19,240,970,258,1030,18,60,person
48199,23,person,24,0,17760,15,260,975,273,1025,13,50,person
48200,26,person,27,0,17760,15,529,993,545,1058,16,65,person
48201,29,car,30,1,17760,31,1116,1009,1360,1152,244,143,car
48202,62,car,63,0,17760,33,923,1018,1131,1121,208,103,car
48203,0,motorbike,1,0,17761,33,481,1047,957,1459,476,412,motorcycle
48204,9,motorbike,10,0,17761,58,311,934,639,1257,328,323,motorcycle
48205,10,motorbike,11,0,17761,115,989,972,1344,1497,355,525,motorcycle
48206,0,person,1,0,17762,22,1687,921,1873,1308,186,387,person
48207,1,person,2,0,17762,18,1191,901,1297,1241,106,340,person
48208,2,motorbike,3,0,17762,15,404,976,648,1220,244,244,motorcycle
48209,22,traffic light,22,0,17762,20,1646,560,1735,1191,89,631,traffic light
48210,25,person,25,0,17762,20,1291,847,1379,1096,88,249,person
48211,28,person,28,0,17762,28,91,872,134,1047,43,175,person
48212,26,window,27,0,17763,21,1098,344,1322,561,224,217,window
48213,1,car,2,0,17764,17,696,256,791,291,95,35,car
48214,3,car,4,0,17764,15,473,265,557,328,84,63,car
48215,6,car,7,1,17764,15,113,274,271,327,158,53,car
48216,15,car,16,0,17765,30,1681,1028,1962,1160,281,132,car
48217,5,bicycle,6,1,17767,38,2,950,186,1252,184,302,bicycle
48218,6,bicycle,7,0,17767,33,350,882,471,1075,121,193,bicycle
48219,8,person,8,1,17767,17,698,760,749,978,51,218,person
48220,9,person,9,1,17767,31,891,790,943,977,52,187,person
48221,11,person,10,0,17767,40,740,779,829,1148,89,369,person
48222,12,person,11,0,17767,32,920,774,1028,1100,108,326,person
48223,16,person,14,1,17767,35,1083,790,1191,1083,108,293,person
48224,21,person,19,0,17767,22,1243,833,1303,950,60,117,person
48225,73,person,70,1,17767,51,724,788,779,1025,55,237,person
48226,74,person,71,1,17767,52,815,798,886,1035,71,237,person
48227,76,person,73,1,17767,32,858,775,889,913,31,138,person
48228,78,person,75,0,17767,40,1024,775,1060,860,36,85,person
48229,79,person,76,1,17767,28,1080,765,1108,857,28,92,person
48230,80,person,77,1,17767,22,1146,762,1166,824,20,62,person
48231,82,person,79,1,17767,24,1277,833,1319,885,42,52,person
48232,83,person,80,1,17767,21,1320,827,1345,908,25,81,person
48233,84,person,81,1,17767,20,1293,829,1332,886,39,57,person
48234,85,person,82,1,17767,23,1286,812,1335,860,49,48,person
48235,86,person,83,1,17767,39,1645,812,1696,944,51,132,person
48236,87,person,84,1,17767,35,1563,824,1635,896,72,72,person
48237,88,chair,85,0,17767,25,1649,887,1696,975,47,88,chair
48238,21,car,16,1,17769,21,578,240,640,314,62,74,car
48239,22,car,17,1,17769,17,442,274,470,295,28,21,car
48240,23,car,18,1,17769,19,271,268,331,287,60,19,car
48241,25,car,20,1,17769,20,280,277,330,313,50,36,car
48242,29,person,24,0,17769,25,186,265,204,316,18,51,person
48243,30,person,25,0,17769,23,237,269,254,316,17,47,person
48244,32,person,27,0,17769,22,221,274,235,318,14,44,person
48245,33,person,28,1,17769,16,232,266,241,307,9,41,person
48246,7,car,8,1,17770,17,875,1143,965,1260,90,117,car
48247,8,car,9,1,17770,23,920,1144,1017,1278,97,134,car
48248,9,car,10,1,17770,29,984,1128,1112,1307,128,179,car
48249,11,car,12,1,17770,50,1038,1124,1282,1339,244,215,car
48250,12,car,13,0,17770,62,1167,1112,1708,1425,541,313,car
48251,25,car,26,1,17770,18,459,1170,523,1347,64,177,car
48252,42,door,43,0,17770,16,1187,1133,1299,1333,112,200,door
48253,43,window,44,0,17770,16,1364,1119,1618,1196,254,77,window
48254,0,car,1,0,17771,19,1824,940,2032,1014,208,74,car
48255,4,traffic light,5,0,17771,25,386,828,432,1028,46,200,traffic light
48256,5,car,6,0,17771,25,49,957,248,1030,199,73,car
48257,10,motorbike,11,0,17771,19,830,957,885,1000,55,43,motorcycle
48258,11,person,12,0,17771,18,694,933,729,1008,35,75,person
48259,17,person,18,0,17771,24,1446,910,1497,1051,51,141,person
48260,18,person,19,0,17771,35,1514,903,1569,1061,55,158,person
48261,19,person,20,0,17771,25,1608,906,1648,1032,40,126,person
48262,4,traffic light,5,0,17772,23,630,805,753,947,123,142,traffic light
48263,9,car,10,1,17772,26,1744,1125,2201,1418,457,293,car
48264,15,person,16,0,17773,41,804,1070,928,1383,124,313,person
48265,16,person,17,0,17773,48,833,1092,1026,1406,193,314,person
48266,17,person,18,1,17773,29,1727,1103,1795,1323,68,220,person
48267,18,person,19,0,17773,36,1783,1111,1847,1352,64,241,person
48268,1,car,2,0,17774,15,316,609,2050,1537,1734,928,car
48269,2,car,3,0,17774,26,2,549,556,868,554,319,car
48270,21,door,22,0,17774,25,1051,662,1785,1413,734,751,door
48271,0,car,1,0,17775,15,1,1044,419,1251,418,207,car
48272,28,traffic light,28,0,17775,15,1036,857,1275,1081,239,224,traffic light
48273,31,car,31,0,17775,15,1356,1003,1500,1114,144,111,car
48274,49,person,49,0,17775,30,1636,1007,1681,1132,45,125,person
48275,52,car,52,1,17775,19,1297,1018,1361,1074,64,56,car
48276,53,car,53,1,17775,15,1186,1017,1267,1042,81,25,car
48277,54,person,54,0,17775,27,1598,1009,1624,1068,26,59,person
48278,55,car,55,1,17775,30,175,997,429,1136,254,139,car
48279,0,car,1,0,17776,36,574,901,1127,1113,553,212,car
48280,62,bicycle,62,0,17776,79,433,964,638,1115,205,151,bicycle
48281,63,person,63,0,17776,59,483,883,596,1093,113,210,person
48282,65,door,65,0,17776,16,707,914,856,1061,149,147,door
48283,66,door,66,0,17776,16,845,911,961,1060,116,149,door
48284,3,car,4,0,17777,30,1170,735,2008,1114,838,379,car
48285,5,car,6,0,17777,43,327,714,1097,1037,770,323,car
48286,23,door,23,0,17777,15,1468,748,1731,1034,263,286,door
48287,27,door,27,0,17777,15,1275,748,1483,1017,208,269,door
48288,36,door,36,0,17777,15,436,721,601,949,165,228,door
48289,16,bus,15,0,17778,15,1570,735,2044,1084,474,349,bus
48290,17,bus,16,1,17778,15,1179,820,1563,1002,384,182,bus
48291,20,person,19,1,17778,19,1434,910,1489,1025,55,115,person
48292,25,car,24,0,17778,21,562,985,694,1093,132,108,car
48293,49,car,48,0,17778,31,768,964,990,1061,222,97,car
48294,64,person,63,1,17778,33,493,954,541,1147,48,193,person
48295,65,motorbike,64,1,17778,25,377,1074,522,1197,145,123,motorcycle
48296,12,car,13,0,17779,23,161,699,323,781,162,82,car
48297,29,person,27,0,17779,15,455,702,472,758,17,56,person
48298,70,traffic light,68,0,17779,16,12,608,47,723,35,115,traffic light
48299,86,person,84,0,17779,16,490,704,504,756,14,52,person
48300,87,person,85,0,17779,25,518,702,536,755,18,53,person
48301,88,person,86,0,17779,25,536,699,550,754,14,55,person
48302,89,person,87,0,17779,28,548,696,559,752,11,56,person
48303,90,person,88,0,17779,27,508,700,521,755,13,55,person
48304,93,car,91,1,17779,22,584,728,624,789,40,61,car
48305,95,person,93,1,17779,22,1061,699,1081,741,20,42,person
48306,96,person,94,0,17779,23,1134,699,1172,741,38,42,person
48307,97,person,95,1,17779,28,1145,702,1190,740,45,38,person
48308,20,traffic light,21,0,17780,16,1123,898,1148,1139,25,241,traffic light
48309,30,traffic light,30,0,17780,47,1337,614,1960,1176,623,562,traffic light
48310,44,person,44,1,17780,26,1156,1021,1191,1132,35,111,person
48311,45,person,45,1,17780,23,1187,1019,1218,1135,31,116,person
48312,0,car,1,0,17781,31,346,1110,997,1318,651,208,car
48313,1,car,2,0,17781,27,1123,1126,1826,1334,703,208,car
48314,11,parking meter,12,0,17781,20,969,1113,1018,1275,49,162,parking meter
48315,12,person,13,1,17781,20,1222,1048,1286,1164,64,116,person
48316,64,person,65,1,17781,18,1286,1054,1337,1145,51,91,person
48317,68,person,69,1,17781,15,1384,1022,1434,1123,50,101,person
48318,13,person,14,0,17782,21,921,1510,1008,1684,87,174,person
48319,16,person,17,0,17782,31,1044,1522,1139,1846,95,324,person
48320,17,person,18,0,17782,30,1154,1502,1273,1854,119,352,person
48321,6,television,7,0,17784,23,604,232,897,409,293,177,tv
48322,15,door,16,0,17784,17,5,213,109,815,104,602,door
48323,0,fire hydrant,1,0,17785,23,1996,1042,2032,1110,36,68,fire hydrant
48324,1,person,2,0,17785,41,60,944,174,1123,114,179,person
48325,2,car,3,0,17785,33,896,998,1490,1180,594,182,car
48326,33,door,34,0,17785,15,1083,1000,1235,1142,152,142,door
48327,37,door,38,0,17785,16,1227,1000,1358,1140,131,140,door
48328,4,person,5,1,17786,25,6,636,168,1065,162,429,person
48329,5,person,6,1,17786,35,42,653,378,1062,336,409,person
48330,6,person,7,1,17786,16,105,609,252,697,147,88,person
48331,9,person,10,1,17786,29,241,609,409,978,168,369,person
48332,10,person,11,1,17786,40,334,592,481,1065,147,473,person
48333,12,person,13,1,17786,30,558,636,624,991,66,355,person
48334,13,person,14,1,17786,37,447,624,565,1063,118,439,person
48335,20,person,21,1,17786,16,934,632,1016,754,82,122,person
48336,22,person,23,1,17786,15,834,661,913,768,79,107,person
48337,23,person,24,1,17786,26,934,682,1035,1058,101,376,person
48338,24,person,25,1,17786,27,869,722,1002,1062,133,340,person
48339,25,person,26,1,17786,30,714,640,920,911,206,271,person
48340,26,person,27,1,17786,34,592,664,968,1063,376,399,person
48341,27,person,28,1,17786,16,1176,651,1222,766,46,115,person
48342,28,person,29,1,17786,24,1086,657,1193,922,107,265,person
48343,29,person,30,1,17786,26,1188,682,1302,937,114,255,person
48344,30,person,31,1,17786,18,1300,727,1445,838,145,111,person
48345,31,person,32,1,17786,69,995,498,1598,1065,603,567,person
48346,33,traffic light,34,0,17786,57,309,2,974,632,665,630,traffic light
48347,5,person,6,0,17787,32,546,828,616,1043,70,215,person
48348,20,motorbike,21,0,17787,19,875,857,933,911,58,54,motorcycle
48349,8,person,9,1,17788,16,99,1814,141,1848,42,34,person
48350,12,window,13,0,17788,86,315,463,1175,1282,860,819,window
48351,30,person,28,1,17789,20,1027,894,1062,956,35,62,person
48352,32,person,30,1,17789,20,968,883,997,996,29,113,person
48353,33,person,31,0,17789,40,1387,902,1435,1022,48,120,person
48354,34,person,32,1,17789,18,1420,907,1439,1018,19,111,person
48355,35,person,33,0,17789,41,1459,901,1496,1014,37,113,person
48356,39,car,37,1,17789,22,1436,904,1470,956,34,52,car
48357,11,motorbike,12,0,17790,30,11,935,234,1059,223,124,motorcycle
48358,12,person,13,0,17790,26,82,868,160,1063,78,195,person
48359,14,person,15,1,17790,20,31,864,77,961,46,97,person
48360,16,motorbikes,17,0,17790,32,281,895,419,979,138,84,motorcycle
48361,18,traffic light,19,0,17790,15,419,776,443,968,24,192,traffic light
48362,25,car,26,1,17790,23,1909,862,2200,1333,291,471,car
48363,31,bus,32,1,17790,22,892,814,1096,884,204,70,bus
48364,43,traffic light,44,0,17790,35,1247,760,1303,855,56,95,traffic light
48365,0,car,1,0,17791,23,1118,996,1912,1250,794,254,car
48366,2,car,3,1,17791,17,8,879,489,1260,481,381,car
48367,7,person,8,0,17791,29,1754,897,1782,984,28,87,person
48368,19,person,20,0,17791,28,400,981,470,1222,70,241,person
48369,20,person,21,0,17791,36,325,993,417,1232,92,239,person
48370,27,umbrella,25,1,17792,16,1135,872,1233,947,98,75,umbrella
48371,28,umbrella,26,1,17792,17,1061,871,1172,959,111,88,umbrella
48372,0,person,1,0,17793,17,196,349,227,436,31,87,person
48373,5,car,6,0,17793,16,127,356,148,373,21,17,car
48374,6,person,7,0,17793,21,162,348,184,415,22,67,person
48375,7,person,8,1,17793,17,181,356,199,426,18,70,person
48376,10,person,11,0,17793,25,241,348,270,424,29,76,person
48377,11,person,12,1,17793,15,284,352,298,416,14,64,person
48378,12,person,13,0,17793,17,273,353,287,419,14,66,person
48379,13,person,14,0,17793,26,295,357,316,431,21,74,person
48380,13,bicycle,14,0,17794,79,1372,1357,1625,1569,253,212,bicycle
48381,14,person,15,0,17794,31,1927,1235,1982,1414,55,179,person
48382,15,person,16,1,17794,25,1892,1249,1942,1401,50,152,person
48383,17,motorbike,18,1,17794,34,1886,1435,2186,1649,300,214,motorcycle
48384,20,motorbike,21,1,17794,42,580,1513,800,1651,220,138,motorcycle
48385,10,window,2,0,17795,15,1119,708,1602,857,483,149,window
48386,57,car,48,0,17795,74,957,693,1849,1243,892,550,car
48387,74,fire hydrant,65,0,17795,22,1,794,48,899,47,105,fire hydrant
48388,76,car,67,1,17795,50,1574,648,1961,1038,387,390,car
48389,77,car,68,1,17795,29,1866,713,2073,931,207,218,car
48390,78,car,69,1,17795,27,2013,722,2132,890,119,168,car
48391,79,car,70,1,17795,19,2107,738,2169,826,62,88,car
48392,81,door,72,0,17795,18,1618,720,1757,1098,139,378,door
48393,82,door,73,0,17795,20,1665,726,1812,1075,147,349,door
48394,4,person,4,0,17796,19,24,911,104,1079,80,168,person
48395,7,car,6,0,17796,18,1468,867,1637,995,169,128,car
48396,9,car,7,0,17796,22,808,916,1066,1044,258,128,car
48397,10,car,8,0,17796,23,1715,902,1897,1009,182,107,car
48398,20,window,18,0,17796,19,170,351,437,578,267,227,window
48399,21,window,19,0,17796,15,766,480,910,648,144,168,window
48400,25,window,23,0,17796,16,961,535,1055,677,94,142,window
48401,42,car,40,0,17796,48,373,934,928,1131,555,197,car
48402,43,car,41,0,17796,35,1175,908,1402,1023,227,115,car
48403,47,person,45,0,17796,25,1073,912,1098,1002,25,90,person
48404,49,traffic light,47,0,17796,29,1437,732,1700,885,263,153,traffic light
48405,54,car,52,1,17796,21,1914,880,1973,923,59,43,car
48406,55,car,53,1,17796,16,1965,884,2000,916,35,32,car
48407,56,car,54,1,17796,20,1985,889,2040,933,55,44,car
48408,58,car,56,1,17796,39,2019,878,2129,953,110,75,car
48409,61,car,59,1,17796,25,1866,901,1961,960,95,59,car
48410,64,person,62,0,17796,19,1713,893,1731,940,18,47,person
48411,66,door,64,0,17796,15,647,940,755,1088,108,148,door
48412,87,door,85,0,17796,15,974,923,1032,1010,58,87,door
48413,10,car,11,0,17797,17,528,1159,705,1280,177,121,car
48414,11,car,12,1,17797,16,298,1171,535,1320,237,149,car
48415,13,car,14,0,17797,22,2,1163,313,1382,311,219,car
48416,19,bench,20,0,17797,19,1979,1140,2048,1193,69,53,bench
48417,20,bench,21,0,17797,18,1783,1140,1839,1180,56,40,bench
48418,21,truck,22,0,17797,37,1034,1120,1513,1192,479,72,truck
48419,1,car,2,0,17798,17,760,978,1063,1088,303,110,car
48420,4,car,4,0,17798,20,0,937,279,1078,279,141,car
48421,9,traffic light,9,0,17798,26,20,557,115,676,95,119,traffic light
48422,23,person,23,0,17798,26,1480,958,1529,1074,49,116,person
48423,27,person,27,0,17798,25,1307,950,1353,1074,46,124,person
48424,28,person,28,0,17798,27,1380,960,1420,1075,40,115,person
48425,29,person,29,0,17798,22,1158,987,1188,1092,30,105,person
48426,30,person,30,1,17798,20,2045,934,2088,1096,43,162,person
48427,31,person,31,1,17798,20,2068,946,2118,1095,50,149,person
48428,6,person,7,0,17799,41,2,633,126,971,124,338,person
48429,17,person,18,0,17799,35,1795,691,1885,889,90,198,person
48430,18,bicycle,19,1,17799,21,1803,807,1861,925,58,118,bicycle
48431,0,car,1,0,17800,29,617,985,1195,1207,578,222,car
48432,1,car,2,0,17800,30,1225,1021,1768,1193,543,172,car
48433,2,bicycle,3,0,17800,18,1665,1071,1862,1209,197,138,bicycle
48434,12,person,12,0,17800,39,1703,978,1830,1185,127,207,person
48435,53,bicycle,52,0,17800,28,1844,1043,1972,1148,128,105,bicycle
48436,0,car,1,0,17801,31,1039,957,1904,1249,865,292,car
48437,1,car,2,0,17801,23,337,944,1018,1225,681,281,car
48438,68,door,68,0,17801,18,1434,976,1634,1189,200,213,door
48439,77,door,77,0,17801,15,40,983,125,1144,85,161,door
48440,82,door,82,0,17801,16,440,969,586,1178,146,209,door
48441,84,door,84,0,17801,16,561,962,711,1181,150,219,door
48442,5,car,6,1,17802,16,1830,815,1959,917,129,102,car
48443,10,motorbike,11,1,17802,41,1820,935,2047,1536,227,601,motorcycle
48444,11,car,12,1,17802,18,1565,825,1862,1052,297,227,car
48445,13,motorbike,14,0,17802,42,1269,883,1510,1061,241,178,motorcycle
48446,15,person,16,0,17802,29,1006,815,1032,900,26,85,person
48447,16,person,17,0,17802,27,1026,809,1051,896,25,87,person
48448,17,motorbike,18,0,17802,21,1063,850,1127,907,64,57,motorcycle
48449,19,car,20,1,17802,20,1377,790,1510,962,133,172,car
48450,20,car,21,1,17802,15,1314,826,1393,926,79,100,car
48451,29,person,30,0,17802,28,959,806,986,900,27,94,person
48452,31,person,32,0,17802,17,974,808,997,898,23,90,person
48453,6,car,6,0,17803,24,1797,937,2046,1021,249,84,car
48454,38,car,38,1,17803,16,1602,952,1670,1030,68,78,car
48455,9,car,10,0,17805,33,730,1199,934,1301,204,102,car
48456,10,car,11,0,17805,27,1255,1194,1537,1326,282,132,car
48457,11,car,12,0,17805,31,1530,1190,1848,1347,318,157,car
48458,13,car,14,1,17805,27,1877,1219,2188,1350,311,131,car
48459,15,person,16,1,17805,21,1866,1190,1916,1265,50,75,person
48460,16,person,17,0,17805,21,1181,1202,1209,1292,28,90,person
48461,17,car,18,0,17805,20,492,1221,594,1287,102,66,car
48462,18,car,19,0,17805,22,597,1227,702,1283,105,56,car
48463,23,car,24,0,17805,21,167,1206,256,1261,89,55,car
48464,24,car,25,0,17805,45,108,1197,650,1537,542,340,car
48465,30,car,31,1,17805,18,2,1211,155,1403,153,192,car
48466,90,door,91,0,17805,16,199,1270,279,1473,80,203,door
48467,94,door,95,0,17805,17,149,1271,249,1456,100,185,door
48468,2,car,3,0,17806,27,1546,871,2197,1137,651,266,car
48469,0,car,1,0,17807,23,940,1011,1604,1285,664,274,car
48470,14,car,15,0,17807,20,376,984,632,1109,256,125,car
48471,17,parking meter,18,0,17807,19,1616,1054,1680,1248,64,194,parking meter
48472,22,person,23,1,17807,16,2029,976,2072,1085,43,109,person
48473,30,car,31,1,17807,18,590,956,736,1057,146,101,car
48474,73,traffic light,74,0,17807,23,779,675,908,1236,129,561,traffic light
48475,99,door,100,0,17807,17,1061,1021,1207,1219,146,198,door
48476,4,window,5,0,17809,19,75,558,285,892,210,334,window
48477,9,person,10,1,17809,19,1679,969,1740,1232,61,263,person
48478,10,person,11,0,17809,38,1566,969,1759,1314,193,345,person
48479,11,bicycle,12,0,17809,95,1520,1095,1894,1329,374,234,bicycle
48480,14,person,15,1,17809,19,1544,959,1612,1191,68,232,person
48481,19,bicycle,20,0,17809,54,2,1073,184,1211,182,138,bicycle
48482,20,bicycle,21,0,17809,76,181,1070,396,1220,215,150,bicycle
48483,0,car,1,0,17810,28,1285,949,1931,1203,646,254,car
48484,13,person,14,0,17810,20,806,1093,839,1190,33,97,person
48485,14,person,15,0,17810,20,843,1089,886,1182,43,93,person
48486,24,car,25,1,17810,17,469,1091,562,1160,93,69,car
48487,25,car,26,1,17810,17,441,1116,501,1182,60,66,car
48488,26,car,27,1,17810,18,412,1113,461,1190,49,77,car
48489,27,car,28,1,17810,18,302,1101,422,1195,120,94,car
48490,0,car,1,0,17812,15,4,269,112,314,108,45,car
48491,1,car,2,0,17812,31,125,253,266,312,141,59,car
48492,0,car,1,0,17813,28,616,699,974,815,358,116,car
48493,15,traffic light,16,0,17813,22,298,193,385,1017,87,824,traffic light
48494,18,person,19,1,17813,19,631,662,659,727,28,65,person
48495,21,traffic light,22,0,17813,21,663,355,710,723,47,368,traffic light
48496,22,bench,23,0,17813,18,402,706,467,746,65,40,bench
48497,26,car,27,0,17813,15,987,664,1033,700,46,36,car
48498,27,car,28,0,17813,21,1036,656,1112,719,76,63,car
48499,30,car,31,0,17813,16,1177,662,1231,700,54,38,car
48500,31,person,32,0,17813,16,1170,659,1181,699,11,40,person
48501,33,person,34,0,17813,34,1120,667,1159,744,39,77,person
48502,35,bicycle,36,1,17813,20,1563,703,1596,752,33,49,bicycle
48503,63,traffic light,64,0,17813,16,848,531,880,728,32,197,traffic light
48504,131,door,129,0,17813,18,711,706,796,790,85,84,door
48505,133,door,131,0,17813,18,782,705,872,789,90,84,door
48506,0,person,1,0,17815,21,267,363,376,697,109,334,person
48507,11,person,11,1,17815,36,2,391,104,797,102,406,person
48508,19,person,19,0,17815,16,133,358,155,424,22,66,person
48509,10,person,11,0,17816,30,319,1027,401,1252,82,225,person
48510,17,person,18,0,17816,28,222,1051,295,1218,73,167,person
48511,18,person,19,0,17816,29,29,1008,116,1266,87,258,person
48512,22,person,23,0,17816,34,853,1037,945,1312,92,275,person
48513,23,person,24,0,17816,26,952,1058,1027,1307,75,249,person
48514,25,person,26,0,17816,22,735,1056,788,1215,53,159,person
48515,47,person,45,0,17818,47,687,654,768,811,81,157,person
48516,48,person,46,0,17818,35,928,669,976,809,48,140,person
48517,2,fire hydrant,3,0,17819,44,107,736,219,996,112,260,fire hydrant
48518,6,motorbike,7,0,17819,48,1940,615,2130,796,190,181,motorcycle
48519,7,motorbike,8,0,17819,130,426,629,1282,1252,856,623,motorcycle
48520,12,car,13,0,17819,22,2,612,270,845,268,233,car
48521,14,person,15,0,17819,17,2133,614,2198,798,65,184,person
48522,15,car,16,1,17819,27,1558,900,2200,1649,642,749,car
48523,16,car,17,0,17819,30,1008,573,1364,754,356,181,car
48524,17,car,18,0,17819,26,754,594,1013,716,259,122,car
48525,18,car,19,0,17819,23,573,596,778,693,205,97,car
48526,39,person,39,0,17819,17,1022,565,1075,632,53,67,person
48527,20,car,21,0,17820,22,1916,952,2091,1033,175,81,car
48528,15,person,16,0,17821,17,368,357,378,391,10,34,person
48529,16,person,17,0,17821,19,295,358,314,393,19,35,person
48530,17,car,12,1,17822,27,936,933,1011,1031,75,98,car
48531,18,person,13,0,17822,30,899,942,963,1085,64,143,person
48532,20,car,15,1,17822,25,994,934,1121,1024,127,90,car
48533,27,car,22,1,17822,23,1401,950,1517,1023,116,73,car
48534,29,person,24,1,17822,17,1410,982,1450,1046,40,64,person
48535,30,person,25,1,17822,17,1405,912,1433,974,28,62,person
48536,32,bicycle,27,1,17822,18,1353,984,1385,1071,32,87,bicycle
48537,34,bicycle,29,0,17822,34,1536,977,1605,1115,69,138,bicycle
48538,53,person,48,1,17822,36,944,944,980,1069,36,125,person
48539,0,person,1,0,17823,41,51,917,120,1074,69,157,person
48540,1,car,2,0,17823,26,448,937,560,1024,112,87,car
48541,2,car,3,0,17823,34,911,950,1285,1128,374,178,car
48542,3,fire hydrant,4,0,17823,36,2011,1023,2081,1179,70,156,fire hydrant
48543,0,car,1,0,17824,22,247,1042,1390,1372,1143,330,car
48544,12,car,12,1,17824,21,1496,990,1711,1110,215,120,car
48545,13,car,13,1,17824,15,1667,1007,1781,1076,114,69,car
48546,16,car,16,1,17824,33,1193,995,1368,1121,175,126,car
48547,23,car,21,1,17824,18,53,1057,396,1159,343,102,car
48548,48,person,46,0,17824,46,2,1036,316,1482,314,446,person
48549,91,motorbike,89,1,17824,68,2,1151,596,1577,594,426,motorcycle
48550,92,bicycle,90,0,17824,18,1103,1068,1151,1151,48,83,bicycle
48551,93,person,91,0,17824,36,1088,987,1158,1140,70,153,person
48552,94,bicycle,92,0,17824,30,1244,1069,1311,1164,67,95,bicycle
48553,95,person,93,0,17824,36,1249,999,1317,1163,68,164,person
48554,8,car,6,0,17825,33,395,970,877,1181,482,211,car
48555,10,car,8,0,17825,28,1500,955,2041,1403,541,448,car
48556,12,car,10,0,17825,20,1065,937,1394,1108,329,171,car
48557,30,car,28,1,17825,16,2097,993,2199,1220,102,227,car
48558,4,car,5,0,17826,36,763,789,1608,1136,845,347,car
48559,5,car,6,0,17826,26,71,770,684,1058,613,288,car
48560,13,person,14,0,17826,35,1234,763,1406,1230,172,467,person
48561,0,car,1,0,17827,36,1195,1060,1838,1279,643,219,car
48562,4,car,5,1,17827,21,3,1126,255,1299,252,173,car
48563,4,person,5,0,17828,19,1171,810,1268,1042,97,232,person
48564,6,person,7,0,17828,17,246,785,313,954,67,169,person
48565,46,person,45,0,17829,50,330,1093,413,1279,83,186,person
48566,47,person,46,0,17829,49,357,1093,455,1269,98,176,person
48567,48,person,47,1,17829,28,431,1095,468,1261,37,166,person
48568,7,car,8,0,17830,38,329,874,755,1055,426,181,car
48569,1,truck,2,0,17831,24,1522,363,1866,684,344,321,truck
48570,15,truck,12,1,17831,18,1821,352,2046,496,225,144,truck
48571,0,car,1,0,17832,36,111,184,497,383,386,199,car
48572,12,person,13,0,17832,18,519,202,543,260,24,58,person
48573,7,motorbike,8,0,17833,33,479,233,552,372,73,139,motorcycle
48574,20,car,21,0,17833,17,12,215,192,300,180,85,car
48575,21,car,22,0,17833,15,2,228,93,385,91,157,car
48576,23,car,24,1,17833,19,659,267,800,435,141,168,car
48577,0,person,1,0,17834,36,608,752,744,1090,136,338,person
48578,1,person,2,1,17834,15,458,707,543,1084,85,377,person
48579,13,person,8,0,17834,23,1322,810,1444,966,122,156,person
48580,15,bench,10,0,17834,17,1151,853,1455,975,304,122,bench
48581,16,person,11,0,17834,31,1126,797,1268,956,142,159,person
48582,26,person,21,0,17834,29,1930,779,2037,976,107,197,person
48583,27,person,22,0,17834,33,1845,793,1913,1005,68,212,person
48584,28,person,23,1,17834,21,1142,720,1189,887,47,167,person
48585,29,person,24,1,17834,17,1078,728,1122,913,44,185,person
48586,30,person,25,0,17834,33,1012,713,1083,893,71,180,person
48587,32,person,27,1,17834,21,76,693,157,874,81,181,person
48588,34,person,29,1,17834,25,291,780,383,964,92,184,person
48589,35,person,30,1,17834,21,4,1012,161,1247,157,235,person
48590,37,person,32,1,17834,17,1,692,62,822,61,130,person
48591,2,person,3,0,17835,16,1427,602,1584,946,157,344,person
48592,23,bicycle,24,0,17835,48,1235,660,1361,736,126,76,bicycle
48593,65,bicycle,66,1,17835,17,642,640,682,706,40,66,bicycle
48594,6,person,7,1,17836,19,181,933,246,1080,65,147,person
48595,7,person,8,1,17836,17,261,935,329,1058,68,123,person
48596,14,car,15,0,17837,15,5,872,119,978,114,106,car
48597,15,car,16,0,17837,20,112,890,279,973,167,83,car
48598,16,truck,17,0,17837,21,255,792,509,963,254,171,truck
48599,18,car,19,1,17837,20,536,885,654,952,118,67,car
48600,20,car,21,0,17837,28,1166,882,1571,1049,405,167,car
48601,5,car,5,1,17838,21,561,176,672,235,111,59,car
48602,0,person,1,0,17839,24,539,617,680,1210,141,593,person
48603,1,person,2,0,17839,66,289,560,487,1218,198,658,person
48604,2,car,3,0,17839,47,73,544,1615,1206,1542,662,car
48605,3,car,4,1,17839,26,1523,671,2199,1069,676,398,car
48606,6,person,7,1,17839,36,3,563,127,1088,124,525,person
48607,22,person,23,1,17839,46,458,568,596,1198,138,630,person
48608,1,truck,2,0,17840,20,539,94,809,349,270,255,truck
48609,6,person,7,0,17840,17,3,204,51,312,48,108,person
48610,7,person,8,0,17840,24,70,185,123,335,53,150,person
48611,12,person,13,0,17840,17,216,223,253,289,37,66,person
48612,15,person,16,0,17840,25,132,187,189,352,57,165,person
48613,19,person,20,0,17840,23,1329,215,1376,355,47,140,person
48614,20,person,21,0,17840,20,1080,215,1123,331,43,116,person
48615,21,person,22,0,17840,23,1123,212,1161,344,38,132,person
48616,0,person,1,0,17841,24,493,440,645,874,152,434,person
48617,1,person,2,0,17841,32,1129,444,1291,793,162,349,person
48618,2,bench,3,0,17841,39,1755,614,2027,832,272,218,bench
48619,6,person,7,0,17841,53,1577,416,1734,824,157,408,person
48620,8,person,9,0,17841,38,1395,437,1498,725,103,288,person
48621,9,person,10,0,17841,44,1281,444,1367,730,86,286,person
48622,10,person,11,1,17841,21,1349,454,1399,633,50,179,person
48623,12,person,13,1,17841,24,1987,504,2049,888,62,384,person
48624,18,car,19,1,17841,18,1,551,412,1085,411,534,car
48625,68,person,69,1,17841,19,1012,449,1043,506,31,57,person
48626,78,door,79,0,17841,17,969,491,1094,622,125,131,door
48627,86,door,87,0,17841,18,422,437,521,639,99,202,door
48628,99,door,100,0,17841,23,42,570,313,915,271,345,door
48629,104,door,105,0,17841,21,2,572,166,945,164,373,door
48630,3,fire hydrant,4,0,17842,15,402,1210,484,1383,82,173,fire hydrant
48631,4,person,5,0,17842,37,497,940,608,1316,111,376,person
48632,5,person,6,0,17842,41,671,970,802,1339,131,369,person
48633,17,car,18,1,17842,20,1064,1009,1299,1163,235,154,car
48634,29,car,30,0,17842,16,1391,1045,1541,1150,150,105,car
48635,48,car,28,1,17843,16,771,944,810,972,39,28,car
48636,49,car,29,1,17843,22,695,933,774,974,79,41,car
48637,50,car,30,1,17843,18,890,951,925,982,35,31,car
48638,51,car,31,0,17843,37,919,949,989,1004,70,55,car
48639,52,car,32,1,17843,25,671,947,717,992,46,45,car
48640,53,car,33,1,17843,33,534,923,678,1005,144,82,car
48641,54,car,34,1,17843,30,504,935,621,1006,117,71,car
48642,55,car,35,1,17843,35,429,927,525,1029,96,102,car
48643,56,car,36,1,17843,49,68,877,460,1053,392,176,car
48644,6,person,7,0,17845,32,317,900,516,1154,199,254,person
48645,7,bench,8,0,17845,15,304,975,446,1149,142,174,bench
48646,8,bench,9,0,17845,22,528,962,676,1143,148,181,bench
48647,13,car,14,1,17845,18,868,880,1026,996,158,116,car
48648,14,motorbikes,15,0,17845,37,956,877,1141,1020,185,143,motorcycle
48649,19,person,18,0,17845,31,1269,865,1337,1065,68,200,person
48650,20,person,19,0,17845,35,1327,867,1401,1071,74,204,person
48651,21,traffic light,20,0,17845,19,1234,589,1309,1061,75,472,traffic light
48652,23,car,22,1,17845,15,1875,882,2044,941,169,59,car
48653,27,motorbikes,26,0,17845,21,1728,898,2044,1045,316,147,motorcycle
48654,29,person,28,1,17845,48,1396,862,1484,1043,88,181,person
48655,30,motorbike,29,0,17845,33,1397,924,1473,1045,76,121,motorcycle
48656,32,car,31,1,17845,21,1190,886,1279,973,89,87,car
48657,33,motorbike,32,0,17845,28,1201,916,1278,1050,77,134,motorcycle
48658,37,flowerpot,36,0,17845,31,222,971,315,1072,93,101,potted plant
48659,40,person,39,1,17845,36,1629,867,1696,1038,67,171,person
48660,41,motorbike,40,0,17845,49,1638,892,1765,1086,127,194,motorcycle
48661,0,person,1,0,17846,23,593,671,660,962,67,291,person
48662,1,car,2,0,17846,18,211,677,604,977,393,300,car
48663,7,car,8,0,17846,23,1,755,383,1174,382,419,car
48664,29,person,28,0,17846,17,1020,692,1037,731,17,39,person
48665,30,person,29,0,17846,23,1041,692,1063,764,22,72,person
48666,32,car,31,1,17846,19,719,681,786,755,67,74,car
48667,40,car,39,1,17846,35,651,724,750,882,99,158,car
48668,41,person,40,1,17846,44,638,688,687,945,49,257,person
48669,0,person,1,0,17847,24,1407,800,1533,1170,126,370,person
48670,28,person,29,0,17847,28,1756,836,1855,1074,99,238,person
48671,29,person,30,0,17847,38,1577,828,1677,1075,100,247,person
48672,30,person,31,0,17847,25,1675,845,1740,1026,65,181,person
48673,34,person,35,1,17847,21,1730,851,1765,992,35,141,person
48674,0,car,1,0,17848,23,903,982,1277,1112,374,130,car
48675,5,car,6,0,17848,20,588,978,892,1091,304,113,car
48676,16,car,17,1,17848,15,1285,982,1600,1118,315,136,car
48677,55,person,52,0,17848,17,887,949,918,1062,31,113,person
48678,64,person,61,0,17848,18,186,929,216,1020,30,91,person
48679,98,door,95,0,17848,15,1406,983,1518,1094,112,111,door
48680,22,car,23,1,17849,22,254,930,418,1061,164,131,car
48681,23,car,24,1,17849,24,2,940,275,1148,273,208,car
48682,27,car,28,0,17849,15,440,937,532,1003,92,66,car
48683,31,person,28,0,17850,32,2087,673,2195,906,108,233,person
48684,32,person,29,0,17850,42,1749,699,1874,1057,125,358,person
48685,40,car,36,0,17850,51,325,743,1170,1114,845,371,car
48686,55,door,51,0,17850,16,408,754,582,1002,174,248,door
48687,0,person,1,0,17851,19,345,1217,469,1567,124,350,person
48688,1,person,2,0,17851,19,631,1210,772,1606,141,396,person
48689,2,person,3,0,17851,19,856,1201,965,1573,109,372,person
48690,3,person,4,0,17851,27,1009,1181,1138,1544,129,363,person
48691,48,truck,48,0,17851,41,1598,1107,1887,1299,289,192,truck
48692,54,car,54,0,17851,16,46,1215,291,1360,245,145,car
48693,62,window,61,0,17851,24,983,848,1047,1095,64,247,window
48694,63,window,62,0,17851,18,1135,872,1190,1076,55,204,window
48695,64,window,63,0,17851,15,1263,899,1312,1073,49,174,window
48696,66,window,65,0,17851,19,544,804,622,1085,78,281,window
48697,67,window,66,0,17851,15,406,825,480,1090,74,265,window
48698,75,traffic light,71,0,17851,38,1604,739,2199,884,595,145,traffic light
48699,76,car,72,1,17851,44,978,1240,1229,1342,251,102,car
48700,77,car,73,1,17851,46,482,1238,801,1370,319,132,car
48701,79,car,75,1,17851,17,1880,1226,1936,1282,56,56,car
48702,80,car,76,1,17851,23,1996,1213,2081,1271,85,58,car
48703,81,car,77,1,17851,17,2036,1202,2110,1254,74,52,car
48704,83,car,79,1,17851,19,2138,1215,2181,1265,43,50,car
48705,84,bus,80,1,17851,19,2083,1154,2192,1258,109,104,bus
48706,85,person,81,0,17851,19,2122,1199,2143,1279,21,80,person
48707,86,person,82,0,17851,24,2102,1209,2134,1283,32,74,person
48708,87,person,83,1,17851,48,755,1202,883,1514,128,312,person
48709,91,person,87,0,17851,21,1647,1201,1686,1306,39,105,person
48710,94,traffic light,90,0,17851,49,879,885,1238,1210,359,325,traffic light
48711,132,person,128,1,17851,24,376,1189,457,1282,81,93,person
48712,13,car,14,0,17852,20,1229,873,1346,935,117,62,car
48713,36,bench,37,0,17852,28,2,923,176,1003,174,80,bench
48714,1,car,2,0,17853,17,671,1008,1051,1247,380,239,car
48715,2,car,3,0,17853,20,185,999,511,1155,326,156,car
48716,3,car,4,0,17853,17,461,999,678,1121,217,122,car
48717,16,car,17,1,17853,15,963,1008,1150,1185,187,177,car
48718,21,person,22,0,17853,32,1313,969,1339,1056,26,87,person
48719,0,parking meter,1,0,17854,16,1942,999,1964,1134,22,135,parking meter
48720,12,car,10,0,17854,34,1557,967,1745,1104,188,137,car
48721,13,car,11,0,17854,41,614,1027,1085,1185,471,158,car
48722,14,car,12,0,17854,42,138,1019,583,1186,445,167,car
48723,15,car,13,0,17854,20,1175,1007,1308,1115,133,108,car
48724,34,person,32,1,17854,19,118,1001,193,1094,75,93,person
48725,37,car,35,1,17854,15,1523,978,1582,1078,59,100,car
48726,38,car,36,1,17854,38,1743,994,1992,1079,249,85,car
48727,39,car,37,1,17854,16,1990,1036,2199,1166,209,130,car
48728,12,car,13,0,17855,55,563,844,1507,1221,944,377,car
48729,13,person,14,0,17855,17,1961,775,1994,842,33,67,person
48730,9,person,10,0,17856,29,441,859,513,972,72,113,person
48731,13,car,14,0,17856,16,980,875,1056,943,76,68,car
48732,15,car,16,1,17856,19,0,871,136,973,136,102,car
48733,43,car,44,1,17856,16,1353,881,1425,939,72,58,car
48734,44,car,45,0,17856,19,1394,892,1495,945,101,53,car
48735,45,car,46,0,17856,27,1485,863,1638,968,153,105,car
48736,47,car,48,1,17856,18,1672,865,1843,939,171,74,car
48737,48,car,49,1,17856,16,1704,879,1824,944,120,65,car
48738,49,car,50,1,17856,18,1752,864,1897,951,145,87,car
48739,50,car,51,0,17856,24,1800,865,2039,959,239,94,car
48740,60,window,60,0,17856,20,1362,739,1432,880,70,141,window
48741,8,car,9,1,17857,15,399,811,528,904,129,93,car
48742,9,car,10,1,17857,26,524,776,805,930,281,154,car
48743,10,car,11,0,17857,26,792,795,1155,954,363,159,car
48744,11,car,12,0,17857,31,111,798,468,976,357,178,car
48745,12,car,13,0,17857,31,1155,802,1610,991,455,189,car
48746,13,car,14,1,17857,24,1627,780,2046,1011,419,231,car
48747,61,door,61,0,17857,15,1761,790,1900,967,139,177,door
48748,24,car,25,0,17858,28,768,993,1479,1329,711,336,car
48749,30,flowerpot,31,0,17858,20,908,932,960,978,52,46,potted plant
48750,32,flowerpot,33,0,17858,17,782,934,832,979,50,45,potted plant
48751,35,door,36,0,17858,17,886,1003,1043,1240,157,237,door
48752,39,door,40,0,17858,17,1010,1002,1155,1251,145,249,door
48753,20,window,21,0,17859,16,1318,713,1616,785,298,72,window
48754,14,car,15,1,17860,16,231,876,602,961,371,85,car
48755,15,car,16,1,17860,28,221,901,697,1167,476,266,car
48756,16,car,17,1,17860,37,85,917,625,1340,540,423,car
48757,17,car,18,1,17860,26,2,915,348,1412,346,497,car
48758,20,motorbike,21,0,17860,18,783,882,855,979,72,97,motorcycle
48759,30,window,31,0,17860,18,259,953,444,1074,185,121,window
48760,7,person,8,0,17861,26,177,1618,268,1891,91,273,person
48761,15,person,16,0,17861,22,597,1570,680,1846,83,276,person
48762,24,person,22,0,17861,38,1130,1602,1225,1834,95,232,person
48763,26,person,24,0,17861,36,1074,1620,1134,1788,60,168,person
48764,27,person,25,0,17861,36,883,1614,945,1802,62,188,person
48765,0,person,1,0,17862,93,1004,137,1218,622,214,485,person
48766,12,person,7,0,17862,23,476,171,566,449,90,278,person
48767,13,person,8,0,17862,25,584,146,709,480,125,334,person
48768,17,car,12,1,17862,15,550,196,605,348,55,152,car
48769,18,person,13,1,17862,17,666,169,707,300,41,131,person
48770,23,bus,18,1,17862,32,767,163,896,234,129,71,bus
48771,32,person,27,0,17862,76,769,189,893,492,124,303,person
48772,33,person,28,1,17862,35,1217,184,1269,426,52,242,person
48773,37,person,32,1,17862,63,876,179,958,399,82,220,person
48774,38,person,33,1,17862,40,954,172,1034,336,80,164,person
48775,39,person,34,1,17862,64,1153,181,1234,526,81,345,person
48776,40,person,35,0,17862,47,904,286,1007,429,103,143,person
48777,0,car,1,0,17863,23,947,1117,1393,1261,446,144,car
48778,36,bicycle,33,1,17863,36,336,1378,624,1646,288,268,bicycle
48779,8,window,9,0,17864,15,1892,340,2045,713,153,373,window
48780,15,window,16,0,17864,16,1675,364,1809,704,134,340,window
48781,18,motorbike,19,0,17864,21,991,701,1033,759,42,58,motorcycle
48782,19,motorbike,20,0,17864,23,1038,693,1099,781,61,88,motorcycle
48783,23,motorbike,24,1,17864,39,736,730,889,859,153,129,motorcycle
48784,10,person,11,0,17865,37,1055,1081,1135,1309,80,228,person
48785,15,window,16,0,17865,19,437,522,516,715,79,193,window
48786,22,bench,23,0,17866,37,650,1140,1066,1324,416,184,bench
48787,30,door,31,0,17866,30,159,945,317,1269,158,324,door
48788,4,person,5,0,17867,18,1227,1212,1279,1358,52,146,person
48789,5,person,6,0,17867,23,1327,1217,1373,1328,46,111,person
48790,7,bicycle,8,0,17867,94,1472,1323,1647,1536,175,213,bicycle
48791,20,bicycle,21,1,17867,29,1410,1338,1509,1505,99,167,bicycle
48792,0,car,1,0,17868,20,378,226,513,267,135,41,car
48793,11,person,12,1,17868,15,491,212,507,238,16,26,person
48794,0,car,1,0,17869,21,516,453,1687,1138,1171,685,car
48795,2,car,3,1,17869,16,1585,425,2168,828,583,403,car
48796,3,car,4,1,17869,22,177,351,783,658,606,307,car
48797,5,car,6,1,17869,18,1472,411,1685,547,213,136,car
48798,7,car,8,1,17869,15,149,764,686,1407,537,643,car
48799,25,parking meter,26,0,17869,16,2137,360,2200,818,63,458,parking meter
48800,48,door,49,0,17869,15,519,361,699,573,180,212,door
48801,5,bicycle,6,0,17870,37,954,1113,1315,1595,361,482,bicycle
48802,6,motorbike,7,0,17870,34,1092,951,1686,1403,594,452,motorcycle
48803,0,car,1,1,17872,18,0,871,586,1528,586,657,car
48804,8,car,5,1,17872,20,319,750,717,1174,398,424,car
48805,14,motorbike,11,0,17872,18,942,891,1001,1026,59,135,motorcycle
48806,18,person,15,0,17872,15,251,747,278,821,27,74,person
48807,25,person,21,0,17872,18,1119,825,1162,969,43,144,person
48808,48,person,44,0,17872,24,1014,833,1069,986,55,153,person
48809,49,person,45,0,17872,26,1074,814,1123,981,49,167,person
48810,50,person,46,0,17872,16,1011,774,1039,858,28,84,person
48811,53,person,49,0,17872,24,89,745,128,837,39,92,person
48812,55,person,51,0,17872,23,45,747,74,835,29,88,person
48813,6,car,7,1,17873,16,1672,1032,2197,1325,525,293,car
48814,7,car,8,1,17873,20,1152,1023,1366,1159,214,136,car
48815,8,car,9,1,17873,17,1009,1016,1180,1132,171,116,car
48816,9,car,10,1,17873,17,949,1011,1054,1106,105,95,car
48817,10,car,11,1,17873,20,895,1009,966,1092,71,83,car
48818,11,car,12,1,17873,17,845,1005,915,1077,70,72,car
48819,12,car,13,1,17873,17,810,998,868,1070,58,72,car
48820,13,car,14,1,17873,15,778,999,822,1062,44,63,car
48821,23,person,11,0,17874,29,199,1164,229,1265,30,101,person
48822,40,person,28,0,17874,39,1414,1197,1463,1324,49,127,person
48823,41,person,29,0,17874,39,1540,1201,1586,1347,46,146,person
48824,49,person,37,0,17874,41,1627,1184,1693,1325,66,141,person
48825,57,car,45,0,17874,31,856,1151,1008,1250,152,99,car
48826,29,car,21,1,17875,18,275,546,450,710,175,164,car
48827,32,person,24,0,17875,15,640,600,661,678,21,78,person
48828,34,person,26,0,17875,49,749,562,868,867,119,305,person
48829,35,person,27,1,17875,57,828,572,936,870,108,298,person
48830,36,person,28,0,17875,52,876,567,996,888,120,321,person
48831,0,car,1,0,17877,35,1318,1067,1819,1410,501,343,car
48832,3,person,4,1,17877,40,2119,1013,2200,1353,81,340,person
48833,11,person,12,0,17877,42,290,1023,372,1220,82,197,person
48834,12,person,13,0,17877,39,365,1009,448,1224,83,215,person
48835,17,car,18,1,17877,17,948,1059,1059,1144,111,85,car
48836,18,car,19,0,17877,28,1039,1079,1252,1153,213,74,car
48837,19,person,20,0,17877,29,1098,1054,1138,1169,40,115,person
48838,21,car,22,1,17877,31,1723,1062,1908,1228,185,166,car
48839,2,car,2,0,17878,37,705,1128,1468,1444,763,316,car
48840,3,car,3,0,17878,35,113,1073,473,1278,360,205,car
48841,5,person,5,1,17878,58,1513,1126,1779,1535,266,409,person
48842,6,backpack,6,0,17878,28,1443,1245,1669,1492,226,247,backpack
48843,7,person,7,0,17878,38,1888,1118,1988,1373,100,255,person
48844,13,person,13,1,17878,27,723,1099,784,1185,61,86,person
48845,27,person,27,0,17878,19,1565,1126,1609,1203,44,77,person
48846,35,person,34,1,17878,23,1889,1097,1949,1197,60,100,person
48847,36,person,35,1,17878,44,1956,1116,2028,1377,72,261,person
48848,37,person,36,1,17878,17,2013,1089,2046,1254,33,165,person
48849,38,person,37,1,17878,15,2026,1149,2047,1352,21,203,person
48850,47,door,46,0,17878,16,921,1149,1064,1373,143,224,door
48851,51,door,50,0,17878,17,798,1149,945,1347,147,198,door
48852,0,person,1,0,17879,39,167,181,213,342,46,161,person
48853,1,person,2,0,17879,37,209,177,273,348,64,171,person
48854,30,person,23,0,17879,49,423,206,451,254,28,48,person
48855,31,person,24,0,17879,33,401,207,413,250,12,43,person
48856,32,person,25,0,17879,38,369,210,383,254,14,44,person
48857,33,person,26,1,17879,25,355,209,364,253,9,44,person
48858,34,person,27,0,17879,34,307,211,321,250,14,39,person
48859,35,person,28,0,17879,56,325,199,356,272,31,73,person
48860,42,car,35,1,17879,18,555,211,600,222,45,11,car
48861,44,car,37,1,17879,19,574,224,640,267,66,43,car
48862,46,car,39,1,17879,29,503,217,604,263,101,46,car
48863,47,car,40,1,17879,27,455,211,532,256,77,45,car
48864,50,car,43,1,17879,20,440,224,464,249,24,25,car
48865,51,car,44,1,17879,46,382,215,431,245,49,30,car
48866,0,person,1,0,17880,25,739,606,842,918,103,312,person
48867,1,person,2,0,17880,40,866,613,969,921,103,308,person
48868,10,car,10,0,17880,16,1131,609,1194,654,63,45,car
48869,11,car,11,1,17880,17,83,646,382,743,299,97,car
48870,12,car,12,1,17880,16,2,611,191,926,189,315,car
48871,20,car,19,1,17880,18,1391,611,1523,680,132,69,car
48872,38,bicycle,37,1,17880,42,372,654,467,725,95,71,bicycle
48873,40,traffic light,39,0,17880,46,571,180,685,726,114,546,traffic light
48874,44,person,43,0,17880,20,1329,609,1348,658,19,49,person
48875,45,person,44,0,17880,19,1263,610,1284,652,21,42,person
48876,51,car,51,0,17881,22,182,878,351,968,169,90,car
48877,58,bus,58,1,17881,30,1377,788,1631,947,254,159,bus
48878,64,bus,64,0,17881,19,536,803,656,900,120,97,bus
48879,71,person,71,0,17881,62,1053,864,1114,1073,61,209,person
48880,72,person,72,0,17881,54,1105,865,1158,1072,53,207,person
48881,73,person,73,0,17881,29,848,876,878,974,30,98,person
48882,74,person,74,0,17881,59,1417,863,1497,1081,80,218,person
48883,75,person,75,0,17881,29,1255,874,1287,966,32,92,person
48884,76,person,76,0,17881,40,1532,866,1581,1038,49,172,person
48885,77,person,77,0,17881,31,1489,887,1529,1039,40,152,person
48886,92,person,92,0,17881,49,967,875,1051,1073,84,198,person
48887,93,traffic light,93,0,17881,23,560,792,597,921,37,129,traffic light
48888,94,traffic light,94,0,17881,19,188,792,227,890,39,98,traffic light
48889,0,car,1,0,17882,19,194,1091,701,1319,507,228,car
48890,16,car,17,1,17882,18,1378,1111,1423,1159,45,48,car
48891,23,car,24,1,17882,20,1108,1082,1184,1162,76,80,car
48892,32,car,33,1,17882,19,209,1072,416,1133,207,61,car
48893,36,car,37,1,17882,24,591,1078,727,1156,136,78,car
48894,37,car,38,1,17882,23,620,1083,805,1160,185,77,car
48895,39,car,40,1,17882,32,708,1078,914,1160,206,82,car
48896,40,car,41,1,17882,50,826,1063,1079,1158,253,95,car
48897,46,umbrella,47,0,17882,16,859,788,952,829,93,41,umbrella
48898,57,door,58,0,17882,16,313,1103,416,1278,103,175,door
48899,63,door,64,0,17882,18,230,1100,341,1270,111,170,door
48900,6,car,7,1,17883,30,2,371,168,497,166,126,car
48901,7,truck,8,1,17883,23,66,300,233,403,167,103,truck
48902,2,car,3,0,17884,40,119,2,1480,1107,1361,1105,car
48903,2,car,3,0,17885,20,344,914,1227,1195,883,281,car
48904,3,parking meter,4,0,17885,18,1207,894,1239,1117,32,223,parking meter
48905,22,person,23,1,17885,25,1402,804,1549,1103,147,299,person
48906,24,person,25,1,17885,18,1610,824,1703,1079,93,255,person
48907,39,door,40,0,17885,17,530,918,726,1129,196,211,door
48908,1,car,2,0,17886,23,1599,1102,2200,1439,601,337,car
48909,40,person,41,0,17886,19,430,1201,454,1280,24,79,person
48910,42,person,43,0,17886,32,230,1238,312,1433,82,195,person
48911,105,person,106,0,17886,16,406,1202,427,1274,21,72,person
48912,144,door,144,0,17886,17,953,1240,1036,1391,83,151,door
48913,146,door,146,0,17886,18,1002,1239,1081,1397,79,158,door
48914,27,motorbike,27,0,17887,20,740,841,786,912,46,71,motorcycle
48915,28,person,28,0,17887,29,835,811,896,894,61,83,person
48916,9,person,10,0,17888,24,457,979,566,1136,109,157,person
48917,0,person,1,0,17889,24,382,823,595,1567,213,744,person
48918,8,person,9,0,17889,47,6,842,273,1644,267,802,person
48919,11,umbrella,12,0,17889,16,325,796,696,1046,371,250,umbrella
48920,0,car,1,0,17890,24,396,1168,604,1242,208,74,car
48921,4,car,5,0,17890,23,38,1160,203,1224,165,64,car
48922,13,car,14,0,17890,16,1961,1127,2048,1206,87,79,car
48923,15,person,16,0,17890,17,1394,1144,1416,1201,22,57,person
48924,18,person,19,0,17890,16,1367,1144,1385,1211,18,67,person
48925,22,traffic light,23,1,17890,50,4,296,375,600,371,304,traffic light
48926,20,person,18,1,17891,19,100,796,154,867,54,71,person
48927,27,car,28,0,17892,18,1672,954,1856,1092,184,138,car
48928,3,car,4,1,17893,17,2,894,249,1039,247,145,car
48929,45,bicycle,46,1,17894,35,1218,1078,1277,1237,59,159,bicycle
48930,0,car,1,0,17895,23,979,776,1900,1153,921,377,car
48931,6,person,7,0,17895,30,413,862,482,983,69,121,person
48932,7,person,8,1,17895,18,418,858,449,948,31,90,person
48933,8,person,9,0,17895,25,747,840,792,998,45,158,person
48934,10,car,11,1,17895,19,821,858,1064,947,243,89,car
48935,11,person,12,0,17895,18,974,819,1030,916,56,97,person
48936,12,car,13,1,17895,32,870,839,1227,1061,357,222,car
48937,15,car,16,1,17895,19,3,839,199,1006,196,167,car
48938,16,car,17,1,17895,29,140,847,416,1005,276,158,car
48939,21,car,22,1,17895,18,1984,854,2199,981,215,127,car
48940,29,person,30,0,17895,28,785,824,833,1001,48,177,person
48941,16,traffic light,12,0,17896,25,485,651,671,1530,186,879,traffic light
48942,23,car,19,0,17896,33,36,1522,784,1793,748,271,car
48943,40,person,36,0,17896,24,782,1469,832,1597,50,128,person
48944,41,person,37,0,17896,27,849,1467,901,1585,52,118,person
48945,42,person,38,0,17896,23,948,1451,988,1569,40,118,person
48946,43,person,39,0,17896,28,1174,1440,1210,1547,36,107,person
48947,44,person,40,0,17896,22,1142,1452,1176,1546,34,94,person
48948,45,person,41,0,17896,21,1003,1460,1034,1542,31,82,person
48949,46,person,42,1,17896,18,653,1487,699,1592,46,105,person
48950,53,person,49,1,17896,15,139,1493,184,1592,45,99,person
48951,54,car,50,1,17896,19,265,1474,413,1528,148,54,car
48952,58,car,54,1,17896,37,570,1478,730,1560,160,82,car
48953,59,car,55,0,17896,33,1225,1443,1563,1589,338,146,car
48954,61,person,57,0,17896,22,1571,1434,1602,1541,31,107,person
48955,66,person,62,0,17896,22,1085,1462,1115,1536,30,74,person
48956,67,person,63,0,17896,20,1614,1437,1638,1539,24,102,person
48957,10,car,7,1,17898,16,69,874,363,1004,294,130,car
48958,15,person,12,0,17898,18,960,858,1005,983,45,125,person
48959,29,person,26,1,17898,27,1741,842,1766,942,25,100,person
48960,30,person,27,0,17898,35,1724,842,1751,943,27,101,person
48961,31,person,28,0,17898,34,1701,848,1725,945,24,97,person
48962,41,car,38,1,17898,24,1327,864,1399,937,72,73,car
48963,42,car,39,1,17898,20,1312,864,1354,942,42,78,car
48964,43,car,40,1,17898,20,1251,862,1325,946,74,84,car
48965,55,car,52,1,17898,16,1607,873,1663,970,56,97,car
48966,57,car,54,1,17898,15,1671,871,1703,945,32,74,car
48967,3,car,4,1,17899,21,2,214,110,285,108,71,car
48968,30,car,31,0,17900,17,591,1239,687,1297,96,58,car
48969,1,bus,2,0,17901,31,116,2,1254,957,1138,955,bus
48970,11,person,11,1,17901,22,1029,591,1207,960,178,369,person
48971,9,car,9,1,17902,18,1739,1177,2200,1571,461,394,car
48972,32,car,29,0,17902,16,1461,1180,1515,1206,54,26,car
48973,44,car,41,1,17902,15,1299,1225,1408,1318,109,93,car
48974,48,person,45,1,17902,16,1697,1231,1722,1309,25,78,person
48975,49,person,46,0,17902,24,1727,1235,1757,1310,30,75,person
48976,50,person,47,1,17902,15,1754,1230,1782,1295,28,65,person
48977,60,traffic light,57,0,17902,22,1249,1013,1293,1261,44,248,traffic light
48978,4,person,5,0,17903,29,952,1312,1017,1503,65,191,person
48979,6,person,7,0,17903,32,1014,1296,1085,1507,71,211,person
48980,7,car,8,0,17903,22,215,1350,473,1483,258,133,car
48981,17,car,18,1,17903,15,4,1381,131,1556,127,175,car
48982,51,person,52,0,17903,21,1113,1291,1147,1384,34,93,person
48983,5,bicycle,6,0,17904,23,516,943,569,1026,53,83,bicycle
48984,7,person,8,0,17904,17,565,898,598,977,33,79,person
48985,13,person,14,0,17904,25,824,888,853,974,29,86,person
48986,15,car,16,1,17904,20,587,902,682,961,95,59,car
48987,16,person,17,0,17904,23,684,892,711,976,27,84,person
48988,18,person,19,0,17904,19,455,898,487,977,32,79,person
48989,22,bicycle,23,0,17904,100,1709,999,1898,1159,189,160,bicycle
48990,26,bicycle,27,0,17904,20,977,929,1028,992,51,63,bicycle
48991,5,car,2,0,17906,28,615,557,1379,1062,764,505,car
48992,6,car,3,1,17906,21,3,668,676,1385,673,717,car
48993,36,person,29,0,17906,44,571,579,625,693,54,114,person
48994,37,person,30,0,17906,41,648,583,700,693,52,110,person
48995,38,person,31,0,17906,39,703,579,738,696,35,117,person
48996,39,person,32,0,17906,39,760,576,793,678,33,102,person
48997,40,person,33,1,17906,23,798,586,839,653,41,67,person
48998,41,person,34,1,17906,30,286,591,400,722,114,131,person
48999,42,person,35,1,17906,24,304,564,340,657,36,93,person
49000,46,car,39,1,17906,21,1579,637,1727,738,148,101,car
49001,48,car,41,1,17906,16,1789,605,1844,643,55,38,car
49002,50,person,43,0,17906,97,1743,617,1859,940,116,323,person
49003,51,person,44,0,17906,49,1853,606,1906,788,53,182,person
49004,52,person,45,0,17906,33,1918,615,1957,735,39,120,person
49005,53,person,46,1,17906,27,1949,611,1978,728,29,117,person
49006,54,fire hydrant,47,0,17906,20,2140,730,2175,798,35,68,fire hydrant
49007,80,door,73,0,17906,20,231,724,545,1252,314,528,door
49008,86,window,79,0,17906,15,5,755,250,1006,245,251,window
49009,13,car,14,0,17907,25,244,761,555,941,311,180,car
49010,14,car,15,1,17907,15,88,787,256,889,168,102,car
49011,12,bicycle,8,1,17908,78,1,615,769,1460,768,845,bicycle
49012,14,bicycle,10,1,17908,94,144,594,921,1331,777,737,bicycle
49013,15,bicycle,11,1,17908,72,556,583,1171,1101,615,518,bicycle
49014,16,bicycle,12,1,17908,81,666,477,1157,876,491,399,bicycle
49015,17,bicycle,13,0,17908,148,809,459,1584,959,775,500,bicycle
49016,2,car,3,0,17909,22,1490,1076,1998,1406,508,330,car
49017,0,car,1,0,17910,37,111,902,947,1183,836,281,car
49018,1,car,2,0,17910,25,993,920,1863,1188,870,268,car
49019,38,door,39,0,17910,16,1303,925,1600,1132,297,207,door
49020,47,door,48,0,17910,16,414,910,611,1139,197,229,door
49021,48,door,49,0,17910,17,254,919,421,1126,167,207,door
49022,0,car,1,0,17911,25,189,903,590,1091,401,188,car
49023,3,car,4,1,17911,16,32,928,119,975,87,47,car
49024,4,car,5,0,17911,26,1107,909,1396,1062,289,153,car
49025,24,car,18,1,17911,18,952,933,1047,986,95,53,car
49026,26,car,20,1,17911,21,765,929,828,991,63,62,car
49027,33,car,27,1,17911,16,2007,897,2085,948,78,51,car
49028,35,car,29,1,17911,23,2040,898,2199,969,159,71,car
49029,0,car,1,0,17912,21,1176,1099,1803,1327,627,228,car
49030,25,door,24,0,17912,22,1403,1108,1616,1284,213,176,door
49031,32,parking meter,31,0,17912,27,1739,1089,1790,1155,51,66,parking meter
49032,0,person,1,0,17913,31,810,463,980,1003,170,540,person
49033,1,person,2,0,17913,25,381,500,585,1046,204,546,person
49034,14,car,15,0,17913,16,588,456,701,607,113,151,car
49035,23,person,24,0,17913,30,782,468,843,615,61,147,person
49036,24,person,25,0,17913,18,749,459,770,532,21,73,person
49037,25,person,26,0,17913,26,684,470,717,571,33,101,person
49038,2,person,3,0,17914,17,751,802,812,998,61,196,person
49039,3,person,4,0,17914,17,992,834,1042,972,50,138,person
49040,4,person,5,0,17914,20,1241,847,1297,1010,56,163,person
49041,5,person,6,0,17914,16,1311,853,1365,999,54,146,person
49042,26,traffic light,23,0,17914,20,949,65,1093,499,144,434,traffic light
49043,38,car,35,0,17914,20,1640,881,1808,983,168,102,car
49044,39,car,36,1,17914,31,1079,857,1242,973,163,116,car
49045,40,person,37,0,17914,23,1124,817,1179,999,55,182,person
49046,23,person,16,0,17915,36,1043,878,1134,1114,91,236,person
49047,24,person,17,0,17915,37,461,876,490,942,29,66,person
49048,26,truck,18,0,17915,46,1,682,401,1002,400,320,truck
49049,32,flowerpot,24,0,17915,26,708,1122,837,1276,129,154,potted plant
49050,33,flowerpot,25,1,17915,20,807,1072,873,1189,66,117,potted plant
49051,34,flowerpot,26,0,17915,17,845,1040,906,1137,61,97,potted plant
49052,52,car,44,0,17915,33,504,887,602,951,98,64,car
49053,53,car,45,1,17915,26,593,878,665,944,72,66,car
49054,54,car,46,1,17915,22,641,871,723,933,82,62,car
49055,58,truck,50,1,17915,21,857,874,907,919,50,45,truck
49056,61,car,53,1,17915,48,620,907,832,1034,212,127,car
49057,62,car,54,1,17915,21,756,904,868,962,112,58,car
49058,63,person,55,1,17915,26,866,888,895,951,29,63,person
49059,0,car,1,0,17916,21,1223,840,2037,1105,814,265,car
49060,1,car,2,0,17916,21,174,849,1084,1135,910,286,car
49061,41,door,42,0,17916,16,1598,849,1836,1053,238,204,door
49062,43,door,44,0,17916,15,1441,846,1629,1057,188,211,door
49063,63,door,64,0,17916,15,368,861,572,1073,204,212,door
49064,6,car,7,0,17917,22,458,772,608,876,150,104,car
49065,8,car,9,0,17917,30,1136,783,1262,900,126,117,car
49066,12,car,11,0,17917,17,1455,823,1630,922,175,99,car
49067,56,car,40,1,17917,20,928,795,1014,871,86,76,car
49068,60,car,44,1,17917,20,1308,824,1428,906,120,82,car
49069,62,car,46,1,17917,17,1425,824,1496,887,71,63,car
49070,64,car,48,1,17917,23,1620,833,1769,928,149,95,car
49071,65,car,49,1,17917,28,1734,811,1929,925,195,114,car
49072,66,car,50,1,17917,16,1921,836,2047,934,126,98,car
49073,73,traffic light,57,0,17917,18,1633,764,1711,814,78,50,traffic light
49074,74,person,58,0,17917,47,133,734,182,866,49,132,person
49075,0,person,1,0,17918,19,1008,1048,1093,1231,85,183,person
49076,45,car,36,1,17918,30,1,1094,377,1358,376,264,car
49077,46,car,37,1,17918,55,334,1078,761,1305,427,227,car
49078,59,car,50,0,17918,21,1266,1053,1348,1112,82,59,car
49079,81,door,72,0,17918,20,569,1091,658,1256,89,165,door
49080,85,door,76,0,17918,17,634,1090,724,1241,90,151,door
49081,0,car,1,0,17919,29,1056,977,1263,1090,207,113,car
49082,1,car,2,0,17919,38,716,989,1062,1109,346,120,car
49083,2,car,3,0,17919,27,1253,983,1510,1082,257,99,car
49084,4,car,5,0,17919,32,365,1004,720,1123,355,119,car
49085,21,car,22,1,17919,16,1806,991,1978,1087,172,96,car
49086,22,car,23,0,17919,20,1568,983,1714,1050,146,67,car
49087,27,person,28,0,17919,34,2061,938,2118,1097,57,159,person
49088,28,person,29,0,17919,52,1958,946,2025,1097,67,151,person
49089,29,person,30,0,17919,30,2122,945,2163,1057,41,112,person
49090,31,person,32,1,17919,17,757,969,795,1036,38,67,person
49091,32,traffic light,33,0,17919,27,190,352,316,540,126,188,traffic light
49092,99,door,100,0,17919,16,934,993,999,1082,65,89,door
49093,128,door,129,0,17919,16,524,1008,615,1107,91,99,door
49094,21,car,13,0,17920,20,1423,902,1577,953,154,51,car
49095,38,car,27,1,17920,22,268,874,450,915,182,41,car
49096,39,bus,28,1,17920,17,456,847,557,934,101,87,bus
49097,47,traffic light,36,0,17920,29,405,737,597,878,192,141,traffic light
49098,53,car,42,1,17920,16,650,899,682,929,32,30,car
49099,54,car,43,1,17920,15,628,895,657,931,29,36,car
49100,55,car,44,1,17920,15,618,898,653,937,35,39,car
49101,56,car,45,0,17920,28,573,898,636,940,63,42,car
49102,63,traffic light,52,0,17920,23,726,838,745,939,19,101,traffic light
49103,66,car,55,0,17920,24,834,899,884,940,50,41,car
49104,70,car,59,0,17920,33,1004,910,1133,955,129,45,car
49105,79,traffic light,68,1,17920,25,1181,114,1599,256,418,142,traffic light
49106,1,bicycle,2,0,17922,27,785,828,1546,1336,761,508,bicycle
49107,0,person,1,0,17923,17,1167,429,1380,1136,213,707,person
49108,1,person,2,0,17923,16,544,511,704,962,160,451,person
49109,2,person,3,0,17923,17,391,452,579,908,188,456,person
49110,3,person,4,0,17923,20,138,492,234,772,96,280,person
49111,4,person,5,0,17923,24,727,514,845,811,118,297,person
49112,34,person,34,0,17923,28,974,502,1187,1026,213,524,person
49113,36,person,36,0,17923,30,965,490,1086,821,121,331,person
49114,66,person,64,0,17923,42,833,539,948,833,115,294,person
49115,3,person,4,0,17924,20,773,985,823,1150,50,165,person
49116,4,person,5,0,17924,24,825,986,869,1159,44,173,person
49117,7,car,8,0,17924,15,1163,1039,1357,1103,194,64,car
49118,13,car,14,0,17924,25,1675,930,2105,1288,430,358,car
49119,0,car,1,0,17925,23,1168,710,2015,996,847,286,car
49120,1,car,2,0,17925,28,250,742,1148,1041,898,299,car
49121,10,umbrella,11,0,17925,36,106,530,436,912,330,382,umbrella
49122,12,umbrella,13,0,17925,16,2061,520,2198,763,137,243,umbrella
49123,29,chair,30,0,17925,22,2002,704,2100,841,98,137,chair
49124,35,chair,36,0,17925,22,240,742,351,911,111,169,chair
49125,36,chair,37,0,17925,19,3,748,88,912,85,164,chair
49126,37,person,38,0,17925,26,36,703,121,886,85,183,person
49127,38,person,39,0,17925,15,118,696,216,774,98,78,person
49128,40,person,41,0,17925,23,205,696,309,901,104,205,person
49129,63,door,64,0,17925,20,1506,716,1749,948,243,232,door
49130,1,bench,2,0,17926,23,143,496,295,558,152,62,bench
49131,2,person,3,0,17926,19,228,477,270,563,42,86,person
49132,6,car,7,0,17927,35,432,834,1413,1254,981,420,car
49133,7,car,8,1,17927,17,267,801,688,1002,421,201,car
49134,8,car,9,1,17927,20,2,786,300,967,298,181,car
49135,14,person,15,0,17927,29,1447,797,1541,1085,94,288,person
49136,15,person,16,1,17927,27,1330,756,1429,1091,99,335,person
49137,27,person,28,1,17927,18,238,739,300,840,62,101,person
49138,1,car,2,0,17928,16,534,917,819,1163,285,246,car
49139,3,car,4,1,17928,20,1475,912,1691,1095,216,183,car
49140,4,car,5,1,17928,17,1367,938,1488,1062,121,124,car
49141,5,car,6,1,17928,17,1618,953,1877,1152,259,199,car
49142,6,car,7,1,17928,19,1790,968,2196,1243,406,275,car
49143,22,person,18,0,17928,16,388,911,450,1078,62,167,person
49144,27,car,23,1,17928,15,1267,913,1387,1017,120,104,car
49145,32,person,28,0,17928,38,883,912,962,1099,79,187,person
49146,33,person,29,0,17928,29,436,909,498,1078,62,169,person
49147,0,car,1,0,17929,85,138,726,595,1045,457,319,car
49148,3,person,4,0,17929,30,1434,787,1502,953,68,166,person
49149,11,car,12,1,17929,15,3,793,267,1173,264,380,car
49150,16,car,17,1,17929,15,510,793,714,936,204,143,car
49151,26,person,27,0,17929,32,1565,794,1611,930,46,136,person
49152,27,person,28,0,17929,28,1506,802,1543,906,37,104,person
49153,29,traffic light,30,0,17929,27,736,677,756,702,20,25,traffic light
49154,40,person,37,1,17929,17,1681,787,1754,872,73,85,person
49155,17,car,18,1,17930,17,1108,984,1158,1075,50,91,car
49156,19,car,20,1,17930,16,1657,969,2048,1536,391,567,car
49157,20,car,21,1,17930,43,1432,917,1947,1520,515,603,car
49158,26,car,27,0,17930,34,1225,932,1469,1113,244,181,car
49159,30,car,31,1,17930,25,1144,955,1256,1085,112,130,car
49160,0,truck,1,0,17931,25,267,539,1372,1109,1105,570,truck
49161,1,person,2,0,17931,15,1416,810,1510,977,94,167,person
49162,15,person,16,0,17931,17,1687,813,1745,968,58,155,person
49163,6,car,7,0,17932,26,1310,1099,1706,1447,396,348,car
49164,12,person,13,0,17933,15,2107,981,2146,1068,39,87,person
49165,14,person,15,1,17933,20,954,979,1011,1077,57,98,person
49166,15,person,16,1,17933,16,895,986,934,1067,39,81,person
49167,18,person,19,1,17933,16,754,1011,795,1058,41,47,person
49168,28,person,29,1,17933,18,740,1009,775,1061,35,52,person
49169,11,person,12,0,17934,16,1659,666,1701,828,42,162,person
49170,17,car,18,1,17934,15,1869,673,2041,1049,172,376,car
49171,0,car,1,0,17937,39,325,729,813,1010,488,281,car
49172,13,car,14,1,17937,20,1383,898,1600,1199,217,301,car
49173,27,fire hydrant,27,0,17937,18,1338,814,1378,894,40,80,fire hydrant
49174,28,car,28,1,17937,19,1371,765,1599,866,228,101,car
49175,13,fire hydrant,14,0,17938,32,553,822,665,1050,112,228,fire hydrant
49176,3,car,2,0,17939,18,229,954,885,1466,656,512,car
49177,18,car,14,0,17939,20,711,831,775,883,64,52,car
49178,20,car,16,1,17939,15,578,827,630,878,52,51,car
49179,22,car,18,1,17939,17,552,836,601,885,49,49,car
49180,23,car,19,1,17939,23,450,833,542,905,92,72,car
49181,25,car,21,1,17939,28,13,854,176,987,163,133,car
49182,26,car,22,1,17939,32,101,847,267,970,166,123,car
49183,27,car,23,1,17939,24,220,838,357,945,137,107,car
49184,28,car,24,1,17939,24,321,843,420,928,99,85,car
49185,35,window,31,0,17939,17,291,1011,746,1146,455,135,window
49186,43,person,39,0,17939,55,1111,886,1248,1251,137,365,person
49187,45,person,41,0,17939,73,1314,805,1506,1367,192,562,person
49188,47,person,43,1,17939,47,1193,869,1276,1197,83,328,person
49189,48,person,44,0,17939,34,1000,848,1069,1030,69,182,person
49190,35,person,35,0,17941,19,1592,926,1619,1023,27,97,person
49191,36,person,36,0,17941,18,1566,929,1587,1023,21,94,person
49192,37,person,37,0,17941,26,1540,938,1566,1021,26,83,person
49193,5,car,6,0,17943,24,1330,516,1599,678,269,162,car
49194,10,truck,11,1,17943,30,674,483,1219,800,545,317,truck
49195,14,person,15,0,17943,29,692,544,776,778,84,234,person
49196,18,person,19,0,17943,27,592,528,648,704,56,176,person
49197,19,person,20,1,17943,17,728,466,767,554,39,88,person
49198,0,car,1,0,17944,25,1244,978,2195,1315,951,337,car
49199,57,person,57,0,17944,32,310,1030,365,1172,55,142,person
49200,64,person,64,0,17944,42,463,1029,538,1187,75,158,person
49201,65,person,65,1,17944,34,536,1028,590,1180,54,152,person
49202,68,person,68,1,17944,21,582,1044,615,1122,33,78,person
49203,69,person,69,0,17944,59,623,1029,704,1199,81,170,person
49204,70,person,70,1,17944,34,682,1064,724,1176,42,112,person
49205,0,car,1,1,17945,15,7,1037,488,1527,481,490,car
49206,2,bicycle,3,0,17945,30,824,1142,1146,1365,322,223,bicycle
49207,3,bicycle,4,0,17945,24,561,1129,873,1331,312,202,bicycle
49208,4,person,5,1,17945,19,583,1028,668,1211,85,183,person
49209,19,person,18,1,17945,21,503,1030,576,1248,73,218,person
49210,2,car,3,0,17946,17,1436,992,1822,1148,386,156,car
49211,3,car,4,0,17946,18,1700,940,2044,1320,344,380,car
49212,18,traffic light,16,0,17946,33,597,459,751,1165,154,706,traffic light
49213,36,car,34,1,17946,22,1321,995,1586,1138,265,143,car
49214,37,car,35,1,17946,30,1435,988,1754,1148,319,160,car
49215,38,car,36,1,17946,15,1783,984,1922,1042,139,58,car
49216,39,car,37,1,17946,15,1906,955,2014,1007,108,52,car
49217,40,parking meter,38,0,17946,15,1736,890,1810,1504,74,614,parking meter
49218,1,person,2,0,17947,24,924,1103,978,1276,54,173,person
49219,35,person,35,0,17947,20,1138,1104,1170,1183,32,79,person
49220,5,car,6,1,17948,28,1318,679,1750,1175,432,496,car
49221,7,person,8,1,17948,25,1607,541,1752,748,145,207,person
49222,11,motorbike,12,0,17948,46,876,774,1179,1088,303,314,motorcycle
49223,12,person,13,0,17948,42,962,601,1165,1019,203,418,person
49224,16,traffic light,17,0,17948,23,313,247,450,1045,137,798,traffic light
49225,17,motorbike,18,1,17948,19,2,744,69,1057,67,313,motorcycle
49226,19,traffic light,20,0,17949,20,982,802,1159,1195,177,393,traffic light
49227,20,car,21,0,17949,18,1087,1086,1204,1189,117,103,car
49228,0,car,1,0,17950,34,209,276,359,329,150,53,car
49229,4,car,5,1,17950,18,378,273,452,309,74,36,car
49230,41,car,42,1,17950,16,516,268,552,292,36,24,car
49231,42,car,43,1,17950,20,552,261,590,289,38,28,car
49232,0,person,1,0,17951,44,909,1046,980,1263,71,217,person
49233,1,person,2,0,17951,37,83,1028,195,1347,112,319,person
49234,2,person,3,0,17951,34,517,1024,609,1293,92,269,person
49235,10,car,11,0,17951,30,1660,1109,1941,1259,281,150,car
49236,11,dog,12,0,17951,16,218,1243,346,1352,128,109,dog
49237,14,car,15,1,17951,22,1564,1101,1710,1217,146,116,car
49238,15,car,16,1,17951,15,1388,1098,1500,1223,112,125,car
49239,18,person,18,0,17951,21,956,1048,1077,1285,121,237,person
49240,19,person,19,0,17951,18,1000,1066,1113,1299,113,233,person
49241,21,person,21,1,17951,23,1356,1052,1409,1305,53,253,person
49242,23,person,23,1,17951,18,1129,1042,1169,1097,40,55,person
49243,24,person,24,1,17951,29,1064,1030,1134,1271,70,241,person
49244,25,person,25,1,17951,42,572,1053,636,1279,64,226,person
49245,26,person,26,1,17951,42,590,1032,643,1257,53,225,person
49246,27,person,27,1,17951,20,27,1123,95,1235,68,112,person
49247,5,car,6,0,17952,29,1151,1043,1842,1268,691,225,car
49248,40,vase,40,0,17953,22,988,794,1040,883,52,89,vase
49249,42,person,42,0,17953,41,1433,1089,1520,1250,87,161,person
49250,0,car,1,0,17954,15,1201,2074,1498,2200,297,126,car
49251,3,car,4,0,17954,23,793,2053,890,2109,97,56,car
49252,4,car,5,0,17954,18,539,2058,620,2110,81,52,car
49253,13,bus,9,1,17954,21,1,2006,110,2101,109,95,bus
49254,20,bus,16,1,17954,21,839,2003,1153,2074,314,71,bus
49255,22,person,18,0,17954,25,233,2045,268,2155,35,110,person
49256,23,person,19,1,17954,21,223,2052,253,2150,30,98,person
49257,24,person,20,0,17954,24,187,2063,230,2160,43,97,person
49258,25,traffic light,21,0,17954,23,239,1805,463,2050,224,245,traffic light
49259,29,person,25,0,17954,30,116,2060,165,2163,49,103,person
49260,30,person,26,1,17954,22,22,2089,80,2200,58,111,person
49261,31,person,27,1,17954,22,17,2067,57,2178,40,111,person
49262,34,car,30,0,17954,18,403,2063,450,2100,47,37,car
49263,35,car,31,0,17954,25,450,2060,520,2105,70,45,car
49264,36,car,32,0,17954,16,515,2061,558,2104,43,43,car
49265,37,car,33,1,17954,15,618,2062,669,2102,51,40,car
49266,38,car,34,1,17954,27,676,2057,748,2106,72,49,car
49267,39,car,35,1,17954,23,738,2054,813,2107,75,53,car
49268,40,person,36,0,17954,21,1111,2029,1136,2099,25,70,person
49269,41,traffic light,37,0,17954,21,1148,1941,1191,2107,43,166,traffic light
49270,44,person,40,1,17954,15,1424,2039,1449,2074,25,35,person
49271,47,person,43,1,17954,15,1459,2035,1484,2109,25,74,person
49272,48,person,44,1,17954,18,1473,2034,1494,2117,21,83,person
49273,49,person,45,1,17954,21,1490,2040,1513,2134,23,94,person
49274,50,person,46,0,17954,22,1506,2043,1538,2139,32,96,person
49275,52,person,48,1,17954,16,1573,2034,1601,2084,28,50,person
49276,59,traffic light,55,0,17954,32,587,1936,773,2054,186,118,traffic light
49277,0,car,1,0,17955,31,553,1011,1089,1280,536,269,car
49278,4,car,5,1,17955,18,305,1002,550,1132,245,130,car
49279,5,car,6,1,17955,23,474,945,897,1174,423,229,car
49280,7,car,8,0,17955,21,977,996,1174,1096,197,100,car
49281,11,car,12,1,17955,20,1208,981,1333,1062,125,81,car
49282,31,person,31,1,17955,18,393,962,425,1043,32,81,person
49283,1,person,1,0,17956,17,469,513,716,1236,247,723,person
49284,19,traffic light,19,1,17956,58,0,3,643,641,643,638,traffic light
49285,21,dog,21,0,17956,60,794,1019,1131,1221,337,202,dog
49286,14,person,14,1,17957,22,500,673,651,911,151,238,person
49287,15,person,15,0,17957,40,505,766,652,1094,147,328,person
49288,16,person,16,1,17957,28,105,690,235,1082,130,392,person
49289,18,person,18,0,17957,27,159,693,401,1131,242,438,person
49290,25,person,25,1,17957,35,1135,672,1218,1006,83,334,person
49291,9,car,9,1,17958,23,1010,741,1154,844,144,103,car
49292,10,car,10,1,17958,27,1124,771,1330,929,206,158,car
49293,11,car,11,1,17958,25,1822,890,2199,1319,377,429,car
49294,26,car,26,0,17958,15,293,792,616,1121,323,329,car
49295,32,car,31,1,17958,24,460,773,656,974,196,201,car
49296,33,car,32,1,17958,21,540,761,706,918,166,157,car
49297,34,car,33,1,17958,17,592,743,727,880,135,137,car
49298,36,car,35,0,17958,17,693,736,790,814,97,78,car
49299,22,car,23,1,17960,16,882,1192,1056,1341,174,149,car
49300,1,person,2,0,17961,18,1434,732,1481,870,47,138,person
49301,2,person,3,0,17961,22,939,717,998,869,59,152,person
49302,18,person,19,0,17961,32,894,712,937,843,43,131,person
49303,19,person,20,0,17961,22,1007,716,1034,813,27,97,person
49304,20,person,21,0,17961,44,1126,756,1183,854,57,98,person
49305,24,person,25,0,17961,23,1393,735,1414,816,21,81,person
49306,25,person,26,0,17961,25,1364,733,1394,817,30,84,person
49307,23,car,23,1,17962,19,1371,830,1465,905,94,75,car
49308,24,car,24,0,17962,16,1484,830,1541,906,57,76,car
49309,25,person,25,0,17962,29,1453,801,1501,916,48,115,person
49310,33,bench,33,0,17962,25,1273,894,1381,970,108,76,bench
49311,34,person,34,0,17962,33,1158,855,1246,961,88,106,person
49312,35,bench,35,1,17962,15,1193,914,1254,963,61,49,bench
49313,36,bench,36,1,17962,23,1082,885,1140,951,58,66,bench
49314,37,person,37,0,17962,28,1054,856,1115,949,61,93,person
49315,38,bench,38,0,17962,21,918,881,988,936,70,55,bench
49316,39,person,39,0,17962,29,667,814,724,938,57,124,person
49317,40,person,40,0,17962,23,62,821,90,923,28,102,person
49318,43,traffic light,43,0,17962,39,1006,615,1236,881,230,266,traffic light
49319,46,person,46,0,17962,21,289,846,325,905,36,59,person
49320,47,person,47,0,17962,24,320,847,341,907,21,60,person
49321,48,bicycle,48,0,17962,29,489,854,531,915,42,61,bicycle
49322,49,person,49,0,17962,24,488,824,529,894,41,70,person
49323,52,bench,52,1,17962,25,1923,928,2047,1048,124,120,bench
49324,1,car,2,0,17963,27,1377,851,2067,1353,690,502,car
49325,2,car,3,0,17963,31,4,881,570,1277,566,396,car
49326,28,person,24,0,17963,18,188,811,217,883,29,72,person
49327,10,person,11,0,17964,16,899,1006,912,1055,13,49,person
49328,11,person,12,0,17964,16,927,1002,943,1053,16,51,person
49329,12,person,13,1,17964,26,1171,992,1200,1086,29,94,person
49330,13,motorbike,14,0,17964,30,1194,1033,1246,1105,52,72,motorcycle
49331,20,person,21,0,17964,15,385,1004,395,1045,10,41,person
49332,21,person,22,0,17964,16,401,1003,417,1051,16,48,person
49333,27,motorbike,28,0,17964,21,237,1024,286,1093,49,69,motorcycle
49334,28,motorbike,29,0,17964,15,288,1024,311,1072,23,48,motorcycle
49335,29,motorbike,30,1,17964,28,155,1034,217,1142,62,108,motorcycle
49336,30,person,31,0,17964,36,93,985,150,1146,57,161,person
49337,4,person,5,0,17965,25,497,800,550,1021,53,221,person
49338,22,person,22,0,17965,62,1765,806,1879,1033,114,227,person
49339,31,window,31,0,17965,18,38,646,624,932,586,286,window
49340,35,flowerpot,35,0,17965,21,401,950,507,1011,106,61,potted plant
49341,43,traffic light,43,0,17965,34,14,2,192,1051,178,1049,traffic light
49342,15,motorbike,11,1,17966,24,2,1112,217,1436,215,324,motorcycle
49343,16,motorbike,12,1,17966,66,122,972,489,1256,367,284,motorcycle
49344,17,motorbike,13,1,17966,26,7,972,197,1137,190,165,motorcycle
49345,19,motorbikes,15,0,17966,109,436,917,1034,1224,598,307,motorcycle
49346,29,person,25,1,17966,33,1153,925,1181,1124,28,199,person
49347,30,person,26,0,17966,37,1161,899,1213,1134,52,235,person
49348,32,person,28,0,17966,48,1071,890,1151,1134,80,244,person
49349,33,person,29,0,17966,61,1014,922,1082,1125,68,203,person
49350,34,person,30,1,17966,26,1060,884,1100,942,40,58,person
49351,35,person,31,0,17966,32,1276,900,1310,977,34,77,person
49352,36,car,32,1,17966,34,1006,881,1103,941,97,60,car
49353,44,car,40,1,17966,20,83,894,222,975,139,81,car
49354,0,car,1,0,17968,35,1018,950,1486,1109,468,159,car
49355,10,person,11,0,17968,22,675,920,775,1158,100,238,person
49356,0,car,1,0,17969,21,6,815,1096,1205,1090,390,car
49357,4,umbrella,5,0,17970,18,750,747,1329,1298,579,551,umbrella
49358,5,person,6,0,17970,28,1319,970,1428,1294,109,324,person
49359,8,table,9,1,17970,15,841,1158,998,1321,157,163,dining table
49360,9,chair,10,0,17970,17,787,1173,950,1373,163,200,chair
49361,14,person,14,0,17970,23,1713,938,1757,1051,44,113,person
49362,15,person,15,0,17970,23,1892,927,1931,1071,39,144,person
49363,16,person,16,0,17970,25,1972,928,2019,1077,47,149,person
49364,18,person,17,1,17970,23,1276,938,1356,1035,80,97,person
49365,19,person,18,1,17970,32,1518,952,1592,1324,74,372,person
49366,20,person,19,1,17970,23,1511,947,1553,1045,42,98,person
49367,21,person,20,0,17970,51,1519,953,1713,1464,194,511,person
49368,22,person,21,0,17970,34,1823,944,1900,1136,77,192,person
49369,23,person,22,1,17970,19,1654,934,1686,1044,32,110,person
49370,24,person,23,0,17970,44,570,961,670,1219,100,258,person
49371,25,person,24,0,17970,38,666,941,752,1216,86,275,person
49372,27,person,26,1,17970,26,877,955,943,1153,66,198,person
49373,28,person,27,1,17970,26,936,952,1009,1146,73,194,person
49374,29,person,28,1,17970,26,1099,940,1159,1099,60,159,person
49375,44,person,42,1,17970,26,1161,971,1231,1065,70,94,person
49376,45,person,43,1,17970,34,1217,946,1274,1089,57,143,person
49377,55,chair,53,0,17970,48,681,1153,795,1354,114,201,chair
49378,83,person,81,1,17970,29,1438,954,1483,1053,45,99,person
49379,84,person,82,1,17970,32,1378,938,1438,1027,60,89,person
49380,85,person,83,0,17970,32,1770,949,1797,1013,27,64,person
49381,86,person,84,0,17970,26,1804,935,1833,1025,29,90,person
49382,11,car,11,0,17971,23,416,1186,859,1350,443,164,car
49383,30,person,29,0,17971,16,541,1008,562,1073,21,65,person
49384,32,person,31,0,17971,38,66,1167,140,1376,74,209,person
49385,33,person,32,0,17971,36,150,1178,217,1375,67,197,person
49386,34,person,33,0,17971,20,433,1005,455,1075,22,70,person
49387,35,person,34,0,17971,18,259,989,281,1053,22,64,person
49388,36,person,35,0,17971,38,266,1153,345,1388,79,235,person
49389,37,person,36,0,17971,26,142,1112,163,1195,21,83,person
49390,40,person,39,0,17971,26,424,1165,462,1263,38,98,person
49391,46,traffic light,45,0,17971,38,1734,891,1808,1192,74,301,traffic light
49392,47,person,46,0,17971,20,227,1103,250,1186,23,83,person
49393,48,person,47,0,17971,19,264,1100,292,1190,28,90,person
49394,49,person,48,1,17971,21,224,1235,264,1386,40,151,person
49395,51,person,50,0,17971,15,284,1068,316,1149,32,81,person
49396,54,person,53,0,17971,20,563,1074,597,1152,34,78,person
49397,55,person,54,0,17971,18,592,1015,618,1082,26,67,person
49398,56,person,55,0,17971,16,597,1079,626,1149,29,70,person
49399,58,person,57,0,17971,17,403,1020,424,1076,21,56,person
49400,59,person,58,1,17971,15,362,1161,398,1248,36,87,person
49401,60,person,59,1,17971,23,334,1229,380,1384,46,155,person
49402,61,person,60,1,17971,19,334,1169,394,1285,60,116,person
49403,62,person,61,1,17971,29,23,1178,84,1395,61,217,person
49404,64,person,63,0,17971,19,272,963,301,1032,29,69,person
49405,87,traffic light,86,0,17971,23,1761,783,2044,936,283,153,traffic light
49406,174,door,173,0,17971,15,550,1193,658,1328,108,135,door
49407,0,car,1,0,17972,15,804,1026,1227,1185,423,159,car
49408,21,traffic light,20,0,17972,56,1748,32,2199,1199,451,1167,traffic light
49409,4,car,4,0,17973,23,418,1019,1095,1228,677,209,car
49410,5,car,5,0,17973,26,1388,997,2055,1217,667,220,car
49411,6,parking meter,6,0,17973,35,301,1017,349,1181,48,164,parking meter
49412,49,parking meter,46,0,17973,17,1900,973,1929,1060,29,87,parking meter
49413,70,person,67,1,17973,25,882,981,963,1074,81,93,person
49414,71,person,68,1,17973,31,964,960,1074,1100,110,140,person
49415,72,person,69,1,17973,24,948,968,998,1091,50,123,person
49416,0,car,1,0,17976,25,20,276,165,351,145,75,car
49417,1,person,2,0,17976,18,266,251,308,367,42,116,person
49418,0,car,1,0,17977,28,1222,749,1972,1106,750,357,car
49419,1,car,2,0,17977,22,171,800,599,987,428,187,car
49420,6,person,7,0,17977,31,1046,773,1142,951,96,178,person
49421,16,motorbike,15,1,17977,22,1843,867,1958,953,115,86,motorcycle
49422,17,motorbike,16,0,17977,57,648,786,839,940,191,154,motorcycle
49423,30,door,29,0,17977,17,1467,822,1641,1052,174,230,door
49424,2,person,3,0,17978,22,2128,1092,2154,1156,26,64,person
49425,4,car,5,0,17978,43,1597,1093,1923,1254,326,161,car
49426,5,person,6,0,17978,21,1911,1103,1945,1198,34,95,person
49427,15,person,16,0,17978,27,750,1097,786,1215,36,118,person
49428,16,person,17,0,17978,23,794,1104,827,1212,33,108,person
49429,17,person,18,1,17978,19,929,1104,988,1176,59,72,person
49430,18,person,19,1,17978,19,661,1108,701,1167,40,59,person
49431,19,person,20,0,17978,36,620,1077,684,1277,64,200,person
49432,20,person,21,1,17978,27,528,1073,589,1273,61,200,person
49433,21,person,22,0,17978,29,474,1103,515,1200,41,97,person
49434,22,person,23,0,17978,40,380,1080,446,1291,66,211,person
49435,23,person,24,0,17978,24,326,1102,356,1207,30,105,person
49436,25,person,26,0,17978,23,244,1129,288,1204,44,75,person
49437,26,person,27,1,17978,17,235,1129,265,1202,30,73,person
49438,11,window,9,0,17979,15,923,568,1113,978,190,410,window
49439,18,umbrella,13,0,17979,16,688,845,769,881,81,36,umbrella
49440,20,flowerpot,15,0,17979,18,418,941,514,1017,96,76,potted plant
49441,21,flowerpot,16,0,17979,15,591,953,678,1022,87,69,potted plant
49442,22,flowerpot,17,0,17979,18,866,943,970,1030,104,87,potted plant
49443,23,flowerpot,18,0,17979,18,1055,946,1163,1033,108,87,potted plant
49444,24,flowerpot,19,0,17979,18,1281,944,1398,1041,117,97,potted plant
49445,25,flowerpot,20,0,17979,15,278,948,353,1012,75,64,potted plant
49446,28,car,23,1,17979,38,1,880,212,976,211,96,car
49447,29,umbrella,24,0,17979,23,165,842,310,904,145,62,umbrella
49448,34,person,29,0,17979,44,1767,853,1861,1021,94,168,person
49449,35,person,30,1,17979,32,1797,833,1880,1012,83,179,person
49450,36,person,31,0,17979,53,2081,841,2176,1014,95,173,person
49451,0,car,1,0,17981,27,53,1078,536,1453,483,375,car
49452,15,car,9,1,17982,26,815,742,911,809,96,67,car
49453,16,car,10,0,17982,25,746,760,842,813,96,53,car
49454,17,car,11,0,17982,35,337,732,547,840,210,108,car
49455,24,car,18,0,17982,20,1659,789,1745,829,86,40,car
49456,27,car,21,0,17982,33,1546,781,1665,854,119,73,car
49457,45,car,39,1,17982,15,603,750,659,782,56,32,car
49458,46,car,40,1,17982,17,539,735,604,784,65,49,car
49459,47,car,41,1,17982,18,299,727,389,769,90,42,car
49460,49,car,43,0,17982,18,184,725,269,767,85,42,car
49461,51,car,45,1,17982,16,75,727,155,757,80,30,car
49462,52,car,46,1,17982,16,1,691,78,788,77,97,car
49463,60,car,54,0,17982,22,1041,738,1200,882,159,144,car
49464,23,bench,23,0,17983,16,313,964,375,1007,62,43,bench
49465,16,car,17,1,17984,17,150,368,213,402,63,34,car
49466,17,car,18,0,17984,24,191,365,284,403,93,38,car
49467,0,person,1,0,17985,30,1732,493,1987,1328,255,835,person
49468,1,person,2,0,17985,31,1364,431,1681,1312,317,881,person
49469,3,person,4,0,17985,36,290,701,391,934,101,233,person
49470,4,person,5,0,17985,50,785,642,976,1125,191,483,person
49471,5,car,6,1,17985,39,524,690,1328,1049,804,359,car
49472,7,car,8,1,17985,33,1306,768,2096,1075,790,307,car
49473,0,fire hydrant,1,0,17987,38,1761,985,1821,1107,60,122,fire hydrant
49474,8,car,9,0,17987,46,39,807,600,1064,561,257,car
49475,9,truck,10,1,17987,30,565,680,1055,993,490,313,truck
49476,10,car,11,0,17987,51,664,778,1159,1078,495,300,car
49477,11,car,12,1,17987,16,1142,815,1218,941,76,126,car
49478,12,car,13,1,17987,16,1508,836,1603,912,95,76,car
49479,13,truck,14,0,17987,27,1580,668,1827,970,247,302,truck
49480,23,person,24,0,17987,23,2006,819,2042,935,36,116,person
49481,24,person,25,0,17987,20,2072,827,2110,929,38,102,person
49482,25,person,26,0,17987,29,1936,817,1996,985,60,168,person
49483,26,person,27,0,17987,29,1853,819,1938,1019,85,200,person
49484,27,person,28,0,17987,16,1301,822,1330,902,29,80,person
49485,82,door,83,0,17987,15,1053,799,1127,985,74,186,door
49486,0,bus,1,0,17988,24,856,733,1765,1206,909,473,bus
49487,5,person,6,1,17988,16,1371,764,1427,848,56,84,person
49488,13,car,14,1,17988,15,1963,1026,2046,1074,83,48,car
49489,26,motorbike,27,0,17988,15,820,1011,854,1059,34,48,motorcycle
49490,0,person,1,0,17989,24,161,543,344,1112,183,569,person
49491,1,person,2,0,17989,29,1127,602,1332,1232,205,630,person
49492,7,person,8,0,17989,53,1515,604,1700,1124,185,520,person
49493,27,person,28,1,17989,75,1048,562,1200,1137,152,575,person
49494,28,person,29,0,17989,81,2036,622,2183,1058,147,436,person
49495,30,person,31,0,17989,47,1922,626,2034,929,112,303,person
49496,31,person,32,1,17989,35,1848,615,1931,908,83,293,person
49497,38,person,39,1,17989,59,2,588,124,1277,122,689,person
49498,39,person,40,0,17989,60,1661,624,1769,961,108,337,person
49499,0,car,1,0,17990,38,756,934,1850,1369,1094,435,car
49500,2,car,3,0,17990,16,5,858,833,1258,828,400,car
49501,0,person,1,1,17991,34,648,771,1082,1526,434,755,person
49502,1,traffic light,2,0,17991,17,417,373,533,600,116,227,traffic light
49503,10,car,11,1,17991,26,1588,885,2039,1064,451,179,car
49504,11,car,12,1,17991,22,1174,880,1638,1097,464,217,car
49505,13,motorbike,14,1,17991,42,1029,880,1244,1226,215,346,motorcycle
49506,14,motorbike,15,0,17991,40,1600,950,1879,1241,279,291,motorcycle
49507,19,traffic light,20,0,17991,21,416,369,533,1296,117,927,traffic light
49508,1,person,2,0,17992,16,581,394,702,728,121,334,person
49509,45,traffic light,39,0,17992,15,796,312,826,476,30,164,traffic light
49510,48,truck,42,1,17992,19,693,378,749,422,56,44,truck
49511,49,person,43,1,17992,32,831,402,862,468,31,66,person
49512,50,bicycle,44,0,17992,23,836,432,857,476,21,44,bicycle
49513,51,person,45,1,17992,22,1027,396,1075,484,48,88,person
49514,53,traffic light,47,0,17992,22,1532,296,1561,452,29,156,traffic light
49515,18,car,15,0,17993,15,3,982,79,1152,76,170,car
49516,0,car,1,0,17994,47,63,938,1352,1488,1289,550,car
49517,1,car,2,0,17994,27,1260,838,1758,1298,498,460,car
49518,2,car,3,1,17994,18,1805,869,2048,1247,243,378,car
49519,3,car,4,1,17994,15,616,813,1018,946,402,133,car
49520,5,car,6,1,17994,20,4,849,412,1126,408,277,car
49521,8,parking meter,9,0,17995,15,698,873,749,1219,51,346,parking meter
49522,10,parking meter,11,0,17995,17,1837,946,1879,1223,42,277,parking meter
49523,11,person,12,1,17995,31,1815,901,1920,1170,105,269,person
49524,28,car,29,1,17995,19,2042,1073,2200,1279,158,206,car
49525,0,car,1,0,17997,37,320,974,996,1238,676,264,car
49526,38,door,38,0,17997,15,477,993,651,1193,174,200,door
49527,1,car,2,1,17998,18,1611,1016,2198,1398,587,382,car
49528,6,car,7,1,17998,17,1305,1034,1437,1200,132,166,car
49529,0,car,1,0,17999,21,1182,636,1962,1203,780,567,car
49530,1,car,2,0,17999,17,904,699,1262,886,358,187,car
49531,5,car,6,1,17999,15,7,683,275,1040,268,357,car
49532,6,car,7,1,17999,19,45,653,416,989,371,336,car
49533,7,car,8,1,17999,17,1995,674,2200,1202,205,528,car
49534,21,truck,22,1,17999,16,746,547,1143,714,397,167,truck
49535,30,car,31,1,17999,17,558,665,731,833,173,168,car
49536,31,car,32,1,17999,15,0,712,118,1075,118,363,car
49537,3,person,3,0,18000,38,310,0,686,1194,376,1194,person
49538,37,car,29,1,18001,20,522,923,663,974,141,51,car
49539,38,car,30,1,18001,36,658,910,837,976,179,66,car
49540,39,person,31,0,18001,33,714,916,767,1018,53,102,person
49541,41,car,33,1,18001,34,1116,926,1292,1005,176,79,car
49542,48,person,40,0,18001,22,376,912,405,992,29,80,person
49543,56,person,48,0,18001,32,1075,915,1125,1004,50,89,person
49544,29,person,29,0,18002,17,547,1118,593,1246,46,128,person
49545,32,person,31,1,18002,19,519,1127,558,1236,39,109,person
49546,6,person,7,0,18003,26,1449,928,1473,1007,24,79,person
49547,11,car,12,1,18003,15,1193,969,1293,1103,100,134,car
49548,12,car,13,1,18003,17,1100,969,1264,1134,164,165,car
49549,13,car,14,0,18003,32,855,981,1205,1218,350,237,car
49550,34,fire hydrant,35,0,18003,26,624,999,657,1065,33,66,fire hydrant
49551,6,fire hydrant,4,0,18004,20,716,318,751,391,35,73,fire hydrant
49552,15,car,13,0,18004,17,6,279,58,321,52,42,car
49553,30,car,27,0,18004,31,216,286,388,369,172,83,car
49554,2,car,2,0,18005,28,340,1083,1205,1458,865,375,car
49555,16,car,16,1,18005,17,684,971,750,1011,66,40,car
49556,18,car,18,1,18005,26,883,966,1011,1008,128,42,car
49557,21,bench,21,0,18005,22,1183,1019,1298,1056,115,37,bench
49558,0,car,1,0,18006,36,438,1155,807,1490,369,335,car
49559,1,person,2,0,18006,38,1027,1150,1170,1479,143,329,person
49560,3,traffic light,3,0,18006,40,795,1003,925,1218,130,215,traffic light
49561,7,person,7,1,18006,16,202,1142,280,1319,78,177,person
49562,9,car,9,1,18006,19,1116,1148,1333,1329,217,181,car
49563,10,car,10,1,18006,17,1303,1188,1491,1301,188,113,car
49564,11,car,11,1,18006,21,1461,1216,1692,1323,231,107,car
49565,38,person,34,0,18006,38,793,1174,821,1229,28,55,person
49566,41,person,37,1,18006,20,322,1143,351,1195,29,52,person
49567,42,car,38,1,18006,18,341,1164,366,1199,25,35,car
49568,43,person,39,1,18006,24,358,1161,378,1215,20,54,person
49569,45,car,41,1,18006,23,372,1163,402,1218,30,55,car
49570,46,car,42,1,18006,31,373,1157,454,1224,81,67,car
49571,47,car,43,1,18006,20,418,1156,503,1253,85,97,car
49572,48,person,44,0,18006,21,838,1178,852,1223,14,45,person
49573,49,person,45,0,18006,24,869,1173,885,1233,16,60,person
49574,1,car,2,0,18007,26,407,698,870,1005,463,307,car
49575,9,car,10,1,18007,23,319,634,530,808,211,174,car
49576,1,person,2,0,18008,15,2041,452,2138,761,97,309,person
49577,8,car,9,1,18008,15,5,491,286,726,281,235,car
49578,10,car,11,1,18008,15,1086,503,1447,901,361,398,car
49579,14,umbrella,15,1,18008,18,626,359,845,525,219,166,umbrella
49580,56,door,57,0,18008,15,1074,594,1268,966,194,372,door
49581,33,person,34,0,18009,36,697,1685,765,1863,68,178,person
49582,40,person,41,0,18009,28,656,1673,705,1868,49,195,person
49583,41,person,42,0,18009,29,581,1693,624,1863,43,170,person
49584,42,person,43,1,18009,19,381,1667,427,1894,46,227,person
49585,0,person,1,0,18010,40,394,603,590,1178,196,575,person
49586,33,traffic light,34,0,18010,25,1017,67,1203,1028,186,961,traffic light
49587,7,person,7,0,18011,57,1275,813,1576,1532,301,719,person
49588,10,person,10,0,18011,45,1021,868,1153,1189,132,321,person
49589,11,person,11,0,18011,72,775,811,1015,1533,240,722,person
49590,13,person,13,0,18011,50,410,853,629,1533,219,680,person
49591,21,umbrella,21,0,18011,28,1660,900,1695,1112,35,212,umbrella
49592,22,umbrella,22,0,18011,22,1658,691,1690,891,32,200,umbrella
49593,25,person,25,0,18011,59,1195,872,1352,1429,157,557,person
49594,54,person,54,1,18011,26,776,815,887,1061,111,246,person
49595,55,person,55,0,18011,25,1116,851,1186,1040,70,189,person
49596,56,person,56,1,18011,15,1080,849,1127,917,47,68,person
49597,57,person,57,1,18011,16,1194,854,1239,963,45,109,person
49598,59,person,59,0,18011,16,1013,840,1034,894,21,54,person
49599,60,person,60,0,18011,21,719,845,758,990,39,145,person
49600,0,car,1,0,18012,21,919,624,1142,727,223,103,car
49601,2,car,3,0,18012,25,12,656,615,870,603,214,car
49602,27,traffic light,28,0,18012,15,250,426,355,668,105,242,traffic light
49603,0,car,1,0,18013,17,641,1043,979,1214,338,171,car
49604,1,car,2,1,18013,20,370,1043,703,1214,333,171,car
49605,2,car,3,1,18013,21,1033,1048,1426,1236,393,188,car
49606,3,car,4,1,18013,18,1425,1060,1727,1248,302,188,car
49607,18,person,19,0,18013,25,3,1022,39,1125,36,103,person
49608,19,person,20,0,18013,29,67,1013,107,1132,40,119,person
49609,20,person,21,0,18013,27,104,1017,132,1131,28,114,person
49610,21,person,22,0,18013,21,215,1016,244,1136,29,120,person
49611,28,person,29,0,18013,32,299,993,340,1178,41,185,person
49612,29,person,30,1,18013,25,356,1011,411,1120,55,109,person
49613,30,traffic light,31,0,18013,19,320,836,363,1177,43,341,traffic light
49614,36,person,37,1,18013,17,1246,993,1291,1050,45,57,person
49615,37,person,38,1,18013,19,1312,1001,1355,1059,43,58,person
49616,40,person,41,1,18013,42,1356,1076,1431,1238,75,162,person
49617,47,window,48,0,18013,15,1755,973,1851,1065,96,92,window
49618,48,window,49,0,18013,18,1877,973,1974,1066,97,93,window
49619,0,car,1,0,18014,23,1104,938,2039,1274,935,336,car
49620,9,car,10,0,18014,17,828,925,1054,1056,226,131,car
49621,42,person,43,1,18014,17,1584,901,1604,944,20,43,person
49622,54,car,55,1,18014,15,1209,922,1283,986,74,64,car
49623,55,car,56,1,18014,22,1119,914,1239,1007,120,93,car
49624,56,car,57,1,18014,25,1008,919,1172,1028,164,109,car
49625,70,person,71,0,18014,15,1557,978,1600,1048,43,70,person
49626,74,person,75,1,18014,20,1704,908,1748,1001,44,93,person
49627,0,car,1,0,18016,22,585,816,1911,1445,1326,629,car
49628,2,car,3,0,18016,16,146,761,600,1109,454,348,car
49629,10,motorbikes,11,0,18016,22,563,822,756,903,193,81,motorcycle
49630,16,person,17,1,18016,20,1039,727,1163,849,124,122,person
49631,18,person,19,1,18016,16,1233,752,1316,841,83,89,person
49632,41,traffic light,42,0,18016,36,1844,168,2142,1288,298,1120,traffic light
49633,53,car,54,1,18016,19,1683,779,1746,833,63,54,car
49634,54,person,55,1,18016,17,1731,772,1771,851,40,79,person
49635,55,person,56,1,18016,20,1643,766,1693,837,50,71,person
49636,56,person,57,1,18016,16,1596,777,1653,831,57,54,person
49637,60,person,61,1,18016,18,1777,806,1826,880,49,74,person
49638,79,door,80,0,18016,17,169,777,256,1019,87,242,door
49639,81,window,82,0,18016,16,749,815,958,878,209,63,window
49640,88,door,89,0,18016,18,112,781,208,918,96,137,door
49641,13,person,13,0,18017,35,93,1033,255,1437,162,404,person
49642,30,car,30,0,18017,18,9,989,95,1320,86,331,car
49643,2,car,3,0,18018,18,346,764,1094,989,748,225,car
49644,9,person,10,0,18018,18,1348,651,1435,914,87,263,person
49645,11,car,12,1,18018,15,2,781,303,969,301,188,car
49646,16,person,17,1,18018,15,142,715,205,835,63,120,person
49647,1,car,2,0,18019,22,798,1047,1064,1187,266,140,car
49648,5,person,6,0,18019,63,1678,1021,1843,1359,165,338,person
49649,10,traffic light,9,0,18019,15,175,102,304,314,129,212,traffic light
49650,11,car,10,0,18019,20,1422,1073,2017,1302,595,229,car
49651,43,car,40,0,18019,23,1245,1035,1335,1091,90,56,car
49652,51,person,48,0,18019,68,1858,1041,1987,1348,129,307,person
49653,52,person,49,1,18019,20,1867,1026,1904,1100,37,74,person
49654,54,car,51,1,18019,25,1,1119,273,1478,272,359,car
49655,67,traffic light,64,0,18019,67,1216,631,1603,1423,387,792,traffic light
49656,68,car,65,0,18019,18,1409,1033,1477,1078,68,45,car
49657,69,car,66,1,18019,18,1311,1032,1372,1083,61,51,car
49658,70,car,67,1,18019,16,1355,1033,1403,1078,48,45,car
49659,0,car,1,0,18021,15,1662,604,2079,876,417,272,car
49660,1,person,2,0,18021,24,1405,616,1610,1133,205,517,person
49661,0,car,1,0,18022,30,1989,669,2180,794,191,125,car
49662,1,person,2,0,18022,40,300,628,407,917,107,289,person
49663,11,motorbike,12,0,18022,47,452,758,637,1021,185,263,motorcycle
49664,14,motorbike,15,0,18022,23,816,757,939,926,123,169,motorcycle
49665,41,car,42,0,18022,44,906,626,1540,1000,634,374,car
49666,63,window,63,0,18022,16,940,713,1142,794,202,81,window
49667,67,door,67,0,18022,22,1275,696,1455,906,180,210,door
49668,70,door,70,0,18022,18,1190,696,1355,915,165,219,door
49669,74,car,74,1,18022,40,1391,627,1804,898,413,271,car
49670,9,person,10,0,18023,24,1276,954,1343,1145,67,191,person
49671,14,car,15,0,18023,25,1225,972,1519,1120,294,148,car
49672,15,car,16,0,18023,23,1508,959,1712,1079,204,120,car
49673,16,car,17,1,18023,18,1706,955,1843,1062,137,107,car
49674,18,car,19,0,18023,24,1807,961,2028,1090,221,129,car
49675,23,person,24,0,18023,25,167,918,213,1039,46,121,person
49676,1,person,2,0,18024,16,851,763,959,1176,108,413,person
49677,2,bicycle,3,0,18024,21,180,994,618,1530,438,536,bicycle
49678,12,bicycle,13,0,18024,49,935,904,1172,1201,237,297,bicycle
49679,16,person,17,0,18024,16,743,793,767,870,24,77,person
49680,17,person,18,0,18024,17,986,798,1011,870,25,72,person
49681,18,person,19,0,18024,32,1106,786,1155,924,49,138,person
49682,19,bicycle,20,0,18024,121,1430,868,1573,1018,143,150,bicycle
49683,20,bicycle,21,0,18024,44,1210,841,1279,943,69,102,bicycle
49684,21,bicycle,22,1,18024,33,1270,852,1320,954,50,102,bicycle
49685,45,person,41,1,18025,26,1493,1012,1579,1124,86,112,person
49686,46,person,42,1,18025,34,1547,1096,1636,1293,89,197,person
49687,48,person,44,0,18025,47,1776,1274,1989,1512,213,238,person
49688,49,person,45,0,18025,69,1614,1188,1794,1481,180,293,person
49689,50,person,46,1,18025,32,1341,864,1427,1030,86,166,person
49690,0,bus,1,0,18026,15,1138,1036,1789,1480,651,444,bus
49691,0,person,1,0,18027,18,135,358,177,508,42,150,person
49692,2,car,3,0,18027,33,498,388,707,548,209,160,car
49693,1,person,2,0,18028,25,1190,671,1512,1468,322,797,person
49694,2,person,3,0,18028,21,720,747,796,962,76,215,person
49695,3,person,4,0,18028,15,811,776,874,955,63,179,person
49696,4,person,5,0,18028,15,895,769,985,956,90,187,person
49697,23,umbrella,24,0,18028,26,143,657,582,904,439,247,umbrella
49698,42,person,42,0,18028,29,864,754,929,951,65,197,person
49699,44,person,44,0,18028,41,0,777,205,1424,205,647,person
49700,45,person,45,1,18028,37,451,688,665,1254,214,566,person
49701,21,flowerpot,20,0,18029,16,106,1,172,54,66,53,potted plant
49702,0,car,1,0,18030,32,1539,810,1740,921,201,111,car
49703,1,car,2,0,18030,28,1714,834,1948,945,234,111,car
49704,3,car,4,0,18030,26,1095,796,1227,897,132,101,car
49705,4,person,5,0,18030,27,649,762,731,951,82,189,person
49706,5,person,6,0,18030,22,747,779,814,952,67,173,person
49707,22,car,16,1,18030,30,1298,803,1396,881,98,78,car
49708,23,car,17,1,18030,27,1369,806,1491,889,122,83,car
49709,24,car,18,1,18030,34,1458,822,1571,900,113,78,car
49710,25,car,19,1,18030,17,1939,856,2047,955,108,99,car
49711,45,car,39,1,18030,27,889,797,1021,944,132,147,car
49712,51,person,45,1,18030,16,407,798,466,837,59,39,person
49713,56,car,50,1,18030,15,864,818,908,862,44,44,car
49714,29,person,29,1,18031,16,636,688,660,715,24,27,person
49715,31,person,31,0,18031,17,779,677,790,712,11,35,person
49716,32,person,32,0,18031,23,576,682,600,758,24,76,person
49717,0,person,1,0,18032,68,1148,527,1257,808,109,281,person
49718,27,person,23,0,18032,21,1518,558,1542,610,24,52,person
49719,28,person,24,0,18032,20,1475,556,1494,599,19,43,person
49720,32,person,28,0,18032,23,1373,562,1391,630,18,68,person
49721,33,person,29,1,18032,21,1393,563,1412,628,19,65,person
49722,34,person,30,0,18032,25,1405,552,1436,633,31,81,person
49723,35,person,31,1,18032,17,1428,561,1440,625,12,64,person
49724,36,person,32,0,18032,30,1437,551,1475,654,38,103,person
49725,0,motorbike,1,0,18033,66,971,222,1970,1250,999,1028,motorcycle
49726,3,car,4,1,18033,39,4,70,1339,1086,1335,1016,car
49727,4,chair,5,1,18033,29,1682,434,1871,667,189,233,chair
49728,5,person,6,0,18033,44,1698,249,1880,545,182,296,person
49729,7,person,8,1,18033,19,1823,242,1919,418,96,176,person
49730,8,table,9,0,18033,24,1880,398,2133,698,253,300,dining table
49731,11,car,12,1,18033,16,1172,103,1627,244,455,141,car
49732,13,person,14,1,18033,36,2008,236,2197,560,189,324,person
49733,2,car,3,0,18034,24,49,855,300,981,251,126,car
49734,15,person,16,0,18035,20,474,1170,514,1280,40,110,person
49735,17,person,18,0,18035,19,843,1174,895,1309,52,135,person
49736,18,person,19,0,18035,24,787,1230,841,1313,54,83,person
49737,0,car,1,0,18036,34,432,1523,1121,1799,689,276,car
49738,57,person,54,1,18036,25,404,1562,509,1677,105,115,person
49739,59,person,56,0,18036,31,1215,1576,1277,1683,62,107,person
49740,68,door,65,0,18036,17,717,1585,864,1747,147,162,door
49741,6,motorbike,7,0,18037,35,1378,865,1521,980,143,115,motorcycle
49742,7,motorbike,8,1,18037,27,1717,975,1927,1329,210,354,motorcycle
49743,39,chair,40,1,18037,21,3,1173,153,1530,150,357,chair
49744,8,person,9,0,18038,45,1534,882,1832,1363,298,481,person
49745,9,bicycle,10,0,18038,64,1481,1090,1887,1469,406,379,bicycle
49746,10,person,11,1,18038,29,1873,826,2049,1148,176,322,person
49747,11,bicycle,12,1,18038,29,1817,1114,1993,1503,176,389,bicycle
49748,19,person,20,1,18038,25,1851,843,1914,1070,63,227,person
49749,2,car,3,1,18039,18,3,906,353,1042,350,136,car
49750,15,truck,16,0,18039,21,761,837,914,974,153,137,truck
49751,13,car,14,1,18040,19,1243,547,1502,718,259,171,car
49752,14,person,15,0,18040,20,1134,529,1306,800,172,271,person
49753,16,person,17,0,18040,52,500,489,649,840,149,351,person
49754,55,traffic light,54,0,18040,23,583,161,666,790,83,629,traffic light
49755,49,bicycle,49,0,18042,50,225,1287,317,1400,92,113,bicycle
49756,50,bicycle,50,0,18042,55,66,1288,152,1412,86,124,bicycle
49757,51,person,51,0,18042,91,1208,1254,1350,1645,142,391,person
49758,52,person,52,0,18042,112,1023,1260,1153,1605,130,345,person
49759,0,car,1,0,18043,26,99,354,1479,881,1380,527,car
49760,51,bicycle,45,1,18043,22,0,466,103,646,103,180,bicycle
49761,5,car,6,0,18044,32,136,1068,666,1269,530,201,car
49762,7,car,8,0,18044,21,811,1066,1060,1187,249,121,car
49763,8,car,9,1,18044,20,1047,1068,1177,1163,130,95,car
49764,9,car,10,1,18044,18,1152,1047,1309,1146,157,99,car
49765,16,car,17,1,18044,15,1506,1083,1621,1290,115,207,car
49766,17,car,18,1,18044,15,1293,1116,1344,1280,51,164,car
49767,25,parking meter,26,0,18044,15,1339,1100,1389,1460,50,360,parking meter
49768,47,person,48,0,18044,16,1809,1000,1841,1069,32,69,person
49769,48,person,49,0,18044,26,1869,1021,1928,1142,59,121,person
49770,49,person,50,0,18044,21,1935,1025,1973,1150,38,125,person
49771,0,truck,1,0,18045,21,247,818,968,1310,721,492,truck
49772,1,car,2,0,18045,17,1263,843,2013,1202,750,359,car
49773,19,car,20,1,18045,17,1154,839,1480,1069,326,230,car
49774,52,car,43,0,18046,48,631,984,1114,1294,483,310,car
49775,53,car,44,1,18046,36,1006,983,1244,1170,238,187,car
49776,4,bus,5,0,18048,22,1627,1138,1979,1307,352,169,bus
49777,127,person,128,0,18048,25,472,1184,507,1282,35,98,person
49778,128,person,129,0,18048,24,551,1168,591,1279,40,111,person
49779,134,person,135,0,18048,23,377,1175,408,1271,31,96,person
49780,136,person,137,0,18048,21,148,1158,185,1250,37,92,person
49781,137,traffic light,138,0,18048,20,95,1012,157,1252,62,240,traffic light
49782,138,person,139,0,18048,29,255,1142,313,1303,58,161,person
49783,0,car,1,0,18049,18,707,560,1369,842,662,282,car
49784,3,car,4,0,18049,20,140,499,723,770,583,271,car
49785,17,door,18,0,18049,16,866,574,1081,758,215,184,door
49786,21,door,22,0,18049,20,1030,574,1227,770,197,196,door
49787,34,door,35,0,18049,18,323,512,444,712,121,200,door
49788,38,door,39,0,18049,18,212,510,337,699,125,189,door
49789,44,motorbike,45,0,18050,25,177,973,294,1081,117,108,motorcycle
49790,47,motorbike,48,0,18050,28,507,992,648,1091,141,99,motorcycle
49791,48,person,49,1,18050,17,562,940,600,1084,38,144,person
49792,49,traffic light,50,0,18050,23,578,813,630,1088,52,275,traffic light
49793,4,bicycle,5,0,18051,15,3,1163,154,1344,151,181,bicycle
49794,16,person,17,0,18051,36,923,1013,1024,1192,101,179,person
49795,17,person,18,0,18051,33,300,1020,404,1261,104,241,person
49796,18,person,19,0,18051,28,380,1020,481,1272,101,252,person
49797,38,person,39,0,18051,28,1561,1013,1605,1148,44,135,person
49798,39,person,40,0,18051,21,1735,1007,1767,1115,32,108,person
49799,40,person,41,0,18051,31,1415,1009,1462,1141,47,132,person
49800,41,person,42,0,18051,23,1247,1031,1318,1183,71,152,person
49801,7,bicycle,8,0,18052,45,333,1077,455,1211,122,134,bicycle
49802,8,car,9,0,18052,27,694,1024,1020,1188,326,164,car
49803,9,car,10,1,18052,20,923,992,1154,1126,231,134,car
49804,10,person,11,0,18052,36,1745,982,1824,1180,79,198,person
49805,30,car,31,1,18052,18,1205,1003,1317,1088,112,85,car
49806,31,car,32,1,18052,17,1124,1012,1235,1102,111,90,car
49807,33,traffic light,34,0,18053,19,7,3,809,797,802,794,traffic light
49808,44,window,45,0,18054,20,588,726,789,877,201,151,window
49809,2,person,3,0,18055,41,541,668,602,816,61,148,person
49810,3,person,4,0,18055,23,632,682,677,782,45,100,person
49811,8,person,6,0,18055,33,683,676,727,800,44,124,person
49812,45,bench,38,0,18055,18,774,732,833,781,59,49,bench
49813,47,car,40,1,18055,17,822,699,891,755,69,56,car
49814,64,bench,57,1,18055,20,1393,855,1598,1034,205,179,bench
49815,0,bus,1,0,18056,17,0,293,1283,1371,1283,1078,bus
49816,3,person,4,0,18056,23,1866,906,1992,1244,126,338,person
49817,4,bicycle,5,0,18056,71,288,1220,682,1645,394,425,bicycle
49818,5,person,6,0,18056,38,342,981,618,1462,276,481,person
49819,14,person,15,0,18056,17,2088,893,2157,1069,69,176,person
49820,17,person,18,1,18056,17,492,463,590,563,98,100,person
49821,32,mirror,33,0,18056,21,423,783,530,915,107,132,mirror
49822,35,person,36,0,18056,28,1805,929,1847,1077,42,148,person
49823,36,car,37,1,18056,20,1692,912,1800,1016,108,104,car
49824,37,car,38,1,18056,18,1591,918,1746,1069,155,151,car
49825,43,person,44,0,18056,16,2012,906,2036,991,24,85,person
49826,44,person,45,0,18056,23,2042,916,2068,996,26,80,person
49827,45,person,46,0,18056,22,1984,912,2019,1039,35,127,person
49828,49,traffic light,50,0,18056,17,2093,812,2175,907,82,95,traffic light
49829,6,person,7,0,18058,21,644,654,682,769,38,115,person
49830,7,person,8,0,18058,26,691,684,734,770,43,86,person
49831,8,person,9,0,18058,19,776,682,806,766,30,84,person
49832,9,person,10,0,18058,24,837,676,877,766,40,90,person
49833,11,person,12,1,18058,20,934,702,990,790,56,88,person
49834,12,person,13,0,18058,30,939,697,1038,824,99,127,person
49835,28,person,29,0,18058,27,2,684,32,835,30,151,person
49836,2,person,1,0,18059,22,1973,738,2038,951,65,213,person
49837,7,car,6,0,18059,45,56,774,919,1026,863,252,car
49838,15,car,14,1,18059,18,1601,792,1673,857,72,65,car
49839,16,car,15,1,18059,15,1655,794,1721,860,66,66,car
49840,17,bus,16,1,18059,23,1717,720,1932,871,215,151,bus
49841,18,car,17,1,18059,21,1803,768,1931,884,128,116,car
49842,19,person,18,0,18059,24,1911,749,1986,923,75,174,person
49843,20,car,19,1,18059,19,2025,765,2193,902,168,137,car
49844,22,car,21,0,18059,18,1366,792,1518,902,152,110,car
49845,24,window,23,0,18059,16,480,89,623,349,143,260,window
49846,25,window,24,0,18059,15,205,95,349,352,144,257,window
49847,26,window,25,0,18059,18,937,101,1034,354,97,253,window
49848,55,person,49,0,18059,57,1134,759,1210,985,76,226,person
49849,56,person,50,0,18059,48,1307,772,1368,944,61,172,person
49850,60,door,54,0,18059,21,272,803,457,988,185,185,door
49851,67,person,61,0,18059,34,2024,771,2094,932,70,161,person
49852,11,person,12,1,18060,39,1393,760,1822,1531,429,771,person
49853,12,person,13,0,18060,23,1969,860,2042,1192,73,332,person
49854,13,car,14,1,18060,15,1762,890,1959,985,197,95,car
49855,15,car,16,1,18060,18,1177,887,1376,992,199,105,car
49856,19,person,20,0,18060,30,957,860,1037,1087,80,227,person
49857,20,person,21,0,18060,21,912,970,955,1084,43,114,person
49858,21,person,22,0,18060,27,1037,945,1079,1087,42,142,person
49859,22,person,23,1,18060,27,708,843,783,1044,75,201,person
49860,24,person,25,1,18060,19,788,872,865,1052,77,180,person
49861,25,car,26,1,18060,16,1309,890,1548,992,239,102,car
49862,26,person,27,0,18060,23,1391,875,1468,1027,77,152,person
49863,27,motorbike,28,1,18060,20,2,945,80,1088,78,143,motorcycle
49864,28,motorbike,29,0,18060,41,120,887,288,1096,168,209,motorcycle
49865,29,car,30,1,18060,27,223,895,501,1013,278,118,car
49866,30,person,31,1,18060,18,308,843,371,973,63,130,person
49867,32,motorbike,33,0,18060,26,328,937,431,1091,103,154,motorcycle
49868,33,car,34,1,18060,17,499,925,712,1020,213,95,car
49869,34,motorbike,35,0,18060,22,466,940,557,1088,91,148,motorcycle
49870,37,traffic light,38,0,18060,28,1114,655,1226,1075,112,420,traffic light
49871,46,person,47,1,18060,18,130,853,181,971,51,118,person
49872,49,traffic light,50,0,18060,22,468,719,530,891,62,172,traffic light
49873,50,traffic light,51,0,18060,17,1299,721,1337,1030,38,309,traffic light
49874,51,motorbike,52,1,18060,16,1399,950,1450,1032,51,82,motorcycle
49875,0,car,1,0,18061,16,592,905,1031,1091,439,186,car
49876,4,car,5,0,18061,23,1841,841,2191,1054,350,213,car
49877,5,car,6,0,18061,25,207,920,667,1103,460,183,car
49878,6,car,7,1,18061,15,1163,903,1364,1014,201,111,car
49879,7,car,8,1,18061,18,895,897,1170,1046,275,149,car
49880,9,car,10,1,18061,15,1675,887,1860,1036,185,149,car
49881,10,car,11,1,18061,15,1602,888,1726,981,124,93,car
49882,19,traffic light,20,0,18061,40,131,168,660,1608,529,1440,traffic light
49883,65,car,66,0,18061,18,1314,908,1599,1110,285,202,car
49884,0,person,1,0,18062,35,1307,593,1434,1064,127,471,person
49885,1,person,2,0,18062,40,1460,583,1630,1124,170,541,person
49886,7,person,8,1,18062,41,436,619,583,1092,147,473,person
49887,8,person,9,0,18062,85,438,608,751,1284,313,676,person
49888,9,person,10,0,18062,64,703,532,934,1280,231,748,person
49889,10,person,11,0,18062,54,995,598,1183,1219,188,621,person
49890,14,person,15,0,18062,31,929,635,972,760,43,125,person
49891,26,car,27,1,18062,15,1610,648,1718,699,108,51,car
49892,2,car,3,0,18063,36,784,726,1289,919,505,193,car
49893,3,car,4,0,18063,42,245,726,639,861,394,135,car
49894,4,car,5,0,18063,34,63,718,305,825,242,107,car
49895,87,door,86,0,18063,17,403,730,494,833,91,103,door
49896,104,person,103,0,18063,63,1386,702,1486,943,100,241,person
49897,105,person,104,0,18063,44,678,666,740,816,62,150,person
49898,3,car,3,0,18065,61,691,473,1091,609,400,136,car
49899,12,person,11,0,18065,53,835,449,939,666,104,217,person
49900,13,person,12,0,18065,40,2055,487,2139,673,84,186,person
49901,14,person,13,0,18065,29,1673,469,1732,638,59,169,person
49902,15,person,14,0,18065,22,1622,481,1674,638,52,157,person
49903,16,person,15,0,18065,28,1760,483,1812,610,52,127,person
49904,17,person,16,0,18065,36,1812,485,1867,614,55,129,person
49905,18,person,17,0,18065,40,1187,457,1243,580,56,123,person
49906,19,person,18,0,18065,28,1147,444,1193,569,46,125,person
49907,20,person,19,0,18065,28,1082,448,1126,556,44,108,person
49908,41,car,37,0,18065,18,25,467,124,522,99,55,car
49909,72,traffic light,66,0,18065,44,1526,1,1650,636,124,635,traffic light
49910,75,car,69,1,18065,33,597,469,782,570,185,101,car
49911,77,umbrella,71,0,18065,15,1492,446,1574,485,82,39,umbrella
49912,78,person,72,0,18065,56,444,452,542,657,98,205,person
49913,81,traffic light,75,0,18065,23,253,361,281,525,28,164,traffic light
49914,82,person,76,0,18065,25,153,454,184,525,31,71,person
49915,83,person,77,0,18065,23,336,459,360,522,24,63,person
49916,84,person,78,0,18065,25,445,457,466,524,21,67,person
49917,85,person,79,0,18065,22,289,458,311,520,22,62,person
49918,86,person,80,1,18065,28,1225,461,1260,573,35,112,person
49919,10,car,11,0,18066,28,1757,830,1887,906,130,76,car
49920,14,person,14,0,18066,20,484,755,572,1004,88,249,person
49921,22,bicycle,22,0,18066,57,1286,998,1779,1377,493,379,bicycle
49922,23,person,23,0,18066,53,1354,790,1734,1398,380,608,person
49923,24,person,24,0,18066,15,1436,810,1484,986,48,176,person
49924,36,traffic light,36,0,18066,28,1694,546,1786,1005,92,459,traffic light
49925,38,car,38,1,18066,15,1577,787,1636,829,59,42,car
49926,41,car,41,1,18066,20,1845,806,1909,872,64,66,car
49927,17,truck,18,0,18067,15,5,570,200,848,195,278,truck
49928,0,car,1,0,18068,20,177,1121,1103,1418,926,297,car
49929,15,bench,16,0,18068,21,1786,1105,2099,1275,313,170,bench
49930,25,person,25,1,18068,19,2015,995,2083,1107,68,112,person
49931,26,person,26,1,18068,19,962,1041,1030,1185,68,144,person
49932,35,person,35,1,18068,17,373,1072,420,1218,47,146,person
49933,36,person,36,1,18068,17,285,1082,384,1238,99,156,person
49934,55,door,55,0,18068,16,616,1130,833,1354,217,224,door
49935,18,person,19,1,18069,26,1631,1100,1696,1253,65,153,person
49936,19,person,20,0,18069,40,1666,1100,1761,1365,95,265,person
49937,20,person,21,0,18069,31,1305,1083,1352,1214,47,131,person
49938,21,person,22,0,18069,31,1388,1085,1448,1262,60,177,person
49939,22,person,23,1,18069,32,1427,1062,1489,1253,62,191,person
49940,23,person,24,0,18069,48,1525,1078,1621,1357,96,279,person
49941,1,person,2,0,18070,27,936,849,1062,1227,126,378,person
49942,2,person,3,0,18070,31,837,849,951,1227,114,378,person
49943,4,person,5,0,18070,24,580,869,708,1133,128,264,person
49944,7,car,8,0,18070,23,1641,848,2048,1119,407,271,car
49945,8,car,9,1,18070,20,1,865,322,1024,321,159,car
49946,35,car,33,1,18070,17,1172,851,1244,922,72,71,car
49947,36,motorbike,34,1,18070,21,1119,870,1161,917,42,47,motorcycle
49948,37,car,35,1,18070,15,1622,857,1672,912,50,55,car
49949,44,backpack,42,0,18070,18,566,1007,612,1079,46,72,backpack
49950,45,person,43,0,18070,28,697,841,720,907,23,66,person
49951,46,person,44,1,18070,25,721,848,739,907,18,59,person
49952,47,person,45,1,18070,26,734,849,751,907,17,58,person
49953,48,person,46,1,18070,22,615,829,639,880,24,51,person
49954,49,person,47,1,18070,27,616,846,657,913,41,67,person
49955,51,person,49,1,18070,22,930,835,949,877,19,42,person
49956,54,door,52,0,18070,16,1929,861,2048,1070,119,209,door
49957,57,window,55,0,18070,19,1820,866,1931,944,111,78,window
49958,58,window,56,0,18070,19,1664,866,1807,939,143,73,window
49959,64,traffic light,62,0,18070,17,1239,684,1339,1077,100,393,traffic light
49960,2,car,3,0,18071,29,252,283,410,336,158,53,car
49961,3,car,4,0,18071,33,427,282,624,346,197,64,car
49962,4,car,5,0,18071,39,128,281,248,325,120,44,car
49963,50,window,51,0,18071,20,426,18,480,134,54,116,window
49964,107,door,106,0,18071,16,512,282,566,328,54,46,door
49965,34,person,27,0,18072,17,704,327,732,408,28,81,person
49966,44,bench,37,0,18072,17,40,377,84,414,44,37,bench
49967,48,parking meter,41,0,18072,18,1141,350,1167,491,26,141,parking meter
49968,52,car,45,0,18072,55,544,434,1293,1045,749,611,car
49969,56,person,49,0,18072,20,333,331,356,405,23,74,person
49970,57,person,50,0,18072,22,306,331,329,398,23,67,person
49971,0,fire hydrant,1,0,18073,32,1045,524,1107,652,62,128,fire hydrant
49972,16,person,17,0,18073,19,792,485,983,1018,191,533,person
49973,41,traffic light,42,0,18073,30,1126,3,1232,699,106,696,traffic light
49974,45,traffic light,46,0,18073,21,1237,193,1475,399,238,206,traffic light
49975,13,car,14,1,18074,35,836,1507,1533,2046,697,539,car
49976,20,car,21,1,18074,47,722,1504,1095,1873,373,369,car
49977,21,car,22,1,18074,25,608,1441,773,1618,165,177,car
49978,23,car,24,1,18074,20,561,1442,644,1552,83,110,car
49979,7,traffic light,8,0,18075,16,1195,584,1252,687,57,103,traffic light
49980,9,traffic light,10,0,18075,27,1150,3,1642,997,492,994,traffic light
49981,13,motorbike,13,0,18075,24,1261,855,1455,963,194,108,motorcycle
49982,29,person,29,0,18075,52,1494,881,1722,1525,228,644,person
49983,30,person,30,0,18075,53,1737,854,2001,1535,264,681,person
49984,31,person,31,0,18075,19,1378,779,1434,978,56,199,person
49985,32,person,32,0,18075,20,1688,795,1766,948,78,153,person
49986,33,person,33,1,18075,16,1530,813,1600,991,70,178,person
49987,36,person,36,0,18075,18,1233,782,1279,942,46,160,person
49988,37,person,37,0,18075,15,1183,802,1230,935,47,133,person
49989,38,person,38,1,18075,19,1430,787,1476,940,46,153,person
49990,2,person,3,0,18076,52,86,979,200,1289,114,310,person
49991,9,person,10,0,18076,35,603,963,676,1194,73,231,person
49992,10,bicycle,11,0,18076,46,733,1043,811,1155,78,112,bicycle
49993,13,person,14,0,18076,34,1149,976,1198,1144,49,168,person
49994,14,person,15,0,18076,35,879,988,941,1159,62,171,person
49995,21,person,22,0,18076,20,1452,987,1473,1059,21,72,person
49996,25,car,26,1,18076,17,1602,998,1725,1102,123,104,car
49997,26,car,27,0,18076,54,1337,1073,1767,1375,430,302,car
49998,36,bicycle,37,1,18076,36,1940,1143,2047,1425,107,282,bicycle
49999,0,traffic light,1,0,18077,24,767,4,995,1065,228,1061,traffic light
50000,3,person,4,0,18077,30,642,649,929,1146,287,497,person
50001,16,backpack,17,0,18077,16,713,725,860,875,147,150,backpack
50002,40,window,40,0,18077,17,529,720,720,776,191,56,window
50003,46,car,46,1,18077,18,769,668,868,762,99,94,car
50004,47,car,47,1,18077,19,773,682,863,801,90,119,car
50005,2,traffic light,3,0,18078,32,1736,554,1894,1265,158,711,traffic light
50006,8,motorbike,9,0,18078,21,453,978,492,1037,39,59,motorcycle
50007,9,motorbike,10,0,18078,22,518,971,562,1037,44,66,motorcycle
50008,10,motorbike,11,0,18078,30,571,983,634,1041,63,58,motorcycle
50009,11,motorbike,12,0,18078,44,583,991,718,1208,135,217,motorcycle
50010,12,motorbike,13,0,18078,85,854,974,1011,1259,157,285,motorcycle
50011,13,motorbike,14,0,18078,48,971,1019,1173,1278,202,259,motorcycle
50012,16,car,17,1,18078,93,688,954,1121,1170,433,216,car
50013,17,car,18,1,18078,22,689,972,812,1043,123,71,car
50014,19,car,20,1,18078,25,964,936,1194,1034,230,98,car
50015,20,bicycle,21,0,18078,55,1275,1003,1378,1133,103,130,bicycle
50016,21,bicycle,22,1,18078,32,1263,1030,1342,1131,79,101,bicycle
50017,22,traffic light,23,0,18078,58,763,714,989,969,226,255,traffic light
50018,27,car,28,0,18078,31,271,966,411,1041,140,75,car
50019,28,car,29,1,18078,28,155,964,303,1038,148,74,car
50020,29,car,30,1,18078,27,23,962,174,1038,151,76,car
50021,36,traffic light,37,0,18078,20,1149,734,1196,989,47,255,traffic light
50022,37,person,38,0,18078,30,1329,929,1365,1032,36,103,person
50023,38,person,39,0,18078,29,1391,937,1426,1038,35,101,person
50024,2,car,3,0,18079,38,258,312,1512,972,1254,660,car
50025,14,door,15,0,18079,16,896,354,1178,792,282,438,door
50026,22,door,23,0,18079,16,1135,354,1378,734,243,380,door
50027,0,person,1,0,18080,39,245,677,295,841,50,164,person
50028,1,car,2,0,18080,31,875,724,1026,833,151,109,car
50029,43,traffic light,44,0,18080,21,591,300,1109,828,518,528,traffic light
50030,11,car,12,0,18081,32,902,1133,1367,1286,465,153,car
50031,46,person,47,0,18081,24,39,1119,101,1247,62,128,person
50032,62,traffic light,63,0,18081,75,202,623,795,1256,593,633,traffic light
50033,63,traffic light,64,0,18081,17,1319,922,1384,1146,65,224,traffic light
50034,3,person,4,1,18082,26,35,831,97,1000,62,169,person
50035,4,person,5,1,18082,29,135,886,245,1128,110,242,person
50036,6,motorbike,7,0,18082,46,770,979,892,1265,122,286,motorcycle
50037,8,person,9,1,18082,21,1097,1094,1208,1293,111,199,person
50038,14,motorbike,15,0,18082,42,1831,1023,2023,1219,192,196,motorcycle
50039,17,motorbike,18,1,18082,27,2082,932,2201,1190,119,258,motorcycle
50040,18,person,19,1,18082,24,1882,861,1941,1038,59,177,person
50041,1,car,2,0,18083,20,167,979,602,1103,435,124,car
50042,5,car,6,0,18083,27,716,979,1090,1096,374,117,car
50043,7,car,8,0,18083,26,1144,974,1459,1083,315,109,car
50044,9,car,10,0,18083,26,1627,968,1855,1059,228,91,car
50045,10,car,11,0,18083,19,1864,968,2049,1048,185,80,car
50046,3,car,3,0,18084,18,671,624,1155,885,484,261,car
50047,8,truck,7,1,18084,23,1098,409,1361,768,263,359,truck
50048,14,traffic light,13,1,18084,28,807,64,1013,1199,206,1135,traffic light
50049,15,person,14,0,18084,56,79,629,317,1116,238,487,person
50050,16,person,15,1,18084,32,1382,600,1580,1154,198,554,person
50051,4,car,5,0,18085,18,975,620,1176,694,201,74,car
50052,13,car,14,0,18085,18,550,607,647,664,97,57,car
50053,1,motorbike,2,1,18087,34,1053,925,1139,1020,86,95,motorcycle
50054,2,bicycle,3,0,18087,24,1109,961,1175,1049,66,88,bicycle
50055,2,car,3,0,18088,16,101,320,156,365,55,45,car
50056,7,car,8,0,18088,20,376,313,425,351,49,38,car
50057,0,car,1,0,18089,30,357,1262,1144,1510,787,248,car
50058,8,car,9,1,18090,18,925,821,1176,1043,251,222,car
50059,9,car,10,1,18090,19,1340,804,1620,991,280,187,car
50060,10,car,11,1,18090,21,1532,797,1750,921,218,124,car
50061,11,car,12,1,18090,20,1883,787,2032,915,149,128,car
50062,28,door,29,0,18090,15,1496,812,1573,955,77,143,door
50063,4,parking meter,5,0,18091,15,1188,895,1205,1017,17,122,parking meter
50064,8,car,9,0,18091,26,633,883,1085,1032,452,149,car
50065,10,car,11,1,18091,15,1272,898,1580,1031,308,133,car
50066,12,fire hydrant,13,0,18091,25,148,928,192,1017,44,89,fire hydrant
50067,13,car,14,1,18091,19,15,905,150,989,135,84,car
50068,17,car,18,1,18091,20,223,901,327,967,104,66,car
50069,64,door,65,0,18091,18,866,889,967,1005,101,116,door
50070,77,door,78,0,18091,28,1930,803,2150,1099,220,296,door
50071,54,car,50,0,18092,45,100,924,957,1240,857,316,car
50072,55,door,51,0,18092,18,313,932,490,1177,177,245,door
50073,65,window,61,0,18092,16,505,947,908,1041,403,94,window
50074,0,person,1,0,18093,19,1085,848,1310,1471,225,623,person
50075,1,person,2,0,18093,19,878,801,1078,1493,200,692,person
50076,3,person,4,0,18093,21,27,775,144,1322,117,547,person
50077,4,person,5,0,18093,18,152,947,391,1291,239,344,person
50078,5,person,6,0,18093,15,1463,845,1574,1319,111,474,person
50079,33,person,30,0,18093,20,1990,843,2037,1107,47,264,person
50080,36,person,33,1,18093,23,1686,842,1771,1124,85,282,person
50081,37,person,34,1,18093,27,1294,839,1376,1023,82,184,person
50082,39,person,36,1,18093,15,874,812,956,954,82,142,person
50083,40,person,37,1,18093,15,1137,867,1174,939,37,72,person
50084,41,person,38,0,18093,18,1378,647,1406,743,28,96,person
50085,42,person,39,0,18093,15,1419,683,1447,784,28,101,person
50086,43,umbrella,40,0,18093,15,1183,753,1429,845,246,92,umbrella
50087,80,person,76,0,18093,37,2056,817,2164,1119,108,302,person
50088,81,person,77,0,18093,28,1577,819,1675,1189,98,370,person
50089,0,car,1,0,18094,20,914,640,1281,795,367,155,car
50090,2,person,3,0,18094,26,633,649,699,830,66,181,person
50091,5,bicycle,5,0,18094,29,788,690,916,788,128,98,bicycle
50092,12,person,10,1,18094,17,981,599,1022,696,41,97,person
50093,41,door,39,0,18094,17,1080,647,1174,759,94,112,door
50094,42,door,40,0,18094,17,1158,645,1234,749,76,104,door
50095,48,person,46,1,18094,25,788,619,828,707,40,88,person
50096,6,bicycle,6,0,18095,82,296,1072,433,1159,137,87,bicycle
50097,7,person,7,0,18095,27,645,1023,694,1144,49,121,person
50098,8,person,8,0,18095,22,894,1034,956,1147,62,113,person
50099,9,bicycle,9,0,18095,77,44,1064,149,1159,105,95,bicycle
50100,12,person,12,0,18095,22,548,1023,597,1152,49,129,person
50101,14,person,14,0,18095,22,1550,1026,1587,1129,37,103,person
50102,15,person,15,0,18095,23,1581,1023,1627,1130,46,107,person
50103,16,person,16,1,18095,15,1957,1028,1983,1113,26,85,person
50104,17,person,17,0,18095,22,1993,1009,2025,1118,32,109,person
50105,2,person,3,0,18096,30,690,1509,793,1845,103,336,person
50106,7,bicycle,8,0,18096,72,1234,1597,1337,1700,103,103,bicycle
50107,9,person,10,0,18096,27,1048,1552,1144,1791,96,239,person
50108,10,person,11,0,18096,29,1115,1527,1198,1812,83,285,person
50109,11,person,12,0,18096,27,936,1532,994,1738,58,206,person
50110,12,person,13,0,18096,30,1373,1516,1480,1829,107,313,person
50111,17,window,18,0,18096,23,806,945,947,1339,141,394,window
50112,5,car,6,0,18097,36,1420,649,1950,978,530,329,car
50113,6,car,7,1,18097,46,530,635,1427,1185,897,550,car
50114,7,motorbike,8,0,18097,59,161,810,726,1252,565,442,motorcycle
50115,8,car,9,0,18097,20,7,793,186,1410,179,617,car
50116,26,window,27,0,18097,15,1274,675,1349,778,75,103,window
50117,29,door,30,0,18097,15,1755,665,1861,878,106,213,door
50118,0,car,1,0,18098,44,214,1022,762,1334,548,312,car
50119,3,car,3,0,18098,21,106,975,306,1095,200,120,car
50120,17,traffic light,15,0,18098,34,1151,549,1401,668,250,119,traffic light
50121,25,person,23,0,18098,42,2036,965,2093,1072,57,107,person
50122,27,person,25,0,18098,37,2124,963,2163,1065,39,102,person
50123,28,person,26,0,18098,39,1983,967,2032,1074,49,107,person
50124,29,person,27,0,18098,40,1962,949,1998,1071,36,122,person
50125,30,person,28,1,18098,27,1949,960,1970,1069,21,109,person
50126,31,person,29,1,18098,17,417,976,442,1024,25,48,person
50127,32,person,30,1,18098,19,379,979,402,1027,23,48,person
50128,34,person,32,1,18098,15,260,939,277,972,17,33,person
50129,35,person,33,1,18098,18,354,984,376,1028,22,44,person
50130,42,car,40,1,18098,15,1620,997,1666,1032,46,35,car
50131,43,car,41,1,18098,19,1630,1005,1726,1040,96,35,car
50132,44,car,42,1,18098,16,1742,995,1789,1039,47,44,car
50133,45,car,43,1,18098,18,1800,1003,1847,1045,47,42,car
50134,46,car,44,1,18098,18,1846,995,1903,1042,57,47,car
50135,47,car,45,1,18098,21,1555,994,1617,1042,62,48,car
50136,51,car,49,1,18098,19,60,982,122,1061,62,79,car
50137,53,traffic light,51,0,18098,30,40,810,201,892,161,82,traffic light
50138,54,car,52,1,18098,21,2027,997,2062,1053,35,56,car
50139,58,person,56,1,18098,20,2175,964,2199,1066,24,102,person
50140,63,traffic light,61,0,18098,31,453,781,593,1041,140,260,traffic light
50141,2,person,3,0,18099,32,314,212,424,479,110,267,person
50142,24,person,24,0,18099,16,239,226,284,284,45,58,person
50143,25,person,25,0,18099,31,493,214,548,479,55,265,person
50144,26,person,26,0,18099,18,530,129,639,479,109,350,person
50145,27,person,27,0,18099,35,501,175,578,480,77,305,person
50146,28,person,28,0,18099,28,380,357,487,479,107,122,person
50147,30,person,30,0,18099,23,81,282,111,363,30,81,person
50148,34,person,34,0,18099,62,171,202,244,467,73,265,person
50149,35,person,35,0,18099,70,99,190,191,479,92,289,person
50150,36,person,36,1,18099,46,350,178,419,318,69,140,person
50151,37,person,37,1,18099,19,320,236,354,317,34,81,person
50152,42,person,42,1,18099,22,427,236,451,296,24,60,person
50153,43,person,43,1,18099,17,475,250,504,298,29,48,person
50154,4,car,5,0,18100,16,1332,738,1442,839,110,101,car
50155,8,car,9,1,18100,20,2,1049,264,1437,262,388,car
50156,9,car,10,1,18100,43,93,843,777,1235,684,392,car
50157,19,car,20,1,18100,33,672,773,1064,1008,392,235,car
50158,20,car,21,1,18100,18,1094,761,1222,876,128,115,car
50159,21,car,22,1,18100,20,1125,723,1280,843,155,120,car
50160,24,person,25,1,18100,23,1738,668,1820,802,82,134,person
50161,26,car,27,1,18100,29,1171,983,2049,1536,878,553,car
50162,27,car,28,1,18100,22,1468,798,2047,1029,579,231,car
50163,28,car,29,1,18100,15,1468,756,1764,917,296,161,car
50164,29,car,30,1,18100,17,1463,711,1676,866,213,155,car
50165,31,person,32,1,18100,20,202,752,311,897,109,145,person
50166,55,door,56,0,18100,15,478,857,634,1133,156,276,door
50167,3,bicycle,4,0,18101,130,62,1191,489,1494,427,303,bicycle
50168,11,person,12,0,18101,38,1074,1033,1158,1271,84,238,person
50169,12,person,13,0,18101,26,1158,1028,1219,1243,61,215,person
50170,13,person,14,0,18101,35,1298,1034,1378,1261,80,227,person
50171,16,person,17,0,18101,30,1447,1028,1504,1209,57,181,person
50172,17,person,18,0,18101,43,1492,1031,1570,1258,78,227,person
50173,18,person,19,0,18101,34,1572,1012,1663,1277,91,265,person
50174,28,person,29,0,18101,18,1872,1070,1901,1140,29,70,person
50175,29,person,30,0,18101,18,1893,1060,1925,1150,32,90,person
50176,30,person,31,0,18101,20,1922,1057,1945,1157,23,100,person
50177,2,car,3,0,18102,19,599,879,1541,1201,942,322,car
50178,3,parking meter,4,0,18102,23,357,870,428,1106,71,236,parking meter
50179,7,flowerpot,8,0,18103,27,1187,1319,1410,1416,223,97,potted plant
50180,8,flowerpot,9,0,18103,29,1424,1352,1725,1496,301,144,potted plant
50181,47,window,47,0,18103,15,1514,791,1630,965,116,174,window
50182,14,traffic light,14,0,18104,45,916,3,1842,1091,926,1088,traffic light
50183,17,person,17,0,18104,25,1251,882,1303,1063,52,181,person
50184,18,person,18,0,18104,36,846,874,912,1037,66,163,person
50185,19,person,19,0,18104,38,1999,862,2070,1034,71,172,person
50186,20,person,20,0,18104,33,1928,856,2012,1035,84,179,person
50187,21,backpack,21,0,18104,17,1923,885,1977,953,54,68,backpack
50188,22,person,22,0,18104,41,1816,883,1883,1046,67,163,person
50189,23,person,23,0,18104,38,2103,870,2186,1030,83,160,person
50190,24,backpack,24,0,18104,15,2095,890,2138,944,43,54,backpack
50191,28,person,28,0,18104,26,763,895,800,1030,37,135,person
50192,3,car,4,0,18105,15,1189,971,1531,1182,342,211,car
50193,4,car,5,1,18105,18,1496,1002,2116,1291,620,289,car
50194,6,person,7,0,18105,16,450,942,552,1280,102,338,person
50195,16,truck,17,0,18105,16,577,932,702,1029,125,97,truck
50196,26,truck,27,1,18105,15,1241,929,1396,986,155,57,truck
50197,28,car,29,1,18105,19,1462,969,1640,1058,178,89,car
50198,32,car,33,1,18105,17,2046,969,2198,1079,152,110,car
50199,0,car,1,0,18106,37,533,963,1055,1128,522,165,car
50200,1,car,2,0,18106,29,1152,960,1751,1140,599,180,car
50201,2,car,3,1,18106,23,1,880,542,1141,541,261,car
50202,90,door,91,0,18106,16,653,968,796,1099,143,131,door
50203,93,door,94,0,18106,18,772,966,889,1102,117,136,door
50204,103,door,104,0,18106,19,1470,965,1597,1100,127,135,door
50205,2,person,3,0,18107,41,85,969,254,1536,169,567,person
50206,3,backpack,4,0,18107,23,160,1039,295,1267,135,228,backpack
50207,4,person,5,1,18107,20,7,986,99,1535,92,549,person
50208,5,person,6,0,18107,40,316,963,368,1186,52,223,person
50209,6,person,7,0,18107,34,531,974,627,1168,96,194,person
50210,8,person,9,0,18107,36,674,971,722,1127,48,156,person
50211,9,person,10,0,18107,35,863,969,919,1140,56,171,person
50212,10,person,11,0,18107,43,1091,961,1170,1191,79,230,person
50213,11,person,12,0,18107,26,1049,966,1104,1148,55,182,person
50214,12,person,13,0,18107,35,1300,976,1362,1209,62,233,person
50215,14,person,15,0,18107,40,1380,966,1443,1207,63,241,person
50216,15,person,16,0,18107,39,1427,968,1507,1230,80,262,person
50217,17,person,18,0,18107,37,1491,979,1583,1308,92,329,person
50218,19,person,20,1,18107,45,1557,963,1688,1359,131,396,person
50219,21,person,22,1,18107,57,1658,948,1965,1535,307,587,person
50220,22,backpack,23,0,18107,22,1772,1093,2044,1447,272,354,backpack
50221,24,person,25,1,18107,20,1917,963,1994,1091,77,128,person
50222,25,person,26,1,18107,20,1945,948,2048,1422,103,474,person
50223,40,person,41,0,18107,60,945,950,1043,1249,98,299,person
50224,41,person,42,0,18107,25,844,969,872,1098,28,129,person
50225,42,person,43,0,18107,24,806,989,831,1098,25,109,person
50226,47,person,48,0,18107,32,417,969,489,1142,72,173,person
50227,48,bicycle,49,1,18107,21,409,1015,451,1131,42,116,bicycle
50228,50,bicycle,51,1,18107,22,492,1034,542,1147,50,113,bicycle
50229,51,person,52,1,18107,21,497,977,565,1109,68,132,person
50230,0,flowerpot,1,0,18109,17,271,1111,370,1204,99,93,potted plant
50231,2,car,3,0,18109,15,1943,954,2200,1116,257,162,car
50232,3,car,4,0,18109,21,688,949,1157,1323,469,374,car
50233,37,flowerpot,36,0,18109,21,167,1120,270,1211,103,91,potted plant
50234,38,flowerpot,37,0,18109,19,372,1095,463,1173,91,78,potted plant
50235,39,flowerpot,38,0,18109,21,58,1127,182,1237,124,110,potted plant
50236,5,person,6,0,18110,26,1121,811,1197,1035,76,224,person
50237,6,person,7,0,18110,31,1192,822,1265,1035,73,213,person
50238,7,person,8,0,18110,28,1270,811,1350,1014,80,203,person
50239,8,motorbike,9,0,18110,20,1390,851,1469,1000,79,149,motorcycle
50240,10,car,11,1,18110,16,1619,833,1835,1064,216,231,car
50241,11,car,12,1,18110,21,1740,878,2199,1209,459,331,car
50242,18,person,13,0,18111,18,2046,959,2092,1057,46,98,person
50243,20,car,15,0,18111,21,1640,962,1883,1082,243,120,car
50244,22,car,17,1,18111,20,1522,966,1661,1050,139,84,car
50245,23,car,18,1,18111,16,1249,966,1327,1027,78,61,car
50246,24,car,19,0,18111,24,1310,963,1464,1063,154,100,car
50247,25,car,20,0,18111,20,1108,966,1247,1052,139,86,car
50248,28,traffic light,23,0,18111,20,1238,760,1526,1007,288,247,traffic light
50249,29,traffic light,24,0,18111,20,1099,818,1321,968,222,150,traffic light
50250,34,traffic light,29,0,18111,23,727,731,1148,987,421,256,traffic light
50251,78,person,73,0,18111,58,658,957,741,1158,83,201,person
50252,79,person,74,0,18111,35,605,949,659,1090,54,141,person
50253,85,traffic light,80,0,18111,18,766,838,787,951,21,113,traffic light
50254,4,car,5,1,18112,26,70,894,565,1298,495,404,car
50255,9,car,10,1,18112,20,676,866,775,954,99,88,car
50256,11,car,12,1,18112,15,800,868,874,1012,74,144,car
50257,12,car,13,1,18112,18,845,860,1016,1012,171,152,car
50258,13,car,14,1,18112,23,878,882,1092,1109,214,227,car
50259,14,car,15,1,18112,30,971,890,1278,1220,307,330,car
50260,15,car,16,1,18112,34,1177,880,2049,1536,872,656,car
50261,38,door,39,0,18112,20,1243,904,1417,1343,174,439,door
50262,39,window,40,0,18112,15,1291,917,1396,1100,105,183,window
50263,28,car,16,1,18113,18,1397,688,1455,725,58,37,car
50264,29,car,17,1,18113,18,1269,685,1340,726,71,41,car
50265,30,car,18,0,18113,22,1456,650,1660,736,204,86,car
50266,33,car,21,0,18113,22,1015,688,1120,733,105,45,car
50267,0,car,1,0,18114,27,635,1128,1253,1364,618,236,car
50268,2,car,3,0,18114,15,1256,1146,1661,1327,405,181,car
50269,30,car,29,1,18114,15,1911,1139,2008,1221,97,82,car
50270,3,person,4,1,18115,25,2,587,86,995,84,408,person
50271,4,person,5,0,18115,49,37,578,248,1034,211,456,person
50272,5,person,6,0,18115,20,363,620,406,728,43,108,person
50273,21,parking meter,22,0,18115,18,1268,724,1333,1216,65,492,parking meter
50274,22,car,23,0,18115,44,1058,664,1869,1159,811,495,car
50275,25,car,26,1,18115,15,1705,726,1957,860,252,134,car
50276,26,car,27,1,18115,25,831,697,1104,944,273,247,car
50277,29,car,30,1,18115,19,1879,757,2199,952,320,195,car
50278,30,car,31,1,18115,17,1869,921,2199,1574,330,653,car
50279,43,traffic light,44,0,18115,16,977,493,993,541,16,48,traffic light
50280,5,car,6,1,18116,17,2,932,157,1281,155,349,car
50281,14,person,15,0,18116,50,1458,958,1538,1159,80,201,person
50282,15,backpack,16,0,18116,18,1465,993,1518,1057,53,64,backpack
50283,16,car,17,0,18116,31,1690,1003,1917,1128,227,125,car
50284,17,car,18,1,18116,25,1891,999,2036,1103,145,104,car
50285,18,car,19,1,18116,24,2012,1002,2128,1085,116,83,car
50286,19,car,20,1,18116,22,2106,1005,2188,1075,82,70,car
50287,2,motorbike,3,0,18117,65,701,546,1371,1045,670,499,motorcycle
50288,4,traffic light,5,0,18117,16,214,324,266,689,52,365,traffic light
50289,7,truck,8,0,18117,16,538,491,721,570,183,79,truck
50290,16,traffic light,16,0,18117,55,357,166,496,809,139,643,traffic light
50291,20,car,20,0,18117,15,141,525,269,575,128,50,car
50292,21,car,21,0,18117,19,3,529,138,575,135,46,car
50293,39,motorbike,39,1,18117,89,912,628,1138,856,226,228,motorcycle
50294,40,car,40,1,18117,40,920,519,1220,624,300,105,car
50295,41,traffic light,41,0,18117,38,522,437,570,553,48,116,traffic light
50296,43,traffic light,43,0,18117,28,1526,427,1578,570,52,143,traffic light
50297,11,car,12,1,18118,17,3,1086,297,1265,294,179,car
50298,14,bicycle,15,0,18118,43,900,1150,1011,1249,111,99,bicycle
50299,4,person,5,0,18119,20,481,825,562,1013,81,188,person
50300,5,person,6,0,18119,18,517,820,577,1019,60,199,person
50301,16,person,17,0,18119,15,1016,822,1064,966,48,144,person
50302,10,person,11,0,18120,16,641,1808,658,1895,17,87,person
50303,17,car,18,0,18120,16,749,1802,799,1839,50,37,car
50304,19,car,20,0,18120,16,524,1812,589,1862,65,50,car
50305,0,car,1,0,18121,24,1148,744,1939,1036,791,292,car
50306,1,person,2,0,18121,21,1121,666,1230,941,109,275,person
50307,2,car,3,0,18121,27,170,752,739,1002,569,250,car
50308,32,door,31,0,18121,19,264,761,450,943,186,182,door
50309,36,door,35,0,18121,20,402,763,529,945,127,182,door
50310,7,car,8,0,18122,42,1129,1082,1782,1303,653,221,car
50311,1,person,2,0,18123,18,1838,854,2091,1598,253,744,person
50312,4,person,5,0,18123,48,1459,894,1601,1315,142,421,person
50313,5,person,6,0,18123,53,1577,912,1733,1345,156,433,person
50314,15,bicycle,16,1,18123,34,3,1135,216,1450,213,315,bicycle
50315,28,car,29,1,18123,20,1362,967,1814,1270,452,303,car
50316,51,car,52,1,18123,21,387,981,449,1042,62,61,car
50317,53,traffic light,54,0,18123,17,758,878,786,1031,28,153,traffic light
50318,55,person,56,0,18123,28,957,946,1000,1035,43,89,person
50319,56,person,57,0,18123,21,716,963,740,1034,24,71,person
50320,57,person,58,0,18123,22,1337,940,1371,1030,34,90,person
50321,58,ball,59,0,18123,19,1292,1439,1475,1619,183,180,sports ball
50322,59,ball,60,0,18123,18,1274,1297,1405,1428,131,131,sports ball
50323,60,ball,61,0,18123,17,1257,1215,1357,1315,100,100,sports ball
50324,61,person,62,0,18123,22,828,958,849,1025,21,67,person
50325,62,person,63,0,18123,26,1260,948,1287,1028,27,80,person
50326,63,person,64,0,18123,24,805,949,825,1026,20,77,person
50327,21,person,22,0,18126,41,645,1090,769,1447,124,357,person
50328,23,motorbike,24,1,18126,26,503,1191,664,1334,161,143,motorcycle
50329,27,person,28,0,18126,38,284,1103,402,1352,118,249,person
50330,28,person,29,0,18126,43,394,1070,499,1350,105,280,person
50331,29,person,30,0,18126,50,952,1070,1068,1433,116,363,person
50332,30,person,31,1,18126,27,884,1200,965,1424,81,224,person
50333,34,motorbike,35,1,18126,18,798,1169,857,1292,59,123,motorcycle
50334,35,person,36,1,18126,18,581,1082,619,1173,38,91,person
50335,36,person,37,1,18126,44,1171,1055,1258,1349,87,294,person
50336,38,person,39,1,18126,42,1392,1055,1474,1375,82,320,person
50337,40,person,41,0,18126,68,1245,1025,1420,1499,175,474,person
50338,41,person,42,0,18126,70,1458,1023,1629,1492,171,469,person
50339,43,person,44,1,18126,57,2,1020,200,1535,198,515,person
50340,107,person,107,0,18126,47,1054,1049,1197,1454,143,405,person
50341,108,person,108,0,18126,36,845,1070,929,1369,84,299,person
50342,10,person,11,1,18127,15,1906,915,1950,1005,44,90,person
50343,19,person,20,1,18128,18,2150,949,2200,1315,50,366,person
50344,1,car,2,0,18129,19,1843,809,2181,915,338,106,car
50345,26,car,27,1,18129,18,571,959,699,1083,128,124,car
50346,27,car,28,1,18129,53,682,829,1378,1182,696,353,car
50347,35,motorbike,36,0,18129,50,1,898,163,1018,162,120,motorcycle
50348,50,door,51,0,18129,15,569,805,708,983,139,178,door
50349,0,car,1,1,18130,15,58,377,172,458,114,81,car
50350,0,car,1,0,18131,20,429,664,1133,935,704,271,car
50351,4,car,5,0,18131,15,981,735,1299,859,318,124,car
50352,2,car,3,0,18132,27,635,866,955,1016,320,150,car
50353,8,car,5,1,18132,15,116,861,213,921,97,60,car
50354,10,person,6,1,18132,20,219,854,291,1084,72,230,person
50355,16,car,12,0,18132,17,549,865,611,906,62,41,car
50356,29,person,25,1,18132,28,1,850,71,1076,70,226,person
50357,30,person,26,0,18132,18,95,862,121,937,26,75,person
50358,31,person,27,0,18132,19,81,863,100,942,19,79,person
50359,32,person,28,1,18132,15,277,858,310,974,33,116,person
50360,33,bicycle,29,0,18132,92,169,970,487,1193,318,223,bicycle
50361,1,person,2,0,18133,21,101,112,139,208,38,96,person
50362,2,car,3,0,18134,29,1100,824,1659,1015,559,191,car
50363,3,person,4,0,18134,32,590,784,690,1023,100,239,person
50364,62,door,62,0,18134,18,1343,827,1473,987,130,160,door
50365,64,door,64,0,18134,17,1455,826,1568,979,113,153,door
50366,0,car,1,0,18135,27,63,316,153,346,90,30,car
50367,1,car,2,0,18135,27,159,318,265,354,106,36,car
50368,2,car,3,0,18135,30,278,314,401,363,123,49,car
50369,15,car,16,0,18135,24,1,312,64,341,63,29,car
50370,1,car,1,0,18136,16,1387,703,2096,957,709,254,car
50371,3,dog,2,0,18136,42,609,968,947,1182,338,214,dog
50372,14,dog,9,0,18136,27,991,939,1250,1183,259,244,dog
50373,43,traffic light,32,0,18136,47,917,334,1137,508,220,174,traffic light
50374,47,person,36,0,18136,39,1234,682,1350,1075,116,393,person
50375,48,person,37,0,18136,62,989,716,1181,1192,192,476,person
50376,49,person,38,0,18136,50,743,659,912,1147,169,488,person
50377,50,person,39,1,18136,41,949,713,1059,1093,110,380,person
50378,51,person,40,1,18136,24,883,669,926,806,43,137,person
50379,53,person,42,1,18136,41,293,643,425,1133,132,490,person
50380,54,car,43,1,18136,16,89,688,233,817,144,129,car
50381,55,person,44,0,18136,58,158,641,345,1198,187,557,person
50382,56,person,45,1,18136,48,3,548,199,1422,196,874,person
50383,61,person,50,0,18136,34,703,676,760,805,57,129,person
50384,2,person,3,0,18137,30,196,789,365,1297,169,508,person
50385,3,person,4,0,18137,24,745,806,891,1195,146,389,person
50386,27,motorbike,28,0,18137,34,383,875,507,1091,124,216,motorcycle
50387,28,motorbike,29,0,18137,34,571,864,690,1024,119,160,motorcycle
50388,29,motorbike,30,1,18137,20,685,883,756,1005,71,122,motorcycle
50389,0,dog,1,0,18138,18,805,1009,1069,1258,264,249,dog
50390,2,traffic light,3,0,18138,20,175,82,417,1181,242,1099,traffic light
50391,7,car,8,0,18138,25,200,666,937,985,737,319,car
50392,9,car,10,1,18138,22,688,665,1214,905,526,240,car
50393,10,car,11,1,18138,18,2,676,259,855,257,179,car
50394,13,person,14,0,18138,42,1352,566,1706,1217,354,651,person
50395,18,car,19,1,18139,15,1117,952,1309,1107,192,155,car
50396,19,car,20,1,18139,23,1280,979,1538,1138,258,159,car
50397,20,car,21,0,18139,27,1521,983,1954,1187,433,204,car
50398,25,car,26,0,18139,29,789,1018,1321,1408,532,390,car
50399,31,car,32,1,18139,17,655,996,901,1228,246,232,car
50400,12,car,13,1,18140,19,1392,1035,1572,1195,180,160,car
50401,0,car,1,0,18141,16,947,948,1881,1450,934,502,car
50402,34,car,28,1,18141,19,1628,856,1963,998,335,142,car
50403,35,car,29,1,18141,22,1503,860,1726,963,223,103,car
50404,38,person,32,0,18141,24,1713,856,1769,1034,56,178,person
50405,39,person,33,0,18141,23,1761,859,1816,1030,55,171,person
50406,40,person,34,0,18141,29,1835,859,1899,1036,64,177,person
50407,41,person,35,1,18141,19,1918,860,1972,1007,54,147,person
50408,42,person,36,0,18141,47,162,861,306,1149,144,288,person
50409,43,person,37,0,18141,42,298,829,406,1158,108,329,person
50410,44,person,38,0,18141,52,406,797,496,1190,90,393,person
50411,45,person,39,0,18141,39,618,845,733,1086,115,241,person
50412,46,person,40,0,18141,40,470,835,581,1175,111,340,person
50413,48,person,42,1,18141,24,377,848,418,1060,41,212,person
50414,49,person,43,1,18141,34,289,840,345,1090,56,250,person
50415,51,person,45,0,18141,23,1388,865,1420,952,32,87,person
50416,54,person,48,1,18141,19,548,837,585,931,37,94,person
50417,59,person,53,1,18141,24,145,840,202,1037,57,197,person
50418,0,person,1,0,18142,54,309,692,484,1130,175,438,person
50419,25,person,25,0,18143,21,619,785,659,881,40,96,person
50420,26,person,26,0,18143,15,589,792,620,880,31,88,person
50421,27,person,27,0,18143,22,1406,810,1457,939,51,129,person
50422,29,person,29,0,18143,22,1699,820,1763,967,64,147,person
50423,30,person,30,0,18143,15,1789,830,1850,974,61,144,person
50424,31,person,31,0,18143,17,1838,824,1906,975,68,151,person
50425,33,person,33,0,18143,15,369,794,402,877,33,83,person
50426,35,motorbike,35,0,18143,34,1929,877,2071,960,142,83,motorcycle
50427,13,person,14,0,18144,44,104,969,221,1235,117,266,person
50428,22,traffic light,23,0,18144,31,224,648,369,1319,145,671,traffic light
50429,1,car,2,0,18145,17,367,931,582,1109,215,178,car
50430,18,bench,10,0,18145,18,914,1010,1031,1076,117,66,bench
50431,28,car,20,0,18145,15,676,943,713,969,37,26,car
50432,47,car,39,1,18145,17,565,951,622,1067,57,116,car
50433,50,car,42,1,18145,28,355,935,421,978,66,43,car
50434,59,person,51,1,18145,17,389,931,412,974,23,43,person
50435,62,car,54,1,18145,16,1,920,93,1016,92,96,car
50436,65,car,57,0,18145,29,85,927,197,1005,112,78,car
50437,0,car,1,0,18146,31,1030,471,1515,631,485,160,car
50438,1,car,2,0,18146,29,66,505,997,960,931,455,car
50439,23,car,21,1,18146,28,325,451,598,522,273,71,car
50440,70,door,68,0,18146,17,1236,478,1346,602,110,124,door
50441,84,door,82,0,18146,15,270,540,451,856,181,316,door
50442,85,door,83,0,18146,17,152,533,312,807,160,274,door
50443,0,person,1,0,18147,37,1112,818,1224,1037,112,219,person
50444,14,person,15,0,18147,36,1625,808,1681,964,56,156,person
50445,0,person,1,0,18148,50,1013,773,1309,1624,296,851,person
50446,1,person,2,1,18148,48,890,762,1094,1565,204,803,person
50447,2,person,3,0,18148,20,1999,800,2119,1111,120,311,person
50448,3,person,4,0,18148,18,2095,805,2200,1105,105,300,person
50449,4,car,5,0,18148,22,8,846,579,1292,571,446,car
50450,5,car,6,0,18148,22,23,744,785,1091,762,347,car
50451,10,car,11,1,18148,15,778,846,963,1071,185,225,car
50452,12,bench,13,0,18148,20,1754,884,2064,1002,310,118,bench
50453,15,person,16,0,18148,27,1715,850,1796,985,81,135,person
50454,11,person,12,0,18149,22,889,984,941,1104,52,120,person
50455,14,person,15,0,18149,18,962,995,1001,1104,39,109,person
50456,19,person,20,0,18149,30,1016,981,1060,1103,44,122,person
50457,1,car,2,0,18150,24,194,86,1533,1052,1339,966,car
50458,1,person,2,0,18151,15,483,901,557,1120,74,219,person
50459,4,person,5,0,18152,48,92,898,251,1201,159,303,person
50460,5,car,6,0,18152,25,521,972,1147,1252,626,280,car
50461,6,car,7,0,18152,24,1146,943,1568,1172,422,229,car
50462,8,car,9,0,18152,25,1756,963,1980,1080,224,117,car
50463,56,person,57,1,18152,16,677,929,712,1048,35,119,person
50464,60,person,60,1,18152,18,1538,912,1579,1057,41,145,person
50465,61,person,61,0,18152,24,1615,925,1654,1057,39,132,person
50466,62,person,62,0,18152,20,1582,925,1619,1068,37,143,person
50467,63,person,63,0,18152,26,1687,938,1738,1070,51,132,person
50468,98,door,93,0,18152,15,976,980,1087,1176,111,196,door
50469,109,door,104,0,18152,17,1371,953,1476,1116,105,163,door
50470,131,person,126,1,18152,17,1817,929,1851,971,34,42,person
50471,133,person,128,1,18152,16,1917,939,1953,975,36,36,person
50472,135,person,130,1,18152,18,1943,930,1967,980,24,50,person
50473,136,person,131,1,18152,23,783,922,831,984,48,62,person
50474,10,person,11,0,18153,28,377,1015,435,1208,58,193,person
50475,11,person,12,0,18153,28,440,1015,507,1220,67,205,person
50476,14,bench,15,0,18153,19,147,1179,590,1319,443,140,bench
50477,17,person,18,0,18153,22,1219,1017,1249,1118,30,101,person
50478,18,person,19,0,18153,27,1127,1018,1165,1150,38,132,person
50479,19,person,20,0,18153,28,1166,1023,1209,1150,43,127,person
50480,21,person,22,0,18153,24,1968,1018,2017,1152,49,134,person
50481,25,person,26,0,18153,29,1693,1017,1741,1152,48,135,person
50482,26,bicycle,27,1,18153,16,1699,1075,1740,1168,41,93,bicycle
50483,43,person,44,0,18153,20,1570,1006,1598,1084,28,78,person
50484,15,bicycle,16,0,18154,117,603,1025,921,1261,318,236,bicycle
50485,1,car,2,0,18156,30,642,890,1575,1534,933,644,car
50486,19,person,20,1,18156,18,745,802,853,1035,108,233,person
50487,2,car,3,1,18157,17,1159,463,1447,695,288,232,car
50488,3,car,4,1,18157,22,824,461,1034,680,210,219,car
50489,8,car,9,1,18157,15,162,485,420,662,258,177,car
50490,9,motorbike,10,0,18157,59,339,461,737,885,398,424,motorcycle
50491,11,car,12,1,18157,26,398,485,835,649,437,164,car
50492,5,truck,5,0,18159,15,295,895,603,1171,308,276,truck
50493,50,traffic light,48,0,18159,22,88,525,199,1177,111,652,traffic light
50494,61,person,59,0,18159,24,1194,1031,1248,1186,54,155,person
50495,62,person,60,0,18159,19,1440,1022,1465,1106,25,84,person
50496,63,person,61,0,18159,22,1400,1021,1440,1130,40,109,person
50497,64,person,62,0,18159,21,1367,1026,1390,1112,23,86,person
50498,0,traffic light,1,0,18160,31,1390,426,1558,1471,168,1045,traffic light
50499,1,person,2,0,18160,33,530,1010,688,1461,158,451,person
50500,7,car,8,0,18160,35,1326,1024,1922,1308,596,284,car
50501,11,person,12,1,18160,42,516,1016,590,1407,74,391,person
50502,15,person,16,0,18160,34,342,1023,418,1225,76,202,person
50503,16,car,17,1,18160,25,801,1044,1001,1153,200,109,car
50504,17,person,18,1,18160,18,975,1029,1007,1109,32,80,person
50505,19,person,20,0,18160,30,1258,1037,1298,1154,40,117,person
50506,20,person,21,0,18160,28,1294,1026,1320,1146,26,120,person
50507,21,car,22,1,18160,26,649,1015,860,1164,211,149,car
50508,22,car,23,1,18160,19,651,1086,734,1200,83,114,car
50509,23,car,24,1,18160,21,422,1067,540,1188,118,121,car
50510,24,car,25,1,18160,16,417,1014,531,1065,114,51,car
50511,27,car,28,1,18160,22,259,1014,356,1147,97,133,car
50512,56,person,56,0,18160,29,1977,1031,2035,1195,58,164,person
50513,139,person,139,0,18160,27,1844,1020,1893,1131,49,111,person
50514,2,person,3,1,18161,30,34,686,135,1041,101,355,person
50515,8,person,9,0,18161,45,532,657,713,1203,181,546,person
50516,9,person,10,0,18161,46,652,686,935,1537,283,851,person
50517,18,person,19,0,18161,70,75,657,314,1522,239,865,person
50518,19,bicycle,20,1,18161,52,309,778,462,1008,153,230,bicycle
50519,26,person,26,1,18161,17,369,685,406,767,37,82,person
50520,20,car,21,1,18162,15,645,993,754,1143,109,150,car
50521,21,car,22,1,18162,21,703,986,933,1201,230,215,car
50522,23,car,24,1,18162,17,1095,1000,1302,1107,207,107,car
50523,24,car,25,1,18162,36,817,1037,1182,1365,365,328,car
50524,25,car,26,1,18162,35,976,1097,1834,1537,858,440,car
50525,11,car,12,0,18163,19,98,1147,284,1238,186,91,car
50526,18,person,19,0,18163,19,1859,1098,1901,1266,42,168,person
50527,8,car,9,0,18164,25,2,1046,570,1326,568,280,car
50528,11,car,12,0,18164,25,424,1037,758,1240,334,203,car
50529,12,car,13,1,18164,27,660,1040,872,1193,212,153,car
50530,13,person,14,0,18164,37,1404,1004,1474,1188,70,184,person
50531,14,car,15,0,18164,17,1306,982,1372,1028,66,46,car
50532,20,car,21,1,18164,28,803,1029,980,1156,177,127,car
50533,21,car,22,1,18164,21,930,1029,1066,1130,136,101,car
50534,0,car,1,0,18165,25,1059,957,1982,1320,923,363,car
50535,1,car,2,0,18165,22,552,968,1079,1208,527,240,car
50536,2,car,3,0,18165,18,253,965,562,1146,309,181,car
50537,0,car,1,0,18166,18,6,804,412,974,406,170,car
50538,2,car,3,0,18166,31,532,776,877,994,345,218,car
50539,5,bicycle,6,0,18167,75,256,1107,614,1389,358,282,bicycle
50540,6,person,7,0,18167,40,336,940,551,1327,215,387,person
50541,13,person,14,0,18167,36,1313,930,1407,1237,94,307,person
50542,14,person,15,0,18167,32,1247,983,1336,1247,89,264,person
50543,24,person,25,1,18167,17,640,949,689,1115,49,166,person
50544,2,car,3,0,18168,26,262,225,604,328,342,103,car
50545,20,person,21,0,18169,24,614,933,664,1128,50,195,person
50546,21,person,22,0,18169,24,681,937,744,1128,63,191,person
50547,25,person,26,0,18169,24,1273,950,1322,1119,49,169,person
50548,18,person,19,0,18170,32,290,1097,360,1269,70,172,person
50549,0,car,1,0,18171,25,1378,740,1699,933,321,193,car
50550,1,car,2,0,18171,27,732,716,1077,937,345,221,car
50551,2,car,3,1,18171,20,423,699,744,936,321,237,car
50552,3,car,4,1,18171,21,110,719,453,938,343,219,car
50553,8,motorbike,9,1,18171,19,1701,752,1758,901,57,149,motorcycle
50554,0,car,1,0,18172,39,813,389,1522,791,709,402,car
50555,3,car,4,0,18172,17,379,325,1036,686,657,361,car
50556,51,door,52,0,18172,20,745,342,884,572,139,230,door
50557,52,door,53,0,18172,15,840,343,1004,537,164,194,door
50558,59,door,60,0,18172,19,1378,410,1487,643,109,233,door
50559,6,person,7,0,18174,21,340,281,366,346,26,65,person
50560,8,car,9,0,18174,17,227,293,287,352,60,59,car
50561,10,car,11,1,18174,17,362,286,442,346,80,60,car
50562,14,car,15,1,18174,17,37,284,146,382,109,98,car
50563,10,car,11,1,18175,17,125,666,287,824,162,158,car
50564,11,car,12,1,18175,20,102,653,248,805,146,152,car
50565,23,traffic light,24,0,18175,33,932,231,1135,1163,203,932,traffic light
50566,0,person,1,0,18176,29,952,391,1179,880,227,489,person
50567,1,car,2,0,18176,23,158,452,674,803,516,351,car
50568,0,person,1,0,18177,38,475,194,566,477,91,283,person
50569,1,person,2,1,18177,20,244,175,394,476,150,301,person
50570,2,person,3,1,18177,18,391,201,474,474,83,273,person
50571,3,person,4,1,18177,21,68,178,233,474,165,296,person
50572,4,person,5,1,18177,16,226,214,268,415,42,201,person
50573,7,person,8,1,18177,18,51,226,122,452,71,226,person
50574,8,person,9,1,18177,24,150,264,246,460,96,196,person
50575,13,person,13,1,18177,18,199,230,249,306,50,76,person
50576,15,person,15,1,18177,18,581,219,612,287,31,68,person
50577,16,person,16,1,18177,16,560,226,596,284,36,58,person
50578,17,person,17,1,18177,39,535,217,598,451,63,234,person
50579,18,person,18,1,18177,16,380,211,403,308,23,97,person
50580,4,person,5,0,18178,30,1967,937,2063,1086,96,149,person
50581,13,car,14,1,18178,27,523,935,1092,1197,569,262,car
50582,14,car,15,0,18178,41,333,987,931,1321,598,334,car
50583,62,door,62,0,18178,17,418,998,584,1240,166,242,door
50584,0,bicycle,1,0,18179,37,1166,1041,1395,1473,229,432,bicycle
50585,16,car,17,1,18179,19,1331,875,1572,1077,241,202,car
50586,17,car,18,1,18179,16,534,892,966,1113,432,221,car
50587,18,car,19,1,18179,28,895,892,1458,1256,563,364,car
50588,19,car,20,1,18179,22,0,856,947,1637,947,781,car
50589,22,person,23,0,18179,22,1666,837,1767,1110,101,273,person
50590,23,person,24,0,18179,16,1796,791,1858,995,62,204,person
50591,57,door,58,0,18179,18,365,946,752,1507,387,561,door
50592,59,door,59,0,18179,15,23,950,504,1604,481,654,door
50593,16,person,13,1,18180,21,8,1081,62,1221,54,140,person
50594,21,person,18,0,18180,26,702,1089,721,1140,19,51,person
50595,22,person,19,0,18180,38,804,1072,839,1188,35,116,person
50596,23,car,20,0,18180,26,829,1089,904,1136,75,47,car
50597,24,car,21,1,18180,29,747,1084,814,1140,67,56,car
50598,25,person,22,0,18180,26,795,1091,821,1172,26,81,person
50599,27,person,24,0,18180,23,510,1087,527,1146,17,59,person
50600,35,person,32,0,18180,39,324,1089,354,1177,30,88,person
50601,37,person,34,0,18180,21,415,1092,430,1165,15,73,person
50602,39,person,36,0,18180,18,555,1035,569,1066,14,31,person
50603,40,person,37,0,18180,15,435,1071,448,1091,13,20,person
50604,41,person,38,0,18180,15,423,1072,436,1092,13,20,person
50605,42,person,39,0,18180,15,316,1082,328,1102,12,20,person
50606,43,person,40,0,18180,17,458,1080,472,1102,14,22,person
50607,44,person,41,0,18180,16,348,1075,359,1096,11,21,person
50608,53,person,50,0,18180,40,182,1093,218,1182,36,89,person
50609,54,person,51,1,18180,18,520,1069,533,1096,13,27,person
50610,55,person,52,0,18180,16,381,1049,394,1070,13,21,person
50611,56,person,53,0,18180,18,335,1037,346,1068,11,31,person
50612,57,person,54,0,18180,16,412,1050,424,1071,12,21,person
50613,58,person,55,0,18180,16,422,1052,434,1071,12,19,person
50614,61,person,58,0,18180,19,182,1063,196,1096,14,33,person
50615,12,car,13,1,18181,27,534,643,727,826,193,183,car
50616,13,car,14,1,18181,19,500,686,662,894,162,208,car
50617,14,car,15,1,18181,44,145,679,614,1058,469,379,car
50618,15,car,16,1,18181,29,5,742,471,1537,466,795,car
50619,21,car,22,1,18181,21,1095,672,1194,834,99,162,car
50620,22,car,23,1,18181,33,1174,594,1600,921,426,327,car
50621,23,car,24,1,18181,40,1423,715,2044,1114,621,399,car
50622,2,person,3,0,18182,19,1718,1094,1778,1241,60,147,person
50623,14,traffic light,15,0,18182,35,922,642,1375,1238,453,596,traffic light
50624,26,car,27,1,18182,15,4,1111,103,1235,99,124,car
50625,36,car,37,0,18182,15,868,1156,983,1239,115,83,car
50626,8,car,4,0,18183,16,1613,975,2091,1176,478,201,car
50627,25,car,16,1,18183,24,1611,914,1898,1013,287,99,car
50628,26,car,17,1,18183,21,1952,904,2198,1006,246,102,car
50629,32,flowerpot,23,0,18183,24,1121,1537,1345,1650,224,113,potted plant
50630,33,flowerpot,24,0,18183,19,208,1267,374,1400,166,133,potted plant
50631,34,flowerpot,25,0,18183,15,419,1223,536,1311,117,88,potted plant
50632,38,person,29,0,18183,42,356,1057,433,1304,77,247,person
50633,39,person,30,1,18183,38,384,1033,438,1280,54,247,person
50634,40,person,31,1,18183,36,362,1066,403,1207,41,141,person
50635,44,door,35,0,18183,17,540,1077,695,1220,155,143,door
50636,0,car,1,0,18184,22,158,1076,684,1308,526,232,car
50637,9,person,8,0,18184,15,1537,1132,1597,1278,60,146,person
50638,21,traffic light,19,0,18184,17,138,722,255,1404,117,682,traffic light
50639,24,traffic light,22,0,18184,29,1438,897,1527,1277,89,380,traffic light
50640,25,person,23,1,18184,31,1358,1136,1401,1276,43,140,person
50641,26,person,24,0,18184,21,968,1158,999,1246,31,88,person
50642,27,person,25,0,18184,29,877,1137,929,1254,52,117,person
50643,28,person,26,0,18184,21,1146,1159,1177,1261,31,102,person
50644,29,person,27,1,18184,18,1176,1136,1211,1229,35,93,person
50645,0,motorbike,1,0,18185,70,1379,578,1852,926,473,348,motorcycle
50646,1,person,2,0,18185,16,1109,479,1150,656,41,177,person
50647,5,person,6,0,18185,28,569,398,935,1394,366,996,person
50648,8,car,9,0,18185,23,1258,515,1499,609,241,94,car
50649,2,car,3,0,18186,48,1322,1020,1893,1319,571,299,car
50650,4,truck,5,1,18186,22,2000,942,2197,1152,197,210,truck
50651,9,car,10,0,18186,30,895,1015,1273,1161,378,146,car
50652,10,car,11,1,18186,18,1777,1005,1988,1121,211,116,car
50653,15,car,16,1,18186,15,1327,1018,1543,1114,216,96,car
50654,53,door,54,0,18186,15,1717,1035,1845,1222,128,187,door
50655,55,door,56,0,18186,15,1669,1033,1776,1238,107,205,door
50656,13,person,12,0,18187,21,1447,1755,1482,1858,35,103,person
50657,14,person,13,0,18187,29,1410,1752,1451,1856,41,104,person
50658,17,person,16,0,18187,26,558,1734,594,1837,36,103,person
50659,0,motorbike,1,0,18188,36,1783,547,2200,1250,417,703,motorcycle
50660,1,car,2,0,18188,31,242,605,1047,945,805,340,car
50661,3,motorbike,4,0,18188,76,1129,619,1473,1274,344,655,motorcycle
50662,4,motorbike,5,1,18188,41,2,684,223,973,221,289,motorcycle
50663,5,person,6,0,18188,37,2,549,160,922,158,373,person
50664,9,person,10,0,18188,37,1443,566,1561,868,118,302,person
50665,11,umbrella,12,0,18188,18,554,355,1065,627,511,272,umbrella
50666,13,umbrella,14,0,18188,22,45,355,599,582,554,227,umbrella
50667,19,motorbike,20,1,18188,40,951,547,1162,919,211,372,motorcycle
50668,5,bench,6,0,18189,23,1115,1334,1497,1587,382,253,bench
50669,12,bench,12,0,18189,21,3,1333,227,1603,224,270,bench
50670,13,car,14,0,18190,15,651,1102,736,1134,85,32,car
50671,3,person,4,0,18191,23,1571,809,1604,905,33,96,person
50672,4,car,5,0,18191,30,926,919,1231,1117,305,198,car
50673,5,car,6,1,18191,23,1126,895,1307,1039,181,144,car
50674,6,car,7,0,18191,18,1096,847,1191,908,95,61,car
50675,10,car,11,1,18191,23,1277,870,1408,963,131,93,car
50676,11,car,12,1,18191,23,1348,836,1469,929,121,93,car
50677,12,car,13,1,18191,16,1451,835,1537,899,86,64,car
50678,0,car,1,1,18192,15,1561,942,2048,1155,487,213,car
50679,1,car,2,1,18192,19,0,851,555,1131,555,280,car
50680,15,traffic light,16,0,18192,49,642,447,784,1089,142,642,traffic light
50681,18,door,19,0,18192,16,187,864,336,1078,149,214,door
50682,21,door,22,0,18192,15,21,862,216,1070,195,208,door
50683,27,person,28,0,18192,35,1371,891,1440,1052,69,161,person
50684,29,person,30,0,18192,60,1213,856,1289,1039,76,183,person
50685,30,person,31,0,18192,36,1568,912,1629,1039,61,127,person
50686,31,person,32,1,18192,23,1694,902,1747,1007,53,105,person
50687,0,car,1,0,18193,38,118,256,389,381,271,125,car
50688,1,car,2,1,18193,28,347,252,511,331,164,79,car
50689,2,car,3,1,18193,24,466,238,589,312,123,74,car
50690,0,car,1,0,18194,19,607,581,1448,834,841,253,car
50691,4,person,5,1,18194,16,422,542,466,731,44,189,person
50692,5,person,6,1,18194,15,676,516,717,680,41,164,person
50693,0,car,1,0,18195,27,995,842,1976,1307,981,465,car
50694,7,person,8,0,18196,42,192,811,395,1299,203,488,person
50695,31,person,32,0,18196,42,952,804,1040,1077,88,273,person
50696,36,person,37,0,18196,17,1146,818,1200,867,54,49,person
50697,2,car,2,0,18197,24,1788,820,1977,895,189,75,car
50698,3,car,3,1,18197,19,1648,812,1802,879,154,67,car
50699,4,car,4,1,18197,20,1560,814,1668,873,108,59,car
50700,5,car,5,1,18197,19,1473,802,1587,867,114,65,car
50701,6,car,6,0,18197,20,1386,814,1488,869,102,55,car
50702,9,car,9,0,18197,34,1053,861,1425,1103,372,242,car
50703,18,car,17,1,18197,16,963,847,1152,1013,189,166,car
50704,24,car,23,0,18197,21,1213,814,1287,855,74,41,car
50705,30,traffic light,28,0,18197,17,1029,688,1266,794,237,106,traffic light
50706,33,car,31,1,18197,17,927,834,1068,968,141,134,car
50707,34,car,32,1,18197,16,889,816,1003,936,114,120,car
50708,46,bicycle,44,1,18197,28,1319,819,1369,850,50,31,bicycle
50709,1,bicycle,2,0,18198,22,542,1091,838,1292,296,201,bicycle
50710,2,bicycle,3,0,18198,15,7,1129,201,1324,194,195,bicycle
50711,0,car,1,0,18200,39,70,899,1526,1482,1456,583,car
50712,15,door,16,0,18200,15,694,930,1128,1360,434,430,door
50713,19,door,20,0,18200,18,356,933,727,1360,371,427,door
50714,1,car,2,0,18201,42,360,669,2190,1381,1830,712,car
50715,29,door,30,0,18201,15,890,688,1389,1219,499,531,door
50716,0,car,1,0,18202,23,950,788,1493,1062,543,274,car
50717,4,car,5,1,18202,54,1511,853,2048,1179,537,326,car
50718,5,car,6,0,18202,97,557,822,813,959,256,137,car
50719,7,person,8,1,18202,60,560,786,593,859,33,73,person
50720,9,car,10,0,18202,21,365,787,527,916,162,129,car
50721,21,person,22,1,18202,15,708,781,755,846,47,65,person
50722,64,car,65,0,18202,24,249,810,351,878,102,68,car
50723,1,person,1,1,18203,17,881,711,1109,962,228,251,person
50724,2,person,2,1,18203,16,1176,596,1280,960,104,364,person
50725,8,person,7,0,18203,17,481,735,545,855,64,120,person
50726,9,person,8,0,18203,17,99,729,135,880,36,151,person
50727,21,person,17,0,18203,35,1094,704,1146,797,52,93,person
50728,22,person,18,0,18203,32,1125,709,1177,795,52,86,person
50729,23,person,19,0,18203,34,1152,709,1190,793,38,84,person
50730,24,car,20,1,18203,47,1083,718,1160,779,77,61,car
50731,25,car,21,1,18203,17,959,725,992,778,33,53,car
50732,26,car,22,0,18203,16,1168,718,1210,739,42,21,car
50733,30,car,26,1,18203,39,203,748,338,813,135,65,car
50734,33,person,29,1,18203,34,512,718,559,845,47,127,person
50735,37,person,33,1,18203,17,486,724,499,805,13,81,person
50736,38,person,34,0,18203,22,753,725,772,793,19,68,person
50737,39,person,35,0,18203,28,455,721,490,832,35,111,person
50738,56,person,52,0,18203,33,59,732,99,882,40,150,person
50739,29,traffic light,26,0,18204,16,252,843,334,1158,82,315,traffic light
50740,30,person,27,0,18204,46,79,1002,151,1165,72,163,person
50741,31,person,28,1,18204,19,48,987,88,1060,40,73,person
50742,41,door,38,0,18204,15,839,1044,888,1159,49,115,door
50743,47,door,44,0,18204,15,1866,934,1997,1226,131,292,door
50744,55,car,52,1,18204,21,1975,1020,2089,1152,114,132,car
50745,9,person,9,0,18205,16,156,242,194,330,38,88,person
50746,10,person,10,0,18205,16,201,250,234,330,33,80,person
50747,17,car,17,0,18205,15,570,263,661,317,91,54,car
50748,2,car,3,0,18206,21,152,808,920,1048,768,240,car
50749,3,car,4,0,18206,22,944,774,1632,1044,688,270,car
50750,19,person,16,1,18206,18,804,707,865,850,61,143,person
50751,39,door,36,0,18206,17,544,816,728,995,184,179,door
50752,0,car,1,0,18207,17,1329,866,1773,1081,444,215,car
50753,12,person,13,0,18207,33,870,822,941,1003,71,181,person
50754,13,car,14,1,18207,18,927,858,1090,973,163,115,car
50755,14,person,15,0,18207,31,1141,825,1204,1018,63,193,person
50756,15,person,16,1,18207,27,1083,802,1148,1006,65,204,person
50757,16,person,17,0,18207,22,1085,835,1136,1020,51,185,person
50758,45,traffic light,46,0,18207,18,854,491,1090,963,236,472,traffic light
50759,46,traffic light,47,0,18207,27,1425,607,1569,862,144,255,traffic light
50760,15,truck,16,1,18208,19,728,676,817,747,89,71,truck
50761,22,car,23,1,18208,19,408,710,482,766,74,56,car
50762,23,car,24,1,18208,25,342,713,437,774,95,61,car
50763,24,car,25,0,18208,24,231,717,361,781,130,64,car
50764,25,car,26,1,18208,21,24,692,229,797,205,105,car
50765,46,person,47,0,18208,22,1726,728,1758,837,32,109,person
50766,47,person,48,0,18208,17,1152,718,1171,780,19,62,person
50767,2,person,3,0,18209,15,892,463,983,643,91,180,person
50768,3,person,4,0,18209,18,574,499,752,827,178,328,person
50769,18,car,18,0,18209,19,781,500,909,548,128,48,car
50770,4,dog,5,0,18210,27,619,907,749,1048,130,141,dog
50771,8,umbrella,9,0,18210,55,915,558,1502,884,587,326,umbrella
50772,33,car,34,1,18210,18,1754,821,2198,1352,444,531,car
50773,17,motorbike,18,0,18211,23,890,1044,987,1289,97,245,motorcycle
50774,0,car,1,0,18212,25,373,746,1877,1274,1504,528,car
50775,15,door,16,0,18212,16,941,762,1343,1170,402,408,door
50776,20,door,21,0,18212,15,628,767,952,1157,324,390,door
50777,2,car,3,0,18213,45,353,1019,1511,1421,1158,402,car
50778,3,car,4,1,18213,17,2,931,513,1120,511,189,car
50779,4,car,5,1,18213,22,828,958,1416,1144,588,186,car
50780,0,motorbike,1,0,18214,18,1032,849,1248,1074,216,225,motorcycle
50781,1,person,2,0,18214,16,826,780,928,1100,102,320,person
50782,13,person,14,1,18214,21,1978,863,2046,1273,68,410,person
50783,16,person,17,0,18214,21,487,818,537,971,50,153,person
50784,18,person,19,0,18215,31,86,832,146,1038,60,206,person
50785,24,person,25,0,18215,19,241,822,273,935,32,113,person
50786,25,person,26,1,18215,23,1169,858,1223,956,54,98,person
50787,10,car,11,1,18216,15,1777,1227,2200,1647,423,420,car
50788,13,car,14,1,18216,37,1358,876,1640,1199,282,323,car
50789,17,bird,18,0,18216,27,1519,1569,1615,1621,96,52,bird
50790,18,person,19,0,18216,33,2142,855,2176,938,34,83,person
50791,3,car,4,1,18217,17,2,1020,283,1447,281,427,car
50792,4,car,5,1,18217,36,237,991,795,1341,558,350,car
50793,17,car,18,0,18217,28,882,983,1177,1179,295,196,car
50794,21,person,22,0,18217,17,1535,966,1561,1067,26,101,person
50795,22,person,23,0,18217,19,1458,963,1482,1064,24,101,person
50796,0,car,1,0,18218,27,230,702,1372,1070,1142,368,car
50797,6,chair,7,0,18218,21,135,802,249,954,114,152,chair
50798,7,person,8,0,18218,33,95,705,219,962,124,257,person
50799,8,chair,9,1,18218,15,2,804,84,964,82,160,chair
50800,9,person,10,1,18218,29,2,698,78,952,76,254,person
50801,10,person,11,1,18218,16,76,713,156,810,80,97,person
50802,17,person,18,1,18218,16,589,654,701,774,112,120,person
50803,18,person,19,1,18218,21,1130,596,1210,760,80,164,person
50804,19,person,20,0,18218,58,1812,636,2008,1046,196,410,person
50805,31,door,32,0,18218,17,509,719,827,1025,318,306,door
50806,34,door,35,0,18218,18,776,714,1025,1020,249,306,door
50807,8,person,8,0,18219,19,768,747,821,908,53,161,person
50808,9,person,9,0,18219,20,691,736,754,912,63,176,person
50809,20,person,18,0,18219,24,668,764,715,904,47,140,person
50810,23,person,21,0,18219,32,1197,727,1255,885,58,158,person
50811,24,person,22,0,18219,25,1112,755,1154,849,42,94,person
50812,25,person,23,0,18219,24,965,752,1000,855,35,103,person
50813,26,person,24,0,18219,25,1303,750,1346,865,43,115,person
50814,27,person,25,0,18219,25,1346,735,1388,837,42,102,person
50815,36,person,34,0,18219,20,627,754,662,913,35,159,person
50816,40,person,38,1,18219,15,832,779,862,850,30,71,person
50817,41,bench,39,0,18219,19,438,837,518,888,80,51,bench
50818,1,person,2,0,18220,29,304,1159,400,1423,96,264,person
50819,7,car,8,0,18220,17,721,1187,832,1265,111,78,car
50820,8,car,9,0,18220,27,930,1196,1181,1327,251,131,car
50821,1,car,2,0,18221,22,751,1111,895,1189,144,78,car
50822,5,car,6,0,18221,36,1230,1114,1556,1248,326,134,car
50823,28,person,29,0,18221,30,70,1081,99,1168,29,87,person
50824,49,person,49,1,18221,18,1981,1073,2014,1133,33,60,person
50825,112,person,112,1,18221,19,2016,1144,2143,1259,127,115,person
50826,209,traffic light,209,0,18221,19,328,995,449,1097,121,102,traffic light
50827,267,person,267,0,18221,18,1081,1100,1127,1185,46,85,person
50828,268,bicycle,268,0,18221,23,1085,1145,1130,1201,45,56,bicycle
50829,280,door,280,0,18221,16,1271,1121,1348,1221,77,100,door
50830,284,door,284,0,18221,17,1321,1121,1384,1224,63,103,door
50831,26,traffic light,27,0,18222,40,1294,2,1483,1006,189,1004,traffic light
50832,1,car,2,0,18223,15,5,871,480,1238,475,367,car
50833,11,car,11,1,18223,16,973,864,1097,956,124,92,car
50834,39,person,39,0,18223,33,1267,850,1399,1194,132,344,person
50835,45,motorbikes,45,1,18223,23,910,864,1020,970,110,106,motorcycle
50836,51,person,51,0,18223,16,1083,837,1110,913,27,76,person
50837,77,person,76,1,18223,41,1371,813,1478,1264,107,451,person
50838,78,person,77,0,18223,55,1404,797,1598,1317,194,520,person
50839,82,person,81,0,18223,15,1144,842,1170,903,26,61,person
50840,0,car,1,0,18224,19,1073,1060,1837,1316,764,256,car
50841,8,car,9,1,18226,15,465,702,687,910,222,208,car
50842,6,car,5,0,18227,23,936,520,1343,800,407,280,car
50843,11,car,10,0,18227,16,1251,517,1509,707,258,190,car
50844,31,person,21,0,18227,41,175,471,242,644,67,173,person
50845,32,person,22,1,18227,35,244,475,287,607,43,132,person
50846,41,truck,31,1,18227,17,663,427,754,540,91,113,truck
50847,44,car,34,1,18227,17,708,495,768,548,60,53,car
50848,46,car,36,1,18227,27,752,480,850,565,98,85,car
50849,47,car,37,0,18227,35,830,483,966,589,136,106,car
50850,0,person,1,0,18228,41,1269,279,1717,1644,448,1365,person
50851,0,car,1,0,18229,19,1017,896,1880,1182,863,286,car
50852,1,person,2,0,18229,21,171,816,322,1185,151,369,person
50853,5,person,6,0,18229,40,316,816,427,1186,111,370,person
50854,7,car,8,1,18229,24,556,866,996,1031,440,165,car
50855,8,car,9,1,18229,19,1238,868,1822,993,584,125,car
50856,5,person,6,0,18230,24,1971,1027,2193,1639,222,612,person
50857,14,traffic light,14,0,18230,25,1667,622,1903,1440,236,818,traffic light
50858,33,bicycle,33,0,18230,56,99,1096,249,1203,150,107,bicycle
50859,34,person,34,0,18230,30,239,1071,278,1162,39,91,person
50860,35,bird,35,0,18230,17,307,1179,335,1201,28,22,bird
50861,5,car,6,0,18231,17,350,870,993,1092,643,222,car
50862,23,door,21,0,18231,18,731,881,883,1055,152,174,door
50863,18,person,18,0,18232,19,1123,888,1151,978,28,90,person
50864,2,person,3,0,18233,24,245,971,425,1462,180,491,person
50865,1,car,2,0,18234,29,138,939,626,1224,488,285,car
50866,0,parking meter,1,0,18235,33,402,503,447,659,45,156,parking meter
50867,1,car,2,0,18235,26,458,514,1076,715,618,201,car
50868,6,person,7,0,18235,15,273,460,363,649,90,189,person
50869,13,car,14,1,18235,15,0,730,545,1196,545,466,car
50870,26,chair,27,0,18235,19,1192,514,1255,582,63,68,chair
50871,29,chair,30,1,18235,17,343,513,398,573,55,60,chair
50872,0,person,1,0,18236,27,1239,616,1482,1364,243,748,person
50873,7,person,8,0,18236,26,1511,715,1572,901,61,186,person
50874,16,flowerpot,17,1,18236,16,2,1078,319,1533,317,455,potted plant
50875,22,car,23,1,18236,15,411,745,586,819,175,74,car
50876,27,person,28,1,18236,20,1142,711,1252,863,110,152,person
50877,28,car,29,1,18236,22,640,727,1042,897,402,170,car
50878,31,car,32,1,18236,19,100,789,600,1278,500,489,car
50879,33,person,34,1,18236,63,1564,670,1774,1417,210,747,person
50880,34,backpack,35,0,18236,18,1614,789,1772,1056,158,267,backpack
50881,35,person,36,1,18236,58,1722,592,2047,1535,325,943,person
50882,0,car,1,0,18237,24,544,509,1146,764,602,255,car
50883,1,car,2,0,18237,20,1519,600,1885,790,366,190,car
50884,17,person,17,1,18237,37,1160,578,1313,842,153,264,person
50885,1,car,2,0,18239,32,194,303,482,402,288,99,car
50886,25,person,26,1,18239,17,241,270,261,334,20,64,person
50887,56,door,57,0,18239,17,13,304,99,398,86,94,door
50888,5,pot,6,0,18240,16,1036,1105,1100,1152,64,47,potted plant
50889,7,person,8,0,18240,26,757,998,815,1203,58,205,person
50890,8,car,9,0,18240,31,206,1009,731,1207,525,198,car
50891,9,fire hydrant,10,0,18240,31,1501,1086,1534,1164,33,78,fire hydrant
50892,10,person,11,0,18240,40,704,1003,766,1201,62,198,person
50893,0,car,1,0,18241,37,1002,751,1585,945,583,194,car
50894,26,traffic light,21,0,18241,18,486,709,515,785,29,76,traffic light
50895,29,car,24,1,18241,23,766,742,1151,934,385,192,car
50896,30,car,25,1,18241,16,290,765,425,865,135,100,car
50897,40,car,35,1,18241,15,1743,824,1832,869,89,45,car
50898,47,traffic light,42,0,18241,31,1853,616,2047,845,194,229,traffic light
50899,0,car,1,0,18244,30,938,1003,1919,1325,981,322,car
50900,51,door,52,0,18244,18,1201,1016,1465,1261,264,245,door
50901,53,door,54,0,18244,20,1442,1012,1658,1254,216,242,door
50902,56,door,57,0,18244,15,97,1045,290,1257,193,212,door
50903,8,person,8,0,18245,41,6,670,55,883,49,213,person
50904,9,person,9,1,18245,30,40,653,99,871,59,218,person
50905,10,person,10,1,18245,27,177,649,219,747,42,98,person
50906,38,flowerpot,38,0,18245,20,435,263,479,304,44,41,potted plant
50907,39,flowerpot,39,0,18245,18,624,230,673,273,49,43,potted plant
50908,43,flowerpot,43,0,18245,41,657,464,742,591,85,127,potted plant
50909,45,flowerpot,45,0,18245,37,157,497,217,603,60,106,potted plant
50910,3,car,4,0,18247,38,78,733,515,963,437,230,car
50911,18,motorbike,18,0,18247,26,669,802,775,908,106,106,motorcycle
50912,34,flowerpot,34,0,18247,17,1008,836,1033,859,25,23,potted plant
50913,40,person,40,0,18247,26,1115,750,1135,828,20,78,person
50914,41,car,41,1,18247,19,1285,755,1345,816,60,61,car
50915,42,car,42,1,18247,20,1328,748,1388,803,60,55,car
50916,43,car,43,1,18247,15,1374,743,1408,794,34,51,car
50917,14,traffic light,4,0,18248,33,661,881,748,1130,87,249,traffic light
50918,28,person,18,0,18248,50,1009,1010,1062,1188,53,178,person
50919,29,person,19,0,18248,51,945,995,1002,1197,57,202,person
50920,30,person,20,1,18248,15,573,1007,604,1057,31,50,person
50921,31,car,21,0,18248,47,378,1022,628,1202,250,180,car
50922,32,car,22,1,18248,38,304,1023,423,1118,119,95,car
50923,33,car,23,1,18248,29,224,1019,323,1096,99,77,car
50924,34,bus,24,0,18248,23,26,919,225,1113,199,194,bus
50925,41,person,31,1,18248,16,388,1012,402,1025,14,13,person
50926,0,bicycle,1,0,18249,24,971,767,1290,1041,319,274,bicycle
50927,12,car,12,0,18249,29,0,670,858,1149,858,479,car
50928,14,person,13,0,18249,33,840,654,971,957,131,303,person
50929,31,door,30,0,18249,17,499,707,714,1007,215,300,door
50930,35,traffic light,34,0,18249,49,1426,27,1982,928,556,901,traffic light
50931,42,car,41,1,18249,16,2,630,348,777,346,147,car
50932,45,traffic light,44,0,18249,35,12,157,291,674,279,517,traffic light
50933,5,street sign,6,0,18250,22,207,112,529,1629,322,1517,street sign
50934,14,traffic light,15,0,18250,49,72,867,255,1033,183,166,traffic light
50935,50,person,48,0,18250,15,866,751,906,878,40,127,person
50936,51,person,49,0,18250,17,815,682,878,885,63,203,person
50937,5,traffic light,6,1,18251,28,1698,1059,2048,1534,350,475,traffic light
50938,2,car,3,0,18253,27,1363,1055,1686,1179,323,124,car
50939,32,bicycle,32,0,18253,22,1033,1091,1156,1183,123,92,bicycle
50940,38,car,38,1,18253,20,137,1050,258,1158,121,108,car
50941,39,car,39,1,18253,22,58,1053,177,1146,119,93,car
50942,40,car,40,1,18253,18,2,1048,92,1137,90,89,car
50943,0,person,1,0,18254,37,1120,988,1169,1129,49,141,person
50944,1,person,2,0,18254,38,83,978,165,1197,82,219,person
50945,7,person,8,0,18254,31,1792,966,1861,1124,69,158,person
50946,8,person,9,0,18254,27,1723,950,1765,1082,42,132,person
50947,64,person,65,0,18254,29,4,985,70,1197,66,212,person
50948,106,person,106,1,18254,26,1843,969,1872,1102,29,133,person
50949,4,window,5,0,18255,20,510,370,657,870,147,500,window
50950,5,window,6,0,18255,24,788,280,1022,875,234,595,window
50951,6,window,7,0,18255,19,288,459,389,884,101,425,window
50952,7,window,8,0,18255,21,1249,167,1486,718,237,551,window
50953,8,bicycle,9,0,18255,88,1348,1145,1720,1397,372,252,bicycle
50954,15,bicycle,16,0,18255,43,331,1080,527,1256,196,176,bicycle
50955,23,car,24,0,18257,23,245,507,359,584,114,77,car
50956,0,car,1,0,18258,27,126,1245,1167,1548,1041,303,car
50957,17,person,16,0,18258,40,1698,1164,1820,1355,122,191,person
50958,18,bicycle,17,1,18258,46,1657,1260,1855,1386,198,126,bicycle
50959,42,door,41,0,18258,15,683,1264,917,1507,234,243,door
50960,12,car,13,1,18259,18,938,1040,1243,1209,305,169,car
50961,13,car,14,1,18259,22,637,1047,1047,1281,410,234,car
50962,14,car,15,0,18259,26,34,1085,731,1406,697,321,car
50963,8,person,9,0,18260,20,1114,982,1143,1085,29,103,person
50964,9,person,10,0,18260,24,1143,993,1175,1093,32,100,person
50965,10,person,11,0,18260,20,1196,978,1232,1092,36,114,person
50966,19,car,20,1,18260,20,2,1020,312,1253,310,233,car
50967,20,car,21,0,18260,27,304,1043,685,1204,381,161,car
50968,42,car,43,1,18260,17,1654,985,1860,1253,206,268,car
50969,43,car,44,0,18260,47,1186,1036,1759,1399,573,363,car
50970,6,motorbike,7,1,18261,61,1692,1194,2181,1467,489,273,motorcycle
50971,11,motorbike,12,0,18261,34,1374,919,1467,1022,93,103,motorcycle
50972,13,motorbike,14,1,18261,27,649,933,812,1058,163,125,motorcycle
50973,14,motorbike,15,0,18261,48,692,945,1000,1137,308,192,motorcycle
50974,1,person,2,0,18262,22,1132,822,1208,1057,76,235,person
50975,2,person,3,0,18262,19,1317,822,1404,1097,87,275,person
50976,3,person,4,0,18262,22,1532,789,1616,1075,84,286,person
50977,4,person,5,0,18262,20,1645,831,1741,1103,96,272,person
50978,5,person,6,0,18262,25,1793,826,1911,1156,118,330,person
50979,49,car,45,1,18262,22,18,816,251,900,233,84,car
50980,56,umbrella,52,0,18262,15,192,749,343,806,151,57,umbrella
50981,61,person,57,0,18262,37,1752,852,1816,1091,64,239,person
50982,0,person,1,0,18263,160,374,1196,489,1507,115,311,person
50983,9,person,10,0,18263,28,1087,1230,1150,1382,63,152,person
50984,10,person,11,0,18263,35,1237,1240,1302,1442,65,202,person
50985,11,person,12,0,18263,32,1278,1227,1339,1442,61,215,person
50986,13,person,14,1,18263,29,1822,1244,1955,1537,133,293,person
50987,30,person,31,0,18263,30,853,1208,899,1370,46,162,person
50988,39,person,40,0,18263,21,703,1240,744,1356,41,116,person
50989,40,person,41,0,18263,21,768,1220,809,1356,41,136,person
50990,58,person,59,0,18263,21,568,1236,600,1336,32,100,person
50991,15,car,16,1,18264,16,2118,1142,2198,1247,80,105,car
50992,67,window,68,0,18264,17,1053,89,1151,232,98,143,window
50993,68,window,69,0,18264,15,910,147,997,278,87,131,window
50994,70,window,71,0,18264,15,672,251,744,366,72,115,window
50995,0,person,1,0,18265,26,193,643,333,1011,140,368,person
50996,1,person,2,0,18265,35,34,698,152,989,118,291,person
50997,3,bicycle,4,0,18265,62,1165,798,1457,992,292,194,bicycle
50998,4,person,5,0,18265,22,401,684,481,954,80,270,person
50999,5,person,6,0,18265,34,664,676,757,1029,93,353,person
51000,6,person,7,0,18265,38,728,619,839,1018,111,399,person
51001,14,person,15,0,18265,26,307,676,381,1000,74,324,person
51002,15,person,16,1,18265,18,1563,691,1674,769,111,78,person
51003,0,door,1,0,18266,17,1193,798,1381,1415,188,617,door
51004,1,window,2,0,18266,17,1676,46,1927,522,251,476,window
51005,6,bicycle,7,0,18266,21,550,1112,700,1296,150,184,bicycle
51006,17,car,18,0,18266,16,904,1049,1012,1133,108,84,car
51007,18,person,19,0,18266,26,317,1024,381,1227,64,203,person
51008,19,window,20,0,18266,15,34,423,343,809,309,386,window
51009,20,person,21,0,18266,35,179,1026,236,1220,57,194,person
51010,24,person,25,0,18266,23,841,1033,876,1155,35,122,person
51011,1,car,2,0,18267,38,1145,1202,1664,1525,519,323,car
51012,19,car,19,0,18267,26,671,1243,793,1324,122,81,car
51013,20,car,20,0,18267,38,943,1249,1190,1428,247,179,car
51014,23,car,23,1,18267,17,618,1247,693,1312,75,65,car
51015,24,car,24,0,18267,19,23,1246,111,1314,88,68,car
51016,33,person,33,1,18267,25,1962,1167,2002,1286,40,119,person
51017,0,car,1,0,18268,18,611,1258,1272,1528,661,270,car
51018,10,car,9,1,18268,23,468,1273,804,1428,336,155,car
51019,16,car,17,1,18269,16,1956,1220,2193,1335,237,115,car
51020,14,bicycle,14,0,18270,25,990,900,1078,1135,88,235,bicycle
51021,15,person,15,0,18270,45,939,699,1109,1051,170,352,person
51022,26,car,27,1,18271,15,477,502,535,549,58,47,car
51023,28,car,29,1,18271,16,496,498,551,544,55,46,car
51024,30,car,31,1,18271,17,550,488,591,527,41,39,car
51025,31,car,32,1,18271,17,550,477,595,522,45,45,car
51026,36,car,37,1,18271,17,606,459,798,537,192,78,car
51027,57,car,58,1,18271,15,396,480,480,508,84,28,car
51028,59,car,60,1,18271,16,304,488,407,531,103,43,car
51029,60,car,61,1,18271,15,291,499,394,537,103,38,car
51030,3,person,4,0,18272,25,17,1116,140,1462,123,346,person
51031,5,person,6,0,18272,33,116,1124,222,1491,106,367,person
51032,10,person,11,0,18272,20,1469,1069,1500,1160,31,91,person
51033,30,window,31,0,18272,18,1403,847,1464,1010,61,163,window
51034,2,car,3,0,18273,37,275,1017,995,1365,720,348,car
51035,21,car,22,1,18273,17,2,1126,333,1455,331,329,car
51036,1,person,2,0,18274,36,1953,933,2045,1146,92,213,person
51037,2,car,3,0,18274,18,1631,946,1815,1013,184,67,car
51038,3,person,4,0,18274,20,1755,918,1783,1052,28,134,person
51039,4,person,5,0,18274,26,1461,925,1506,1064,45,139,person
51040,5,person,6,0,18274,26,1376,931,1418,1062,42,131,person
51041,6,person,7,0,18274,30,1210,901,1270,1064,60,163,person
51042,7,person,8,0,18274,28,1264,927,1309,1067,45,140,person
51043,8,person,9,0,18274,25,1300,908,1346,1066,46,158,person
51044,10,person,11,0,18274,25,1131,901,1176,1054,45,153,person
51045,16,person,17,0,18274,16,1820,946,1850,1028,30,82,person
51046,0,person,1,0,18275,23,1318,1164,1406,1465,88,301,person
51047,2,car,2,0,18275,18,844,1199,1330,1391,486,192,car
51048,6,car,6,1,18275,16,1278,1168,1526,1323,248,155,car
51049,30,car,29,1,18275,15,1615,1192,1672,1263,57,71,car
51050,43,backpack,42,0,18275,24,1304,1200,1384,1308,80,108,backpack
51051,52,door,51,0,18275,17,1147,1204,1258,1348,111,144,door
51052,3,car,2,0,18276,65,604,775,716,869,112,94,car
51053,4,flowerpot,3,0,18276,30,1212,837,1265,878,53,41,potted plant
51054,7,umbrella,6,0,18276,20,95,767,165,783,70,16,umbrella
51055,9,person,8,0,18276,97,392,800,522,1079,130,279,person
51056,10,person,9,0,18276,37,1602,805,1638,889,36,84,person
51057,28,car,24,0,18276,38,712,786,816,861,104,75,car
51058,29,person,25,0,18276,19,2018,813,2053,869,35,56,person
51059,30,person,26,0,18276,27,1295,796,1331,870,36,74,person
51060,41,traffic light,37,0,18276,72,190,5,471,1017,281,1012,traffic light
51061,45,flowerpot,41,0,18276,16,1340,845,1402,894,62,49,potted plant
51062,47,flowerpot,43,0,18276,22,1488,855,1557,908,69,53,potted plant
51063,49,flowerpot,45,0,18276,21,1639,864,1717,923,78,59,potted plant
51064,51,flowerpot,47,0,18276,15,1121,832,1159,868,38,36,potted plant
51065,55,car,51,1,18276,17,537,792,569,823,32,31,car
51066,56,car,52,1,18276,19,509,792,547,828,38,36,car
51067,58,umbrella,54,0,18276,25,362,762,503,839,141,77,umbrella
51068,59,bus,55,1,18276,26,360,766,414,825,54,59,bus
51069,61,flowerpot,57,0,18276,19,1057,829,1104,863,47,34,potted plant
51070,63,flowerpot,59,0,18276,17,991,824,1030,858,39,34,potted plant
51071,65,flowerpot,61,0,18276,17,933,824,973,854,40,30,potted plant
51072,0,car,1,1,18277,18,1597,664,2046,906,449,242,car
51073,2,person,3,0,18277,22,428,709,446,756,18,47,person
51074,4,fire hydrant,5,0,18277,21,290,755,321,819,31,64,fire hydrant
51075,21,traffic light,13,1,18277,20,643,1,724,843,81,842,traffic light
51076,38,person,30,0,18277,41,1258,676,1313,810,55,134,person
51077,39,person,31,0,18277,32,1171,677,1220,816,49,139,person
51078,40,person,32,0,18277,24,1109,682,1150,822,41,140,person
51079,42,person,34,0,18277,15,490,702,505,757,15,55,person
51080,47,car,39,0,18277,19,175,751,281,811,106,60,car
51081,49,car,41,1,18277,20,267,722,306,789,39,67,car
51082,52,car,44,0,18277,22,113,715,187,746,74,31,car
51083,53,car,45,1,18277,18,93,716,114,752,21,36,car
51084,54,car,46,0,18277,21,55,714,97,755,42,41,car
51085,55,car,47,0,18277,16,30,722,68,756,38,34,car
51086,56,car,48,1,18277,15,0,722,44,761,44,39,car
51087,0,car,1,0,18278,17,228,989,545,1191,317,202,car
51088,1,car,2,0,18278,22,734,968,937,1050,203,82,car
51089,2,car,3,1,18278,17,2,952,258,1129,256,177,car
51090,10,motorbike,11,1,18278,21,2097,1070,2200,1226,103,156,motorcycle
51091,11,person,12,1,18278,20,2107,923,2163,1076,56,153,person
51092,18,person,19,0,18278,31,1732,918,1778,1041,46,123,person
51093,19,dog,20,0,18278,15,1782,996,1813,1035,31,39,dog
51094,20,motorbike,21,0,18278,32,1479,978,1587,1047,108,69,motorcycle
51095,23,person,24,0,18278,26,1663,932,1696,1039,33,107,person
51096,24,person,25,0,18278,31,1611,931,1657,1041,46,110,person
51097,35,person,36,1,18278,21,1125,997,1249,1105,124,108,person
51098,40,motorbike,41,0,18278,33,132,1035,222,1155,90,120,motorcycle
51099,41,person,42,0,18278,32,126,964,217,1149,91,185,person
51100,0,person,1,0,18279,21,647,479,856,988,209,509,person
51101,11,person,12,1,18279,27,116,530,432,1017,316,487,person
51102,15,bicycle,16,1,18279,35,435,558,516,684,81,126,bicycle
51103,17,person,18,0,18279,23,1086,462,1123,589,37,127,person
51104,22,person,23,0,18279,20,468,466,508,578,40,112,person
51105,33,traffic light,34,0,18279,27,1190,324,1254,562,64,238,traffic light
51106,35,person,36,0,18279,21,781,471,818,573,37,102,person
51107,0,car,1,0,18280,26,8,1472,716,1904,708,432,car
51108,1,car,2,0,18280,21,837,1452,1028,1551,191,99,car
51109,2,person,3,0,18280,55,1186,1405,1338,1788,152,383,person
51110,7,traffic light,8,1,18280,16,7,710,531,923,524,213,traffic light
51111,8,traffic light,9,0,18280,45,919,486,1141,2042,222,1556,traffic light
51112,9,traffic light,10,0,18280,28,1103,952,1208,1714,105,762,traffic light
51113,13,person,14,1,18280,26,1458,1365,1534,1958,76,593,person
51114,14,person,15,0,18280,20,1423,1398,1458,1536,35,138,person
51115,16,person,17,1,18280,19,1178,1391,1241,1507,63,116,person
51116,24,car,25,1,18280,19,750,1457,827,1527,77,70,car
51117,25,car,26,1,18280,20,627,1442,772,1536,145,94,car
51118,26,car,27,1,18280,21,487,1436,683,1547,196,111,car
51119,19,window,20,0,18281,16,1762,996,1861,1139,99,143,window
51120,20,window,21,0,18281,16,1930,987,2007,1104,77,117,window
51121,17,person,18,0,18282,65,322,1381,557,1909,235,528,person
51122,19,person,20,1,18282,15,774,1348,820,1532,46,184,person
51123,20,person,21,0,18282,41,840,1430,996,1973,156,543,person
51124,21,backpack,22,0,18282,16,856,1499,976,1676,120,177,backpack
51125,23,person,24,1,18282,32,583,1412,694,1743,111,331,person
51126,24,person,25,0,18282,56,636,1426,849,2002,213,576,person
51127,26,person,27,1,18282,50,1091,1435,1428,2044,337,609,person
51128,0,car,1,0,18283,31,1520,918,1904,1127,384,209,car
51129,2,car,3,0,18283,28,1008,1002,1648,1423,640,421,car
51130,16,person,14,0,18283,18,481,962,524,1077,43,115,person
51131,24,car,22,1,18283,26,1939,958,2200,1159,261,201,car
51132,30,traffic light,28,0,18283,31,945,763,1207,970,262,207,traffic light
51133,31,car,29,1,18283,22,1331,966,1524,1079,193,113,car
51134,32,car,30,1,18283,21,1183,963,1350,1011,167,48,car
51135,33,car,31,1,18283,19,1098,970,1221,1030,123,60,car
51136,34,car,32,1,18283,15,859,970,906,1007,47,37,car
51137,35,car,33,0,18283,24,779,965,866,1033,87,68,car
51138,44,person,42,0,18283,20,562,976,584,1034,22,58,person
51139,1,person,2,0,18284,39,817,947,894,1162,77,215,person
51140,2,person,3,0,18284,32,882,935,971,1172,89,237,person
51141,3,car,4,0,18284,21,1600,930,1824,1061,224,131,car
51142,4,car,5,1,18284,15,1474,930,1624,1087,150,157,car
51143,5,car,6,1,18284,21,1351,913,1554,1128,203,215,car
51144,6,car,7,0,18284,24,1078,928,1450,1194,372,266,car
51145,25,person,26,0,18284,19,2002,931,2047,1079,45,148,person
51146,26,person,27,0,18284,25,1936,942,2001,1074,65,132,person
51147,27,person,28,0,18284,20,1885,942,1924,1035,39,93,person
51148,23,motorbike,24,0,18286,25,508,1159,598,1226,90,67,motorcycle
51149,3,person,4,0,18287,17,227,985,427,1627,200,642,person
51150,5,traffic light,6,0,18287,16,239,150,401,943,162,793,traffic light
51151,13,person,14,0,18287,32,601,923,665,1149,64,226,person
51152,14,person,15,0,18287,31,542,926,608,1151,66,225,person
51153,15,person,16,0,18287,30,766,925,835,1162,69,237,person
51154,16,person,17,1,18287,24,966,955,1004,1136,38,181,person
51155,17,person,18,0,18287,44,893,954,972,1178,79,224,person
51156,18,person,19,0,18287,47,985,960,1064,1183,79,223,person
51157,19,person,20,1,18287,28,1235,981,1266,1141,31,160,person
51158,20,person,21,0,18287,39,1187,943,1238,1137,51,194,person
51159,21,person,22,0,18287,30,1260,958,1307,1142,47,184,person
51160,22,person,23,0,18287,50,1306,939,1372,1147,66,208,person
51161,23,person,24,0,18287,37,1370,937,1430,1147,60,210,person
51162,24,person,25,0,18287,38,1420,949,1501,1209,81,260,person
51163,25,person,26,0,18287,47,1776,946,1904,1365,128,419,person
51164,26,person,27,0,18287,45,1897,947,1992,1241,95,294,person
51165,27,person,28,0,18287,35,1501,931,1567,1134,66,203,person
51166,33,person,34,0,18287,42,1676,964,1776,1193,100,229,person
51167,36,person,37,0,18287,34,1576,962,1658,1150,82,188,person
51168,0,car,1,0,18288,23,448,1052,882,1267,434,215,car
51169,19,person,16,0,18288,19,1912,1115,1977,1278,65,163,person
51170,29,car,26,1,18288,17,1250,1114,1362,1182,112,68,car
51171,30,car,27,0,18288,22,1365,1119,1469,1180,104,61,car
51172,31,car,28,1,18288,17,1453,1125,1507,1176,54,51,car
51173,32,car,29,1,18288,18,1496,1125,1557,1175,61,50,car
51174,33,car,30,1,18288,18,1548,1128,1602,1170,54,42,car
51175,34,car,31,1,18288,19,1601,1127,1660,1165,59,38,car
51176,3,car,4,0,18289,15,1393,1063,1608,1189,215,126,car
51177,6,car,7,0,18289,23,364,1100,748,1261,384,161,car
51178,23,car,21,1,18289,20,1886,1036,1998,1141,112,105,car
51179,24,car,22,1,18289,16,1805,1059,1947,1158,142,99,car
51180,25,car,23,1,18289,22,1737,1065,1946,1241,209,176,car
51181,28,car,26,1,18289,15,1584,1047,1676,1108,92,61,car
51182,29,person,27,0,18289,29,2128,1024,2196,1212,68,188,person
51183,34,bicycle,32,0,18289,30,857,1110,906,1195,49,85,bicycle
51184,25,car,26,1,18290,30,1867,1150,2200,1636,333,486,car
51185,0,person,1,0,18291,23,524,511,649,879,125,368,person
51186,2,person,3,0,18291,20,715,480,814,655,99,175,person
51187,39,car,40,1,18291,16,638,501,740,547,102,46,car
51188,14,car,13,0,18292,22,1531,1061,1677,1128,146,67,car
51189,31,person,30,0,18292,26,347,1091,382,1190,35,99,person
51190,32,person,31,0,18292,24,477,1088,510,1189,33,101,person
51191,33,person,32,0,18292,26,494,1092,545,1191,51,99,person
51192,95,car,94,0,18292,37,1319,1048,1535,1146,216,98,car
51193,107,car,106,1,18292,45,944,1085,1177,1179,233,94,car
51194,10,car,11,1,18293,21,762,1582,1071,1913,309,331,car
51195,11,car,12,1,18293,22,738,1550,970,1812,232,262,car
51196,12,car,13,1,18293,16,704,1509,845,1680,141,171,car
51197,0,car,1,0,18295,16,0,1058,428,1406,428,348,car
51198,1,car,2,0,18295,29,272,1057,880,1237,608,180,car
51199,3,car,4,1,18295,26,878,982,1502,1271,624,289,car
51200,4,car,5,1,18295,21,1459,933,2198,1330,739,397,car
51201,1,bicycle,2,0,18296,34,624,585,916,824,292,239,bicycle
51202,16,car,16,0,18296,15,2,461,424,636,422,175,car
51203,17,car,17,0,18296,27,1497,470,2012,704,515,234,car
51204,18,car,18,0,18296,18,354,471,636,585,282,114,car
51205,19,car,19,0,18296,18,673,457,1010,583,337,126,car
51206,20,car,20,0,18296,25,901,444,1392,572,491,128,car
51207,0,person,1,0,18297,24,1795,908,2031,1531,236,623,person
51208,23,person,24,0,18297,33,1357,873,1409,1020,52,147,person
51209,24,person,25,0,18297,29,877,873,915,1010,38,137,person
51210,25,person,26,0,18297,24,1173,872,1199,981,26,109,person
51211,0,car,1,0,18298,16,1366,1015,1695,1138,329,123,car
51212,3,traffic light,4,0,18298,25,817,418,1457,1274,640,856,traffic light
51213,16,traffic light,13,0,18298,28,1222,741,1486,1047,264,306,traffic light
51214,17,traffic light,14,0,18298,50,529,691,755,1114,226,423,traffic light
51215,26,car,23,1,18298,15,944,1032,989,1101,45,69,car
51216,51,car,48,1,18298,16,62,1042,224,1089,162,47,car
51217,1,person,2,0,18299,16,1217,766,1305,1118,88,352,person
51218,2,person,3,0,18299,26,1385,739,1573,1078,188,339,person
51219,0,person,1,0,18300,22,1462,1036,1589,1408,127,372,person
51220,1,person,2,0,18300,22,1588,1047,1744,1459,156,412,person
51221,2,person,3,0,18300,22,1835,1020,1998,1444,163,424,person
51222,3,person,4,0,18300,34,1736,1048,1840,1395,104,347,person
51223,4,car,5,0,18300,32,620,1114,926,1269,306,155,car
51224,5,car,6,0,18300,28,961,1061,1188,1205,227,144,car
51225,7,car,8,1,18300,15,1229,1056,1367,1171,138,115,car
51226,10,car,11,0,18300,17,460,1078,554,1131,94,53,car
51227,24,bench,25,0,18300,17,1314,1137,1408,1254,94,117,bench
51228,27,person,26,1,18301,31,1953,942,2046,1363,93,421,person
51229,28,person,27,1,18301,27,1293,1015,1335,1151,42,136,person
51230,42,person,38,0,18301,53,1232,1001,1310,1213,78,212,person
51231,44,person,40,0,18301,44,1700,978,1768,1225,68,247,person
51232,45,person,41,0,18301,42,1537,989,1581,1130,44,141,person
51233,46,person,42,0,18301,54,1599,994,1663,1148,64,154,person
51234,47,person,43,1,18301,46,327,949,569,1193,242,244,person
51235,48,person,44,1,18301,47,505,947,634,1182,129,235,person
51236,63,person,59,0,18301,38,1946,1027,1990,1184,44,157,person
51237,64,person,60,0,18301,24,1505,1023,1532,1098,27,75,person
51238,65,person,61,0,18301,41,1577,1002,1626,1139,49,137,person
51239,66,person,62,0,18301,30,1652,1005,1693,1154,41,149,person
51240,67,person,63,1,18301,32,1686,992,1718,1157,32,165,person
51241,68,person,64,1,18301,24,1984,938,2022,1065,38,127,person
51242,73,backpack,69,0,18301,15,1729,1022,1770,1093,41,71,backpack
51243,0,person,1,0,18302,19,1170,1014,1282,1326,112,312,person
51244,24,person,24,0,18302,30,1075,979,1189,1304,114,325,person
51245,25,person,25,0,18302,39,288,949,429,1408,141,459,person
51246,26,person,26,0,18302,35,402,979,541,1417,139,438,person
51247,0,motorbike,1,0,18303,17,378,934,541,1070,163,136,motorcycle
51248,2,bus,3,0,18303,18,1508,806,1963,1010,455,204,bus
51249,17,person,18,0,18303,24,731,897,758,994,27,97,person
51250,18,bench,19,0,18303,21,637,952,691,995,54,43,bench
51251,19,person,20,0,18303,31,823,894,850,990,27,96,person
51252,20,person,21,0,18303,34,859,904,892,994,33,90,person
51253,24,car,25,0,18303,21,1267,912,1343,959,76,47,car
51254,31,motorbike,32,1,18303,39,529,931,644,1036,115,105,motorcycle
51255,40,person,41,0,18303,33,190,902,235,998,45,96,person
51256,4,car,5,0,18304,20,130,1612,413,1731,283,119,car
51257,5,car,6,0,18304,21,437,1633,648,1724,211,91,car
51258,6,car,7,1,18304,20,615,1620,767,1709,152,89,car
51259,7,car,8,0,18304,22,812,1627,975,1696,163,69,car
51260,8,car,9,0,18304,22,970,1622,1120,1689,150,67,car
51261,11,car,12,1,18304,17,1306,1646,1484,1819,178,173,car
51262,12,bicycle,13,0,18304,17,1152,1726,1241,1932,89,206,bicycle
51263,13,person,14,0,18304,32,1159,1616,1250,1886,91,270,person
51264,17,person,18,1,18304,16,1449,1620,1533,2025,84,405,person
51265,0,car,1,0,18305,43,910,743,2197,1283,1287,540,car
51266,6,person,7,0,18306,23,492,890,543,1026,51,136,person
51267,0,person,1,0,18307,34,91,490,254,874,163,384,person
51268,1,person,2,0,18307,36,588,490,717,910,129,420,person
51269,2,person,3,0,18307,33,1024,531,1132,886,108,355,person
51270,3,person,4,0,18307,39,1113,492,1246,894,133,402,person
51271,4,person,5,0,18307,25,2,479,150,851,148,372,person
51272,44,person,44,1,18307,25,574,523,640,871,66,348,person
51273,7,car,7,0,18308,25,1004,899,1451,1045,447,146,car
51274,8,car,8,0,18308,30,1489,905,1955,1039,466,134,car
51275,9,car,9,0,18308,18,3,858,555,1078,552,220,car
51276,10,car,10,1,18308,17,537,880,885,1035,348,155,car
51277,11,car,11,0,18308,21,1878,854,2082,943,204,89,car
51278,22,car,22,1,18308,15,1445,871,1742,978,297,107,car
51279,8,car,9,0,18309,16,927,965,1043,1050,116,85,car
51280,6,car,7,0,18310,28,624,953,1043,1145,419,192,car
51281,14,car,15,0,18310,19,1277,957,1709,1117,432,160,car
51282,0,person,1,0,18312,27,467,462,586,802,119,340,person
51283,14,car,15,1,18312,32,633,503,817,568,184,65,car
51284,32,parking meter,33,0,18312,18,1418,571,1488,846,70,275,parking meter
51285,4,bicycle,4,0,18313,16,973,1218,1105,1281,132,63,bicycle
51286,8,car,7,0,18313,23,1684,1106,1793,1164,109,58,car
51287,14,person,12,1,18313,20,1043,1149,1078,1221,35,72,person
51288,15,person,13,1,18313,26,1063,1141,1110,1230,47,89,person
51289,18,chair,16,0,18313,16,706,1204,779,1276,73,72,chair
51290,29,chair,26,0,18313,19,1232,1152,1285,1211,53,59,chair
51291,36,chair,33,0,18313,15,537,1203,587,1247,50,44,chair
51292,49,car,45,0,18313,19,1907,1098,2001,1152,94,54,car
51293,50,car,46,1,18313,17,1842,1091,1906,1152,64,61,car
51294,7,person,8,0,18314,52,1753,858,1807,1025,54,167,person
51295,8,person,9,1,18314,34,1684,851,1728,1002,44,151,person
51296,9,person,10,0,18314,36,1722,864,1759,1020,37,156,person
51297,10,person,11,0,18314,38,1917,862,1962,1000,45,138,person
51298,7,car,8,0,18315,48,842,475,1554,968,712,493,car
51299,11,person,12,0,18315,17,823,395,835,430,12,35,person
51300,14,car,15,1,18315,16,622,438,674,532,52,94,car
51301,15,car,16,1,18315,27,639,432,773,558,134,126,car
51302,16,car,17,1,18315,37,672,446,898,603,226,157,car
51303,18,car,19,1,18315,16,852,419,900,470,48,51,car
51304,0,person,1,0,18316,15,891,708,916,790,25,82,person
51305,5,person,6,0,18317,19,1996,985,2016,1049,20,64,person
51306,1,car,2,0,18318,23,2,322,157,384,155,62,car
51307,3,car,4,0,18318,18,161,323,281,366,120,43,car
51308,0,person,1,0,18319,17,441,517,599,882,158,365,person
51309,12,truck,13,0,18319,38,598,399,1027,595,429,196,truck
51310,0,car,1,0,18320,20,102,637,532,871,430,234,car
51311,12,truck,13,1,18320,19,972,545,1084,670,112,125,truck
51312,21,car,22,1,18320,24,1409,629,1533,839,124,210,car
51313,22,car,23,1,18320,23,1347,608,1470,732,123,124,car
51314,23,car,24,1,18320,15,977,623,1037,688,60,65,car
51315,24,car,25,1,18320,17,952,620,1004,696,52,76,car
51316,25,car,26,1,18320,23,852,613,973,713,121,100,car
51317,26,car,27,0,18320,32,734,629,892,737,158,108,car
51318,33,car,34,1,18320,19,2,747,144,944,142,197,car
51319,38,door,39,0,18320,22,1609,460,1755,1133,146,673,door
51320,5,car,6,0,18321,22,1400,736,2034,1008,634,272,car
51321,27,car,26,1,18321,20,1365,790,1589,925,224,135,car
51322,28,car,27,1,18321,25,1315,798,1410,930,95,132,car
51323,32,car,31,0,18321,33,890,846,1015,937,125,91,car
51324,33,car,32,1,18321,17,885,843,929,883,44,40,car
51325,34,car,33,0,18321,27,832,842,880,876,48,34,car
51326,14,person,15,0,18322,15,1532,961,1582,1084,50,123,person
51327,17,person,18,0,18322,15,1168,1013,1255,1115,87,102,person
51328,3,car,1,0,18325,19,1104,893,1297,1041,193,148,car
51329,5,bicycle,3,0,18325,31,1450,1096,1822,1536,372,440,bicycle
51330,8,car,6,0,18325,18,1660,906,2014,1048,354,142,car
51331,17,car,14,1,18325,41,950,930,1111,1018,161,88,car
51332,18,person,15,0,18325,37,1020,910,1089,1034,69,124,person
51333,19,traffic light,16,0,18325,31,1308,754,1350,1021,42,267,traffic light
51334,21,traffic light,18,0,18325,41,947,748,996,963,49,215,traffic light
51335,24,person,21,0,18325,31,1349,919,1388,1012,39,93,person
51336,25,person,22,0,18325,54,227,852,337,1114,110,262,person
51337,26,person,23,0,18325,44,337,869,415,1110,78,241,person
51338,27,person,24,0,18325,37,840,905,880,1015,40,110,person
51339,28,traffic light,25,0,18325,39,140,679,194,1040,54,361,traffic light
51340,33,door,30,0,18325,20,1773,911,1859,1038,86,127,door
51341,36,door,33,0,18325,16,1831,911,1934,1039,103,128,door
51342,29,car,27,0,18326,18,636,908,697,954,61,46,car
51343,30,car,28,0,18326,17,582,915,637,948,55,33,car
51344,35,person,36,0,18327,35,1892,965,2017,1299,125,334,person
51345,36,person,37,0,18327,38,1637,986,1830,1427,193,441,person
51346,37,window,38,0,18327,15,1613,754,1758,1111,145,357,window
51347,39,person,40,0,18327,28,1444,950,1590,1408,146,458,person
51348,40,person,41,0,18327,38,1202,973,1310,1404,108,431,person
51349,42,person,43,0,18327,28,1046,1038,1253,1424,207,386,person
51350,43,person,44,1,18327,18,1092,979,1189,1380,97,401,person
51351,0,bench,1,0,18329,47,1308,1052,1708,1410,400,358,bench
51352,1,bench,2,1,18329,16,1873,957,2044,1133,171,176,bench
51353,9,person,10,0,18329,21,863,793,886,877,23,84,person
51354,12,person,13,0,18329,21,1191,801,1210,876,19,75,person
51355,16,bench,17,0,18329,41,1103,871,1192,953,89,82,bench
51356,17,person,18,1,18329,24,1131,844,1204,947,73,103,person
51357,18,bench,19,1,18329,22,1083,835,1131,892,48,57,bench
51358,27,person,28,0,18329,56,1364,799,1477,1124,113,325,person
51359,28,person,29,0,18329,41,1461,791,1591,1114,130,323,person
51360,32,bench,33,1,18329,20,1576,898,1775,981,199,83,bench
51361,33,motorbike,34,1,18329,27,1774,824,1838,890,64,66,motorcycle
51362,34,car,35,1,18329,19,1637,820,1758,897,121,77,car
51363,6,person,7,0,18330,43,51,805,227,1201,176,396,person
51364,11,person,12,0,18330,23,1841,822,1906,1058,65,236,person
51365,12,person,13,0,18330,24,1068,822,1140,1027,72,205,person
51366,13,person,14,0,18330,23,1020,837,1065,1008,45,171,person
51367,14,person,15,0,18330,29,876,829,922,976,46,147,person
51368,15,bicycle,16,0,18330,71,1570,917,1784,1108,214,191,bicycle
51369,16,bicycle,17,0,18330,51,1196,911,1407,1059,211,148,bicycle
51370,25,person,26,0,18330,20,542,837,575,938,33,101,person
51371,45,bicycle,46,0,18330,31,138,956,241,1219,103,263,bicycle
51372,51,person,52,1,18330,20,1766,819,1812,947,46,128,person
51373,52,person,53,1,18330,20,1721,848,1783,974,62,126,person
51374,53,person,54,1,18330,27,1124,821,1169,1006,45,185,person
51375,35,motorbike,21,0,18331,39,0,1026,467,1417,467,391,motorcycle
51376,36,person,22,0,18331,38,839,985,960,1331,121,346,person
51377,37,person,23,0,18331,24,737,955,793,1156,56,201,person
51378,38,person,24,0,18331,32,639,970,694,1166,55,196,person
51379,39,person,25,0,18331,40,1423,989,1540,1214,117,225,person
51380,40,car,26,1,18331,45,1295,977,1485,1066,190,89,car
51381,41,person,27,1,18331,18,1406,1018,1427,1109,21,91,person
51382,42,person,28,0,18331,37,1419,976,1466,1119,47,143,person
51383,43,person,29,0,18331,37,1300,1006,1403,1245,103,239,person
51384,44,car,30,1,18331,35,433,971,648,1100,215,129,car
51385,45,person,31,0,18331,34,468,941,554,1182,86,241,person
51386,46,person,32,1,18331,28,300,931,385,1135,85,204,person
51387,47,person,33,1,18331,30,374,963,445,1137,71,174,person
51388,48,person,34,0,18331,28,195,953,260,1161,65,208,person
51389,50,bus,35,1,18331,30,451,889,718,990,267,101,bus
51390,51,car,36,1,18331,15,558,951,672,1010,114,59,car
51391,53,bus,38,1,18331,35,2,836,452,1005,450,169,bus
51392,55,traffic light,40,0,18331,15,694,781,748,1133,54,352,traffic light
51393,0,car,1,0,18332,35,29,727,1361,1276,1332,549,car
51394,11,door,12,0,18332,19,392,747,869,1159,477,412,door
51395,19,parking meter,3,0,18333,15,750,953,839,1390,89,437,parking meter
51396,56,car,37,1,18333,16,1169,1020,1188,1042,19,22,car
51397,60,motorbike,41,0,18333,26,1268,1017,1308,1083,40,66,motorcycle
51398,61,car,42,1,18333,45,1260,999,1326,1064,66,65,car
51399,62,truck,43,1,18333,29,1259,941,1359,1030,100,89,truck
51400,65,person,46,0,18333,48,1522,978,1550,1052,28,74,person
51401,68,person,49,0,18333,59,1224,989,1272,1102,48,113,person
51402,71,person,52,1,18333,22,879,977,903,1036,24,59,person
51403,76,car,57,1,18333,53,1010,1026,1189,1196,179,170,car
51404,83,door,64,0,18333,21,1133,1034,1169,1155,36,121,door
51405,87,car,68,1,18333,128,836,1034,1090,1271,254,237,car
51406,94,door,75,0,18333,23,1001,1049,1053,1222,52,173,door
51407,98,door,79,0,18333,21,1022,1048,1081,1196,59,148,door
51408,101,motorbike,82,1,18333,97,870,1065,999,1325,129,260,motorcycle
51409,102,motorbike,83,1,18333,72,612,1146,915,1345,303,199,motorcycle
51410,4,car,5,0,18334,29,489,1060,1206,1263,717,203,car
51411,0,car,1,0,18336,49,690,1059,1054,1238,364,179,car
51412,1,car,2,0,18336,50,412,1024,715,1191,303,167,car
51413,2,car,3,0,18336,20,303,1039,475,1142,172,103,car
51414,6,car,7,0,18336,34,1246,1106,1585,1229,339,123,car
51415,25,car,26,1,18336,16,199,1018,355,1124,156,106,car
51416,8,person,9,0,18337,22,218,1036,278,1181,60,145,person
51417,15,car,12,0,18338,18,18,828,584,1165,566,337,car
51418,22,car,19,1,18338,30,721,850,1016,1142,295,292,car
51419,23,car,20,0,18338,69,257,948,886,1341,629,393,car
51420,32,door,29,0,18338,18,759,975,847,1235,88,260,door
51421,33,mirror,30,0,18338,22,766,1061,829,1103,63,42,mirror
51422,34,window,31,0,18338,17,772,985,815,1075,43,90,window
51423,40,door,37,0,18338,20,397,855,477,1039,80,184,door
51424,49,car,46,0,18338,15,547,855,661,948,114,93,car
51425,50,car,47,1,18338,18,648,864,756,951,108,87,car
51426,51,truck,48,1,18338,23,693,805,894,878,201,73,truck
51427,56,car,53,1,18338,16,1234,869,1262,976,28,107,car
51428,57,truck,54,1,18338,24,1252,814,1313,936,61,122,truck
51429,60,person,57,1,18338,23,1278,878,1305,955,27,77,person
51430,61,bicycle,58,1,18338,32,1200,933,1260,1053,60,120,bicycle
51431,62,person,59,1,18338,28,1297,880,1317,952,20,72,person
51432,63,person,60,0,18338,38,1324,881,1355,963,31,82,person
51433,64,person,61,1,18338,34,1354,877,1383,954,29,77,person
51434,65,person,62,0,18338,22,1316,872,1334,950,18,78,person
51435,66,person,63,0,18338,26,1442,898,1468,959,26,61,person
51436,4,person,5,1,18339,21,1672,933,1732,1109,60,176,person
51437,5,person,6,1,18339,18,1580,914,1620,1072,40,158,person
51438,6,person,7,1,18339,15,1522,930,1586,1062,64,132,person
51439,7,car,8,0,18339,44,1057,1002,1830,1276,773,274,car
51440,9,person,10,1,18339,15,1409,913,1469,1006,60,93,person
51441,19,person,20,1,18339,22,1207,932,1268,1024,61,92,person
51442,21,car,22,0,18339,33,466,993,995,1209,529,216,car
51443,23,car,24,1,18339,33,143,963,487,1157,344,194,car
51444,98,door,98,0,18339,15,1171,1016,1327,1207,156,191,door
51445,107,door,107,0,18339,15,531,999,633,1152,102,153,door
51446,109,person,109,1,18339,18,606,941,644,997,38,56,person
51447,110,person,110,1,18339,22,537,946,578,1026,41,80,person
51448,111,person,111,1,18339,22,493,950,535,1033,42,83,person
51449,112,door,112,0,18339,16,248,967,330,1115,82,148,door
51450,113,door,113,0,18339,16,190,964,271,1107,81,143,door
51451,29,car,28,0,18340,30,384,236,738,486,354,250,car
51452,0,car,1,0,18341,17,744,1054,1378,1273,634,219,car
51453,1,car,2,0,18341,17,1465,1039,2101,1268,636,229,car
51454,21,door,21,0,18341,15,1072,1059,1239,1221,167,162,door
51455,30,door,30,0,18341,19,1681,1041,1889,1223,208,182,door
51456,31,window,31,0,18341,21,1716,1051,1867,1120,151,69,window
51457,10,car,11,1,18342,19,1137,1063,1536,1240,399,177,car
51458,22,car,23,1,18342,19,106,1101,253,1220,147,119,car
51459,23,car,24,0,18342,25,192,1097,443,1259,251,162,car
51460,26,car,27,1,18342,15,549,1093,786,1191,237,98,car
51461,27,car,28,0,18342,33,411,1135,818,1344,407,209,car
51462,30,car,31,0,18342,45,771,1154,1621,1536,850,382,car
51463,0,person,1,0,18343,25,896,570,1037,1014,141,444,person
51464,1,traffic light,2,0,18343,21,496,9,585,908,89,899,traffic light
51465,15,car,16,1,18343,15,82,527,188,582,106,55,car
51466,22,fire hydrant,23,0,18343,16,256,645,299,723,43,78,fire hydrant
51467,0,car,1,0,18344,31,1296,971,1712,1118,416,147,car
51468,1,car,2,0,18344,23,61,989,619,1158,558,169,car
51469,2,car,3,0,18344,21,652,988,1069,1134,417,146,car
51470,3,car,4,0,18344,15,1897,962,2137,1063,240,101,car
51471,45,person,46,1,18344,16,1619,940,1648,990,29,50,person
51472,1,bicycle,2,0,18345,82,286,836,857,1227,571,391,bicycle
51473,3,person,4,1,18345,41,640,596,873,993,233,397,person
51474,4,person,5,0,18345,63,1202,545,1376,1120,174,575,person
51475,5,person,6,0,18345,55,1352,569,1541,1195,189,626,person
51476,7,person,8,1,18345,19,1669,569,1753,724,84,155,person
51477,8,person,9,0,18345,38,1587,543,1728,1120,141,577,person
51478,9,person,10,0,18345,52,1732,612,1907,1126,175,514,person
51479,10,person,11,1,18345,19,1980,549,2088,696,108,147,person
51480,11,person,12,1,18345,66,1857,556,2073,1166,216,610,person
51481,13,person,14,1,18345,22,2082,520,2199,724,117,204,person
51482,14,person,15,1,18345,54,1966,619,2201,1467,235,848,person
51483,16,traffic light,17,0,18345,29,1433,2,1743,1278,310,1276,traffic light
51484,24,car,25,0,18346,15,1483,1061,1521,1090,38,29,car
51485,0,car,1,0,18347,35,1205,899,1765,1102,560,203,car
51486,1,car,2,0,18347,24,506,872,637,964,131,92,car
51487,2,car,3,0,18347,19,745,878,889,1004,144,126,car
51488,33,car,22,0,18347,22,351,819,404,839,53,20,car
51489,37,car,26,1,18347,16,235,846,280,882,45,36,car
51490,38,car,27,0,18347,16,239,851,289,886,50,35,car
51491,43,car,32,0,18347,17,389,852,437,891,48,39,car
51492,44,car,33,1,18347,15,433,850,473,883,40,33,car
51493,45,car,34,0,18347,21,182,816,243,836,61,20,car
51494,46,car,35,0,18347,20,112,820,180,842,68,22,car
51495,51,person,40,0,18347,28,699,850,736,936,37,86,person
51496,53,person,42,0,18347,34,893,854,936,949,43,95,person
51497,54,person,43,1,18347,19,862,857,890,917,28,60,person
51498,55,person,44,0,18347,20,1033,838,1058,908,25,70,person
51499,59,person,48,1,18347,33,1196,857,1243,980,47,123,person
51500,60,person,49,1,18347,25,1168,854,1194,984,26,130,person
51501,61,person,50,0,18347,36,1136,862,1173,993,37,131,person
51502,65,person,54,0,18347,65,1930,855,2041,1063,111,208,person
51503,66,person,55,1,18347,33,2004,961,2048,1334,44,373,person
51504,79,car,68,1,18347,15,64,812,86,834,22,22,car
51505,1,bench,2,0,18348,27,517,389,631,499,114,110,bench
51506,10,person,11,0,18348,23,246,310,267,369,21,59,person
51507,2,truck,3,0,18349,24,1691,712,2040,1010,349,298,truck
51508,10,car,11,1,18349,18,1354,845,1492,956,138,111,car
51509,13,car,14,0,18349,18,1153,871,1379,979,226,108,car
51510,14,car,15,1,18349,18,457,833,776,1019,319,186,car
51511,15,car,16,0,18349,35,733,873,1217,1114,484,241,car
51512,38,door,39,0,18349,17,1052,889,1165,1048,113,159,door
51513,41,door,42,0,18349,23,1010,889,1099,1053,89,164,door
51514,52,door,53,0,18349,16,1204,876,1252,958,48,82,door
51515,0,person,1,0,18350,24,41,692,153,936,112,244,person
51516,4,person,5,0,18350,22,136,730,172,897,36,167,person
51517,5,person,6,1,18350,18,903,742,959,1171,56,429,person
51518,9,motorbike,10,1,18350,16,896,760,953,842,57,82,motorcycle
51519,10,person,11,0,18350,32,656,741,691,838,35,97,person
51520,11,person,12,0,18350,20,758,758,787,827,29,69,person
51521,16,motorbike,17,0,18350,23,702,788,746,822,44,34,motorcycle
51522,0,car,1,0,18351,17,1114,769,1584,1000,470,231,car
51523,3,car,4,0,18351,23,399,718,798,990,399,272,car
51524,4,car,5,0,18351,16,778,726,1048,875,270,149,car
51525,15,car,13,0,18351,57,268,736,405,823,137,87,car
51526,16,car,14,0,18351,21,376,746,426,796,50,50,car
51527,17,car,15,0,18351,24,362,728,441,752,79,24,car
51528,18,car,16,0,18351,50,993,752,1160,825,167,73,car
51529,19,car,17,0,18351,38,1388,775,1513,833,125,58,car
51530,21,car,19,0,18351,32,1494,767,1667,833,173,66,car
51531,22,car,20,0,18351,26,1664,778,1794,833,130,55,car
51532,24,car,22,0,18351,16,1793,799,1902,835,109,36,car
51533,25,car,23,0,18351,25,1996,789,2108,825,112,36,car
51534,26,car,24,0,18351,16,2105,800,2178,832,73,32,car
51535,40,traffic light,35,0,18351,46,1091,493,1293,767,202,274,traffic light
51536,41,traffic light,36,0,18351,22,73,305,892,443,819,138,traffic light
51537,42,traffic light,37,0,18351,32,576,529,794,752,218,223,traffic light
51538,51,car,46,0,18351,26,130,741,224,798,94,57,car
51539,52,car,47,1,18351,16,171,727,235,780,64,53,car
51540,53,car,48,1,18351,15,104,734,154,774,50,40,car
51541,55,bench,50,0,18351,26,2027,818,2166,867,139,49,bench
51542,4,person,3,1,18352,24,1420,1044,1509,1300,89,256,person
51543,10,car,9,1,18352,24,1,1108,394,1388,393,280,car
51544,12,bicycle,11,1,18352,21,346,1119,460,1216,114,97,bicycle
51545,14,motorbike,13,1,18352,38,969,1109,1169,1332,200,223,motorcycle
51546,15,motorbike,14,1,18352,51,993,1127,1288,1381,295,254,motorcycle
51547,16,motorbike,15,1,18352,59,920,1136,1430,1534,510,398,motorcycle
51548,17,motorbike,16,1,18352,33,1317,1202,1651,1531,334,329,motorcycle
51549,18,motorbike,17,1,18352,26,1022,1325,1356,1536,334,211,motorcycle
51550,19,motorbike,18,1,18352,25,1443,1332,1935,1536,492,204,motorcycle
51551,30,car,28,0,18352,27,836,1067,874,1174,38,107,car
51552,35,car,33,1,18352,16,889,1075,925,1109,36,34,car
51553,36,car,34,1,18352,17,884,1074,914,1115,30,41,car
51554,38,car,36,1,18352,19,864,1072,897,1124,33,52,car
51555,39,car,37,1,18352,18,863,1079,889,1126,26,47,car
51556,42,door,40,0,18352,22,266,1127,368,1358,102,231,door
51557,46,door,44,0,18352,26,219,1127,317,1370,98,243,door
51558,0,car,1,0,18353,26,310,1017,793,1218,483,201,car
51559,2,car,3,0,18353,15,2,1046,286,1199,284,153,car
51560,0,car,1,0,18354,18,892,1067,1216,1259,324,192,car
51561,12,person,13,0,18355,24,71,836,176,1044,105,208,person
51562,22,person,23,0,18355,31,181,848,280,1035,99,187,person
51563,23,person,24,0,18355,22,318,835,355,960,37,125,person
51564,26,person,27,0,18355,15,172,837,210,958,38,121,person
51565,0,person,1,0,18356,16,149,1567,256,1754,107,187,person
51566,54,person,55,0,18356,21,655,1565,744,1725,89,160,person
51567,55,person,56,0,18356,19,828,1567,875,1718,47,151,person
51568,56,person,57,0,18356,27,970,1588,1035,1722,65,134,person
51569,57,person,58,0,18356,18,1252,1565,1287,1685,35,120,person
51570,58,person,59,0,18356,23,1091,1555,1130,1700,39,145,person
51571,59,person,60,0,18356,18,526,1574,578,1669,52,95,person
51572,60,person,61,0,18356,24,470,1580,514,1666,44,86,person
51573,62,car,63,1,18356,17,878,1584,1086,1687,208,103,car
51574,67,traffic light,68,0,18356,34,792,1138,1239,1710,447,572,traffic light
51575,121,person,122,0,18356,32,1134,1562,1174,1692,40,130,person
51576,122,person,123,0,18356,23,1172,1565,1205,1690,33,125,person
51577,123,person,124,0,18356,20,1229,1590,1256,1686,27,96,person
51578,0,car,1,0,18357,40,309,1052,1027,1287,718,235,car
51579,13,person,10,0,18357,24,1872,936,1935,1122,63,186,person
51580,14,person,11,0,18357,23,1810,939,1865,1119,55,180,person
51581,49,traffic light,45,0,18357,31,1544,508,1700,1239,156,731,traffic light
51582,0,car,1,0,18358,19,1130,952,1665,1253,535,301,car
51583,1,car,2,0,18358,16,1653,929,1940,1127,287,198,car
51584,0,person,1,0,18359,20,1737,779,1911,1275,174,496,person
51585,1,motorbike,2,0,18359,26,1178,929,1475,1387,297,458,motorcycle
51586,6,person,7,0,18359,29,1911,836,2076,1279,165,443,person
51587,19,motorbike,19,0,18359,41,1483,924,1698,1176,215,252,motorcycle
51588,28,car,28,1,18359,20,2056,743,2116,773,60,30,car
51589,30,person,30,1,18359,32,1897,835,1934,936,37,101,person
51590,31,person,31,1,18359,18,2001,822,2026,878,25,56,person
51591,33,bench,33,0,18359,25,2075,837,2128,863,53,26,bench
51592,34,person,34,0,18359,22,2096,817,2117,862,21,45,person
51593,35,person,35,0,18359,18,2115,817,2130,855,15,38,person
51594,38,car,38,1,18359,20,2074,788,2173,815,99,27,car
51595,41,person,41,0,18359,42,2138,840,2177,950,39,110,person
51596,42,person,42,0,18359,43,2043,840,2078,931,35,91,person
51597,43,person,43,0,18359,38,2024,822,2059,920,35,98,person
51598,44,person,44,1,18359,15,1931,869,1950,906,19,37,person
51599,2,car,3,0,18360,24,718,1003,2002,1410,1284,407,car
51600,5,person,4,0,18361,15,1004,863,1057,997,53,134,person
51601,10,car,9,1,18361,17,535,872,625,961,90,89,car
51602,12,bench,11,0,18361,19,932,894,1007,934,75,40,bench
51603,36,person,35,1,18361,38,1005,855,1052,984,47,129,person
51604,2,car,3,0,18362,15,901,1073,1506,1315,605,242,car
51605,15,car,16,1,18362,29,1394,1118,1677,1172,283,54,car
51606,19,parking meter,20,0,18362,15,1502,1103,1534,1278,32,175,parking meter
51607,22,person,23,1,18362,28,848,1115,909,1252,61,137,person
51608,5,car,6,0,18363,16,1726,1073,2039,1319,313,246,car
51609,38,person,39,0,18363,15,1311,1068,1333,1157,22,89,person
51610,39,person,40,0,18363,16,1331,1073,1357,1135,26,62,person
51611,0,person,1,0,18364,39,1173,686,1281,974,108,288,person
51612,14,person,14,0,18364,35,777,672,842,868,65,196,person
51613,20,person,20,1,18364,30,649,672,732,893,83,221,person
51614,21,person,21,0,18364,25,688,705,752,890,64,185,person
51615,22,person,22,1,18364,33,1257,706,1325,965,68,259,person
51616,32,door,32,1,18364,24,1251,559,1328,888,77,329,door
51617,35,person,35,0,18364,34,374,680,427,818,53,138,person
51618,36,person,36,0,18364,33,323,678,372,815,49,137,person
51619,37,person,37,0,18364,23,286,674,319,813,33,139,person
51620,38,person,38,0,18364,32,253,677,291,819,38,142,person
51621,1,car,2,1,18365,18,1152,856,1570,986,418,130,car
51622,29,door,29,0,18366,16,985,1161,1131,1649,146,488,door
51623,42,person,42,1,18366,18,66,1490,153,1594,87,104,person
51624,0,car,1,0,18369,33,175,859,1362,1367,1187,508,car
51625,0,car,1,0,18370,34,993,1039,1886,1390,893,351,car
51626,1,car,2,0,18370,38,170,1087,833,1320,663,233,car
51627,9,person,10,0,18370,18,1922,1053,1983,1307,61,254,person
51628,21,person,22,1,18370,20,132,1041,177,1146,45,105,person
51629,22,car,23,1,18370,20,2,1073,203,1262,201,189,car
51630,30,window,31,0,18370,15,1054,1062,1185,1132,131,70,window
51631,76,person,77,1,18370,15,673,1006,740,1079,67,73,person
51632,9,person,10,0,18372,19,1010,1052,1091,1294,81,242,person
51633,11,person,12,0,18372,20,1866,996,1929,1150,63,154,person
51634,9,bus,10,1,18373,17,1646,915,2046,1160,400,245,bus
51635,13,car,14,0,18373,27,1465,1076,1726,1175,261,99,car
51636,17,car,18,1,18373,15,951,1031,1145,1102,194,71,car
51637,19,car,20,1,18373,19,1199,1067,1457,1164,258,97,car
51638,20,car,21,0,18373,26,872,1072,1141,1147,269,75,car
51639,24,car,25,0,18373,23,687,1052,874,1138,187,86,car
51640,0,car,1,0,18374,24,450,305,561,352,111,47,car
51641,0,car,1,0,18376,51,54,685,1586,1437,1532,752,car
51642,14,door,12,0,18376,21,823,721,1304,1229,481,508,door
51643,18,door,16,0,18376,22,477,722,915,1268,438,546,door
51644,18,person,19,0,18378,28,596,1557,694,1903,98,346,person
51645,19,person,20,0,18378,40,1253,1514,1370,1820,117,306,person
51646,20,person,21,1,18378,34,765,1495,940,2047,175,552,person
51647,21,person,22,1,18378,45,812,1499,1200,2047,388,548,person
51648,28,person,27,1,18379,15,1508,705,1559,767,51,62,person
51649,2,car,3,0,18380,32,322,202,559,308,237,106,car
51650,3,car,4,1,18380,22,496,176,641,278,145,102,car
51651,5,car,6,1,18380,27,112,203,360,313,248,110,car
51652,5,person,6,0,18382,29,1823,870,1912,1124,89,254,person
51653,16,person,17,0,18382,27,194,827,278,1046,84,219,person
51654,32,person,33,1,18382,24,252,837,291,1022,39,185,person
51655,6,person,7,0,18383,27,1790,637,2197,1648,407,1011,person
51656,9,person,10,0,18383,20,1529,702,1660,1075,131,373,person
51657,11,person,12,0,18383,30,240,618,536,1476,296,858,person
51658,12,person,13,1,18383,24,564,658,682,1097,118,439,person
51659,13,person,14,0,18383,19,631,727,769,1128,138,401,person
51660,20,person,21,0,18383,21,729,729,870,1119,141,390,person
51661,21,person,22,0,18383,15,1395,739,1481,973,86,234,person
51662,30,person,31,0,18383,27,1170,746,1276,1074,106,328,person
51663,35,person,35,0,18383,42,948,758,1078,1111,130,353,person
51664,36,person,36,1,18383,44,841,719,952,1013,111,294,person
51665,38,person,38,1,18383,42,927,698,1019,1015,92,317,person
51666,39,person,39,1,18383,23,1024,727,1092,821,68,94,person
51667,40,person,40,1,18383,42,1057,749,1128,952,71,203,person
51668,41,person,41,0,18383,54,1271,727,1367,1053,96,326,person
51669,43,person,43,1,18383,48,1136,729,1226,1030,90,301,person
51670,45,traffic light,45,0,18383,42,728,436,873,800,145,364,traffic light
51671,46,person,46,1,18383,23,450,723,497,850,47,127,person
51672,0,fire hydrant,1,0,18384,16,343,1256,411,1388,68,132,fire hydrant
51673,0,car,1,0,18385,27,118,547,961,1245,843,698,car
51674,3,car,4,1,18385,15,2,476,244,706,242,230,car
51675,0,car,1,0,18386,19,973,908,1650,1231,677,323,car
51676,21,boat,21,1,18386,24,182,795,448,875,266,80,boat
51677,25,car,25,1,18386,18,122,856,248,920,126,64,car
51678,26,car,26,1,18386,22,1,863,159,959,158,96,car
51679,27,car,27,0,18386,30,151,865,406,970,255,105,car
51680,0,person,1,0,18387,27,815,735,944,1055,129,320,person
51681,3,person,4,0,18387,58,184,631,481,1269,297,638,person
51682,5,person,6,0,18387,31,573,705,661,972,88,267,person
51683,6,person,7,0,18387,49,1047,731,1219,1226,172,495,person
51684,7,person,8,0,18387,61,1269,728,1501,1244,232,516,person
51685,8,person,9,0,18387,40,1647,711,1842,1172,195,461,person
51686,11,person,12,0,18387,31,1767,740,1899,1147,132,407,person
51687,1,person,2,0,18388,75,415,987,599,1373,184,386,person
51688,3,person,4,0,18388,49,584,1150,666,1385,82,235,person
51689,4,person,5,1,18388,43,712,1012,803,1250,91,238,person
51690,6,person,7,0,18388,40,696,1089,800,1344,104,255,person
51691,7,person,8,0,18388,50,1036,1030,1186,1362,150,332,person
51692,8,bicycle,9,1,18388,26,1074,1191,1168,1393,94,202,bicycle
51693,9,person,10,0,18388,36,1158,1036,1220,1220,62,184,person
51694,14,person,15,0,18388,41,1836,1046,1942,1254,106,208,person
51695,15,bicycle,16,1,18388,37,1828,1126,1908,1248,80,122,bicycle
51696,22,person,23,0,18388,49,13,976,127,1308,114,332,person
51697,24,person,25,0,18388,49,134,995,231,1298,97,303,person
51698,25,person,26,0,18388,46,239,997,340,1305,101,308,person
51699,26,person,27,0,18388,45,332,1015,422,1311,90,296,person
51700,27,backpack,28,0,18388,17,376,1062,427,1194,51,132,backpack
51701,48,person,49,1,18388,17,105,1021,188,1270,83,249,person
51702,1,car,2,1,18389,16,690,728,2200,1651,1510,923,car
51703,20,car,20,1,18389,18,684,797,834,1033,150,236,car
51704,22,car,22,1,18389,17,988,837,1069,938,81,101,car
51705,3,bicycle,4,0,18390,50,121,1087,375,1237,254,150,bicycle
51706,6,person,7,0,18390,26,623,983,691,1194,68,211,person
51707,11,person,12,0,18390,21,1314,1005,1353,1162,39,157,person
51708,12,person,13,0,18390,24,1370,1000,1416,1162,46,162,person
51709,26,person,27,1,18390,21,576,980,639,1166,63,186,person
51710,2,car,3,0,18391,51,87,481,1485,1495,1398,1014,car
51711,13,motorbike,14,0,18391,31,1687,525,1775,710,88,185,motorcycle
51712,14,motorbike,15,1,18391,24,1537,486,1650,620,113,134,motorcycle
51713,29,door,30,1,18391,18,1629,405,1758,624,129,219,door
51714,2,car,3,0,18392,26,372,258,545,320,173,62,car
51715,3,bicycle,4,0,18392,29,173,280,279,358,106,78,bicycle
51716,4,car,5,0,18392,30,125,261,363,335,238,74,car
51717,6,car,7,1,18392,16,518,256,623,303,105,47,car
51718,13,person,14,0,18392,34,192,233,258,328,66,95,person
51719,14,person,15,1,18392,15,14,244,31,293,17,49,person
51720,16,person,17,1,18392,17,37,240,55,293,18,53,person
51721,17,person,18,1,18392,17,60,243,81,296,21,53,person
51722,18,person,19,0,18392,27,96,254,114,320,18,66,person
51723,19,person,20,1,18392,26,109,246,141,330,32,84,person
51724,81,door,82,0,18392,15,457,261,487,306,30,45,door
51725,0,car,1,0,18393,15,655,1028,1121,1226,466,198,car
51726,25,car,21,1,18393,19,1736,994,1852,1070,116,76,car
51727,26,car,22,1,18393,25,1588,1018,1737,1103,149,85,car
51728,27,car,23,1,18393,24,1859,1028,2083,1232,224,204,car
51729,28,car,24,1,18393,27,2001,1019,2164,1169,163,150,car
51730,0,car,1,0,18394,30,323,783,1317,1241,994,458,car
51731,1,car,2,0,18394,18,1732,750,2141,971,409,221,car
51732,4,car,5,0,18394,18,1252,775,1818,1074,566,299,car
51733,8,person,9,0,18395,33,1480,1044,1534,1248,54,204,person
51734,11,car,12,1,18395,24,1575,1099,2046,1524,471,425,car
51735,14,mirror,15,0,18395,17,1956,1232,2036,1305,80,73,mirror
51736,21,person,22,1,18395,19,1023,1033,1067,1122,44,89,person
51737,22,person,23,1,18395,22,1418,1063,1451,1181,33,118,person
51738,23,person,24,1,18395,21,1395,1061,1438,1198,43,137,person
51739,33,person,34,1,18395,15,594,1049,631,1125,37,76,person
51740,35,car,36,0,18395,32,394,1092,674,1268,280,176,car
51741,36,car,37,1,18395,24,227,1094,406,1233,179,139,car
51742,37,car,38,0,18395,24,60,1078,260,1210,200,132,car
51743,50,door,51,0,18395,18,1631,1112,1831,1445,200,333,door
51744,0,traffic light,1,0,18396,31,1138,117,1912,1104,774,987,traffic light
51745,5,truck,5,0,18396,15,1158,771,1500,993,342,222,truck
51746,19,car,14,1,18396,21,389,892,522,962,133,70,car
51747,20,car,15,1,18396,19,322,890,407,955,85,65,car
51748,21,motorbike,16,0,18396,32,523,878,612,966,89,88,motorcycle
51749,22,car,17,1,18396,23,692,898,817,975,125,77,car
51750,23,bench,18,1,18396,16,671,931,712,978,41,47,bench
51751,24,person,19,0,18396,25,645,904,697,977,52,73,person
51752,25,person,20,0,18396,25,619,902,683,976,64,74,person
51753,26,car,21,1,18396,22,595,896,671,968,76,72,car
51754,28,motorbike,23,0,18396,35,132,912,215,985,83,73,motorcycle
51755,29,person,24,0,18396,26,135,871,182,968,47,97,person
51756,30,car,25,1,18396,27,43,890,153,978,110,88,car
51757,35,traffic light,30,0,18396,33,706,733,794,998,88,265,traffic light
51758,37,person,32,0,18396,56,844,861,891,998,47,137,person
51759,38,person,33,0,18396,54,892,872,948,997,56,125,person
51760,39,person,34,0,18396,55,941,871,985,996,44,125,person
51761,44,person,39,0,18396,25,1992,880,2035,1017,43,137,person
51762,46,person,41,0,18396,23,1510,862,1545,984,35,122,person
51763,47,bicycle,42,0,18396,51,1546,936,1658,1031,112,95,bicycle
51764,48,person,43,0,18396,18,988,881,1025,971,37,90,person
51765,49,person,44,1,18396,17,1066,868,1101,964,35,96,person
51766,50,person,45,1,18396,17,732,869,764,985,32,116,person
51767,0,car,1,0,18397,23,1336,1059,2048,1381,712,322,car
51768,2,person,3,0,18397,18,268,1047,337,1280,69,233,person
51769,3,person,4,0,18397,24,339,1028,442,1287,103,259,person
51770,5,person,6,0,18397,29,1223,1068,1361,1450,138,382,person
51771,14,car,15,0,18397,33,506,1048,891,1236,385,188,car
51772,19,person,20,1,18397,17,1395,1080,1441,1194,46,114,person
51773,25,car,26,1,18397,16,44,1042,197,1122,153,80,car
51774,26,car,27,1,18397,19,96,1058,281,1170,185,112,car
51775,30,person,31,0,18397,19,1152,1072,1188,1200,36,128,person
51776,43,door,44,0,18397,15,548,1063,637,1191,89,128,door
51777,2,car,3,0,18398,31,92,243,372,330,280,87,car
51778,11,person,12,1,18398,18,30,232,52,293,22,61,person
51779,15,person,16,0,18398,22,369,228,385,288,16,60,person
51780,23,person,24,1,18398,15,142,228,161,270,19,42,person
51781,36,car,36,1,18399,17,2,1020,156,1127,154,107,car
51782,37,car,37,1,18399,24,3,1057,255,1388,252,331,car
51783,39,window,39,0,18399,15,7,1073,153,1176,146,103,window
51784,47,car,47,1,18399,17,658,1010,775,1131,117,121,car
51785,48,car,48,1,18399,25,483,1016,753,1188,270,172,car
51786,50,car,50,1,18399,18,917,1003,1033,1081,116,78,car
51787,55,car,55,1,18399,20,819,1018,966,1116,147,98,car
51788,56,person,56,1,18399,27,766,992,834,1131,68,139,person
51789,60,flowerpot,60,0,18399,15,994,1076,1063,1108,69,32,potted plant
51790,62,person,62,0,18399,28,1218,1042,1256,1127,38,85,person
51791,63,person,63,0,18399,38,1273,983,1327,1127,54,144,person
51792,66,flowerpot,66,0,18399,25,764,1131,899,1192,135,61,potted plant
51793,68,flowerpot,68,0,18399,44,376,1253,685,1391,309,138,potted plant
51794,71,person,71,0,18399,29,1036,1015,1123,1182,87,167,person
51795,72,person,72,0,18399,23,1117,1009,1170,1133,53,124,person
51796,8,traffic light,9,0,18400,26,741,891,968,1200,227,309,traffic light
51797,6,person,7,0,18401,40,475,1314,685,1875,210,561,person
51798,7,person,8,1,18401,25,715,1348,796,1639,81,291,person
51799,8,person,9,1,18401,23,899,1303,989,1665,90,362,person
51800,9,person,10,0,18401,42,775,1339,937,1888,162,549,person
51801,31,person,32,0,18401,20,1009,1363,1055,1512,46,149,person
51802,10,truck,11,0,18402,18,1337,839,1604,1063,267,224,truck
51803,15,person,16,0,18402,20,1700,923,1735,1062,35,139,person
51804,20,person,21,0,18402,19,1173,925,1194,993,21,68,person
51805,0,car,1,0,18403,23,309,1024,1004,1272,695,248,car
51806,4,bench,3,0,18404,43,1554,854,1712,937,158,83,bench
51807,5,bench,4,0,18404,28,1707,833,1905,886,198,53,bench
51808,19,person,17,0,18404,44,1304,713,1382,950,78,237,person
51809,0,motorbike,1,0,18405,25,130,1296,388,1480,258,184,motorcycle
51810,1,motorbike,2,0,18405,17,1279,1259,1420,1401,141,142,motorcycle
51811,4,traffic light,5,0,18405,25,851,1002,929,1411,78,409,traffic light
51812,5,person,6,0,18405,28,989,1192,1078,1400,89,208,person
51813,7,person,8,0,18405,34,1417,1213,1518,1487,101,274,person
51814,8,motorbikes,9,0,18405,20,1880,1232,2197,1390,317,158,motorcycle
51815,11,car,12,1,18405,16,1503,1231,1664,1369,161,138,car
51816,12,car,13,0,18405,23,1576,1230,1866,1402,290,172,car
51817,13,traffic light,14,0,18405,28,1719,969,1785,1447,66,478,traffic light
51818,37,person,38,0,18405,39,1340,1225,1399,1372,59,147,person
51819,4,bicycle,5,0,18406,23,729,1012,1016,1231,287,219,bicycle
51820,21,bicycle,22,0,18406,42,1502,898,1856,1107,354,209,bicycle
51821,23,bicycle,24,0,18406,55,540,1012,740,1208,200,196,bicycle
51822,24,bicycle,25,0,18406,51,381,1002,561,1188,180,186,bicycle
51823,30,bicycle,31,1,18406,15,5,961,70,1149,65,188,bicycle
51824,60,car,56,0,18407,15,43,319,200,374,157,55,car
51825,6,car,7,1,18408,21,1457,1095,2047,1534,590,439,car
51826,13,car,14,0,18408,33,819,954,1295,1259,476,305,car
51827,4,car,5,0,18409,27,56,346,213,407,157,61,car
51828,16,car,16,1,18409,16,292,337,344,367,52,30,car
51829,21,car,21,1,18409,15,502,330,552,365,50,35,car
51830,22,car,22,1,18409,25,406,336,518,373,112,37,car
51831,17,person,17,0,18411,177,133,546,396,1226,263,680,person
51832,1,car,2,0,18412,20,1365,1043,1778,1200,413,157,car
51833,6,car,7,0,18412,20,369,1020,714,1187,345,167,car
51834,15,motorbike,16,0,18413,22,812,865,905,922,93,57,motorcycle
51835,2,person,3,1,18414,39,1167,1041,1343,1529,176,488,person
51836,1,person,2,0,18415,18,166,520,216,660,50,140,person
51837,2,person,3,0,18415,19,86,524,132,655,46,131,person
51838,3,person,4,0,18415,15,1268,554,1314,651,46,97,person
51839,4,car,5,0,18415,19,1452,545,1744,657,292,112,car
51840,24,traffic light,24,0,18415,22,1181,258,1458,431,277,173,traffic light
51841,30,car,30,1,18415,16,1846,572,1926,635,80,63,car
51842,1,person,1,0,18416,17,790,880,872,1051,82,171,person
51843,4,traffic light,2,0,18416,19,1269,447,1342,1087,73,640,traffic light
51844,42,truck,30,0,18416,37,447,758,754,973,307,215,truck
51845,43,car,31,0,18416,29,181,875,474,972,293,97,car
51846,44,car,32,1,18416,19,753,875,826,958,73,83,car
51847,45,car,33,1,18416,19,856,892,960,956,104,64,car
51848,46,car,34,1,18416,20,974,857,1165,918,191,61,car
51849,47,car,35,0,18416,34,930,868,1151,1007,221,139,car
51850,48,car,36,1,18416,23,1149,870,1294,986,145,116,car
51851,51,person,39,0,18416,44,702,884,778,1121,76,237,person
51852,57,traffic light,45,1,18416,37,2,2,143,459,141,457,traffic light
51853,66,car,54,1,18416,33,1197,923,1417,1051,220,128,car
51854,67,car,55,1,18416,19,1361,920,1482,1018,121,98,car
51855,68,car,56,1,18416,18,1455,923,1544,1011,89,88,car
51856,69,car,57,1,18416,15,1511,915,1586,989,75,74,car
51857,72,person,60,0,18416,18,1945,911,1972,985,27,74,person
51858,74,person,62,0,18416,19,1837,918,1857,975,20,57,person
51859,75,person,63,0,18416,22,1861,916,1882,967,21,51,person
51860,7,person,8,0,18417,20,1459,961,1548,1158,89,197,person
51861,8,person,9,0,18417,23,1385,951,1453,1151,68,200,person
51862,9,person,10,0,18417,20,1305,945,1367,1151,62,206,person
51863,11,person,12,0,18417,15,1219,988,1262,1154,43,166,person
51864,0,car,1,0,18418,37,434,268,565,327,131,59,car
51865,17,car,12,1,18418,16,140,278,152,293,12,15,car
51866,18,car,13,0,18418,19,150,273,176,294,26,21,car
51867,19,car,14,1,18418,15,161,276,189,295,28,19,car
51868,20,car,15,1,18418,23,169,276,197,297,28,21,car
51869,21,car,16,0,18418,21,196,271,233,298,37,27,car
51870,22,car,17,1,18418,17,229,274,262,298,33,24,car
51871,1,truck,2,0,18420,20,82,668,541,1065,459,397,truck
51872,24,car,20,1,18420,15,495,827,564,900,69,73,car
51873,30,person,26,0,18420,23,1250,797,1297,918,47,121,person
51874,2,car,3,0,18421,19,10,737,152,810,142,73,car
51875,3,car,4,0,18421,37,148,732,503,877,355,145,car
51876,4,car,5,1,18421,20,458,724,581,817,123,93,car
51877,8,motorbike,9,1,18421,45,1770,785,1984,927,214,142,motorcycle
51878,9,person,10,0,18421,42,1913,737,1971,946,58,209,person
51879,10,person,11,0,18421,25,1619,749,1658,891,39,142,person
51880,12,traffic light,13,0,18421,63,1975,2,2195,951,220,949,traffic light
51881,6,car,7,1,18422,25,449,926,728,1131,279,205,car
51882,7,car,8,1,18422,28,711,931,1022,1160,311,229,car
51883,8,car,9,0,18422,18,1012,921,1407,1234,395,313,car
51884,6,car,7,1,18423,19,1946,842,2164,972,218,130,car
51885,7,person,8,1,18423,16,2022,878,2067,1033,45,155,person
51886,8,person,9,0,18423,18,2060,875,2133,1041,73,166,person
51887,9,person,10,0,18423,21,1883,856,1950,1031,67,175,person
51888,11,person,12,1,18423,26,1137,861,1234,1088,97,227,person
51889,12,person,13,0,18423,26,991,854,1050,1035,59,181,person
51890,24,person,25,0,18423,20,679,875,735,1012,56,137,person
51891,30,person,31,0,18423,22,1503,862,1557,970,54,108,person
51892,31,bicycle,32,0,18423,15,1507,914,1540,989,33,75,bicycle
51893,34,traffic light,35,0,18423,15,712,633,782,1136,70,503,traffic light
51894,36,bicycle,37,0,18423,17,1440,912,1487,992,47,80,bicycle
51895,37,person,38,1,18423,40,1439,874,1484,985,45,111,person
51896,38,person,39,0,18423,24,1383,866,1426,963,43,97,person
51897,0,car,1,0,18424,28,925,884,2044,1278,1119,394,car
51898,3,door,4,0,18424,15,683,804,809,954,126,150,door
51899,33,car,33,0,18424,21,421,791,964,999,543,208,car
51900,46,car,45,1,18424,30,1614,846,2009,978,395,132,car
51901,1,car,2,0,18425,32,269,299,433,360,164,61,car
51902,3,car,4,1,18425,17,431,306,561,353,130,47,car
51903,8,car,9,1,18425,20,91,296,253,379,162,83,car
51904,26,car,27,1,18425,15,83,292,118,314,35,22,car
51905,27,person,28,1,18425,15,407,283,418,316,11,33,person
51906,28,person,29,1,18425,17,419,283,433,320,14,37,person
51907,31,person,32,1,18425,16,571,287,583,327,12,40,person
51908,33,person,34,1,18425,15,559,290,570,327,11,37,person
51909,12,person,13,1,18426,38,1619,493,1787,939,168,446,person
51910,15,person,16,0,18426,23,1555,563,1622,807,67,244,person
51911,17,car,18,1,18426,30,1453,539,1681,731,228,192,car
51912,0,person,1,0,18427,23,1309,868,1434,1305,125,437,person
51913,26,traffic light,25,0,18428,47,1174,727,1373,950,199,223,traffic light
51914,29,car,28,0,18428,20,927,885,976,924,49,39,car
51915,30,car,29,0,18428,18,859,888,910,925,51,37,car
51916,31,person,30,0,18428,20,881,881,893,926,12,45,person
51917,34,truck,33,0,18428,24,1125,840,1228,920,103,80,truck
51918,35,car,34,0,18428,30,1088,896,1169,952,81,56,car
51919,36,car,35,0,18428,37,1165,896,1265,963,100,67,car
51920,37,car,36,1,18428,15,1254,901,1295,946,41,45,car
51921,38,car,37,0,18428,22,1273,901,1345,954,72,53,car
51922,39,car,38,0,18428,16,1021,886,1052,912,31,26,car
51923,40,car,39,1,18428,32,1396,916,1488,974,92,58,car
51924,41,car,40,1,18428,25,1446,921,1558,984,112,63,car
51925,42,car,41,1,18428,22,1509,924,1682,1009,173,85,car
51926,45,person,44,1,18428,52,1897,930,1997,1137,100,207,person
51927,46,person,45,1,18428,53,1865,937,1917,1123,52,186,person
51928,47,person,46,1,18428,40,1809,936,1866,1128,57,192,person
51929,48,person,47,1,18428,28,1785,931,1830,1024,45,93,person
51930,0,car,1,0,18429,15,510,820,1262,1092,752,272,car
51931,19,traffic light,18,0,18429,22,449,442,586,1041,137,599,traffic light
51932,33,person,32,0,18429,32,320,810,349,891,29,81,person
51933,38,traffic light,37,0,18429,24,270,598,358,968,88,370,traffic light
51934,0,car,1,0,18430,21,752,695,1760,1069,1008,374,car
51935,6,car,7,1,18430,21,1731,726,1984,991,253,265,car
51936,7,car,8,1,18430,16,1655,733,1851,1052,196,319,car
51937,9,traffic light,10,0,18430,28,234,246,381,1095,147,849,traffic light
51938,19,door,20,0,18430,17,1341,710,1545,969,204,259,door
51939,0,bicycle,1,0,18431,48,1503,907,1659,1015,156,108,bicycle
51940,10,car,11,0,18431,31,348,898,842,1045,494,147,car
51941,11,car,12,0,18431,27,1027,892,1506,1040,479,148,car
51942,12,car,13,0,18431,34,1670,853,2142,1028,472,175,car
51943,28,person,29,1,18431,19,1652,860,1682,972,30,112,person
51944,71,door,72,0,18431,15,593,906,692,1025,99,119,door
51945,12,bicycle,11,0,18432,38,1191,822,1319,1109,128,287,bicycle
51946,25,person,23,0,18432,97,781,600,940,1016,159,416,person
51947,5,person,6,0,18433,32,921,986,1099,1356,178,370,person
51948,8,person,9,0,18433,27,48,952,138,1249,90,297,person
51949,9,person,10,1,18433,19,2,959,97,1365,95,406,person
51950,34,person,35,0,18433,25,1070,998,1128,1182,58,184,person
51951,35,person,35,0,18434,15,1030,1432,1055,1507,25,75,person
51952,38,person,38,1,18434,15,1366,1424,1410,1525,44,101,person
51953,8,door,9,0,18435,16,7,942,370,1532,363,590,door
51954,17,car,18,0,18435,24,1793,947,2015,1066,222,119,car
51955,20,car,21,1,18435,22,1433,979,1585,1155,152,176,car
51956,21,car,22,1,18435,28,1220,974,1510,1211,290,237,car
51957,22,car,23,0,18435,36,773,1005,1327,1363,554,358,car
51958,13,car,14,1,18436,22,1287,1126,1564,1354,277,228,car
51959,14,car,15,1,18436,29,1448,1154,1939,1448,491,294,car
51960,15,car,16,1,18436,16,1781,1220,2044,1536,263,316,car
51961,20,car,21,1,18436,21,533,1112,789,1298,256,186,car
51962,21,car,22,1,18436,19,487,1115,712,1371,225,256,car
51963,22,car,23,0,18436,20,4,1126,614,1536,610,410,car
51964,2,car,3,0,18437,28,62,431,1075,1039,1013,608,car
51965,7,person,8,0,18437,57,1378,329,1783,1150,405,821,person
51966,22,door,21,0,18437,15,168,449,356,878,188,429,door
51967,8,person,7,0,18438,41,65,882,186,1191,121,309,person
51968,9,person,8,1,18438,33,176,904,246,1121,70,217,person
51969,10,person,9,0,18438,46,237,860,346,1198,109,338,person
51970,14,bicycle,13,0,18438,26,882,957,943,1039,61,82,bicycle
51971,15,person,14,0,18438,19,959,930,995,1058,36,128,person
51972,17,person,16,1,18438,18,692,921,758,1035,66,114,person
51973,18,person,17,1,18438,20,749,929,847,1039,98,110,person
51974,20,person,19,1,18438,20,512,896,577,995,65,99,person
51975,71,person,70,0,18438,43,1355,908,1519,1240,164,332,person
51976,72,bicycle,71,0,18438,40,1372,1052,1527,1279,155,227,bicycle
51977,73,person,72,0,18438,45,1192,899,1328,1271,136,372,person
51978,3,person,4,0,18439,31,1008,909,1055,1048,47,139,person
51979,4,person,5,0,18439,28,1064,935,1109,1046,45,111,person
51980,20,umbrella,21,0,18439,17,359,871,392,959,33,88,umbrella
51981,25,car,26,1,18439,26,416,952,626,1148,210,196,car
51982,26,car,27,1,18439,41,245,966,598,1357,353,391,car
51983,27,car,28,1,18439,19,1,1023,424,1464,423,441,car
51984,4,car,5,0,18440,30,36,1481,577,1792,541,311,car
51985,9,car,10,0,18440,19,796,1541,1004,1669,208,128,car
51986,12,car,13,0,18440,19,1065,1517,1266,1675,201,158,car
51987,13,person,14,0,18440,28,1452,1513,1528,1716,76,203,person
51988,17,person,18,0,18440,21,1528,1528,1566,1689,38,161,person
51989,25,person,25,0,18440,19,20,1492,92,1660,72,168,person
51990,33,person,32,0,18440,23,1298,1521,1358,1708,60,187,person
51991,34,person,33,1,18440,20,1335,1533,1390,1701,55,168,person
51992,35,person,34,0,18440,27,1367,1523,1430,1711,63,188,person
51993,36,person,35,1,18440,16,104,1491,145,1584,41,93,person
51994,3,car,4,0,18441,21,866,994,1218,1165,352,171,car
51995,13,car,14,1,18441,16,1911,949,2027,1029,116,80,car
51996,14,car,15,1,18441,15,1846,956,1954,1039,108,83,car
51997,0,car,1,0,18442,19,3,321,248,508,245,187,car
51998,1,person,2,0,18442,20,507,345,537,400,30,55,person
51999,2,person,3,0,18442,43,562,341,668,598,106,257,person
52000,3,car,4,0,18442,23,264,327,377,425,113,98,car
52001,0,parking meter,1,0,18443,19,965,553,1005,809,40,256,parking meter
52002,10,parking meter,11,0,18443,15,1443,599,1504,1072,61,473,parking meter
52003,18,person,19,0,18443,18,442,483,474,590,32,107,person
52004,2,car,3,0,18444,18,1084,933,1810,1162,726,229,car
52005,3,car,4,0,18444,16,180,898,888,1152,708,254,car
52006,8,person,9,0,18444,17,1854,869,1970,1094,116,225,person
52007,23,person,24,1,18444,19,1261,893,1319,999,58,106,person
52008,24,parking meter,25,0,18444,16,1082,917,1111,1060,29,143,parking meter
52009,27,window,28,0,18444,17,898,779,1507,974,609,195,window
52010,0,person,1,0,18445,36,94,1030,165,1254,71,224,person
52011,1,car,2,0,18445,31,1500,1031,1892,1204,392,173,car
52012,3,person,4,0,18445,29,1473,981,1571,1226,98,245,person
52013,45,person,37,1,18445,15,1548,980,1593,1091,45,111,person
52014,61,bicycle,53,1,18445,32,1212,1078,1302,1184,90,106,bicycle
52015,63,person,55,0,18445,39,564,986,630,1186,66,200,person
52016,64,person,56,0,18445,46,672,996,759,1194,87,198,person
52017,65,person,57,0,18445,39,837,1002,899,1186,62,184,person
52018,66,person,58,0,18445,38,1278,1026,1367,1227,89,201,person
52019,67,person,59,0,18445,39,156,1021,240,1220,84,199,person
52020,68,person,60,1,18445,35,273,997,357,1213,84,216,person
52021,69,person,61,0,18445,22,377,991,427,1189,50,198,person
52022,70,person,62,1,18445,29,427,983,480,1189,53,206,person
52023,71,person,63,0,18445,30,467,1003,518,1203,51,200,person
52024,72,traffic light,64,1,18445,60,1,466,307,1238,306,772,traffic light
52025,4,fire hydrant,5,0,18446,40,592,1024,646,1176,54,152,fire hydrant
52026,5,car,6,0,18446,27,578,928,871,1032,293,104,car
52027,7,traffic light,8,0,18446,15,1910,627,1999,1033,89,406,traffic light
52028,2,car,3,0,18449,40,1327,923,1961,1197,634,274,car
52029,3,car,4,0,18449,30,860,870,1349,1120,489,250,car
52030,4,car,5,0,18449,23,648,910,867,1069,219,159,car
52031,5,car,6,0,18449,30,335,887,682,1069,347,182,car
52032,8,car,9,1,18449,20,234,890,320,983,86,93,car
52033,9,car,10,1,18449,19,169,885,263,968,94,83,car
52034,14,person,15,1,18449,15,616,876,650,947,34,71,person
52035,16,car,17,1,18449,17,98,879,194,958,96,79,car
52036,18,car,19,1,18449,16,35,858,126,894,91,36,car
52037,19,person,20,0,18449,18,32,867,55,945,23,78,person
52038,2,car,3,0,18450,19,1036,911,1781,1203,745,292,car
52039,3,car,4,0,18450,26,364,944,966,1170,602,226,car
52040,8,car,8,0,18450,21,2,936,335,1117,333,181,car
52041,14,person,14,1,18450,23,1681,897,1751,1040,70,143,person
52042,15,parking meter,15,0,18450,30,1786,956,1848,1164,62,208,parking meter
52043,42,parking meter,42,0,18450,21,331,936,375,1098,44,162,parking meter
52044,1,car,2,0,18451,31,1270,825,2048,1364,778,539,car
52045,2,car,3,1,18451,22,1169,755,1523,1088,354,333,car
52046,53,car,49,1,18451,18,1047,747,1132,838,85,91,car
52047,54,car,50,1,18451,21,1058,757,1169,853,111,96,car
52048,56,car,52,1,18451,18,1205,725,1257,757,52,32,car
52049,57,car,53,1,18451,18,1155,714,1208,737,53,23,car
52050,63,person,59,1,18451,15,1438,734,1454,762,16,28,person
52051,68,car,64,1,18451,15,1132,710,1159,731,27,21,car
52052,69,car,65,1,18451,15,1106,708,1146,725,40,17,car
52053,71,bicycle,67,0,18451,21,1114,723,1127,739,13,16,bicycle
52054,81,door,77,0,18451,18,1276,850,1426,1161,150,311,door
52055,83,door,79,0,18451,19,1331,851,1465,1223,134,372,door
52056,0,person,1,0,18452,15,588,907,719,1179,131,272,person
52057,21,person,22,0,18453,23,979,948,1037,1148,58,200,person
52058,22,person,23,1,18453,21,1148,948,1198,1136,50,188,person
52059,23,person,24,0,18453,27,1197,941,1245,1146,48,205,person
52060,24,person,25,1,18453,24,1954,822,2048,1134,94,312,person
52061,0,car,1,0,18454,18,361,987,1069,1206,708,219,car
52062,25,door,26,0,18454,17,685,1004,840,1169,155,165,door
52063,28,door,29,0,18454,15,531,1003,714,1171,183,168,door
52064,0,car,1,0,18455,25,423,816,1450,1176,1027,360,car
52065,6,person,7,0,18455,21,1372,747,1517,1195,145,448,person
52066,31,person,32,0,18456,58,33,1086,170,1451,137,365,person
52067,35,person,36,1,18456,39,208,1124,316,1413,108,289,person
52068,36,person,37,0,18456,47,278,1080,448,1462,170,382,person
52069,37,bicycle,38,0,18456,136,177,1258,512,1473,335,215,bicycle
52070,38,person,39,0,18456,41,762,1111,859,1422,97,311,person
52071,39,bicycle,40,0,18456,124,784,1245,1148,1479,364,234,bicycle
52072,41,person,42,0,18456,33,1751,1071,1839,1375,88,304,person
52073,4,car,5,0,18457,27,1187,933,1358,1035,171,102,car
52074,111,bicycle,112,0,18457,35,258,969,319,1012,61,43,bicycle
52075,112,bicycle,113,1,18457,35,223,966,268,1009,45,43,bicycle
52076,113,motorbike,114,0,18457,33,144,951,224,1005,80,54,motorcycle
52077,3,car,4,1,18458,30,1671,1060,2198,1445,527,385,car
52078,6,motorbike,7,1,18458,46,1558,1105,1843,1327,285,222,motorcycle
52079,7,motorbike,8,1,18458,46,1473,1081,1716,1271,243,190,motorcycle
52080,8,motorbike,9,0,18458,67,1190,1111,1492,1366,302,255,motorcycle
52081,11,motorbike,12,1,18458,24,912,1084,988,1163,76,79,motorcycle
52082,13,motorbike,14,0,18458,17,775,1076,836,1158,61,82,motorcycle
52083,14,motorbike,15,0,18458,25,993,1067,1084,1148,91,81,motorcycle
52084,15,motorbike,16,1,18458,28,599,1076,700,1158,101,82,motorcycle
52085,0,car,1,0,18459,46,0,1245,873,1647,873,402,car
52086,30,person,29,1,18459,15,2113,1202,2198,1645,85,443,person
52087,38,window,37,0,18459,17,351,1265,725,1361,374,96,window
52088,41,door,40,0,18459,16,53,1265,295,1552,242,287,door
52089,0,person,1,0,18460,16,1149,828,1302,1219,153,391,person
52090,44,bench,33,1,18460,18,1343,970,1492,1051,149,81,bench
52091,52,person,41,1,18460,26,933,850,982,958,49,108,person
52092,53,person,42,0,18460,30,712,858,749,954,37,96,person
52093,57,person,46,0,18460,31,773,850,823,940,50,90,person
52094,58,person,47,0,18460,30,635,844,670,946,35,102,person
52095,59,person,48,0,18460,43,382,840,457,1032,75,192,person
52096,60,person,49,1,18460,22,1453,852,1492,973,39,121,person
52097,63,bus,52,1,18460,55,1754,773,1945,1007,191,234,bus
52098,64,bus,53,1,18460,25,1927,729,2046,1052,119,323,bus
52099,66,person,55,1,18460,36,1372,861,1425,971,53,110,person
52100,83,person,72,1,18460,31,949,914,1031,1034,82,120,person
52101,84,person,73,1,18460,43,1032,913,1118,1038,86,125,person
52102,85,person,74,1,18460,24,1003,850,1037,943,34,93,person
52103,86,person,75,1,18460,22,993,907,1039,963,46,56,person
52104,87,bench,76,1,18460,67,934,959,1190,1028,256,69,bench
52105,88,person,77,1,18460,32,1480,861,1523,997,43,136,person
52106,89,person,78,1,18460,18,1596,867,1633,909,37,42,person
52107,0,car,1,0,18461,24,937,981,1954,1269,1017,288,car
52108,17,car,18,1,18461,18,954,1033,1076,1149,122,116,car
52109,21,traffic light,22,0,18461,17,709,942,754,1163,45,221,traffic light
52110,22,person,23,0,18461,29,447,1018,494,1151,47,133,person
52111,2,car,3,0,18462,22,1374,679,2007,986,633,307,car
52112,31,traffic light,32,0,18462,33,343,444,461,885,118,441,traffic light
52113,42,door,41,0,18462,17,1659,695,1797,922,138,227,door
52114,0,person,1,0,18463,44,1914,1011,1977,1162,63,151,person
52115,8,person,9,0,18463,29,1659,1030,1701,1187,42,157,person
52116,9,car,10,0,18463,27,1271,1076,1647,1199,376,123,car
52117,10,car,11,0,18463,33,817,1112,1101,1226,284,114,car
52118,19,flowerpot,15,0,18463,15,739,406,819,510,80,104,potted plant
52119,41,window,37,0,18463,15,1443,917,1830,1092,387,175,window
52120,62,street sign,58,0,18463,117,910,377,1128,1295,218,918,street sign
52121,74,door,70,0,18463,17,1462,1079,1542,1176,80,97,door
52122,80,person,76,0,18463,30,2072,991,2113,1114,41,123,person
52123,81,person,77,0,18463,34,2040,1005,2074,1118,34,113,person
52124,82,person,78,0,18463,40,2130,1012,2168,1116,38,104,person
52125,83,person,79,0,18463,36,2154,998,2200,1116,46,118,person
52126,84,person,80,0,18463,34,1219,1052,1261,1171,42,119,person
52127,85,person,81,0,18463,19,1287,1064,1311,1144,24,80,person
52128,24,bus,15,1,18464,19,808,716,977,933,169,217,bus
52129,31,person,22,1,18464,34,1096,855,1158,1152,62,297,person
52130,32,person,23,1,18464,27,982,826,1056,1053,74,227,person
52131,35,person,26,0,18464,31,901,843,1002,1100,101,257,person
52132,36,person,27,0,18464,36,714,801,861,1172,147,371,person
52133,37,person,28,0,18464,35,1151,877,1252,1152,101,275,person
52134,38,person,29,1,18464,28,1277,846,1368,1002,91,156,person
52135,39,person,30,0,18464,32,1285,893,1399,1219,114,326,person
52136,40,person,31,0,18464,38,1382,859,1493,1199,111,340,person
52137,41,person,32,0,18464,26,1508,835,1580,1212,72,377,person
52138,45,person,36,0,18464,30,1025,841,1141,1188,116,347,person
52139,0,person,1,0,18465,29,1672,573,1913,1239,241,666,person
52140,2,person,3,0,18465,26,222,647,266,743,44,96,person
52141,4,car,4,0,18465,22,950,658,1087,746,137,88,car
52142,21,person,18,0,18465,46,1623,676,1675,860,52,184,person
52143,22,person,19,0,18465,65,1534,672,1618,859,84,187,person
52144,23,person,20,1,18465,26,1517,682,1544,777,27,95,person
52145,24,person,21,0,18465,38,1472,691,1532,858,60,167,person
52146,30,car,27,1,18465,25,1299,671,1387,739,88,68,car
52147,31,car,28,0,18465,41,1193,685,1331,772,138,87,car
52148,32,car,29,1,18465,29,1353,695,1478,786,125,91,car
52149,36,motorbike,33,1,18465,15,1087,682,1131,721,44,39,motorcycle
52150,38,car,35,1,18465,22,806,668,888,737,82,69,car
52151,39,car,36,1,18465,26,694,654,811,742,117,88,car
52152,40,car,37,1,18465,27,589,655,705,746,116,91,car
52153,41,bicycle,38,0,18465,42,544,692,614,752,70,60,bicycle
52154,42,person,39,0,18465,32,557,652,604,731,47,79,person
52155,0,car,1,0,18466,19,117,253,197,286,80,33,car
52156,1,car,2,0,18466,23,193,259,289,293,96,34,car
52157,2,car,3,0,18466,20,476,245,587,292,111,47,car
52158,3,car,4,0,18466,42,297,251,449,302,152,51,car
52159,22,car,23,1,18466,18,432,249,489,286,57,37,car
52160,63,door,63,0,18466,15,517,247,550,281,33,34,door
52161,33,car,22,1,18467,17,1172,912,1384,1006,212,94,car
52162,34,car,23,1,18467,21,1731,921,1940,1049,209,128,car
52163,37,traffic light,26,0,18467,69,791,481,1118,926,327,445,traffic light
52164,39,car,28,0,18467,39,743,923,1331,1185,588,262,car
52165,40,person,29,0,18467,37,664,895,723,1071,59,176,person
52166,41,person,30,1,18467,19,767,895,812,987,45,92,person
52167,42,person,31,1,18467,16,870,876,926,938,56,62,person
52168,44,traffic light,33,0,18467,15,551,785,588,984,37,199,traffic light
52169,45,person,34,0,18467,48,202,860,316,1130,114,270,person
52170,52,person,41,0,18467,33,410,887,456,996,46,109,person
52171,53,person,42,0,18467,29,495,884,532,993,37,109,person
52172,2,person,3,0,18468,40,1837,786,1997,1205,160,419,person
52173,3,person,4,0,18468,28,1196,784,1284,1027,88,243,person
52174,12,person,13,0,18468,16,726,778,828,1071,102,293,person
52175,18,table,19,0,18468,24,991,923,1112,1098,121,175,dining table
52176,20,person,21,1,18468,16,1037,751,1118,925,81,174,person
52177,0,person,1,0,18469,24,368,839,521,1417,153,578,person
52178,1,person,2,0,18469,27,588,826,804,1382,216,556,person
52179,16,person,17,0,18469,38,160,845,247,1233,87,388,person
52180,8,car,9,0,18470,24,1376,592,1805,901,429,309,car
52181,9,parking meter,10,0,18470,20,1580,662,1640,1047,60,385,parking meter
52182,10,car,11,1,18470,16,1958,748,2195,1196,237,448,car
52183,11,car,12,0,18471,23,537,1226,1301,1491,764,265,car
52184,14,car,15,1,18471,15,152,1255,485,1534,333,279,car
52185,26,car,26,1,18471,18,543,1203,645,1319,102,116,car
52186,27,car,27,1,18471,26,284,1183,569,1313,285,130,car
52187,29,car,29,1,18471,20,137,1189,440,1295,303,106,car
52188,30,car,30,1,18471,16,1,1187,318,1276,317,89,car
52189,37,car,36,1,18471,17,1437,1204,1679,1336,242,132,car
52190,39,car,38,1,18471,27,1207,1230,1580,1448,373,218,car
52191,40,car,39,1,18471,22,1218,1245,1486,1385,268,140,car
52192,2,person,1,1,18472,39,175,375,615,1196,440,821,person
52193,43,car,39,1,18472,15,1087,519,1134,563,47,44,car
52194,44,car,40,1,18472,15,1061,519,1111,560,50,41,car
52195,45,car,41,1,18472,20,993,495,1064,568,71,73,car
52196,46,bus,42,1,18472,26,873,448,956,576,83,128,bus
52197,47,person,43,1,18472,22,873,462,921,654,48,192,person
52198,48,person,44,1,18472,43,877,538,1024,788,147,250,person
52199,49,person,45,1,18472,59,987,542,1059,841,72,299,person
52200,1,car,2,0,18473,31,1571,976,2034,1136,463,160,car
52201,2,car,3,0,18473,35,243,987,939,1209,696,222,car
52202,54,door,55,0,18473,18,1869,981,1963,1092,94,111,door
52203,2,car,3,0,18474,16,4,811,306,1162,302,351,car
52204,10,car,11,0,18474,19,1683,883,2195,1301,512,418,car
52205,12,truck,13,0,18474,22,1422,777,1990,1222,568,445,truck
52206,0,person,1,0,18475,16,580,776,701,1050,121,274,person
52207,19,person,18,0,18475,21,803,803,845,890,42,87,person
52208,29,traffic light,28,0,18475,22,705,670,759,872,54,202,traffic light
52209,31,traffic light,30,0,18475,29,587,423,662,902,75,479,traffic light
52210,32,person,31,1,18475,39,1343,776,1475,1142,132,366,person
52211,7,person,6,0,18476,30,815,1155,891,1378,76,223,person
52212,19,person,8,0,18476,51,700,1154,746,1334,46,180,person
52213,20,person,9,0,18476,63,785,1154,840,1327,55,173,person
52214,23,person,12,0,18476,75,986,1156,1044,1302,58,146,person
52215,52,door,20,0,18476,18,1415,1208,1778,1532,363,324,door
52216,68,person,35,1,18476,36,653,1145,701,1339,48,194,person
52217,69,person,36,1,18476,16,618,1146,649,1218,31,72,person
52218,70,person,37,0,18476,32,618,1156,680,1339,62,183,person
52219,71,car,38,1,18476,53,402,1145,715,1284,313,139,car
52220,72,person,39,1,18476,15,313,1142,347,1195,34,53,person
52221,73,person,40,1,18476,16,338,1148,370,1209,32,61,person
52222,74,person,41,1,18476,21,365,1157,429,1239,64,82,person
52223,90,traffic light,57,0,18476,21,1509,1089,1618,1125,109,36,traffic light
52224,14,person,15,0,18478,21,905,968,968,1157,63,189,person
52225,15,person,16,0,18478,27,288,957,389,1252,101,295,person
52226,17,person,18,0,18478,32,431,967,528,1233,97,266,person
52227,18,car,19,1,18478,17,499,973,781,1105,282,132,car
52228,19,person,20,0,18478,31,991,996,1057,1132,66,136,person
52229,20,person,21,0,18478,28,1066,989,1105,1134,39,145,person
52230,22,person,23,0,18478,28,1107,979,1177,1156,70,177,person
52231,24,traffic light,25,0,18478,26,1336,831,1439,1123,103,292,traffic light
52232,27,person,28,0,18478,21,1492,977,1552,1121,60,144,person
52233,34,person,34,0,18478,26,198,952,237,1142,39,190,person
52234,51,bicycle,51,1,18478,37,757,1113,896,1357,139,244,bicycle
52235,52,person,52,0,18478,62,763,975,893,1300,130,325,person
52236,11,car,12,0,18479,22,991,1092,1240,1226,249,134,car
52237,16,car,17,0,18479,18,636,1104,773,1184,137,80,car
52238,9,bench,10,0,18480,17,2,362,52,431,50,69,bench
52239,14,person,15,0,18480,20,468,307,483,339,15,32,person
52240,0,person,1,0,18481,26,76,695,349,1154,273,459,person
52241,1,car,2,0,18481,18,464,757,902,1079,438,322,car
52242,3,car,4,0,18481,20,192,405,372,767,180,362,car
52243,27,car,28,1,18481,22,714,744,983,970,269,226,car
52244,28,car,29,1,18481,22,742,717,992,907,250,190,car
52245,58,bicycle,55,1,18481,16,951,909,999,1058,48,149,bicycle
52246,0,car,1,0,18482,28,1304,1015,1812,1330,508,315,car
52247,2,car,3,0,18482,19,1144,1038,1386,1226,242,188,car
52248,4,car,5,0,18482,20,1702,1118,2192,1644,490,526,car
52249,6,car,7,0,18482,24,6,1091,347,1625,341,534,car
52250,7,car,8,0,18482,30,43,972,469,1345,426,373,car
52251,8,car,9,0,18482,22,414,991,618,1199,204,208,car
52252,2,truck,3,0,18483,22,4,1024,285,1282,281,258,truck
52253,4,person,5,0,18483,15,690,1105,731,1191,41,86,person
52254,5,person,6,0,18483,21,739,1093,786,1220,47,127,person
52255,34,table,32,0,18484,27,381,404,422,438,41,34,dining table
52256,35,flowerpot,33,0,18484,15,412,462,498,506,86,44,potted plant
52257,36,flowerpot,34,0,18484,17,216,449,281,478,65,29,potted plant
52258,7,car,8,0,18487,45,88,986,775,1227,687,241,car
52259,13,car,14,0,18487,29,1474,951,1804,1092,330,141,car
52260,21,car,22,0,18487,40,798,919,1357,1154,559,235,car
52261,23,car,24,0,18487,26,1824,934,2079,1058,255,124,car
52262,3,person,4,0,18488,30,239,1183,308,1380,69,197,person
52263,16,person,15,0,18489,30,2,955,182,1344,180,389,person
52264,17,motorbike,16,0,18489,58,146,1074,451,1360,305,286,motorcycle
52265,19,car,18,0,18489,16,433,944,508,995,75,51,car
52266,20,person,19,0,18489,20,840,936,868,1012,28,76,person
52267,30,person,29,0,18489,19,807,938,834,1021,27,83,person
52268,31,person,30,0,18489,17,734,940,762,1007,28,67,person
52269,3,car,4,0,18490,27,1643,895,1906,1062,263,167,car
52270,5,car,6,1,18490,22,415,862,721,1048,306,186,car
52271,13,person,14,1,18490,19,1593,867,1618,942,25,75,person
52272,14,person,15,0,18490,24,1607,873,1636,941,29,68,person
52273,26,traffic light,27,0,18490,16,1036,592,1096,959,60,367,traffic light
52274,34,traffic light,35,0,18490,25,583,681,770,861,187,180,traffic light
52275,37,motorbike,38,1,18490,35,2054,1264,2201,1467,147,203,motorcycle
52276,0,car,1,0,18491,31,1019,630,1683,945,664,315,car
52277,11,car,12,1,18491,17,709,644,906,703,197,59,car
52278,14,car,15,1,18491,17,492,650,594,699,102,49,car
52279,22,traffic light,23,0,18491,20,1395,491,1449,585,54,94,traffic light
52280,25,traffic light,26,0,18491,16,1978,536,2023,722,45,186,traffic light
52281,27,person,28,0,18491,30,1712,617,1767,726,55,109,person
52282,28,person,29,0,18491,24,1823,623,1849,719,26,96,person
52283,29,person,30,0,18491,27,1855,622,1889,718,34,96,person
52284,30,person,31,0,18491,26,2141,623,2183,721,42,98,person
52285,0,person,1,0,18493,17,1018,402,1140,666,122,264,person
52286,1,person,2,0,18493,15,1148,416,1241,672,93,256,person
52287,3,car,4,0,18493,20,626,471,893,647,267,176,car
52288,11,car,12,1,18493,17,845,487,957,639,112,152,car
52289,12,car,13,1,18493,15,914,494,1012,637,98,143,car
52290,0,person,1,0,18494,27,515,925,678,1417,163,492,person
52291,17,motorbikes,11,0,18494,44,1349,952,1745,1184,396,232,motorcycle
52292,30,person,24,0,18494,37,766,911,840,1144,74,233,person
52293,32,person,26,0,18494,36,704,910,767,1113,63,203,person
52294,33,person,27,0,18494,16,674,899,695,1019,21,120,person
52295,34,person,28,0,18494,24,864,890,911,1027,47,137,person
52296,35,person,29,0,18494,35,415,888,500,1169,85,281,person
52297,36,person,30,0,18494,34,322,877,419,1168,97,291,person
52298,37,person,31,0,18494,20,255,898,286,1057,31,159,person
52299,4,person,5,1,18496,27,1407,1100,1538,1805,131,705,person
52300,6,person,7,1,18496,36,1243,1144,1410,1709,167,565,person
52301,9,person,10,0,18496,18,394,1187,482,1566,88,379,person
52302,12,person,13,1,18496,17,570,1159,649,1410,79,251,person
52303,13,person,14,0,18496,28,478,1171,626,1642,148,471,person
52304,15,person,16,1,18496,27,661,1215,825,1689,164,474,person
52305,17,person,18,0,18496,46,773,1199,1028,1825,255,626,person
52306,20,person,21,0,18496,39,1008,1163,1211,1789,203,626,person
52307,4,person,5,0,18497,40,1052,809,1113,939,61,130,person
52308,10,person,10,0,18497,55,986,803,1042,919,56,116,person
52309,11,person,11,0,18497,42,1088,818,1132,934,44,116,person
52310,12,person,12,0,18497,58,1334,818,1395,957,61,139,person
52311,13,person,13,0,18497,65,1209,814,1282,957,73,143,person
52312,14,person,14,0,18497,51,1181,814,1216,963,35,149,person
52313,15,person,15,1,18497,17,279,788,308,822,29,34,person
52314,16,person,16,1,18497,18,239,785,279,820,40,35,person
52315,17,person,17,1,18497,19,183,797,217,839,34,42,person
52316,18,person,18,0,18497,24,0,779,23,860,23,81,person
52317,19,person,19,0,18497,58,1905,813,1950,995,45,182,person
52318,21,person,20,1,18497,39,1344,828,1400,954,56,126,person
52319,23,car,22,0,18497,51,1771,822,1890,907,119,85,car
52320,24,car,23,0,18497,60,1876,847,2074,959,198,112,car
52321,25,car,24,0,18497,21,1973,830,2063,890,90,60,car
52322,26,car,25,0,18497,18,1864,829,1920,874,56,45,car
52323,27,car,26,0,18497,20,2051,839,2084,893,33,54,car
52324,28,car,27,0,18497,29,2074,831,2199,929,125,98,car
52325,45,traffic light,41,0,18497,21,1189,389,1326,611,137,222,traffic light
52326,1,car,2,0,18498,16,1170,478,1467,650,297,172,car
52327,3,person,4,0,18498,17,407,452,534,712,127,260,person
52328,18,bicycle,19,1,18498,16,646,569,700,707,54,138,bicycle
52329,23,bench,24,1,18498,22,33,828,569,1198,536,370,bench
52330,41,traffic light,34,1,18499,35,1,508,363,1082,362,574,traffic light
52331,42,traffic light,35,1,18499,48,1874,1,2197,1648,323,1647,traffic light
52332,47,person,40,1,18499,21,2063,933,2124,1041,61,108,person
52333,51,person,44,0,18499,34,784,957,827,1085,43,128,person
52334,52,person,45,0,18499,32,682,931,721,1047,39,116,person
52335,53,person,46,0,18499,38,715,929,755,1047,40,118,person
52336,54,person,47,0,18499,25,644,936,691,1099,47,163,person
52337,55,person,48,1,18499,23,629,941,656,1092,27,151,person
52338,56,person,49,1,18499,30,613,916,656,1047,43,131,person
52339,59,person,52,1,18499,25,1,922,36,1053,35,131,person
52340,62,traffic light,55,0,18499,20,1557,839,1630,906,73,67,traffic light
52341,67,car,60,1,18499,16,1649,920,1712,982,63,62,car
52342,72,person,65,1,18499,94,1898,869,2195,1626,297,757,person
52343,73,backpack,66,0,18499,25,2064,1025,2130,1209,66,184,backpack
52344,9,motorbike,10,0,18500,47,589,1091,773,1212,184,121,motorcycle
52345,15,motorbikes,16,0,18500,20,763,1030,860,1084,97,54,motorcycle
52346,17,motorbike,18,1,18500,55,586,1038,734,1167,148,129,motorcycle
52347,2,bus,3,0,18501,24,39,1304,131,1374,92,70,bus
52348,5,person,6,0,18501,23,1842,1228,1916,1386,74,158,person
52349,5,person,5,0,18502,20,1250,1341,1350,1648,100,307,person
52350,6,person,6,0,18502,45,268,1317,454,1723,186,406,person
52351,9,person,9,0,18502,43,948,1335,1064,1716,116,381,person
52352,10,person,10,0,18502,43,1052,1321,1239,1771,187,450,person
52353,56,person,52,0,18502,57,435,1336,570,1705,135,369,person
52354,57,person,53,1,18502,32,896,1458,1072,1684,176,226,person
52355,58,person,54,1,18502,42,1169,1349,1240,1651,71,302,person
52356,0,car,1,0,18503,31,1309,991,2101,1239,792,248,car
52357,1,car,2,0,18503,24,372,1018,1174,1262,802,244,car
52358,78,door,79,0,18503,15,649,1030,888,1214,239,184,door
52359,85,door,86,0,18503,15,1620,997,1789,1189,169,192,door
52360,87,door,88,0,18503,17,1777,996,1939,1180,162,184,door
52361,7,person,8,0,18504,27,401,937,835,1536,434,599,person
52362,9,person,10,1,18504,39,127,1082,396,1536,269,454,person
52363,12,car,13,1,18504,17,2,983,98,1048,96,65,car
52364,13,person,14,0,18504,24,164,976,197,1038,33,62,person
52365,14,person,15,0,18504,25,572,984,598,1080,26,96,person
52366,17,person,18,1,18504,26,2,1061,218,1534,216,473,person
52367,24,person,25,0,18504,31,1269,1000,1317,1148,48,148,person
52368,25,person,26,0,18504,49,1313,992,1389,1147,76,155,person
52369,27,person,28,1,18504,21,1178,976,1231,1061,53,85,person
52370,28,motorbike,29,0,18504,27,1158,1047,1234,1152,76,105,motorcycle
52371,17,motorbike,18,0,18505,19,1220,935,1275,1046,55,111,motorcycle
52372,21,motorbike,22,1,18505,19,6,1055,127,1339,121,284,motorcycle
52373,33,motorbike,34,0,18505,17,816,965,868,1055,52,90,motorcycle
52374,0,car,1,0,18506,33,526,766,1582,1192,1056,426,car
52375,4,motorbike,5,0,18506,16,1549,755,1853,1080,304,325,motorcycle
52376,19,motorbike,20,1,18506,37,1934,774,2031,945,97,171,motorcycle
52377,20,motorbike,21,1,18506,28,1868,793,2008,964,140,171,motorcycle
52378,21,motorbike,22,1,18506,35,1842,789,1960,983,118,194,motorcycle
52379,22,motorbike,23,1,18506,48,1770,759,1928,994,158,235,motorcycle
52380,23,motorbike,24,1,18506,45,1721,763,1911,1018,190,255,motorcycle
52381,24,door,25,0,18506,20,968,772,1240,1092,272,320,door
52382,26,mirror,27,0,18506,15,988,885,1065,926,77,41,mirror
52383,28,door,29,0,18506,21,1229,774,1468,1070,239,296,door
52384,38,car,39,1,18506,19,2070,646,2199,1035,129,389,car
52385,0,car,1,0,18507,30,494,999,1398,1286,904,287,car
52386,9,car,10,1,18507,18,-5,1000,454,1307,459,307,car
52387,31,car,28,1,18508,18,1120,1172,1185,1227,65,55,car
52388,32,person,29,0,18508,20,1282,1167,1304,1240,22,73,person
52389,1,car,2,0,18509,22,153,1016,392,1139,239,123,car
52390,2,car,3,1,18509,20,339,984,509,1114,170,130,car
52391,6,car,7,0,18509,39,1503,1066,1910,1362,407,296,car
52392,12,car,13,1,18509,23,1429,1065,1589,1243,160,178,car
52393,13,motorbike,14,1,18509,42,1758,1089,2048,1535,290,446,motorcycle
52394,14,car,15,1,18509,22,1373,1046,1526,1184,153,138,car
52395,15,car,16,1,18509,18,1317,1022,1464,1156,147,134,car
52396,3,car,4,0,18510,52,1201,939,2196,1372,995,433,car
52397,14,car,15,1,18510,35,857,950,1362,1227,505,277,car
52398,15,car,16,1,18510,30,670,944,968,1142,298,198,car
52399,16,car,17,1,18510,25,510,932,734,1096,224,164,car
52400,17,car,18,1,18510,19,394,946,541,1036,147,90,car
52401,18,car,19,1,18510,15,357,927,480,1024,123,97,car
52402,24,window,25,0,18510,19,796,107,1031,600,235,493,window
52403,91,door,92,0,18510,16,1492,959,1689,1268,197,309,door
52404,97,door,98,0,18510,18,914,969,1031,1142,117,173,door
52405,100,door,101,0,18510,17,982,967,1090,1152,108,185,door
52406,7,car,8,0,18511,19,568,952,718,1054,150,102,car
52407,8,car,9,0,18511,18,735,957,870,1049,135,92,car
52408,10,car,11,1,18511,16,982,937,1147,1034,165,97,car
52409,19,car,20,0,18511,18,1504,960,1635,1030,131,70,car
52410,23,person,24,0,18511,16,1873,946,1893,1028,20,82,person
52411,24,car,25,0,18511,16,1687,966,1813,1018,126,52,car
52412,9,car,10,1,18512,15,1322,982,1532,1161,210,179,car
52413,14,person,15,0,18512,24,1091,950,1213,1248,122,298,person
52414,15,person,16,0,18512,26,1210,898,1340,1238,130,340,person
52415,38,eyeglasses,39,0,18512,16,1255,922,1292,932,37,10,eye glasses
52416,7,bicycle,8,0,18513,100,759,906,1336,1302,577,396,bicycle
52417,8,bicycle,9,0,18513,98,126,950,822,1397,696,447,bicycle
52418,0,car,1,0,18514,23,1242,1087,1863,1335,621,248,car
52419,0,car,1,0,18515,27,426,571,1282,851,856,280,car
52420,12,person,12,0,18515,24,184,473,282,728,98,255,person
52421,39,door,39,0,18515,17,643,581,882,793,239,212,door
52422,41,door,41,0,18515,24,839,580,1029,789,190,209,door
52423,0,person,1,0,18516,28,254,610,369,955,115,345,person
52424,22,car,16,1,18516,24,1191,656,1272,727,81,71,car
52425,23,bus,17,1,18516,18,1046,584,1251,692,205,108,bus
52426,26,person,20,0,18516,16,1489,652,1511,729,22,77,person
52427,28,car,22,1,18516,15,1382,657,1440,702,58,45,car
52428,29,traffic light,23,0,18516,18,1320,581,1394,677,74,96,traffic light
52429,0,car,1,0,18518,30,1774,491,2200,729,426,238,car
52430,14,person,15,0,18518,16,75,460,107,533,32,73,person
52431,15,person,16,0,18518,18,159,460,187,539,28,79,person
52432,16,person,17,0,18518,15,189,456,218,540,29,84,person
52433,18,car,19,0,18518,19,321,476,464,584,143,108,car
52434,22,car,23,0,18518,26,474,489,779,706,305,217,car
52435,26,car,27,1,18518,42,750,497,1411,896,661,399,car
52436,34,car,35,1,18518,20,1180,474,1399,622,219,148,car
52437,35,car,36,0,18518,26,1365,513,1694,648,329,135,car
52438,53,door,54,0,18518,15,848,516,954,804,106,288,door
52439,54,mirror,55,0,18518,16,869,597,950,654,81,57,mirror
52440,57,door,58,0,18518,17,789,517,888,768,99,251,door
52441,68,door,69,0,18518,16,1458,520,1530,619,72,99,door
52442,87,window,88,0,18518,17,1291,484,1389,526,98,42,window
52443,0,car,1,0,18519,24,364,987,1135,1259,771,272,car
52444,10,person,11,1,18519,19,532,897,587,982,55,85,person
52445,11,person,12,1,18519,20,609,895,649,980,40,85,person
52446,17,window,18,0,18519,19,1654,982,1921,1097,267,115,window
52447,23,person,24,0,18519,27,1263,937,1297,1002,34,65,person
52448,7,car,8,0,18520,17,681,1788,768,1819,87,31,car
52449,16,person,17,0,18520,21,621,1779,647,1860,26,81,person
52450,5,bicycle,6,0,18521,71,1587,956,1827,1466,240,510,bicycle
52451,6,person,7,0,18521,48,1788,712,2053,1465,265,753,person
52452,10,bird,11,0,18521,15,1294,948,1313,979,19,31,bird
52453,17,motorbike,18,1,18521,44,1411,785,1620,939,209,154,motorcycle
52454,26,car,27,0,18521,19,1326,773,1399,824,73,51,car
52455,29,motorbike,30,0,18521,23,1395,759,1423,820,28,61,motorcycle
52456,30,backpack,31,0,18521,19,1982,909,2093,1134,111,225,backpack
52457,31,person,32,0,18521,71,1961,710,2149,1339,188,629,person
52458,32,person,33,0,18521,59,1735,743,1828,977,93,234,person
52459,35,person,36,0,18521,81,563,732,686,1037,123,305,person
52460,42,backpack,43,0,18521,19,1713,761,1750,821,37,60,backpack
52461,43,person,44,0,18521,70,1696,731,1755,912,59,181,person
52462,44,motorbike,45,1,18521,21,1529,766,1605,866,76,100,motorcycle
52463,47,motorbike,48,0,18521,51,851,914,1009,1212,158,298,motorcycle
52464,48,person,49,1,18521,60,847,848,1037,1108,190,260,person
52465,49,person,50,0,18521,18,936,833,1040,946,104,113,person
52466,3,traffic light,4,0,18522,27,543,953,944,1361,401,408,traffic light
52467,4,car,5,0,18522,15,1650,1285,1856,1372,206,87,car
52468,12,car,12,0,18522,22,155,1260,331,1372,176,112,car
52469,113,person,113,0,18522,27,11,1267,66,1389,55,122,person
52470,117,car,117,1,18522,22,68,1257,165,1341,97,84,car
52471,119,traffic light,119,1,18522,35,0,662,306,907,306,245,traffic light
52472,120,traffic light,120,1,18522,27,1732,713,2198,889,466,176,traffic light
52473,11,car,12,1,18523,15,224,912,357,994,133,82,car
52474,38,car,39,0,18523,17,568,900,684,966,116,66,car
52475,39,person,40,0,18523,21,114,886,148,1005,34,119,person
52476,67,window,67,0,18525,19,160,399,564,778,404,379,window
52477,68,window,68,0,18525,15,196,67,579,432,383,365,window
52478,4,parking meter,3,0,18526,16,834,954,878,1263,44,309,parking meter
52479,0,person,1,0,18527,21,400,646,496,894,96,248,person
52480,1,person,2,0,18527,22,503,635,568,894,65,259,person
52481,2,person,3,0,18527,20,627,646,696,866,69,220,person
52482,3,person,4,0,18527,22,681,634,787,848,106,214,person
52483,4,person,5,0,18527,18,851,639,917,838,66,199,person
52484,27,person,28,0,18527,25,1014,638,1057,822,43,184,person
52485,29,person,30,0,18527,24,969,665,1015,827,46,162,person
52486,30,person,31,0,18527,28,919,647,961,837,42,190,person
52487,31,person,32,1,18527,23,800,633,835,809,35,176,person
52488,32,person,33,1,18527,21,771,647,809,835,38,188,person
52489,34,person,35,1,18527,26,670,632,723,843,53,211,person
52490,35,person,36,1,18527,22,597,633,642,807,45,174,person
52491,36,person,37,1,18527,24,552,645,615,838,63,193,person
52492,37,person,38,1,18527,21,468,647,514,868,46,221,person
52493,38,person,39,0,18527,30,347,630,412,880,65,250,person
52494,40,person,41,0,18527,25,308,670,365,838,57,168,person
52495,42,person,43,0,18527,25,218,691,291,845,73,154,person
52496,34,car,35,0,18528,16,493,915,657,1051,164,136,car
52497,40,window,41,0,18528,16,531,928,636,960,105,32,window
52498,2,car,3,0,18529,17,3,983,393,1457,390,474,car
52499,14,person,12,1,18529,15,179,902,284,1002,105,100,person
52500,22,motorbikes,20,1,18529,32,303,991,511,1191,208,200,motorcycle
52501,26,person,24,0,18529,40,921,889,968,1023,47,134,person
52502,27,person,25,0,18529,36,863,894,905,1032,42,138,person
52503,28,person,26,1,18529,37,701,922,773,1108,72,186,person
52504,0,person,1,0,18530,17,1054,611,1130,853,76,242,person
52505,1,person,2,0,18530,16,1171,609,1232,794,61,185,person
52506,2,person,3,0,18530,15,1254,629,1319,831,65,202,person
52507,4,person,5,0,18530,18,1571,683,1759,923,188,240,person
52508,24,parking meter,25,0,18530,19,766,690,839,1064,73,374,parking meter
52509,2,car,3,0,18531,24,947,1038,1510,1443,563,405,car
52510,6,car,7,0,18531,17,230,1015,408,1078,178,63,car
52511,8,car,9,1,18531,16,2,1068,188,1240,186,172,car
52512,0,car,1,0,18533,22,777,735,1449,1047,672,312,car
52513,1,car,2,0,18533,18,316,725,803,973,487,248,car
52514,3,car,4,1,18533,20,1352,648,2199,1195,847,547,car
52515,4,car,5,0,18533,21,36,719,346,907,310,188,car
52516,30,door,29,0,18533,16,1761,663,2091,1095,330,432,door
52517,34,door,33,0,18533,19,1543,655,1806,1054,263,399,door
52518,20,person,18,0,18534,30,344,1007,400,1244,56,237,person
52519,23,car,21,1,18534,21,3,1020,306,1274,303,254,car
52520,24,car,22,1,18534,17,10,1015,313,1218,303,203,car
52521,2,truck,3,0,18535,52,94,907,447,1216,353,309,truck
52522,3,fire hydrant,4,0,18535,23,273,1144,345,1301,72,157,fire hydrant
52523,5,motorbike,6,1,18536,19,24,957,127,1088,103,131,motorcycle
52524,6,car,7,0,18536,29,322,901,1104,1218,782,317,car
52525,12,car,13,1,18536,27,1594,946,2197,1156,603,210,car
52526,13,car,14,1,18536,23,1279,951,1705,1132,426,181,car
52527,14,person,15,0,18536,18,1478,969,1540,1052,62,83,person
52528,22,traffic light,23,0,18536,20,272,747,324,1090,52,343,traffic light
52529,25,person,26,1,18536,18,328,926,367,1007,39,81,person
52530,36,door,37,0,18536,15,451,916,637,1158,186,242,door
52531,40,person,41,1,18536,21,906,929,943,991,37,62,person
52532,5,person,4,0,18537,59,172,828,379,1364,207,536,person
52533,6,person,5,0,18537,64,334,843,543,1388,209,545,person
52534,8,person,7,0,18537,21,643,825,681,977,38,152,person
52535,10,motorbikes,9,0,18537,24,980,817,1131,872,151,55,motorcycle
52536,21,motorbikes,20,0,18537,47,1327,845,1637,1000,310,155,motorcycle
52537,22,bench,21,0,18537,22,1587,938,1753,1021,166,83,bench
52538,23,person,22,1,18537,16,1617,890,1690,946,73,56,person
52539,26,motorbikes,25,0,18537,24,1121,838,1278,937,157,99,motorcycle
52540,27,person,26,0,18537,20,1281,833,1316,956,35,123,person
52541,31,person,30,0,18537,25,941,825,980,973,39,148,person
52542,30,person,30,0,18538,46,1343,652,1419,835,76,183,person
52543,0,person,1,0,18539,24,1332,757,1592,1431,260,674,person
52544,1,person,2,0,18539,22,1058,784,1253,1406,195,622,person
52545,54,person,53,0,18539,102,1563,586,2046,1646,483,1060,person
52546,60,person,59,1,18539,38,967,887,1088,1227,121,340,person
52547,74,umbrella,73,0,18539,29,1288,705,1565,915,277,210,umbrella
52548,75,umbrella,74,0,18539,40,930,750,1271,924,341,174,umbrella
52549,2,dog,3,0,18540,75,1485,1078,1734,1209,249,131,dog
52550,9,person,10,0,18540,71,1790,803,1978,1224,188,421,person
52551,14,dog,15,1,18540,25,1942,1032,2047,1209,105,177,dog
52552,2,car,3,0,18541,17,726,812,834,947,108,135,car
52553,3,vase,4,0,18542,16,1958,1041,2008,1113,50,72,vase
52554,6,person,7,0,18542,54,1342,1043,1484,1371,142,328,person
52555,8,person,9,1,18542,43,1455,1053,1558,1367,103,314,person
52556,9,bench,10,0,18542,30,1531,1160,1872,1290,341,130,bench
52557,13,vase,14,0,18542,21,864,993,934,1092,70,99,vase
52558,16,person,17,1,18542,15,946,1086,985,1165,39,79,person
52559,39,car,40,1,18542,21,660,1095,832,1230,172,135,car
52560,46,person,47,0,18542,32,156,1054,207,1203,51,149,person
52561,52,car,53,1,18542,17,834,1077,883,1152,49,75,car
52562,58,person,59,0,18542,24,335,1028,358,1096,23,68,person
52563,59,person,60,0,18542,27,360,1020,388,1098,28,78,person
52564,60,person,61,0,18542,29,406,1055,445,1173,39,118,person
52565,62,car,63,1,18542,15,507,1044,587,1100,80,56,car
52566,0,car,1,0,18544,34,846,782,996,848,150,66,car
52567,1,car,2,0,18544,30,15,769,200,833,185,64,car
52568,2,car,3,0,18544,30,504,770,704,857,200,87,car
52569,21,person,15,0,18544,26,1019,773,1040,854,21,81,person
52570,22,person,16,0,18544,24,1042,785,1065,854,23,69,person
52571,23,person,17,0,18544,26,1076,776,1100,856,24,80,person
52572,24,car,18,1,18544,20,1098,782,1162,836,64,54,car
52573,25,person,19,0,18544,23,1161,768,1183,842,22,74,person
52574,27,person,21,0,18544,26,1419,771,1443,848,24,77,person
52575,28,car,22,0,18544,22,1471,768,1561,825,90,57,car
52576,5,car,5,0,18545,31,217,1184,650,1440,433,256,car
52577,7,motorbikes,7,1,18545,17,622,1234,813,1335,191,101,motorcycle
52578,9,car,9,1,18545,16,1282,1243,1440,1340,158,97,car
52579,11,car,11,1,18545,15,1709,1241,1809,1315,100,74,car
52580,12,car,12,1,18545,18,1552,1221,1712,1344,160,123,car
52581,13,car,13,0,18545,25,1380,1242,1594,1369,214,127,car
52582,14,car,14,1,18545,23,1854,1210,2199,1552,345,342,car
52583,17,traffic light,17,0,18545,82,1797,452,2133,1206,336,754,traffic light
52584,18,traffic light,18,0,18545,18,1950,1074,1995,1255,45,181,traffic light
52585,31,car,31,0,18545,52,716,1205,1234,1457,518,252,car
52586,34,door,34,0,18545,18,1044,1224,1134,1406,90,182,door
52587,37,window,37,0,18545,15,1051,1228,1113,1288,62,60,window
52588,38,door,38,0,18545,17,1104,1223,1191,1392,87,169,door
52589,43,traffic light,43,0,18545,15,1402,1136,1433,1243,31,107,traffic light
52590,46,traffic light,46,0,18545,18,807,1089,857,1263,50,174,traffic light
52591,48,person,48,1,18545,18,1305,1222,1349,1275,44,53,person
52592,0,car,1,0,18546,19,939,1035,1111,1116,172,81,car
52593,1,person,2,0,18546,23,1808,1002,1889,1248,81,246,person
52594,25,person,26,0,18546,27,1735,1016,1792,1247,57,231,person
52595,35,person,36,0,18546,16,1510,1034,1540,1112,30,78,person
52596,0,person,1,0,18547,37,248,615,594,1185,346,570,person
52597,3,person,4,0,18548,40,547,869,613,1025,66,156,person
52598,11,person,12,0,18548,45,434,862,514,1029,80,167,person
52599,12,person,13,0,18548,32,334,861,397,1028,63,167,person
52600,0,car,1,0,18549,38,236,279,438,361,202,82,car
52601,9,person,10,0,18549,22,211,266,230,328,19,62,person
52602,10,fire hydrant,11,0,18549,15,180,302,191,327,11,25,fire hydrant
52603,14,person,15,0,18549,15,426,268,448,338,22,70,person
52604,15,person,16,0,18549,18,195,265,211,321,16,56,person
52605,0,car,1,0,18550,30,877,791,1429,970,552,179,car
52606,5,car,6,1,18550,19,174,781,314,840,140,59,car
52607,7,car,8,0,18550,30,338,772,758,932,420,160,car
52608,15,car,16,0,18550,29,1419,793,1900,963,481,170,car
52609,16,car,17,1,18550,21,758,786,1091,918,333,132,car
52610,18,car,19,1,18550,18,3,743,168,890,165,147,car
52611,105,door,106,0,18550,18,993,800,1142,933,149,133,door
52612,106,door,107,0,18550,20,1109,800,1229,938,120,138,door
52613,6,backpack,7,0,18551,22,970,647,1135,869,165,222,backpack
52614,13,bicycle,14,0,18551,76,838,863,1540,1327,702,464,bicycle
52615,14,door,15,0,18551,17,902,132,1232,1040,330,908,door
52616,22,person,23,0,18551,88,750,635,957,1213,207,578,person
52617,23,person,24,0,18551,58,928,594,1098,1209,170,615,person
52618,3,car,4,0,18552,42,342,855,979,1131,637,276,car
52619,8,person,9,0,18552,37,175,869,249,1061,74,192,person
52620,13,person,10,0,18553,25,750,789,817,858,67,69,person
52621,27,person,24,0,18553,36,618,730,679,922,61,192,person
52622,29,car,26,0,18553,15,1615,750,1674,794,59,44,car
52623,6,person,7,0,18554,27,901,1067,945,1214,44,147,person
52624,7,person,8,0,18554,28,867,1057,906,1215,39,158,person
52625,8,person,9,0,18554,19,627,1060,650,1171,23,111,person
52626,9,person,10,0,18554,17,580,1052,627,1170,47,118,person
52627,10,person,11,1,18554,16,321,1047,378,1126,57,79,person
52628,11,person,12,0,18554,42,225,1075,383,1409,158,334,person
52629,12,bicycle,13,0,18554,34,235,1199,362,1448,127,249,bicycle
52630,13,bicycle,14,0,18554,34,454,1132,533,1258,79,126,bicycle
52631,14,person,15,0,18554,24,466,1049,536,1192,70,143,person
52632,18,person,19,1,18554,19,1921,1051,2046,1499,125,448,person
52633,49,person,50,0,18554,15,77,1034,101,1104,24,70,person
52634,56,bicycle,57,1,18554,18,1859,1316,2048,1536,189,220,bicycle
52635,1,car,2,0,18555,23,974,803,1615,999,641,196,car
52636,25,person,26,0,18555,15,901,729,944,813,43,84,person
52637,28,person,29,0,18555,16,1602,806,1660,913,58,107,person
52638,31,person,32,0,18555,65,1717,769,1955,1179,238,410,person
52639,32,person,33,1,18555,37,1734,778,1855,1152,121,374,person
52640,14,car,9,0,18556,56,1430,749,1922,1028,492,279,car
52641,15,car,10,1,18556,31,1937,780,2199,1015,262,235,car
52642,16,car,11,1,18556,22,1961,737,2119,782,158,45,car
52643,17,car,12,1,18556,22,1931,767,2096,835,165,68,car
52644,18,motorbike,13,1,18556,34,1876,811,1962,906,86,95,motorcycle
52645,19,person,14,1,18556,36,1890,754,1960,863,70,109,person
52646,31,car,26,0,18556,82,490,828,1345,1189,855,361,car
52647,32,motorbike,27,0,18556,101,258,781,483,1059,225,278,motorcycle
52648,34,person,29,1,18556,29,1429,738,1477,842,48,104,person
52649,35,person,30,1,18556,23,1850,749,1884,834,34,85,person
52650,36,person,31,1,18556,25,1035,763,1099,857,64,94,person
52651,37,person,32,1,18556,18,984,752,1024,798,40,46,person
52652,39,door,34,0,18556,24,988,845,1210,1092,222,247,door
52653,43,door,38,0,18556,21,860,845,1052,1108,192,263,door
52654,47,window,42,0,18556,18,559,850,820,946,261,96,window
52655,62,door,57,0,18556,18,1760,771,1871,954,111,183,door
52656,35,person,36,1,18557,22,1234,284,1389,425,155,141,person
52657,36,person,37,1,18557,24,1425,335,1499,425,74,90,person
52658,48,person,48,1,18557,20,685,279,781,426,96,147,person
52659,49,person,49,1,18557,17,522,239,615,427,93,188,person
52660,51,person,51,1,18557,17,815,323,900,429,85,106,person
52661,53,door,53,0,18557,19,1434,211,2197,424,763,213,door
52662,58,person,58,1,18557,17,1804,453,1900,615,96,162,person
52663,3,bicycle,4,0,18558,62,912,839,1281,1427,369,588,bicycle
52664,4,window,5,0,18558,19,1149,230,1367,735,218,505,window
52665,10,door,11,0,18558,22,566,940,781,1501,215,561,door
52666,12,window,13,0,18558,23,364,164,645,680,281,516,window
52667,7,car,8,1,18559,19,5,935,222,1107,217,172,car
52668,8,motorbikes,9,1,18559,25,2,967,199,1271,197,304,motorcycle
52669,9,motorbike,10,1,18559,28,135,898,268,990,133,92,motorcycle
52670,10,car,11,1,18559,34,218,903,625,1134,407,231,car
52671,11,motorbike,12,0,18559,56,429,955,637,1173,208,218,motorcycle
52672,12,person,13,0,18559,47,615,883,690,1186,75,303,person
52673,13,motorbike,14,1,18559,48,682,945,877,1141,195,196,motorcycle
52674,15,traffic light,16,0,18559,35,818,629,930,1111,112,482,traffic light
52675,16,person,17,0,18559,31,1026,863,1075,990,49,127,person
52676,17,person,18,0,18559,42,1171,862,1284,1178,113,316,person
52677,18,person,19,1,18559,38,1269,867,1356,1161,87,294,person
52678,19,person,20,0,18559,70,1377,882,1514,1236,137,354,person
52679,28,car,29,1,18559,18,1109,971,1218,1081,109,110,car
52680,32,traffic light,33,0,18559,26,396,707,454,917,58,210,traffic light
52681,34,person,35,1,18559,15,665,852,707,923,42,71,person
52682,23,person,24,0,18560,39,122,1084,203,1355,81,271,person
52683,25,person,26,0,18560,19,371,1054,409,1178,38,124,person
52684,27,person,28,0,18560,21,1752,1032,1818,1182,66,150,person
52685,38,person,38,0,18560,58,1248,997,1367,1395,119,398,person
52686,39,person,39,0,18560,59,1382,1017,1533,1415,151,398,person
52687,40,person,40,0,18560,41,1503,1009,1579,1389,76,380,person
52688,41,person,41,1,18560,31,1381,1044,1436,1309,55,265,person
52689,0,car,1,0,18562,20,867,919,1703,1221,836,302,car
52690,4,car,5,1,18562,18,1738,913,2159,1114,421,201,car
52691,11,person,12,1,18562,28,3,891,114,1272,111,381,person
52692,12,motorbikes,13,0,18562,42,626,934,1132,1182,506,248,motorcycle
52693,19,person,20,1,18562,22,733,870,799,1041,66,171,person
52694,54,door,55,0,18562,16,1821,927,1961,1079,140,152,door
52695,3,car,3,0,18563,34,497,1014,1002,1234,505,220,car
52696,13,bench,13,0,18563,16,1215,1116,2071,1246,856,130,bench
52697,14,person,14,0,18563,26,1516,1038,1622,1232,106,194,person
52698,15,person,15,0,18563,26,1854,1041,2029,1165,175,124,person
52699,21,person,21,0,18563,23,1362,1016,1462,1139,100,123,person
52700,22,person,22,0,18563,17,1462,1031,1534,1139,72,108,person
52701,23,person,23,0,18563,21,1701,1024,1785,1153,84,129,person
52702,24,person,24,0,18563,27,1719,1030,1871,1168,152,138,person
52703,25,umbrella,25,0,18563,18,1631,590,1675,804,44,214,umbrella
52704,26,umbrella,26,0,18563,22,1999,574,2053,794,54,220,umbrella
52705,29,person,29,1,18563,24,2093,734,2176,801,83,67,person
52706,31,person,31,1,18563,20,1418,658,1462,739,44,81,person
52707,32,person,32,1,18563,29,1299,993,1352,1130,53,137,person
52708,33,person,33,1,18563,32,969,1011,1055,1182,86,171,person
52709,36,person,36,1,18563,20,643,967,671,1046,28,79,person
52710,37,person,37,1,18563,15,594,999,658,1073,64,74,person
52711,45,door,45,0,18563,16,711,1020,817,1183,106,163,door
52712,49,door,49,1,18563,16,592,1022,753,1173,161,151,door
52713,0,car,1,0,18564,23,417,676,1119,890,702,214,car
52714,22,person,22,1,18564,29,1103,659,1170,852,67,193,person
52715,23,person,23,0,18564,36,1265,598,1378,870,113,272,person
52716,42,door,42,0,18564,16,639,683,810,855,171,172,door
52717,43,door,43,0,18564,20,799,682,954,853,155,171,door
52718,0,person,1,0,18565,24,1708,959,1753,1068,45,109,person
52719,7,car,8,0,18565,26,620,972,882,1051,262,79,car
52720,10,car,11,0,18565,33,1349,989,1696,1101,347,112,car
52721,11,car,12,0,18565,35,1745,959,2076,1088,331,129,car
52722,23,traffic light,24,0,18565,33,1549,398,2033,1176,484,778,traffic light
52723,24,traffic light,25,0,18565,28,126,590,474,1090,348,500,traffic light
52724,43,motorbike,44,0,18565,52,1926,1086,2146,1334,220,248,motorcycle
52725,1,car,2,0,18566,33,895,719,1565,1077,670,358,car
52726,2,car,3,0,18566,21,297,783,686,943,389,160,car
52727,20,car,21,0,18566,19,3,771,352,895,349,124,car
52728,26,umbrella,27,0,18566,26,660,702,810,738,150,36,umbrella
52729,28,person,29,0,18566,35,1598,821,1639,966,41,145,person
52730,33,person,34,0,18566,39,1656,821,1721,965,65,144,person
52731,36,person,37,0,18566,19,1710,811,1760,971,50,160,person
52732,1,car,1,0,18567,47,769,903,1003,1040,234,137,car
52733,17,car,17,1,18567,19,697,894,827,1017,130,123,car
52734,127,car,121,0,18567,27,1716,883,2042,1018,326,135,car
52735,2,person,3,0,18568,44,334,741,440,1044,106,303,person
52736,13,bench,14,1,18568,30,2,978,114,1261,112,283,bench
52737,15,person,16,1,18568,20,4,800,86,1008,82,208,person
52738,18,person,19,1,18568,19,97,809,208,921,111,112,person
52739,19,person,20,0,18568,33,560,755,631,1000,71,245,person
52740,20,person,21,1,18568,33,416,758,463,1008,47,250,person
52741,21,person,22,1,18568,22,206,803,255,910,49,107,person
52742,22,person,23,1,18568,23,296,728,360,989,64,261,person
52743,24,person,25,1,18568,20,212,788,288,897,76,109,person
52744,0,car,1,0,18569,15,469,1046,680,1147,211,101,car
52745,1,car,2,0,18569,22,159,1030,475,1269,316,239,car
52746,20,car,20,1,18569,18,42,1008,130,1067,88,59,car
52747,22,car,22,1,18569,21,21,1057,149,1186,128,129,car
52748,25,car,25,1,18569,16,397,1035,486,1100,89,65,car
52749,8,traffic light,9,0,18570,28,907,531,1553,1091,646,560,traffic light
52750,26,traffic light,27,0,18570,46,2,2,414,314,412,312,traffic light
52751,84,person,85,0,18570,20,218,960,234,1001,16,41,person
52752,11,person,12,0,18571,16,1104,1112,1138,1247,34,135,person
52753,12,person,13,0,18571,27,795,1011,891,1208,96,197,person
52754,13,person,14,0,18571,34,926,1092,1092,1482,166,390,person
52755,25,car,26,0,18571,27,1282,1161,1558,1346,276,185,car
52756,31,person,32,0,18571,21,1957,1125,1984,1221,27,96,person
52757,1,car,1,0,18572,21,0,1026,928,1535,928,509,car
52758,16,person,9,1,18572,55,705,898,808,1051,103,153,person
52759,26,car,19,1,18572,19,1326,931,1376,969,50,38,car
52760,27,car,20,1,18572,22,1018,953,1115,1021,97,68,car
52761,28,car,21,1,18572,17,995,939,1054,989,59,50,car
52762,29,person,22,0,18572,41,971,973,1005,1098,34,125,person
52763,30,person,23,0,18572,45,895,933,954,1097,59,164,person
52764,24,car,22,1,18573,24,778,1025,994,1169,216,144,car
52765,9,car,10,0,18574,15,315,811,421,897,106,86,car
52766,11,car,12,1,18574,25,4,807,247,987,243,180,car
52767,0,car,1,0,18575,32,709,721,1443,1178,734,457,car
52768,4,motorbike,5,0,18575,44,1793,837,2055,1026,262,189,motorcycle
52769,7,motorbikes,8,0,18575,16,502,797,615,842,113,45,motorcycle
52770,8,car,9,0,18575,16,324,768,409,834,85,66,car
52771,14,person,15,0,18575,30,44,758,104,916,60,158,person
52772,0,motorbike,1,0,18578,22,1115,439,1705,1153,590,714,motorcycle
52773,13,bicycle,14,0,18578,35,565,461,710,558,145,97,bicycle
52774,14,person,15,0,18578,30,704,362,776,525,72,163,person
52775,15,person,16,0,18578,26,866,357,911,502,45,145,person
52776,16,person,17,0,18578,30,1108,372,1162,498,54,126,person
52777,17,motorbike,18,1,18578,19,1143,435,1215,512,72,77,motorcycle
52778,18,bicycle,19,0,18578,56,4,419,146,550,142,131,bicycle
52779,0,car,1,0,18579,35,1621,999,2156,1207,535,208,car
52780,1,parking meter,2,0,18579,15,259,1031,286,1213,27,182,parking meter
52781,2,fire hydrant,3,0,18579,23,1341,1074,1384,1190,43,116,fire hydrant
52782,3,car,4,0,18579,45,320,980,1061,1254,741,274,car
52783,15,person,16,0,18579,16,2147,981,2185,1123,38,142,person
52784,1,bicycle,2,0,18580,112,66,891,539,1273,473,382,bicycle
52785,2,person,3,0,18580,32,1393,742,1492,1034,99,292,person
52786,12,person,13,0,18580,27,86,683,289,1245,203,562,person
52787,13,person,14,0,18580,26,755,788,904,1081,149,293,person
52788,14,person,15,0,18580,34,1104,706,1239,1135,135,429,person
52789,17,person,18,0,18580,21,1831,772,1913,1066,82,294,person
52790,18,person,19,0,18580,28,1221,723,1322,1065,101,342,person
52791,20,person,21,1,18580,16,908,710,998,840,90,130,person
52792,21,person,22,0,18580,25,931,899,1080,1095,149,196,person
52793,24,person,24,1,18580,22,261,786,442,1131,181,345,person
52794,27,person,27,1,18580,26,1061,712,1145,890,84,178,person
52795,28,person,28,1,18580,31,1068,745,1145,1114,77,369,person
52796,30,person,30,1,18580,29,1273,736,1335,1053,62,317,person
52797,2,car,3,1,18581,20,4,1084,421,1336,417,252,car
52798,3,car,4,0,18581,26,330,1087,1073,1441,743,354,car
52799,14,car,15,1,18581,25,1231,1122,2048,1536,817,414,car
52800,2,car,3,0,18582,69,1337,1086,1580,1277,243,191,car
52801,6,car,7,0,18582,18,680,1060,929,1168,249,108,car
52802,0,person,1,0,18584,36,126,953,211,1119,85,166,person
52803,10,car,11,0,18584,37,570,984,1067,1140,497,156,car
52804,11,car,12,0,18584,31,1188,951,1655,1122,467,171,car
52805,13,car,14,0,18584,37,1753,975,2170,1103,417,128,car
52806,38,person,39,1,18584,16,186,968,216,1102,30,134,person
52807,1,parking meter,2,0,18585,20,137,466,181,779,44,313,parking meter
52808,13,car,14,1,18585,24,1320,457,1599,807,279,350,car
52809,0,person,1,0,18586,20,1903,542,2006,875,103,333,person
52810,3,motorbike,4,0,18586,102,1104,577,1629,1097,525,520,motorcycle
52811,6,person,7,0,18586,27,300,447,373,655,73,208,person
52812,7,car,8,1,18586,18,343,478,442,605,99,127,car
52813,14,car,15,1,18586,18,1764,560,2190,794,426,234,car
52814,18,traffic light,19,0,18586,23,1284,36,1417,941,133,905,traffic light
52815,24,motorbike,25,0,18586,32,716,510,808,572,92,62,motorcycle
52816,26,car,19,1,18587,15,944,926,1035,971,91,45,car
52817,27,car,20,1,18587,15,903,923,989,970,86,47,car
52818,28,car,21,1,18587,16,869,916,947,968,78,52,car
52819,29,car,22,1,18587,16,820,911,901,967,81,56,car
52820,30,car,23,1,18587,16,823,919,892,970,69,51,car
52821,31,car,24,1,18587,18,777,917,870,969,93,52,car
52822,32,car,25,0,18587,18,736,918,850,972,114,54,car
52823,33,car,26,1,18587,18,656,908,725,956,69,48,car
52824,34,car,27,1,18587,18,420,897,510,956,90,59,car
52825,35,car,28,1,18587,26,553,898,660,954,107,56,car
52826,36,car,29,0,18587,25,258,888,429,958,171,70,car
52827,62,traffic light,55,0,18587,19,125,793,166,940,41,147,traffic light
52828,6,car,7,1,18588,19,893,967,1064,1050,171,83,car
52829,9,motorbike,10,0,18588,15,831,991,890,1072,59,81,motorcycle
52830,17,car,18,1,18588,24,2,1050,708,1467,706,417,car
52831,23,car,24,1,18589,21,1399,1097,1930,1318,531,221,car
52832,24,car,25,0,18589,35,988,1118,1789,1427,801,309,car
52833,53,fire hydrant,54,0,18589,36,15,1203,70,1335,55,132,fire hydrant
52834,2,car,3,0,18590,21,482,856,761,977,279,121,car
52835,29,person,22,1,18590,32,339,848,407,956,68,108,person
52836,30,motorbike,23,0,18590,37,328,892,407,968,79,76,motorcycle
52837,31,person,24,1,18590,44,85,826,180,1027,95,201,person
52838,32,person,25,1,18590,39,27,829,135,1025,108,196,person
52839,33,motorbike,26,1,18590,67,1,914,195,1067,194,153,motorcycle
52840,34,car,27,1,18590,18,396,877,503,923,107,46,car
52841,35,car,28,1,18590,22,724,876,809,935,85,59,car
52842,36,car,29,1,18590,16,1535,883,1598,925,63,42,car
52843,37,car,30,1,18590,15,1669,888,1709,920,40,32,car
52844,38,person,31,1,18590,27,803,863,850,939,47,76,person
52845,39,motorbike,32,0,18590,21,804,902,841,952,37,50,motorcycle
52846,40,person,33,0,18590,40,871,857,928,1054,57,197,person
52847,41,person,34,0,18590,41,980,850,1046,1045,66,195,person
52848,42,person,35,1,18590,26,1034,845,1071,1037,37,192,person
52849,43,person,36,0,18590,34,1122,853,1175,1049,53,196,person
52850,44,motorbike,37,0,18590,47,1200,875,1304,1018,104,143,motorcycle
52851,45,car,38,1,18590,24,1061,872,1132,950,71,78,car
52852,48,traffic light,41,0,18590,71,783,446,1220,1013,437,567,traffic light
52853,51,motorbike,44,0,18590,36,1302,900,1397,1006,95,106,motorcycle
52854,52,motorbike,45,1,18590,46,1354,871,1477,996,123,125,motorcycle
52855,53,car,46,1,18590,25,1709,886,1779,933,70,47,car
52856,20,car,20,1,18591,22,313,242,358,275,45,33,car
52857,21,car,21,1,18591,17,338,248,369,279,31,31,car
52858,22,car,22,0,18591,23,359,249,403,284,44,35,car
52859,0,person,1,0,18592,21,529,850,657,1245,128,395,person
52860,1,person,2,0,18592,22,695,852,815,1260,120,408,person
52861,2,person,3,0,18592,17,3,811,156,1312,153,501,person
52862,0,car,1,0,18593,29,827,827,1561,1121,734,294,car
52863,1,car,2,0,18593,19,1,866,871,1265,870,399,car
52864,3,car,4,1,18593,17,632,844,938,970,306,126,car
52865,29,door,28,0,18593,18,363,892,681,1138,318,246,door
52866,14,person,15,0,18594,27,1116,1063,1181,1282,65,219,person
52867,20,person,21,0,18594,31,1046,1065,1118,1276,72,211,person
52868,21,person,22,0,18594,29,1326,1042,1385,1249,59,207,person
52869,22,person,23,0,18594,25,1421,1050,1479,1269,58,219,person
52870,23,person,24,0,18594,15,1894,1027,1932,1149,38,122,person
52871,91,person,90,0,18594,34,1467,1067,1521,1259,54,192,person
52872,92,person,91,1,18594,36,1383,1043,1428,1250,45,207,person
52873,93,person,92,0,18594,40,1528,1045,1575,1238,47,193,person
52874,94,person,93,0,18594,32,1996,1035,2032,1150,36,115,person
52875,95,person,94,0,18594,24,2081,1052,2130,1179,49,127,person
52876,96,person,95,0,18594,29,1795,1030,1838,1155,43,125,person
52877,97,person,96,0,18594,26,2155,1045,2199,1174,44,129,person
52878,98,person,97,1,18594,24,1717,1038,1772,1142,55,104,person
52879,99,person,98,1,18594,29,1747,1037,1786,1220,39,183,person
52880,100,person,99,1,18594,28,1651,1049,1712,1142,61,93,person
52881,0,car,1,0,18595,38,879,850,1029,937,150,87,car
52882,1,car,2,0,18595,44,1389,864,1730,1006,341,142,car
52883,2,car,3,0,18595,24,419,832,653,1042,234,210,car
52884,3,car,4,0,18595,31,701,844,871,955,170,111,car
52885,4,person,5,0,18595,30,1245,842,1276,940,31,98,person
52886,47,car,46,1,18595,20,1293,862,1437,932,144,70,car
52887,56,person,55,0,18595,25,256,813,300,942,44,129,person
52888,0,flowerpot,1,0,18596,16,1228,859,1292,919,64,60,potted plant
52889,11,person,12,0,18596,27,507,693,558,921,51,228,person
52890,14,bench,15,0,18596,20,811,825,1089,955,278,130,bench
52891,19,person,20,0,18596,19,684,719,733,964,49,245,person
52892,10,person,11,0,18597,15,714,1007,801,1182,87,175,person
52893,5,car,6,0,18598,21,413,1028,597,1087,184,59,car
52894,1,motorbike,2,1,18599,37,2070,1034,2196,1303,126,269,motorcycle
52895,2,motorbike,3,1,18599,16,1971,1315,2201,1465,230,150,motorcycle
52896,3,car,4,0,18599,17,1659,1022,1750,1089,91,67,car
52897,5,motorbike,6,0,18599,40,2,1040,275,1273,273,233,motorcycle
52898,6,motorbike,7,1,18599,49,229,1087,484,1279,255,192,motorcycle
52899,7,motorbike,8,0,18599,63,389,1046,672,1287,283,241,motorcycle
52900,14,car,15,0,18599,15,1406,1020,1534,1119,128,99,car
52901,0,car,1,0,18600,29,364,966,891,1157,527,191,car
52902,42,car,43,1,18600,15,1153,919,1221,952,68,33,car
52903,1,car,2,0,18601,22,4,817,916,1165,912,348,car
52904,2,car,3,0,18601,29,956,773,1587,1072,631,299,car
52905,3,car,4,1,18601,19,1666,760,2048,1007,382,247,car
52906,4,person,5,0,18602,43,234,794,525,1288,291,494,person
52907,5,person,6,0,18602,41,511,1038,638,1296,127,258,person
52908,8,motorbike,9,0,18602,39,1225,776,1414,969,189,193,motorcycle
52909,10,car,11,1,18602,18,1556,813,1759,991,203,178,car
52910,15,car,16,1,18602,15,1099,795,1206,849,107,54,car
52911,16,motorbikes,17,1,18602,29,1170,789,1336,875,166,86,motorcycle
52912,17,person,18,0,18602,25,895,766,943,911,48,145,person
52913,18,person,19,0,18602,18,1041,781,1060,847,19,66,person
52914,4,person,5,0,18603,31,398,867,484,1089,86,222,person
52915,6,person,7,0,18603,30,557,884,645,1075,88,191,person
52916,25,person,26,1,18603,23,163,867,214,1060,51,193,person
52917,26,person,27,0,18603,28,199,882,258,1076,59,194,person
52918,27,car,28,1,18603,34,81,856,398,1016,317,160,car
52919,67,door,66,0,18603,15,709,831,825,1053,116,222,door
52920,2,person,3,0,18605,22,669,1014,796,1396,127,382,person
52921,3,person,4,0,18605,18,794,976,903,1377,109,401,person
52922,4,person,5,0,18605,18,920,965,993,1262,73,297,person
52923,14,person,12,0,18605,38,530,982,568,1149,38,167,person
52924,16,person,14,0,18605,27,556,984,602,1176,46,192,person
52925,17,person,15,1,18605,21,604,996,659,1153,55,157,person
52926,18,person,16,1,18605,41,617,986,708,1310,91,324,person
52927,20,person,18,1,18605,16,722,995,756,1070,34,75,person
52928,22,person,20,1,18605,24,755,1010,812,1183,57,173,person
52929,28,bicycle,26,0,18605,59,1120,1045,1264,1151,144,106,bicycle
52930,29,bicycle,27,0,18605,43,1366,1050,1517,1144,151,94,bicycle
52931,30,bicycle,28,1,18605,54,1509,1035,1640,1144,131,109,bicycle
52932,34,person,32,0,18605,19,976,982,1020,1215,44,233,person
52933,41,person,41,0,18606,44,420,1113,505,1384,85,271,person
52934,42,person,42,0,18606,58,319,1123,434,1397,115,274,person
52935,0,person,1,0,18607,49,357,912,447,1104,90,192,person
52936,1,person,2,0,18607,33,1561,896,1607,1086,46,190,person
52937,7,car,8,0,18607,31,712,951,1358,1158,646,207,car
52938,8,parking meter,9,0,18607,17,1340,940,1365,1109,25,169,parking meter
52939,16,bicycle,11,1,18607,37,1283,966,1484,1109,201,143,bicycle
52940,34,person,29,1,18607,19,2106,865,2187,976,81,111,person
52941,79,person,71,0,18607,38,189,908,278,1093,89,185,person
52942,80,person,72,1,18607,30,242,889,296,1077,54,188,person
52943,81,person,73,0,18607,41,439,901,503,1093,64,192,person
52944,82,person,74,0,18607,37,31,914,115,1089,84,175,person
52945,83,person,75,1,18607,38,100,882,162,1096,62,214,person
52946,84,person,76,0,18607,46,140,878,213,1108,73,230,person
52947,5,car,6,0,18608,18,335,1048,933,1286,598,238,car
52948,17,door,18,0,18608,18,463,1057,670,1232,207,175,door
52949,0,car,1,0,18610,32,1072,797,1403,912,331,115,car
52950,16,car,17,1,18610,33,766,796,1108,1015,342,219,car
52951,17,car,18,0,18610,41,125,781,843,1112,718,331,car
52952,17,person,15,0,18611,46,139,979,235,1165,96,186,person
52953,18,person,16,1,18611,21,1984,960,2013,1038,29,78,person
52954,1,fire hydrant,2,0,18612,26,2013,1052,2079,1172,66,120,fire hydrant
52955,29,bench,25,0,18612,18,1753,1013,1839,1064,86,51,bench
52956,0,car,1,0,18613,42,759,1564,1243,1816,484,252,car
52957,1,person,2,0,18613,24,1426,1528,1484,1727,58,199,person
52958,42,car,43,1,18613,25,1021,1535,1344,1760,323,225,car
52959,46,traffic light,47,0,18613,17,63,1233,249,1824,186,591,traffic light
52960,5,window,6,0,18614,16,328,127,436,244,108,117,window
52961,21,car,22,1,18614,15,929,771,1003,824,74,53,car
52962,30,car,31,1,18614,45,445,724,858,1119,413,395,car
52963,31,car,32,1,18614,36,825,787,991,983,166,196,car
52964,32,car,33,1,18614,15,982,777,1103,867,121,90,car
52965,37,parking meter,38,0,18614,15,1010,794,1033,996,23,202,parking meter
52966,40,person,41,0,18614,32,1187,756,1229,873,42,117,person
52967,41,person,42,0,18614,30,1230,746,1277,882,47,136,person
52968,42,person,43,0,18614,32,1147,762,1200,890,53,128,person
52969,43,person,44,0,18614,65,1272,728,1381,997,109,269,person
52970,46,door,47,0,18614,27,1412,658,1501,1038,89,380,door
52971,70,door,71,0,18614,15,413,779,602,1273,189,494,door
52972,0,boat,1,0,18615,45,159,65,470,293,311,228,boat
52973,0,person,1,0,18616,100,148,668,415,1488,267,820,person
52974,2,person,3,0,18616,64,1013,622,1332,1523,319,901,person
52975,23,person,24,0,18616,54,1270,702,1498,1457,228,755,person
52976,31,person,32,1,18616,63,344,666,522,1389,178,723,person
52977,33,person,34,1,18616,16,8,617,82,796,74,179,person
52978,34,person,35,1,18616,62,930,637,1122,1257,192,620,person
52979,1,car,1,0,18617,21,98,745,378,893,280,148,car
52980,6,car,6,1,18617,15,69,727,152,785,83,58,car
52981,25,person,25,0,18617,32,960,729,1012,877,52,148,person
52982,26,person,26,0,18617,42,869,714,953,879,84,165,person
52983,27,bicycle,27,1,18617,20,879,783,914,879,35,96,bicycle
52984,0,person,1,0,18618,17,604,1006,697,1275,93,269,person
52985,1,person,2,0,18618,15,383,1006,498,1296,115,290,person
52986,2,motorbike,3,0,18618,19,1559,1142,1865,1441,306,299,motorcycle
52987,13,motorbike,13,1,18618,53,1457,1108,1710,1374,253,266,motorcycle
52988,15,car,15,1,18618,16,1474,1036,1594,1093,120,57,car
52989,17,car,17,1,18618,16,1324,1040,1417,1085,93,45,car
52990,18,car,18,1,18618,15,1188,1036,1276,1086,88,50,car
52991,19,car,19,0,18618,18,1083,1025,1191,1080,108,55,car
52992,38,person,38,0,18618,38,304,1008,353,1159,49,151,person
52993,39,person,39,0,18618,30,230,1013,281,1158,51,145,person
52994,40,person,40,0,18618,39,82,978,155,1241,73,263,person
52995,77,person,76,1,18618,21,1285,1022,1308,1090,23,68,person
52996,78,motorbike,77,0,18618,37,1268,1023,1334,1119,66,96,motorcycle
52997,0,person,1,0,18619,24,863,963,966,1232,103,269,person
52998,5,person,6,1,18619,38,1873,904,2049,1534,176,630,person
52999,1,car,2,0,18623,18,813,910,1338,1077,525,167,car
53000,2,car,3,0,18623,17,117,842,660,1042,543,200,car
53001,36,person,36,1,18623,18,1222,869,1272,948,50,79,person
53002,0,person,1,0,18624,38,1104,1098,1164,1295,60,197,person
53003,1,person,2,0,18624,34,1057,1097,1114,1298,57,201,person
53004,8,pot,9,0,18624,15,359,1216,422,1261,63,45,potted plant
53005,9,person,10,0,18624,24,284,1115,336,1263,52,148,person
53006,0,car,1,0,18625,22,1092,817,1892,1118,800,301,car
53007,1,car,2,0,18625,18,193,824,873,1076,680,252,car
53008,0,car,1,0,18626,23,526,907,1310,1239,784,332,car
53009,2,motorbike,3,0,18626,34,90,839,368,1185,278,346,motorcycle
53010,3,car,4,1,18626,17,1262,938,1911,1212,649,274,car
53011,5,traffic light,6,0,18626,16,452,632,508,746,56,114,traffic light
53012,9,person,10,0,18626,24,130,858,293,1107,163,249,person
53013,8,car,9,1,18627,15,125,222,156,247,31,25,car
53014,9,car,10,1,18627,23,94,223,137,255,43,32,car
53015,10,car,11,0,18627,17,41,228,108,256,67,28,car
53016,9,car,10,0,18628,15,97,144,120,167,23,23,car
53017,12,car,13,1,18628,15,21,143,45,156,24,13,car
53018,16,person,17,0,18628,37,143,143,168,193,25,50,person
53019,17,person,18,0,18628,26,166,146,182,194,16,48,person
53020,18,person,19,0,18628,26,188,145,207,201,19,56,person
53021,19,person,20,0,18628,30,208,145,230,200,22,55,person
53022,6,person,7,1,18629,22,127,146,141,184,14,38,person
53023,10,person,11,0,18629,35,107,139,128,206,21,67,person
53024,20,person,21,0,18629,30,17,138,36,190,19,52,person
53025,5,car,6,1,18630,19,159,140,204,157,45,17,car
53026,5,car,6,0,18631,18,120,154,146,166,26,12,car
53027,6,car,7,0,18631,19,91,154,119,169,28,15,car
53028,7,car,8,1,18631,22,53,157,93,173,40,16,car
53029,8,car,9,0,18631,25,4,157,56,178,52,21,car
53030,4,truck,5,1,18632,18,149,152,231,196,82,44,truck
53031,11,car,12,1,18633,28,201,158,256,213,55,55,car
53032,13,person,14,1,18633,15,65,160,73,180,8,20,person
53033,15,car,16,0,18633,32,49,162,129,223,80,61,car
53034,10,person,11,0,18634,16,52,130,57,154,5,24,person
53035,11,person,12,0,18634,17,61,130,68,153,7,23,person
53036,12,person,13,0,18634,29,127,127,144,181,17,54,person
53037,4,person,5,0,18635,22,227,123,239,169,12,46,person
53038,10,car,11,0,18635,29,41,139,102,181,61,42,car
53039,10,person,11,0,18636,26,77,134,89,170,12,36,person
53040,13,truck,14,1,18636,27,151,110,211,177,60,67,truck
53041,14,car,15,1,18636,25,180,144,256,213,76,69,car
53042,9,person,10,1,18637,20,213,157,225,193,12,36,person
53043,10,person,11,0,18637,31,223,153,239,204,16,51,person
53044,14,car,15,0,18637,29,136,165,211,208,75,43,car
53045,10,car,11,1,18639,20,41,152,79,181,38,29,car
53046,11,car,12,1,18639,20,2,141,50,184,48,43,car
53047,18,car,19,1,18639,21,191,148,252,194,61,46,car
53048,19,car,20,1,18639,16,219,154,256,197,37,43,car
53049,11,person,12,0,18640,15,9,164,14,182,5,18,person
53050,14,person,15,0,18640,24,132,166,143,191,11,25,person
53051,15,car,16,0,18640,22,145,163,185,185,40,22,car
53052,16,car,17,0,18640,19,66,164,89,181,23,17,car
53053,17,car,18,0,18640,22,93,163,130,188,37,25,car
53054,19,car,20,1,18640,17,36,169,66,188,30,19,car
53055,20,person,21,0,18640,16,50,165,59,194,9,29,person
53056,21,car,22,1,18640,16,219,164,256,207,37,43,car
53057,13,person,14,0,18641,16,103,125,112,146,9,21,person
53058,15,car,16,1,18641,17,87,121,109,152,22,31,car
53059,17,car,18,1,18641,15,71,125,95,166,24,41,car
53060,20,person,21,0,18641,16,199,126,206,149,7,23,person
53061,21,car,22,0,18641,16,133,136,198,182,65,46,car
53062,12,car,13,1,18642,22,66,139,98,170,32,31,car
53063,13,car,14,1,18642,29,18,141,82,199,64,58,car
53064,14,car,15,1,18642,19,2,149,51,236,49,87,car
53065,3,person,4,0,18643,24,236,134,251,165,15,31,person
53066,4,person,5,0,18643,26,207,137,227,175,20,38,person
53067,7,person,8,0,18643,27,76,134,94,176,18,42,person
53068,8,car,9,1,18643,16,0,134,35,151,35,17,car
53069,9,car,10,0,18644,29,2,161,61,192,59,31,car
53070,10,person,11,0,18644,18,71,153,81,178,10,25,person
53071,11,person,12,0,18644,20,81,153,89,179,8,26,person
53072,10,car,11,0,18645,17,59,130,88,152,29,22,car
53073,12,car,13,1,18645,18,93,128,136,162,43,34,car
53074,13,car,14,1,18645,20,123,135,173,172,50,37,car
53075,7,car,8,0,18646,18,68,134,89,147,21,13,car
53076,9,car,10,1,18646,15,97,136,121,154,24,18,car
53077,10,car,11,1,18646,17,117,137,141,157,24,20,car
53078,11,car,12,1,18646,23,138,128,212,168,74,40,car
53079,12,car,13,1,18646,18,203,140,256,180,53,40,car
53080,11,car,12,1,18647,15,127,164,148,187,21,23,car
53081,12,car,13,1,18647,17,102,165,132,193,30,28,car
53082,13,car,14,0,18647,21,63,163,117,200,54,37,car
53083,14,car,15,1,18647,15,2,162,40,214,38,52,car
53084,20,car,21,1,18647,17,233,160,256,202,23,42,car
53085,12,car,13,0,18648,21,183,175,209,192,26,17,car
53086,14,car,15,1,18648,15,229,180,256,210,27,30,car
53087,16,car,17,0,18648,21,83,171,112,192,29,21,car
53088,13,car,14,1,18649,16,90,140,115,173,25,33,car
53089,15,car,16,1,18649,17,2,145,41,236,39,91,car
53090,10,person,11,0,18650,21,211,129,217,147,6,18,person
53091,15,car,16,0,18650,17,71,132,93,151,22,19,car
53092,16,car,17,1,18650,16,41,134,69,154,28,20,car
53093,17,car,18,1,18650,20,2,137,43,165,41,28,car
53094,5,car,6,0,18651,21,2,174,26,189,24,15,car
53095,9,truck,10,0,18651,18,83,172,110,186,27,14,truck
53096,13,car,14,0,18651,32,169,169,256,203,87,34,car
53097,38,person,39,0,18651,19,156,165,163,181,7,16,person
53098,8,car,9,0,18652,17,189,134,216,150,27,16,car
53099,9,car,10,1,18652,20,222,132,256,157,34,25,car
53100,12,person,13,1,18652,29,7,149,68,202,61,53,person
53101,9,car,10,1,18653,18,63,155,92,175,29,20,car
53102,10,car,11,0,18653,22,90,158,135,181,45,23,car
53103,11,car,12,1,18653,16,213,159,256,199,43,40,car
53104,8,car,9,1,18654,17,64,162,93,181,29,19,car
53105,9,car,10,1,18654,26,84,165,144,190,60,25,car
53106,11,car,12,0,18654,28,10,162,68,206,58,44,car
53107,12,car,13,1,18654,20,86,183,256,256,170,73,car
53108,5,person,6,0,18655,19,190,169,203,208,13,39,person
53109,6,person,7,0,18655,20,177,169,190,208,13,39,person
53110,7,person,8,0,18655,20,167,168,177,209,10,41,person
53111,8,person,9,0,18655,20,152,173,162,204,10,31,person
53112,9,person,10,0,18655,16,141,181,149,204,8,23,person
53113,10,person,11,0,18655,27,123,173,142,212,19,39,person
53114,11,person,12,0,18655,19,112,169,123,201,11,32,person
53115,12,person,13,0,18655,19,100,170,108,202,8,32,person
53116,13,person,14,0,18655,17,81,170,90,194,9,24,person
53117,14,person,15,0,18655,26,40,163,64,240,24,77,person
53118,15,person,16,0,18655,24,18,170,35,246,17,76,person
53119,5,person,6,0,18656,24,109,158,123,203,14,45,person
53120,6,person,7,0,18656,17,128,167,137,201,9,34,person
53121,7,person,8,0,18656,25,131,163,151,208,20,45,person
53122,8,person,9,0,18656,20,170,160,180,187,10,27,person
53123,9,person,10,1,18656,16,9,155,22,184,13,29,person
53124,10,person,11,1,18656,24,2,161,21,253,19,92,person
53125,11,person,12,0,18656,31,22,155,38,210,16,55,person
53126,12,person,13,0,18656,28,38,155,55,211,17,56,person
53127,13,person,14,0,18656,30,221,157,234,214,13,57,person
53128,14,person,15,1,18656,29,186,169,202,219,16,50,person
53129,15,person,16,0,18656,31,198,162,217,219,19,57,person
53130,13,car,14,1,18657,16,57,145,81,170,24,25,car
53131,14,car,15,1,18657,23,2,146,63,181,61,35,car
53132,15,car,16,0,18657,17,188,145,208,160,20,15,car
53133,16,car,17,0,18657,22,213,148,245,167,32,19,car
53134,14,truck,15,0,18658,21,108,149,158,207,50,58,truck
53135,9,car,10,0,18659,20,68,127,97,148,29,21,car
53136,11,car,12,1,18660,25,51,150,102,194,51,44,car
53137,12,car,13,1,18660,18,2,157,71,256,69,99,car
53138,15,car,16,1,18660,25,177,150,223,191,46,41,car
53139,16,car,17,1,18660,18,207,151,256,227,49,76,car
53140,6,person,7,0,18662,24,208,143,220,168,12,25,person
53141,14,car,15,0,18662,22,45,150,97,188,52,38,car
53142,11,car,12,0,18663,24,36,152,78,179,42,27,car
53143,16,car,17,1,18663,27,164,151,217,201,53,50,car
53144,17,car,18,1,18663,18,176,160,256,256,80,96,car
53145,11,person,12,0,18664,28,33,143,47,197,14,54,person
53146,18,car,19,1,18664,16,142,143,161,164,19,21,car
53147,19,car,20,0,18664,19,157,144,191,169,34,25,car
53148,20,car,21,1,18664,19,213,148,256,181,43,33,car
53149,9,car,10,1,18665,15,214,143,239,167,25,24,car
53150,11,car,12,0,18665,20,165,151,208,178,43,27,car
53151,12,car,13,0,18665,20,101,151,165,188,64,37,car
53152,18,person,19,0,18665,27,8,138,35,190,27,52,person
53153,9,car,10,1,18667,15,24,215,69,256,45,41,car
53154,11,person,12,0,18667,19,174,207,183,238,9,31,person
53155,13,person,14,0,18667,15,162,209,168,231,6,22,person
53156,14,person,15,0,18667,18,188,206,196,232,8,26,person
53157,19,person,20,0,18667,16,95,201,115,255,20,54,person
53158,10,car,11,0,18668,15,76,167,93,181,17,14,car
53159,12,car,13,0,18668,15,110,172,139,192,29,20,car
53160,2,car,3,0,18669,27,82,159,155,198,73,39,car
53161,12,person,13,0,18669,21,157,151,167,181,10,30,person
53162,13,person,14,0,18669,25,197,146,209,186,12,40,person
53163,14,person,15,0,18669,33,167,145,182,196,15,51,person
53164,9,person,10,0,18670,22,193,144,202,164,9,20,person
53165,10,person,11,1,18670,18,243,139,255,175,12,36,person
53166,15,car,16,1,18670,15,79,143,100,162,21,19,car
53167,16,car,17,1,18670,22,44,143,85,176,41,33,car
53168,17,car,18,1,18670,25,0,147,56,204,56,57,car
53169,10,car,11,1,18671,17,14,140,50,182,36,42,car
53170,11,car,12,0,18671,28,24,147,120,229,96,82,car
53171,15,car,16,1,18671,20,118,142,146,166,28,24,car
53172,16,car,17,0,18671,27,142,144,208,176,66,32,car
53173,18,car,19,1,18671,16,207,150,256,187,49,37,car
53174,4,car,5,0,18672,21,24,148,54,167,30,19,car
53175,5,car,6,1,18672,16,53,149,75,167,22,18,car
53176,6,car,7,1,18672,16,70,150,100,170,30,20,car
53177,7,car,8,1,18672,23,95,147,144,175,49,28,car
53178,8,car,9,1,18672,23,137,153,200,178,63,25,car
53179,9,car,10,1,18672,24,184,148,256,191,72,43,car
53180,8,person,9,0,18673,17,2,156,13,185,11,29,person
53181,9,person,10,0,18673,17,16,157,26,185,10,28,person
53182,11,car,12,0,18673,20,106,164,134,181,28,17,car
53183,12,car,13,0,18673,20,54,156,107,188,53,32,car
53184,14,car,15,0,18673,21,138,165,197,212,59,47,car
53185,5,truck,6,1,18674,23,86,112,127,157,41,45,truck
53186,6,car,7,1,18674,19,59,135,103,173,44,38,car
53187,9,person,10,0,18674,20,199,124,206,148,7,24,person
53188,10,person,11,0,18674,22,208,127,218,151,10,24,person
53189,3,person,4,0,18675,17,227,137,236,160,9,23,person
53190,11,person,12,0,18675,26,21,147,28,173,7,26,person
53191,13,car,14,1,18675,23,93,140,133,166,40,26,car
53192,15,truck,16,0,18675,24,183,135,217,161,34,26,truck
53193,4,person,5,0,18676,18,225,160,231,182,6,22,person
53194,5,car,6,0,18676,22,34,165,70,178,36,13,car
53195,10,car,11,0,18677,22,83,139,117,164,34,25,car
53196,5,person,6,0,18678,16,92,134,97,157,5,23,person
53197,6,person,7,0,18678,20,98,131,106,159,8,28,person
53198,7,person,8,0,18678,19,106,134,116,161,10,27,person
53199,8,person,9,0,18678,16,122,133,129,161,7,28,person
53200,9,person,10,0,18678,20,77,134,87,164,10,30,person
53201,10,person,11,0,18678,16,51,135,57,166,6,31,person
53202,11,person,12,0,18678,18,61,137,74,175,13,38,person
53203,15,car,16,1,18678,23,141,133,183,181,42,48,car
53204,17,car,18,1,18678,27,156,141,246,211,90,70,car
53205,19,car,20,0,18679,23,163,160,213,195,50,35,car
53206,20,car,21,1,18679,24,211,152,256,244,45,92,car
53207,12,car,13,0,18680,22,171,149,216,183,45,34,car
53208,7,car,8,1,18681,18,121,149,157,179,36,30,car
53209,8,car,9,0,18681,23,147,149,201,192,54,43,car
53210,9,person,10,0,18681,15,240,151,246,169,6,18,person
53211,7,person,8,0,18682,24,237,126,255,165,18,39,person
53212,11,car,12,1,18682,16,158,129,181,149,23,20,car
53213,12,car,13,0,18682,24,169,130,222,165,53,35,car
53214,15,car,16,1,18682,16,2,154,44,216,42,62,car
53215,9,person,10,1,18683,20,10,149,22,176,12,27,person
53216,12,person,13,0,18683,22,229,144,238,168,9,24,person
53217,14,car,15,0,18683,18,110,151,135,172,25,21,car
53218,16,car,17,1,18683,25,2,157,87,209,85,52,car
53219,17,car,18,1,18683,15,181,151,230,182,49,31,car
53220,18,person,19,0,18683,52,188,149,229,238,41,89,person
53221,10,car,11,1,18685,18,158,134,176,157,18,23,car
53222,11,car,12,1,18685,22,168,136,190,165,22,29,car
53223,12,car,13,0,18685,31,178,136,256,184,78,48,car
53224,5,person,6,0,18686,15,136,174,142,194,6,20,person
53225,6,person,7,0,18686,15,141,173,148,192,7,19,person
53226,13,car,14,1,18686,15,231,179,256,202,25,23,car
53227,14,car,15,1,18687,19,212,196,256,223,44,27,car
53228,5,door,6,1,18689,26,2,78,36,160,34,82,door
53229,10,car,11,0,18689,20,81,139,107,160,26,21,car
53230,12,car,13,1,18689,25,2,143,72,200,70,57,car
53231,14,car,15,0,18689,17,153,139,176,157,23,18,car
53232,10,truck,11,0,18690,24,74,153,121,177,47,24,truck
53233,13,car,14,0,18690,22,4,164,52,214,48,50,car
53234,7,car,8,0,18691,19,86,133,117,146,31,13,car
53235,8,car,9,0,18691,18,118,135,151,148,33,13,car
53236,9,car,10,1,18691,17,163,134,209,151,46,17,car
53237,9,person,10,1,18692,15,44,150,53,169,9,19,person
53238,11,person,12,1,18692,19,31,152,40,175,9,23,person
53239,16,person,17,0,18692,15,183,148,188,166,5,18,person
53240,17,person,18,0,18692,18,195,149,200,166,5,17,person
53241,18,person,19,0,18692,27,210,150,223,183,13,33,person
53242,20,person,21,0,18692,27,73,146,89,204,16,58,person
53243,21,car,22,1,18692,18,2,164,41,223,39,59,car
53244,6,person,7,0,18693,18,66,184,76,210,10,26,person
53245,10,car,11,0,18693,20,78,185,122,217,44,32,car
53246,11,car,12,1,18693,20,175,179,256,248,81,69,car
53247,6,car,7,0,18694,19,217,163,243,174,26,11,car
53248,11,person,12,0,18695,16,80,167,93,185,13,18,person
53249,15,person,16,0,18695,19,151,158,160,185,9,27,person
53250,16,person,17,0,18695,22,160,156,170,187,10,31,person
53251,5,person,6,0,18696,15,190,168,199,195,9,27,person
53252,9,car,10,0,18696,15,142,172,163,191,21,19,car
53253,9,car,10,1,18697,16,229,158,256,222,27,64,car
53254,11,car,12,1,18697,15,80,150,106,174,26,24,car
53255,12,car,13,1,18697,33,33,150,94,205,61,55,car
53256,15,car,16,1,18698,17,151,123,176,153,25,30,car
53257,16,car,17,1,18698,21,163,123,210,160,47,37,car
53258,17,car,18,1,18698,21,195,122,256,173,61,51,car
53259,18,car,19,1,18698,16,31,116,76,152,45,36,car
53260,3,person,4,0,18700,20,145,160,158,182,13,22,person
53261,9,person,10,1,18700,17,92,138,111,165,19,27,person
53262,10,horse,11,0,18700,52,57,142,104,231,47,89,horse
53263,11,person,12,0,18700,31,17,162,44,221,27,59,person
53264,8,car,9,0,18701,20,22,166,50,190,28,24,car
53265,12,car,13,1,18701,15,122,167,137,188,15,21,car
53266,13,car,14,1,18701,18,130,166,161,190,31,24,car
53267,14,car,15,1,18701,22,143,168,204,197,61,29,car
53268,15,car,16,1,18701,16,189,169,233,204,44,35,car
53269,16,car,17,1,18701,17,218,169,256,212,38,43,car
53270,19,car,20,0,18701,20,87,165,123,191,36,26,car
53271,8,car,9,0,18702,22,214,168,247,194,33,26,car
53272,11,car,12,1,18702,19,93,180,132,200,39,20,car
53273,14,car,15,0,18702,22,26,182,72,201,46,19,car
53274,5,car,6,0,18703,28,190,147,243,182,53,35,car
53275,10,car,11,1,18703,16,114,148,133,167,19,19,car
53276,11,car,12,1,18703,23,84,148,117,181,33,33,car
53277,12,car,13,1,18703,33,16,150,99,215,83,65,car
53278,9,car,10,0,18704,17,179,181,203,196,24,15,car
53279,10,car,11,0,18704,15,218,178,239,194,21,16,car
53280,13,car,14,0,18705,17,207,192,234,205,27,13,car
53281,16,traffic light,17,0,18705,22,69,133,160,220,91,87,traffic light
53282,19,person,20,0,18705,25,115,191,126,213,11,22,person
53283,21,car,22,1,18705,15,89,221,134,250,45,29,car
53284,10,car,11,0,18707,19,71,135,104,163,33,28,car
53285,11,car,12,1,18707,27,2,141,73,220,71,79,car
53286,14,car,15,0,18707,17,154,134,175,153,21,19,car
53287,16,person,17,0,18707,17,214,129,220,154,6,25,person
53288,17,person,18,0,18707,20,222,131,230,156,8,25,person
53289,7,car,8,1,18708,16,27,167,51,183,24,16,car
53290,8,car,9,1,18708,17,2,170,32,198,30,28,car
53291,9,car,10,1,18708,24,49,165,89,196,40,31,car
53292,15,car,16,1,18708,15,223,177,241,207,18,30,car
53293,16,car,17,0,18708,36,73,173,174,240,101,67,car
53294,17,car,18,1,18708,23,157,169,223,211,66,42,car
53295,16,car,17,1,18709,18,169,140,206,175,37,35,car
53296,17,car,18,1,18709,21,196,138,256,219,60,81,car
53297,5,person,6,1,18710,18,204,132,217,183,13,51,person
53298,6,person,7,0,18710,27,187,131,213,193,26,62,person
53299,10,car,11,0,18710,18,154,143,188,166,34,23,car
53300,11,car,12,0,18710,19,64,146,96,175,32,29,car
53301,13,traffic light,14,0,18710,19,29,40,56,205,27,165,traffic light
53302,15,car,16,1,18711,16,228,171,256,200,28,29,car
53303,10,car,11,1,18712,16,99,169,121,185,22,16,car
53304,13,car,14,1,18712,17,85,167,106,186,21,19,car
53305,14,car,15,1,18712,21,54,164,92,190,38,26,car
53306,15,car,16,1,18712,22,11,169,58,196,47,27,car
53307,20,person,21,0,18712,33,137,160,159,204,22,44,person
53308,24,car,25,1,18712,18,235,169,256,200,21,31,car
53309,7,truck,8,0,18713,17,84,126,116,151,32,25,truck
53310,9,car,10,1,18713,19,122,135,148,153,26,18,car
53311,10,car,11,1,18713,17,139,139,169,156,30,17,car
53312,11,car,12,0,18713,26,167,141,212,162,45,21,car
53313,12,car,13,0,18713,17,28,137,55,163,27,26,car
53314,13,person,14,0,18713,24,99,134,113,167,14,33,person
53315,14,person,15,0,18713,19,245,137,254,167,9,30,person
53316,15,person,16,0,18713,17,227,137,236,164,9,27,person
53317,6,person,7,0,18714,23,70,140,79,169,9,29,person
53318,7,person,8,0,18714,26,55,140,67,174,12,34,person
53319,16,car,17,1,18714,20,159,145,202,191,43,46,car
53320,17,car,18,1,18714,20,189,149,256,256,67,107,car
53321,5,car,6,0,18715,21,204,131,256,175,52,44,car
53322,13,truck,14,0,18715,20,100,100,145,162,45,62,truck
53323,6,person,7,0,18716,34,2,129,31,220,29,91,person
53324,10,car,11,0,18716,30,179,120,253,181,74,61,car
53325,13,car,14,0,18716,15,100,137,119,151,19,14,car
53326,14,car,15,0,18716,27,40,139,102,184,62,45,car
53327,7,car,8,0,18717,17,23,153,56,165,33,12,car
53328,12,person,13,0,18718,16,12,148,19,171,7,23,person
53329,16,car,17,1,18718,19,24,153,96,191,72,38,car
53330,17,car,18,0,18718,20,6,159,76,221,70,62,car
53331,14,person,15,0,18719,22,70,145,80,171,10,26,person
53332,15,person,16,0,18719,30,101,139,117,192,16,53,person
53333,16,person,17,0,18719,31,86,136,103,197,17,61,person
53334,18,car,19,1,18719,20,17,148,68,180,51,32,car
53335,19,person,20,1,18719,20,10,143,30,194,20,51,person
53336,20,person,21,0,18719,18,0,141,19,194,19,53,person
53337,25,person,26,0,18719,27,229,146,242,200,13,54,person
53338,8,car,9,1,18720,17,113,210,140,233,27,23,car
53339,9,car,10,0,18720,20,77,212,123,242,46,30,car
53340,11,car,12,0,18721,23,145,149,193,174,48,25,car
53341,2,car,3,0,18722,20,123,135,152,148,29,13,car
53342,10,car,11,0,18722,25,66,136,111,167,45,31,car
53343,11,car,12,1,18722,16,2,145,67,236,65,91,car
53344,8,car,9,0,18723,16,3,153,34,177,31,24,car
53345,10,car,11,0,18723,19,78,154,106,170,28,16,car
53346,11,car,12,0,18723,23,110,155,147,178,37,23,car
53347,7,person,8,1,18724,18,232,167,251,197,19,30,person
53348,10,car,11,0,18724,15,0,161,26,177,26,16,car
53349,14,car,15,1,18724,16,52,169,72,189,20,20,car
53350,15,car,16,1,18724,15,67,172,93,195,26,23,car
53351,16,car,17,0,18724,22,85,171,136,202,51,31,car
53352,17,car,18,0,18724,31,152,171,254,229,102,58,car
53353,8,person,9,0,18725,23,77,136,92,182,15,46,person
53354,9,person,10,0,18725,21,104,144,115,171,11,27,person
53355,10,motorbike,11,1,18725,25,231,156,256,194,25,38,motorcycle
53356,11,car,12,1,18726,15,159,133,180,157,21,24,car
53357,12,car,13,1,18726,23,169,136,217,170,48,34,car
53358,14,car,15,1,18726,18,78,131,104,157,26,26,car
53359,15,car,16,0,18726,27,28,132,88,169,60,37,car
53360,9,car,10,1,18727,18,2,133,52,167,50,34,car
53361,10,car,11,1,18727,17,216,135,256,168,40,33,car
53362,10,car,11,1,18728,16,236,164,256,198,20,34,car
53363,15,car,16,1,18728,25,102,163,159,203,57,40,car
53364,17,car,18,1,18728,28,2,157,113,243,111,86,car
53365,10,person,11,0,18729,22,100,150,112,185,12,35,person
53366,12,person,13,0,18729,17,159,157,170,189,11,32,person
53367,2,person,3,0,18730,23,91,116,104,154,13,38,person
53368,11,truck,12,1,18730,18,152,113,183,144,31,31,truck
53369,12,car,13,1,18730,19,164,123,184,148,20,25,car
53370,13,car,14,1,18730,22,177,123,218,161,41,38,car
53371,6,car,7,1,18731,20,308,190,400,296,92,106,car
53372,7,car,8,1,18731,22,233,176,339,221,106,45,car
53373,8,car,9,0,18731,29,144,180,257,242,113,62,car
53374,9,car,10,1,18731,26,87,170,151,218,64,48,car
53375,11,car,12,1,18731,20,59,178,88,201,29,23,car
53376,6,person,7,1,18732,20,175,181,188,225,13,44,person
53377,7,person,8,1,18732,19,186,176,203,220,17,44,person
53378,13,person,14,0,18732,49,29,163,68,256,39,93,person
53379,9,car,10,1,18733,20,103,159,132,176,29,17,car
53380,10,car,11,0,18733,21,131,161,167,180,36,19,car
53381,12,car,13,1,18733,25,163,165,256,214,93,49,car
53382,13,car,14,0,18733,26,62,159,98,181,36,22,car
53383,14,car,15,1,18733,17,2,163,75,231,73,68,car
53384,15,car,16,1,18733,16,34,190,256,256,222,66,car
53385,11,car,12,1,18734,15,108,169,137,197,29,28,car
53386,12,car,13,0,18734,25,62,175,116,212,54,37,car
53387,14,car,15,1,18734,19,0,184,51,256,51,72,car
53388,10,car,11,0,18735,18,154,141,180,159,26,18,car
53389,15,person,16,0,18735,17,78,138,83,158,5,20,person
53390,16,person,17,0,18735,19,84,138,93,161,9,23,person
53391,19,person,20,0,18735,20,192,137,202,157,10,20,person
53392,9,car,10,1,18738,18,2,145,33,174,31,29,car
53393,13,person,14,0,18738,25,129,139,142,168,13,29,person
53394,5,car,6,1,18739,22,11,153,77,177,66,24,car
53395,9,car,10,0,18739,28,65,151,142,189,77,38,car
53396,10,car,11,1,18739,29,156,154,231,207,75,53,car
53397,11,car,12,1,18740,15,133,163,147,185,14,22,car
53398,12,person,13,0,18740,18,144,165,152,189,8,24,person
53399,13,car,14,1,18740,17,159,170,186,195,27,25,car
53400,14,bicycle,15,0,18740,38,208,177,234,206,26,29,bicycle
53401,15,person,16,0,18740,26,183,158,195,208,12,50,person
53402,16,motorbike,17,1,18740,23,231,179,248,214,17,35,motorcycle
53403,19,person,20,0,18740,22,87,161,99,205,12,44,person
53404,21,person,22,0,18740,27,73,163,90,212,17,49,person
53405,22,person,23,0,18740,25,64,166,75,215,11,49,person
53406,23,person,24,0,18740,28,53,167,70,219,17,52,person
53407,11,person,12,0,18741,17,131,146,140,171,9,25,person
53408,18,car,19,1,18741,20,203,166,256,204,53,38,car
53409,20,car,21,0,18741,21,41,152,72,174,31,22,car
53410,21,car,22,0,18741,22,69,160,113,189,44,29,car
53411,22,car,23,0,18741,23,137,160,226,215,89,55,car
53412,14,car,15,0,18742,24,65,131,110,154,45,23,car
53413,21,car,22,1,18742,16,2,133,51,165,49,32,car
53414,10,car,11,1,18743,15,100,145,113,160,13,15,car
53415,11,car,12,0,18743,25,63,142,103,171,40,29,car
53416,15,person,16,0,18743,34,167,132,179,169,12,37,person
53417,11,car,12,1,18744,17,169,113,202,144,33,31,car
53418,12,car,13,1,18744,18,196,119,229,152,33,33,car
53419,14,car,15,1,18744,16,213,121,256,172,43,51,car
53420,8,car,9,1,18745,20,50,132,82,150,32,18,car
53421,9,car,10,0,18745,15,16,133,57,155,41,22,car
53422,12,car,13,1,18745,20,128,128,179,169,51,41,car
53423,13,car,14,0,18745,29,66,136,162,191,96,55,car
53424,17,parking meter,18,0,18745,16,104,144,119,220,15,76,parking meter
53425,15,car,16,1,18746,24,160,156,231,202,71,46,car
53426,16,car,17,1,18746,19,201,166,256,255,55,89,car
53427,2,person,3,1,18747,18,209,180,256,256,47,76,person
53428,4,person,5,0,18747,31,169,167,202,256,33,89,person
53429,11,person,12,0,18747,21,61,171,71,202,10,31,person
53430,12,person,13,0,18747,23,94,184,107,224,13,40,person
53431,13,person,14,0,18747,18,45,169,57,202,12,33,person
53432,14,person,15,0,18747,23,26,166,41,212,15,46,person
53433,18,chair,19,1,18747,15,2,221,27,256,25,35,chair
53434,9,car,10,0,18748,26,64,142,102,169,38,27,car
53435,10,car,11,0,18748,15,148,140,170,158,22,18,car
53436,11,car,12,1,18748,21,2,144,66,217,64,73,car
53437,3,bus,4,0,18749,22,12,111,50,139,38,28,bus
53438,7,person,8,0,18749,16,164,124,170,143,6,19,person
53439,9,car,10,1,18749,16,79,125,98,142,19,17,car
53440,10,car,11,1,18749,19,92,128,117,145,25,17,car
53441,11,car,12,0,18749,27,119,131,164,150,45,19,car
53442,12,car,13,1,18749,28,164,133,231,159,67,26,car
53443,13,car,14,1,18749,15,226,138,256,164,30,26,car
53444,12,person,13,0,18750,23,198,130,207,161,9,31,person
53445,4,car,5,0,18751,15,197,133,223,145,26,12,car
53446,7,car,8,1,18751,16,66,139,89,166,23,27,car
53447,8,car,9,0,18751,26,18,141,78,191,60,50,car
53448,14,car,15,0,18751,30,127,136,182,170,55,34,car
53449,9,person,7,0,18752,47,43,161,72,240,29,79,person
53450,10,person,8,1,18752,32,20,156,50,237,30,81,person
53451,11,person,9,1,18752,25,5,155,20,236,15,81,person
53452,12,car,10,1,18752,15,71,169,88,197,17,28,car
53453,15,car,13,0,18752,22,118,174,144,198,26,24,car
53454,19,person,17,0,18752,21,206,168,221,207,15,39,person
53455,20,person,18,0,18752,15,151,171,159,192,8,21,person
53456,10,car,11,0,18753,18,124,137,157,167,33,30,car
53457,11,person,12,0,18753,18,209,128,217,158,8,30,person
53458,12,person,13,0,18753,21,220,132,227,158,7,26,person
53459,13,person,14,0,18753,23,231,132,239,157,8,25,person
53460,27,car,28,1,18754,17,47,188,108,207,61,19,car
53461,28,car,29,0,18754,29,41,195,115,226,74,31,car
53462,29,person,30,1,18754,16,48,223,71,256,23,33,person
53463,30,person,31,1,18754,17,32,230,48,256,16,26,person
53464,9,car,10,1,18755,18,180,190,256,216,76,26,car
53465,10,motorbike,11,0,18755,38,184,201,251,238,67,37,motorcycle
53466,11,car,12,0,18755,15,107,191,134,209,27,18,car
53467,14,car,15,1,18755,16,0,196,44,226,44,30,car
53468,8,car,9,1,18756,19,129,165,163,190,34,25,car
53469,9,car,10,1,18756,23,84,168,128,199,44,31,car
53470,10,car,11,1,18756,26,12,173,87,204,75,31,car
53471,12,car,13,1,18756,17,198,168,237,203,39,35,car
53472,13,car,14,0,18756,24,153,179,213,221,60,42,car
53473,8,car,9,1,18757,19,161,138,181,163,20,25,car
53474,9,car,10,1,18757,29,173,137,223,182,50,45,car
53475,10,car,11,1,18757,18,204,143,256,225,52,82,car
53476,13,person,14,1,18757,33,20,140,38,183,18,43,person
53477,9,truck,10,1,18758,15,159,142,189,177,30,35,truck
53478,12,car,13,1,18758,16,180,154,206,192,26,38,car
53479,13,car,14,1,18758,22,188,151,256,222,68,71,car
53480,14,car,15,1,18758,15,231,179,256,255,25,76,car
53481,21,car,22,1,18758,19,63,162,86,185,23,23,car
53482,22,car,23,1,18758,19,30,163,70,192,40,29,car
53483,23,car,24,1,18758,20,2,163,45,203,43,40,car
53484,10,car,11,1,18759,19,36,175,64,213,28,38,car
53485,11,car,12,1,18759,16,2,165,48,238,46,73,car
53486,14,car,15,0,18759,20,124,173,152,196,28,23,car
53487,15,car,16,1,18759,17,157,174,176,197,19,23,car
53488,16,car,17,1,18759,23,172,167,212,204,40,37,car
53489,17,car,18,1,18759,19,200,165,256,218,56,53,car
53490,7,car,8,1,18760,22,169,122,192,163,23,41,car
53491,8,car,9,1,18760,20,182,117,256,188,74,71,car
53492,6,person,7,1,18761,15,217,130,228,143,11,13,person
53493,10,car,11,0,18761,19,164,139,199,164,35,25,car
53494,12,car,13,1,18761,18,199,141,256,191,57,50,car
53495,3,person,4,0,18762,21,134,136,150,168,16,32,person
53496,9,car,10,0,18762,20,232,143,256,159,24,16,car
53497,10,car,11,0,18762,18,194,143,232,167,38,24,car
53498,4,truck,5,1,18763,15,148,132,182,150,34,18,truck
53499,12,car,13,1,18763,22,54,144,92,176,38,32,car
53500,13,car,14,1,18763,25,2,153,70,199,68,46,car
53501,12,car,13,0,18764,20,2,141,44,176,42,35,car
53502,14,car,15,1,18764,20,182,140,228,170,46,30,car
53503,15,car,16,1,18764,17,223,146,256,190,33,44,car
53504,6,person,7,0,18765,27,72,138,83,167,11,29,person
53505,10,car,11,1,18765,15,162,148,180,183,18,35,car
53506,18,car,19,1,18766,16,134,180,158,203,24,23,car
53507,19,car,20,1,18766,17,116,179,143,209,27,30,car
53508,20,car,21,1,18766,20,0,161,124,256,124,95,car
53509,8,car,9,1,18767,15,157,153,200,189,43,36,car
53510,18,car,19,0,18767,20,42,155,68,172,26,17,car
53511,6,person,7,0,18768,20,38,207,47,237,9,30,person
53512,7,person,8,0,18768,15,50,211,56,233,6,22,person
53513,17,person,18,0,18768,24,130,206,140,236,10,30,person
53514,34,car,35,1,18768,18,173,210,208,241,35,31,car
53515,35,car,36,1,18768,25,194,212,251,256,57,44,car
53516,5,motorbike,6,0,18769,18,82,166,92,190,10,24,motorcycle
53517,9,person,10,0,18769,18,111,149,120,187,9,38,person
53518,10,person,11,0,18769,15,123,152,133,183,10,31,person
53519,12,motorbikes,13,0,18769,40,115,136,230,256,115,120,motorcycle
53520,6,person,7,0,18770,20,157,229,170,251,13,22,person
53521,7,person,8,0,18770,21,170,230,183,251,13,21,person
53522,15,person,16,0,18771,26,163,171,183,222,20,51,person
53523,6,car,7,1,18772,22,50,143,109,180,59,37,car
53524,9,car,10,1,18772,24,181,134,245,174,64,40,car
53525,10,car,11,1,18772,15,219,138,256,194,37,56,car
53526,7,car,8,0,18773,15,104,179,128,199,24,20,car
53527,9,car,10,0,18773,15,52,180,71,192,19,12,car
53528,12,car,13,0,18773,18,2,173,30,198,28,25,car
53529,15,car,16,1,18773,19,171,177,208,208,37,31,car
53530,16,car,17,0,18773,26,192,178,251,218,59,40,car
53531,4,bus,5,0,18774,17,50,122,93,137,43,15,bus
53532,16,car,17,1,18774,15,79,141,110,164,31,23,car
53533,17,car,18,1,18774,16,213,145,246,180,33,35,car
53534,20,car,21,0,18774,19,125,145,172,177,47,32,car
53535,7,person,8,0,18775,15,5,150,18,182,13,32,person
53536,15,car,16,0,18775,15,112,142,141,155,29,13,car
53537,16,car,17,1,18775,16,138,141,158,159,20,18,car
53538,17,car,18,1,18775,15,147,143,168,161,21,18,car
53539,19,car,20,1,18775,16,175,148,199,169,24,21,car
53540,20,car,21,0,18775,24,188,149,236,175,48,26,car
53541,23,car,24,0,18775,25,49,150,121,213,72,63,car
53542,11,car,12,1,18776,19,69,142,106,176,37,34,car
53543,12,car,13,1,18776,26,0,144,82,222,82,78,car
53544,15,car,16,1,18776,21,182,139,220,176,38,37,car
53545,16,car,17,1,18776,18,210,141,256,208,46,67,car
53546,16,car,17,1,18777,19,2,220,44,256,42,36,car
53547,18,person,19,0,18777,16,214,211,219,235,5,24,person
53548,21,motorbike,22,0,18777,24,214,220,247,242,33,22,motorcycle
53549,22,person,23,0,18777,19,229,214,238,237,9,23,person
53550,10,car,11,0,18778,18,73,172,125,191,52,19,car
53551,12,person,13,0,18778,16,50,171,62,196,12,25,person
53552,14,person,15,0,18779,20,129,192,139,220,10,28,person
53553,16,person,17,1,18779,28,169,198,193,256,24,58,person
53554,17,person,18,1,18779,30,199,190,230,256,31,66,person
53555,18,person,19,1,18779,17,235,198,256,255,21,57,person
53556,9,person,10,0,18780,21,103,163,117,191,14,28,person
53557,12,car,13,0,18780,23,128,171,162,198,34,27,car
53558,13,car,14,1,18780,33,12,165,100,239,88,74,car
53559,14,person,15,1,18780,35,0,163,20,255,20,92,person
53560,16,person,17,0,18780,37,197,164,220,249,23,85,person
53561,17,person,18,0,18780,40,169,169,197,245,28,76,person
53562,8,car,9,0,18781,32,26,137,81,169,55,32,car
53563,12,car,13,0,18781,20,90,137,126,171,36,34,car
53564,11,car,12,1,18782,16,183,168,203,187,20,19,car
53565,13,car,14,0,18782,17,136,168,173,193,37,25,car
53566,14,car,15,1,18782,17,82,176,127,200,45,24,car
53567,15,person,16,0,18782,23,118,175,144,221,26,46,person
53568,16,person,17,0,18782,27,98,177,114,219,16,42,person
53569,17,person,18,0,18782,16,11,166,21,194,10,28,person
53570,18,person,19,0,18782,23,26,171,38,224,12,53,person
53571,8,person,9,0,18783,16,41,198,48,221,7,23,person
53572,9,person,10,0,18783,28,54,201,65,236,11,35,person
53573,10,person,11,0,18783,32,65,199,82,236,17,37,person
53574,11,person,12,0,18783,31,2,200,17,256,15,56,person
53575,12,person,13,0,18783,34,17,195,33,250,16,55,person
53576,13,person,14,0,18783,39,123,196,144,250,21,54,person
53577,14,person,15,0,18783,17,109,200,117,228,8,28,person
53578,18,person,19,0,18783,28,87,196,108,255,21,59,person
53579,10,car,11,0,18784,15,131,174,151,191,20,17,car
53580,13,car,14,1,18784,17,186,169,223,208,37,39,car
53581,14,car,15,1,18784,22,207,161,256,230,49,69,car
53582,10,car,11,0,18785,20,211,182,245,204,34,22,car
53583,11,car,12,0,18785,15,172,167,197,179,25,12,car
53584,14,truck,15,0,18785,17,128,173,176,218,48,45,truck
53585,15,car,16,0,18785,21,175,204,226,237,51,33,car
53586,7,person,8,0,18787,20,148,208,156,231,8,23,person
53587,12,car,13,0,18787,22,162,212,196,242,34,30,car
53588,9,car,10,1,18788,18,95,175,127,194,32,19,car
53589,13,person,14,0,18788,22,4,171,15,211,11,40,person
53590,14,person,15,0,18788,27,22,169,35,212,13,43,person
53591,12,car,13,0,18790,15,220,143,241,159,21,16,car
53592,13,car,14,1,18790,15,191,143,210,160,19,17,car
53593,15,car,16,0,18790,23,144,146,180,167,36,21,car
53594,18,person,19,0,18790,17,52,144,59,176,7,32,person
53595,3,car,4,0,18791,22,113,164,169,190,56,26,car
53596,4,car,5,0,18791,31,170,154,224,183,54,29,car
53597,5,car,6,1,18791,23,223,153,256,178,33,25,car
53598,2,person,3,0,18792,32,166,167,181,213,15,46,person
53599,3,person,4,0,18792,26,183,171,198,212,15,41,person
53600,7,person,8,1,18792,26,140,170,155,218,15,48,person
53601,8,person,9,1,18792,32,113,173,136,248,23,75,person
53602,9,person,10,0,18792,30,129,193,150,253,21,60,person
53603,10,person,11,0,18792,29,14,174,28,222,14,48,person
53604,11,person,12,1,18792,25,32,179,58,256,26,77,person
53605,12,person,13,1,18792,29,54,177,87,256,33,79,person
53606,10,car,11,0,18793,23,114,166,149,190,35,24,car
53607,11,car,12,0,18793,17,41,171,85,197,44,26,car
53608,12,car,13,1,18793,16,2,169,42,204,40,35,car
53609,10,car,11,1,18794,15,132,189,149,204,17,15,car
53610,12,car,13,0,18794,20,79,188,118,209,39,21,car
53611,5,person,6,0,18795,18,241,136,250,160,9,24,person
53612,7,car,8,0,18795,16,42,138,76,160,34,22,car
53613,10,car,11,0,18795,19,161,140,189,155,28,15,car
53614,4,truck,5,1,18796,16,205,99,256,173,51,74,truck
53615,6,car,7,0,18796,26,173,149,236,187,63,38,car
53616,15,person,16,0,18796,22,145,145,155,180,10,35,person
53617,16,person,17,1,18796,15,3,138,15,204,12,66,person
53618,5,car,6,0,18797,21,4,164,54,190,50,26,car
53619,7,car,8,1,18797,17,145,156,178,183,33,27,car
53620,8,car,9,1,18797,17,124,166,162,192,38,26,car
53621,9,car,10,0,18797,26,67,167,137,214,70,47,car
53622,12,car,13,1,18798,17,205,154,256,256,51,102,car
53623,7,person,8,0,18799,23,10,146,23,182,13,36,person
53624,8,car,9,0,18799,16,132,149,171,184,39,35,car
53625,9,bus,10,1,18799,19,170,128,224,171,54,43,bus
53626,10,car,11,1,18799,16,215,154,256,196,41,42,car
53627,8,car,9,1,18800,20,118,168,152,201,34,33,car
53628,9,car,10,1,18800,29,138,166,227,221,89,55,car
53629,11,car,12,1,18800,16,47,162,103,218,56,56,car
53630,12,car,13,1,18800,25,2,174,94,238,92,64,car
53631,15,car,16,1,18800,16,188,181,256,256,68,75,car
53632,7,car,8,1,18801,20,142,159,170,192,28,33,car
53633,8,person,9,0,18801,25,32,152,50,195,18,43,person
53634,9,person,10,0,18801,26,59,154,78,193,19,39,person
53635,13,car,14,0,18801,28,178,150,232,200,54,50,car
53636,14,car,15,0,18801,30,77,156,149,205,72,49,car
53637,15,car,16,1,18801,17,0,164,35,221,35,57,car
53638,9,car,10,0,18802,19,174,210,214,234,40,24,car
53639,4,car,5,1,18803,24,172,178,256,245,84,67,car
53640,5,person,6,1,18803,20,182,165,198,192,16,27,person
53641,6,person,7,1,18803,16,195,165,210,191,15,26,person
53642,9,car,10,0,18803,15,9,158,25,169,16,11,car
53643,6,car,7,0,18804,23,68,120,107,145,39,25,car
53644,11,person,12,0,18804,18,195,110,203,135,8,25,person
53645,13,car,14,0,18805,16,140,137,169,159,29,22,car
53646,15,car,16,1,18805,21,195,136,224,161,29,25,car
53647,16,car,17,1,18805,20,218,136,256,166,38,30,car
53648,18,car,19,1,18805,16,54,143,106,189,52,46,car
53649,19,car,20,1,18805,29,0,136,103,256,103,120,car
53650,7,car,8,0,18806,15,122,130,145,146,23,16,car
53651,8,car,9,1,18806,17,73,134,105,152,32,18,car
53652,9,car,10,0,18806,22,29,137,79,157,50,20,car
53653,11,car,12,0,18806,19,177,136,207,155,30,19,car
53654,4,person,5,0,18807,38,193,134,221,197,28,63,person
53655,8,car,9,1,18807,19,67,134,98,152,31,18,car
53656,9,car,10,1,18807,20,30,133,69,155,39,22,car
53657,10,car,11,1,18807,19,0,125,45,165,45,40,car
53658,12,car,13,0,18807,21,139,133,178,162,39,29,car
53659,7,car,8,1,18809,20,36,138,73,171,37,33,car
53660,8,car,9,1,18809,22,48,146,80,180,32,34,car
53661,9,car,10,1,18809,32,65,144,133,196,68,52,car
53662,10,car,11,1,18809,29,96,146,256,249,160,103,car
53663,10,car,11,1,18810,18,199,157,231,184,32,27,car
53664,13,car,14,0,18810,24,30,163,97,195,67,32,car
53665,8,person,9,0,18811,16,80,188,88,211,8,23,person
53666,9,person,10,0,18811,15,88,187,95,208,7,21,person
53667,10,person,11,0,18811,16,100,186,108,211,8,25,person
53668,14,car,15,1,18811,20,189,182,236,225,47,43,car
53669,15,car,16,1,18811,21,218,172,256,256,38,84,car
53670,10,person,11,0,18812,23,42,142,52,178,10,36,person
53671,11,person,12,0,18812,28,10,143,29,188,19,45,person
53672,13,car,14,0,18812,31,38,149,146,243,108,94,car
53673,14,car,15,1,18812,20,165,145,200,179,35,34,car
53674,15,car,16,1,18812,31,185,147,256,236,71,89,car
53675,10,car,11,1,18813,15,182,134,217,157,35,23,car
53676,11,car,12,0,18813,26,187,143,239,179,52,36,car
53677,14,car,15,0,18813,21,128,136,159,154,31,18,car
53678,15,car,16,1,18813,18,77,140,114,156,37,16,car
53679,17,person,18,0,18813,15,62,133,71,166,9,33,person
53680,18,person,19,0,18813,30,39,132,56,176,17,44,person
53681,21,car,22,1,18813,16,0,160,30,202,30,42,car
53682,12,car,13,1,18814,16,60,179,81,201,21,22,car
53683,13,car,14,1,18814,20,69,183,93,204,24,21,car
53684,14,car,15,1,18814,17,75,188,96,208,21,20,car
53685,15,car,16,0,18814,26,90,181,140,222,50,41,car
53686,13,car,14,1,18815,17,78,137,104,173,26,36,car
53687,14,car,15,0,18815,19,2,129,86,190,84,61,car
53688,17,car,18,1,18815,15,195,137,214,164,19,27,car
53689,18,car,19,1,18815,19,202,139,252,176,50,37,car
53690,15,truck,16,0,18816,19,41,142,84,186,43,44,truck
53691,18,person,19,0,18816,16,144,165,149,191,5,26,person
53692,19,person,20,0,18816,16,154,159,161,181,7,22,person
53693,13,car,14,0,18817,15,106,137,127,145,21,8,car
53694,14,car,15,0,18817,15,162,138,181,153,19,15,car
53695,16,car,17,1,18817,23,198,137,256,198,58,61,car
53696,8,car,9,0,18818,21,161,130,194,153,33,23,car
53697,9,motorbike,10,0,18818,17,209,130,222,144,13,14,motorcycle
53698,10,motorbike,11,0,18818,22,240,126,254,152,14,26,motorcycle
53699,14,car,15,1,18818,18,76,131,112,156,36,25,car
53700,15,person,16,0,18818,28,93,130,107,172,14,42,person
53701,16,person,17,0,18818,28,8,127,23,169,15,42,person
53702,2,car,3,0,18819,23,57,191,108,231,51,40,car
53703,9,person,10,0,18819,18,29,183,38,211,9,28,person
53704,11,person,12,0,18819,26,3,193,23,233,20,40,person
53705,14,car,15,1,18819,18,116,190,188,219,72,29,car
53706,16,car,17,1,18819,19,123,194,256,251,133,57,car
53707,20,car,21,1,18820,15,206,121,224,149,18,28,car
53708,21,car,22,1,18820,17,220,115,256,164,36,49,car
53709,6,motorbike,7,0,18821,38,21,148,64,210,43,62,motorcycle
53710,9,person,10,0,18821,27,212,134,226,166,14,32,person
53711,10,person,11,0,18821,32,240,136,256,172,16,36,person
53712,14,car,15,0,18821,26,155,138,204,174,49,36,car
53713,18,motorbike,19,1,18821,15,69,142,88,169,19,27,motorcycle
53714,30,bus,31,0,18822,17,22,137,89,209,67,72,bus
53715,14,boat,15,0,18823,20,183,174,245,236,62,62,boat
53716,5,person,6,1,18824,16,195,98,204,131,9,33,person
53717,6,motorbike,7,1,18824,40,199,124,231,176,32,52,motorcycle
53718,7,motorbike,8,1,18824,25,214,130,251,191,37,61,motorcycle
53719,8,person,9,1,18824,27,233,122,256,211,23,89,person
53720,10,motorbike,11,1,18824,31,96,112,115,158,19,46,motorcycle
53721,11,motorbike,12,1,18824,18,81,122,107,165,26,43,motorcycle
53722,12,table,13,1,18824,15,39,163,70,203,31,40,dining table
53723,13,person,14,1,18824,29,26,93,56,163,30,70,person
53724,14,person,15,1,18824,21,2,95,16,154,14,59,person
53725,15,motorbikes,16,0,18824,27,2,155,58,256,56,101,motorcycle
53726,17,motorbike,18,1,18824,27,64,124,83,173,19,49,motorcycle
53727,19,person,20,0,18824,40,134,100,161,181,27,81,person
53728,5,truck,6,1,18825,15,155,102,189,145,34,43,truck
53729,6,motorbike,7,0,18825,40,174,127,227,166,53,39,motorcycle
53730,7,person,8,0,18825,24,201,113,213,142,12,29,person
53731,9,person,10,0,18825,29,35,118,49,152,14,34,person
53732,12,car,13,0,18825,21,68,123,105,148,37,25,car
53733,11,car,12,0,18826,21,131,161,169,179,38,18,car
53734,13,car,14,0,18826,20,191,159,222,177,31,18,car
53735,14,car,15,0,18826,30,23,162,100,191,77,29,car
53736,15,car,16,0,18827,20,78,164,101,184,23,20,car
53737,16,car,17,1,18827,18,30,166,53,186,23,20,car
53738,20,car,21,0,18827,26,186,172,222,197,36,25,car
53739,7,person,8,0,18828,18,119,125,126,147,7,22,person
53740,8,person,9,0,18828,46,229,119,254,177,25,58,person
53741,13,car,14,0,18828,22,21,129,74,164,53,35,car
53742,3,person,4,0,18829,17,140,177,147,206,7,29,person
53743,6,person,7,0,18829,31,69,195,97,232,28,37,person
53744,8,person,9,1,18829,33,147,179,167,236,20,57,person
53745,9,person,10,0,18829,44,159,180,186,253,27,73,person
53746,14,car,15,0,18830,21,54,131,85,149,31,18,car
53747,15,car,16,1,18830,17,0,131,49,154,49,23,car
53748,18,car,19,0,18830,19,186,132,216,149,30,17,car
53749,8,car,9,0,18831,21,146,147,173,163,27,16,car
53750,15,car,16,1,18832,18,154,157,189,183,35,26,car
53751,16,car,17,1,18832,22,118,158,168,194,50,36,car
53752,17,car,18,1,18832,25,65,162,135,214,70,52,car
53753,9,car,10,1,18833,21,36,214,113,290,77,76,car
53754,20,car,21,1,18833,19,144,207,260,295,116,88,car
53755,21,car,22,0,18833,27,82,212,256,360,174,148,car
53756,28,person,29,0,18833,25,658,209,693,297,35,88,person
53757,29,person,30,0,18833,20,618,204,643,276,25,72,person
53758,6,car,7,1,18834,22,112,188,155,217,43,29,car
53759,7,car,8,1,18834,23,145,195,203,226,58,31,car
53760,8,car,9,1,18834,22,189,189,256,245,67,56,car
53761,10,truck,11,0,18835,24,153,103,219,169,66,66,truck
53762,3,person,4,1,18836,15,59,136,68,161,9,25,person
53763,10,car,11,1,18836,19,65,143,108,172,43,29,car
53764,11,car,12,1,18836,19,34,142,67,188,33,46,car
53765,12,car,13,1,18836,27,2,139,56,206,54,67,car
53766,16,car,17,1,18836,17,180,139,199,179,19,40,car
53767,18,car,19,1,18836,27,196,135,244,198,48,63,car
53768,19,car,20,1,18836,19,217,135,256,206,39,71,car
53769,8,car,9,0,18837,16,227,134,250,155,23,21,car
53770,10,car,11,0,18837,16,169,144,195,157,26,13,car
53771,12,car,13,1,18837,18,130,142,159,161,29,19,car
53772,13,car,14,1,18837,20,91,141,130,167,39,26,car
53773,14,car,15,1,18837,32,2,140,90,184,88,44,car
53774,7,person,8,0,18839,15,86,150,96,178,10,28,person
53775,8,person,9,0,18839,18,99,154,111,187,12,33,person
53776,11,car,12,0,18839,31,138,160,244,240,106,80,car
53777,7,person,8,0,18840,15,192,104,196,120,4,16,person
53778,15,person,16,0,18840,63,17,121,61,246,44,125,person
53779,18,car,19,0,18840,19,156,123,189,156,33,33,car
53780,4,person,5,0,18841,17,98,156,108,194,10,38,person
53781,9,person,10,0,18841,33,25,157,58,238,33,81,person
53782,11,person,12,0,18841,38,130,154,166,245,36,91,person
53783,19,person,20,0,18841,18,112,153,120,177,8,24,person
53784,8,car,9,1,18843,21,46,144,92,179,46,35,car
53785,9,car,10,1,18843,26,2,145,79,215,77,70,car
53786,12,car,13,1,18843,25,125,140,170,166,45,26,car
53787,13,car,14,1,18843,29,167,143,224,183,57,40,car
53788,14,car,15,1,18843,21,197,144,256,226,59,82,car
53789,9,person,10,0,18844,18,184,143,192,162,8,19,person
53790,10,person,11,0,18844,25,237,133,252,178,15,45,person
53791,12,car,13,1,18844,24,33,150,91,192,58,42,car
53792,8,car,9,1,18846,16,2,161,41,224,39,63,car
53793,9,car,10,1,18846,27,2,131,109,206,107,75,car
53794,10,car,11,1,18846,15,93,126,129,150,36,24,car
53795,13,car,14,0,18846,19,121,126,165,159,44,33,car
53796,9,car,10,1,18847,18,111,179,148,196,37,17,car
53797,10,car,11,1,18847,23,47,178,111,204,64,26,car
53798,12,car,13,0,18848,19,87,138,119,162,32,24,car
53799,14,car,15,1,18848,16,164,132,183,155,19,23,car
53800,15,car,16,0,18848,23,175,134,225,167,50,33,car
53801,8,truck,9,1,18849,15,102,153,144,174,42,21,truck
53802,9,truck,10,1,18849,15,57,153,100,177,43,24,truck
53803,15,car,16,1,18849,16,221,172,243,190,22,18,car
53804,16,car,17,1,18849,15,27,167,76,190,49,23,car
53805,17,car,18,1,18849,18,63,169,120,199,57,30,car
53806,18,car,19,1,18849,17,194,169,226,196,32,27,car
53807,19,car,20,1,18849,19,173,170,208,204,35,34,car
53808,20,car,21,1,18849,25,146,173,196,215,50,42,car
53809,22,car,23,1,18849,31,70,176,160,235,90,59,car
53810,23,car,24,0,18849,18,2,178,89,256,87,78,car
53811,14,car,15,0,18850,23,93,149,126,167,33,18,car
53812,15,car,16,0,18850,21,138,146,184,184,46,38,car
53813,16,car,17,1,18850,27,0,147,89,190,89,43,car
53814,9,truck,10,1,18851,18,61,139,96,171,35,32,truck
53815,10,car,11,1,18851,19,18,158,51,180,33,22,car
53816,11,car,12,0,18851,18,53,161,82,181,29,20,car
53817,13,car,14,1,18851,27,138,160,211,218,73,58,car
53818,14,car,15,1,18851,16,147,171,256,256,109,85,car
53819,6,person,7,0,18852,37,0,369,73,556,73,187,person
53820,7,person,8,0,18852,18,141,370,173,507,32,137,person
53821,8,person,9,1,18852,15,119,382,147,503,28,121,person
53822,8,person,9,0,18853,20,95,128,104,157,9,29,person
53823,10,car,11,1,18853,19,56,134,90,167,34,33,car
53824,11,car,12,1,18853,25,2,134,69,193,67,59,car
53825,15,car,16,0,18853,16,152,129,175,149,23,20,car
53826,17,car,18,1,18853,16,218,127,256,161,38,34,car
53827,18,person,19,0,18853,29,197,127,213,158,16,31,person
53828,6,car,7,1,18854,19,159,141,184,165,25,24,car
53829,7,car,8,1,18854,20,178,141,226,183,48,42,car
53830,8,car,9,1,18854,19,210,143,256,211,46,68,car
53831,13,person,14,0,18854,19,84,140,92,164,8,24,person
53832,8,car,9,1,18855,15,75,145,100,179,25,34,car
53833,9,car,10,1,18855,25,2,149,84,215,82,66,car
53834,10,car,11,1,18855,20,161,144,192,168,31,24,car
53835,11,car,12,1,18855,24,188,145,239,195,51,50,car
53836,4,person,5,0,18856,15,246,141,253,171,7,30,person
53837,5,person,6,0,18856,15,230,147,245,169,15,22,person
53838,10,car,11,1,18856,17,4,142,50,164,46,22,car
53839,11,person,12,0,18856,19,22,135,34,168,12,33,person
53840,12,person,13,0,18856,16,16,136,25,167,9,31,person
53841,13,car,14,1,18856,15,53,139,78,156,25,17,car
53842,9,car,10,1,18857,17,117,114,139,130,22,16,car
53843,10,car,11,1,18857,20,90,116,124,136,34,20,car
53844,11,car,12,0,18857,28,34,117,91,145,57,28,car
53845,14,car,15,0,18857,22,175,117,227,153,52,36,car
53846,11,car,12,0,18858,18,73,174,104,194,31,20,car
53847,12,car,13,0,18858,19,47,174,81,200,34,26,car
53848,13,car,14,0,18858,20,2,175,50,208,48,33,car
53849,8,person,9,0,18859,17,140,163,147,185,7,22,person
53850,10,bus,11,0,18859,18,96,150,137,187,41,37,bus
53851,8,car,9,1,18860,24,7,165,79,225,72,60,car
53852,11,car,12,1,18860,18,171,156,208,195,37,39,car
53853,12,car,13,1,18860,22,196,159,256,230,60,71,car
53854,15,car,16,0,18861,23,155,136,186,160,31,24,car
53855,17,car,18,0,18861,28,33,151,100,195,67,44,car
53856,12,car,13,0,18863,19,79,140,100,155,21,15,car
53857,17,car,18,0,18863,22,163,136,212,164,49,28,car
53858,18,car,19,1,18863,23,209,142,256,175,47,33,car
53859,19,car,20,1,18863,18,217,150,256,198,39,48,car
53860,20,car,21,0,18863,18,102,142,130,160,28,18,car
53861,12,car,13,1,18864,19,167,123,202,154,35,31,car
53862,13,car,14,1,18864,21,185,122,256,179,71,57,car
53863,8,car,9,1,18865,15,203,162,239,197,36,35,car
53864,11,person,12,0,18865,16,247,154,256,187,9,33,person
53865,4,car,5,0,18866,16,190,154,220,168,30,14,car
53866,5,car,6,0,18866,15,162,157,186,172,24,15,car
53867,6,car,7,0,18866,23,114,159,155,178,41,19,car
53868,7,person,8,0,18867,21,85,108,98,150,13,42,person
53869,8,person,9,0,18867,20,98,121,106,150,8,29,person
53870,9,person,10,0,18867,19,115,117,125,151,10,34,person
53871,12,car,13,1,18867,19,142,122,173,150,31,28,car
53872,17,car,18,1,18867,25,169,126,221,169,52,43,car
53873,23,car,24,1,18867,15,214,133,256,205,42,72,car
53874,12,car,13,0,18868,29,9,150,86,190,77,40,car
53875,16,person,17,0,18868,18,243,144,254,181,11,37,person
53876,17,person,18,0,18868,18,214,151,223,183,9,32,person
53877,18,person,19,0,18868,20,196,152,204,181,8,29,person
53878,19,car,20,0,18868,19,151,155,181,179,30,24,car
53879,7,person,8,0,18869,16,221,184,230,221,9,37,person
53880,8,person,9,0,18869,17,231,188,240,217,9,29,person
53881,14,car,15,1,18869,20,163,198,232,256,69,58,car
53882,13,person,14,0,18870,15,57,143,63,163,6,20,person
53883,14,person,15,0,18870,16,67,143,74,162,7,19,person
53884,15,person,16,0,18870,21,74,144,82,163,8,19,person
53885,16,person,17,0,18870,24,24,144,36,173,12,29,person
53886,17,car,18,0,18870,22,130,146,162,174,32,28,car
53887,18,car,19,0,18870,16,84,148,109,170,25,22,car
53888,19,car,20,1,18870,18,153,149,256,256,103,107,car
53889,6,person,7,0,18871,24,92,161,100,188,8,27,person
53890,8,person,9,0,18871,37,209,169,227,229,18,60,person
53891,9,person,10,0,18871,40,231,163,255,231,24,68,person
53892,10,person,11,0,18871,33,118,160,148,244,30,84,person
53893,6,car,7,1,18872,16,212,122,228,153,16,31,car
53894,7,car,8,1,18872,16,224,115,256,165,32,50,car
53895,9,person,10,0,18873,19,22,131,27,148,5,17,person
53896,10,person,11,0,18873,19,27,132,33,148,6,16,person
53897,11,car,12,0,18874,17,13,167,41,186,28,19,car
53898,14,car,15,1,18874,21,71,163,113,189,42,26,car
53899,17,car,18,1,18874,25,105,160,185,201,80,41,car
53900,18,car,19,1,18874,21,180,160,256,229,76,69,car
53901,10,person,11,0,18875,23,137,148,149,181,12,33,person
53902,5,person,6,0,18876,17,247,175,254,206,7,31,person
53903,18,car,19,0,18876,19,81,180,120,207,39,27,car
53904,19,car,20,0,18876,23,154,186,230,256,76,70,car
53905,10,car,11,1,18877,20,92,141,110,160,18,19,car
53906,11,car,12,1,18877,20,77,146,98,170,21,24,car
53907,12,car,13,1,18877,24,27,147,80,190,53,43,car
53908,13,car,14,1,18877,17,2,153,44,224,42,71,car
53909,15,car,16,1,18877,25,151,140,194,173,43,33,car
53910,16,car,17,1,18877,25,187,144,256,248,69,104,car
53911,11,person,12,1,18878,18,208,184,221,233,13,49,person
53912,12,person,13,0,18878,40,192,185,215,244,23,59,person
53913,15,car,16,1,18878,19,165,189,195,209,30,20,car
53914,18,car,19,1,18878,15,134,196,159,220,25,24,car
53915,20,car,21,1,18878,21,88,201,136,245,48,44,car
53916,21,car,22,1,18878,22,73,205,123,256,50,51,car
53917,6,car,7,1,18879,15,212,139,253,154,41,15,car
53918,9,car,10,0,18880,23,55,131,92,154,37,23,car
53919,10,car,11,1,18880,20,0,134,53,160,53,26,car
53920,14,car,15,1,18881,17,0,128,62,180,62,52,car
53921,11,car,12,0,18882,20,55,145,83,163,28,18,car
53922,13,car,14,1,18882,19,2,150,47,180,45,30,car
53923,17,car,18,1,18882,18,174,144,197,162,23,18,car
53924,15,car,16,1,18883,18,2,163,79,256,77,93,car
53925,17,car,18,0,18883,18,171,144,200,163,29,19,car
53926,19,car,20,1,18883,22,211,140,256,178,45,38,car
53927,6,person,7,0,18884,27,41,143,58,192,17,49,person
53928,12,car,13,0,18884,19,163,145,189,162,26,17,car
53929,13,car,14,1,18884,18,214,148,249,167,35,19,car
53930,7,person,8,1,18885,17,203,85,217,104,14,19,person
53931,11,car,12,1,18885,18,32,120,63,154,31,34,car
53932,12,car,13,1,18885,16,2,117,24,167,22,50,car
53933,13,person,14,0,18885,31,17,117,39,183,22,66,person
53934,16,person,17,0,18885,20,121,118,127,139,6,21,person
53935,13,car,14,1,18886,18,97,172,128,192,31,20,car
53936,14,car,15,1,18886,16,66,172,101,196,35,24,car
53937,15,car,16,1,18886,18,30,172,76,202,46,30,car
53938,10,flowerpot,11,0,18887,24,9,188,39,253,30,65,potted plant
53939,21,car,22,0,18887,24,200,213,248,242,48,29,car
53940,8,car,9,1,18888,23,29,132,85,178,56,46,car
53941,11,car,12,1,18888,18,202,129,256,206,54,77,car
53942,6,car,7,0,18889,15,210,136,230,147,20,11,car
53943,14,car,15,0,18889,15,109,140,130,152,21,12,car
53944,15,traffic light,16,0,18889,15,160,78,256,96,96,18,traffic light
53945,17,car,18,0,18889,18,140,136,163,152,23,16,car
53946,20,car,21,0,18889,33,31,142,111,174,80,32,car
53947,10,truck,11,0,18890,16,82,116,100,133,18,17,truck
53948,12,car,13,0,18890,15,142,129,157,139,15,10,car
53949,13,car,14,0,18890,21,161,125,195,144,34,19,car
53950,12,person,13,0,18891,16,248,208,253,228,5,20,person
53951,13,person,14,0,18891,21,70,208,83,235,13,27,person
53952,14,person,15,0,18891,19,2,204,13,233,11,29,person
53953,6,car,7,0,18892,20,86,131,108,143,22,12,car
53954,7,car,8,1,18892,18,139,133,166,149,27,16,car
53955,8,car,9,0,18892,26,166,133,212,153,46,20,car
53956,9,car,10,1,18892,17,221,132,256,157,35,25,car
53957,11,car,12,1,18892,17,0,145,96,232,96,87,car
53958,9,person,10,0,18893,15,113,130,118,147,5,17,person
53959,10,person,11,0,18893,19,120,129,124,148,4,19,person
53960,11,person,12,0,18893,19,204,124,210,150,6,26,person
53961,8,person,9,1,18895,27,2,123,23,216,21,93,person
53962,9,person,10,0,18895,27,18,119,37,195,19,76,person
53963,10,person,11,0,18895,16,37,123,47,149,10,26,person
53964,11,person,12,0,18895,22,73,124,88,159,15,35,person
53965,12,person,13,0,18895,19,138,118,147,151,9,33,person
53966,13,person,14,0,18895,23,241,114,256,165,15,51,person
53967,14,person,15,0,18895,16,206,114,216,142,10,28,person
53968,22,car,23,0,24497,15,907,556,945,583,38,27,car
53969,26,car,27,0,24497,21,203,587,266,620,63,33,car
53970,27,car,28,0,24497,23,273,606,344,640,71,34,car
53971,28,car,29,0,24497,22,349,625,427,662,78,37,car
53972,29,car,30,0,24497,17,301,582,353,611,52,29,car
53973,30,car,31,0,24497,22,498,633,571,672,73,39,car
53974,31,car,32,0,24497,22,530,699,626,743,96,44,car
53975,32,car,33,0,24497,27,615,683,714,738,99,55,car
53976,33,car,34,1,24497,19,656,671,730,710,74,39,car
53977,34,car,35,0,24497,20,770,727,856,767,86,40,car
53978,35,car,36,0,24497,23,838,711,939,768,101,57,car
53979,36,car,37,0,24497,17,120,533,174,562,54,29,car
53980,37,car,38,0,24497,16,78,505,114,531,36,26,car
53981,43,person,44,0,24497,15,331,510,338,530,7,20,person
53982,3,car,4,1,24498,19,552,671,682,760,130,89,car
53983,4,car,5,1,24498,23,495,664,578,740,83,76,car
53984,5,car,6,1,24498,15,497,657,557,695,60,38,car
53985,6,car,7,1,24498,15,475,656,508,721,33,65,car
53986,7,car,8,1,24498,16,473,650,529,681,56,31,car
53987,8,car,9,1,24498,51,21,636,207,802,186,166,car
53988,9,car,10,0,24498,20,283,660,349,715,66,55,car
53989,10,car,11,1,24498,15,336,660,364,705,28,45,car
53990,11,car,12,1,24498,17,348,655,388,696,40,41,car
53991,12,car,13,1,24498,17,370,649,409,688,39,39,car
53992,14,motorbike,15,0,24498,19,410,654,431,708,21,54,motorcycle
53993,21,bus,22,1,24498,26,449,628,531,657,82,29,bus
53994,22,umbrella,23,0,24498,16,387,636,427,662,40,26,umbrella
53995,25,plant pot,26,0,24498,28,578,759,682,839,104,80,potted plant
53996,28,plant pot,29,0,24498,19,69,810,115,863,46,53,potted plant
53997,29,plant pot,30,0,24498,27,0,830,69,893,69,63,potted plant
53998,36,person,37,0,24498,17,463,652,470,676,7,24,person
53999,37,person,38,0,24498,19,441,652,449,670,8,18,person
54000,11,person,12,1,24499,24,377,351,411,532,34,181,person
54001,12,person,13,0,24499,35,383,359,425,560,42,201,person
54002,13,person,14,0,24499,51,417,337,479,572,62,235,person
54003,14,person,15,1,24499,17,466,423,500,544,34,121,person
54004,15,person,16,1,24499,28,477,365,513,523,36,158,person
54005,16,person,17,0,24499,41,510,353,559,521,49,168,person
54006,17,person,18,1,24499,19,548,373,570,485,22,112,person
54007,18,person,19,0,24499,50,567,334,626,587,59,253,person
54008,19,person,20,0,24499,18,627,376,659,469,32,93,person
54009,20,person,21,1,24499,97,644,246,830,682,186,436,person
54010,22,person,23,1,24499,41,838,310,887,579,49,269,person
54011,23,person,24,0,24499,63,845,275,989,662,144,387,person
54012,19,person,20,0,24500,34,682,451,715,523,33,72,person
54013,20,person,21,0,24500,28,744,458,773,533,29,75,person
54014,22,person,23,0,24500,23,446,442,466,505,20,63,person
54015,23,person,24,0,24500,29,425,437,447,504,22,67,person
54016,24,person,25,0,24500,28,339,439,370,518,31,79,person
54017,25,person,26,1,24500,17,329,432,346,482,17,50,person
54018,26,person,27,0,24500,20,524,443,536,488,12,45,person
54019,27,person,28,0,24500,17,567,449,576,476,9,27,person
54020,8,car,9,0,24501,18,494,404,534,438,40,34,car
54021,10,truck,11,0,24501,16,396,348,477,461,81,113,truck
54022,11,person,12,1,24502,32,2,608,105,894,103,286,person
54023,12,person,13,1,24502,18,43,672,112,757,69,85,person
54024,13,person,14,1,24502,46,177,624,268,900,91,276,person
54025,14,person,15,0,24502,39,276,626,344,888,68,262,person
54026,16,person,17,0,24502,34,385,656,435,779,50,123,person
54027,17,person,18,1,24502,21,664,645,703,718,39,73,person
54028,18,person,19,0,24502,35,613,643,659,751,46,108,person
54029,19,person,20,0,24502,39,527,649,592,820,65,171,person
54030,20,bicycle,21,0,24502,34,743,696,786,780,43,84,bicycle
54031,21,bicycle,22,0,24502,30,704,689,752,776,48,87,bicycle
54032,22,bicycle,23,1,24502,15,548,755,568,827,20,72,bicycle
54033,23,motorbike,24,0,24502,20,466,663,500,705,34,42,motorcycle
54034,24,person,25,0,24502,26,495,647,518,715,23,68,person
54035,25,person,26,1,24502,16,516,648,527,707,11,59,person
54036,26,person,27,1,24502,17,535,640,552,678,17,38,person
54037,27,person,28,1,24502,16,570,640,587,681,17,41,person
54038,28,person,29,0,24502,19,587,645,605,702,18,57,person
54039,29,person,30,0,24502,20,605,643,621,688,16,45,person
54040,5,car,6,1,18896,18,542,310,639,456,97,146,car
54041,7,car,8,1,18896,29,369,294,611,442,242,148,car
54042,8,car,9,1,18896,15,274,317,384,412,110,95,car
54043,9,car,10,1,18896,22,208,299,386,401,178,102,car
54044,11,car,12,1,18896,19,111,323,216,369,105,46,car
54045,12,car,13,1,18896,18,46,310,153,365,107,55,car
54046,4,car,5,1,18897,15,502,275,598,333,96,58,car
54047,9,car,10,0,18897,20,2,262,171,323,169,61,car
54048,11,car,12,1,18897,16,147,258,231,300,84,42,car
54049,12,car,13,1,18897,25,195,259,289,306,94,47,car
54050,14,car,15,1,18897,19,264,263,339,308,75,45,car
54051,15,car,16,1,18897,23,294,263,394,310,100,47,car
54052,17,car,18,1,18897,18,359,268,503,301,144,33,car
54053,18,car,19,0,18897,35,250,287,533,390,283,103,car
54054,22,door,23,0,18897,17,392,292,464,375,72,83,door
54055,5,car,6,1,18899,16,21,213,73,261,52,48,car
54056,7,car,8,0,18899,32,108,206,287,316,179,110,car
54057,10,car,11,1,18899,16,321,210,376,254,55,44,car
54058,11,car,12,0,18899,31,344,213,467,255,123,42,car
54059,4,car,5,0,18900,23,368,219,467,256,99,37,car
54060,8,car,9,0,18901,21,12,136,77,162,65,26,car
54061,4,car,5,0,18903,36,46,150,195,220,149,70,car
54062,5,car,6,0,18903,32,188,149,337,220,149,71,car
54063,3,car,4,1,18904,16,40,165,69,198,29,33,car
54064,4,car,5,0,18904,31,56,163,152,204,96,41,car
54065,5,car,6,0,18904,23,294,163,344,194,50,31,car
54066,4,car,5,0,18910,17,285,287,318,307,33,20,car
54067,9,traffic light,10,0,18910,15,229,210,301,312,72,102,traffic light
54068,24,person,25,0,18910,26,376,284,388,311,12,27,person
54069,8,train,9,0,18914,16,0,147,64,181,64,34,train
54070,11,car,12,0,18914,15,88,194,113,207,25,13,car
54071,12,car,13,0,18914,15,141,182,161,194,20,12,car
54072,4,car,5,0,18915,23,148,516,273,583,125,67,car
54073,8,person,9,0,18915,20,28,518,84,599,56,81,person
54074,3,car,4,0,19062,17,173,541,287,586,114,45,car
54075,4,car,5,0,19062,16,392,550,472,573,80,23,car
54076,7,person,8,0,19062,15,370,538,392,595,22,57,person
54077,8,car,9,1,19063,18,455,339,560,387,105,48,car
54078,9,car,10,0,19063,34,177,339,354,399,177,60,car
54079,3,person,4,0,25220,37,187,113,257,255,70,142,person
54080,10,person,11,0,25224,38,331,830,370,979,39,149,person
54081,14,person,15,0,25224,30,5,821,49,962,44,141,person
54082,17,person,18,0,25224,35,735,828,766,913,31,85,person
54083,9,clock,10,0,25225,15,421,152,476,209,55,57,clock
54084,17,person,18,0,25225,17,180,713,195,752,15,39,person
54085,18,person,19,0,25225,18,193,716,210,752,17,36,person
54086,19,person,20,0,25225,16,210,718,224,755,14,37,person
54087,21,bench,22,0,25225,20,333,763,381,815,48,52,bench
54088,22,bench,23,0,25225,29,447,778,543,842,96,64,bench
54089,23,bench,24,1,25225,18,381,772,449,826,68,54,bench
54090,24,person,25,0,25225,20,398,743,453,801,55,58,person
54091,25,bench,26,1,25225,16,551,784,658,847,107,63,bench
54092,26,bench,27,1,25225,26,905,785,1086,854,181,69,bench
54093,38,bicycle,39,1,25225,37,656,807,755,854,99,47,bicycle
54094,9,person,10,0,25226,34,734,628,749,670,15,42,person
54095,10,person,11,0,25226,23,724,634,733,670,9,36,person
54096,11,person,12,0,25226,31,643,624,656,660,13,36,person
54097,12,person,13,0,25226,34,626,625,642,660,16,35,person
54098,13,person,14,0,25226,35,593,626,606,665,13,39,person
54099,14,person,15,0,25226,24,606,634,615,661,9,27,person
54100,15,person,16,0,25226,29,567,626,582,665,15,39,person
54101,16,person,17,0,25226,27,511,620,525,660,14,40,person
54102,17,person,18,0,25226,33,396,618,409,657,13,39,person
54103,18,person,19,0,25226,32,413,621,426,663,13,42,person
54104,19,person,20,0,25226,29,478,621,491,658,13,37,person
54105,20,person,21,1,25226,22,463,623,473,657,10,34,person
54106,21,person,22,0,25226,38,984,630,1007,682,23,52,person
54107,22,person,23,1,25226,26,1008,630,1023,682,15,52,person
54108,23,person,24,1,25226,19,434,626,443,662,9,36,person
54109,24,person,25,1,25226,17,437,631,447,662,10,31,person
54110,5,car,6,0,19070,31,48,177,167,241,119,64,car
54111,6,car,7,0,19070,28,163,179,270,229,107,50,car
54112,13,motorbikes,14,0,19070,22,279,180,325,204,46,24,motorcycle
54113,14,car,15,1,19071,18,195,121,243,165,48,44,car
54114,15,car,16,1,19071,15,206,129,245,187,39,58,car
54115,18,car,19,1,19071,18,147,120,191,159,44,39,car
54116,19,car,20,0,19071,27,73,122,159,181,86,59,car
54117,9,person,10,0,19072,21,486,158,552,301,66,143,person
54118,10,person,11,0,19072,28,254,324,334,514,80,190,person
54119,11,person,12,0,19072,24,155,570,228,810,73,240,person
54120,12,car,13,1,19072,15,0,377,141,580,141,203,car
54121,13,person,14,0,19072,16,1115,290,1194,416,79,126,person
54122,14,car,15,1,19072,22,456,390,655,552,199,162,car
54123,15,car,16,1,19072,25,412,459,614,659,202,200,car
54124,16,car,17,1,19072,30,424,524,684,729,260,205,car
54125,17,car,18,1,19072,29,384,599,676,793,292,194,car
54126,18,car,19,1,19072,27,352,687,663,945,311,258,car
54127,19,car,20,1,19072,29,305,776,641,1096,336,320,car
54128,20,car,21,1,19072,37,228,861,629,1232,401,371,car
54129,21,car,22,1,19072,33,248,1038,648,1395,400,357,car
54130,22,car,23,1,19072,43,94,1232,625,1650,531,418,car
54131,23,car,24,0,19072,37,0,1548,594,2117,594,569,car
54132,24,car,25,0,19072,26,1002,1569,1460,2157,458,588,car
54133,25,car,26,0,19072,29,1009,1284,1460,1627,451,343,car
54134,26,car,27,1,19072,42,955,1085,1403,1475,448,390,car
54135,27,car,28,1,19072,38,985,910,1390,1164,405,254,car
54136,28,car,29,1,19072,37,846,699,1253,957,407,258,car
54137,29,car,30,1,19072,28,925,594,1191,772,266,178,car
54138,30,car,31,1,19072,32,923,491,1177,661,254,170,car
54139,31,car,32,1,19072,33,859,452,1068,659,209,207,car
54140,32,car,33,1,19072,23,866,381,1066,507,200,126,car
54141,33,person,34,0,19072,25,705,381,750,594,45,213,person
54142,34,person,35,0,19072,24,759,380,805,586,46,206,person
54143,35,person,36,0,19072,21,816,377,889,594,73,217,person
54144,36,person,37,0,19072,31,641,688,755,1017,114,329,person
54145,37,person,38,0,19072,17,390,333,445,492,55,159,person
54146,38,person,39,0,19072,25,319,412,413,627,94,215,person
54147,39,person,40,0,19072,43,36,878,179,1262,143,384,person
54148,40,person,41,0,19072,38,757,1064,855,1492,98,428,person
54149,41,person,42,0,19072,36,605,1062,755,1488,150,426,person
54150,42,person,43,0,19072,33,938,1469,1083,1969,145,500,person
54151,76,window,77,0,19072,15,479,433,630,489,151,56,window
54152,5,car,6,0,19073,15,200,152,302,185,102,33,car
54153,6,car,7,0,19073,22,83,150,171,186,88,36,car
54154,19,bicycle,20,0,19073,23,348,152,386,183,38,31,bicycle
54155,1,car,2,0,19074,54,59,43,270,129,211,86,car
54156,10,door,11,0,19074,16,143,55,223,115,80,60,door
54157,8,airplane,9,0,19075,39,5,120,295,200,290,80,airplane
54158,9,airplane,10,0,19075,43,329,73,507,184,178,111,airplane
54159,14,airplane,15,0,19075,106,54,96,699,465,645,369,airplane
54160,1,airplane,2,0,19077,39,73,155,505,265,432,110,airplane
54161,3,person,4,1,19078,39,46,80,107,117,61,37,person
54162,4,person,5,1,19078,34,124,46,175,121,51,75,person
54163,4,person,5,0,19079,40,109,108,148,312,39,204,person
54164,5,person,6,0,19079,36,79,167,123,332,44,165,person
54165,3,person,4,0,19108,17,191,269,204,308,13,39,person
54166,10,person,11,0,19113,16,153,204,160,228,7,24,person
54167,6,window,7,0,19116,15,62,163,81,200,19,37,window
54168,8,person,9,0,19116,17,247,204,253,236,6,32,person
54169,9,person,10,0,19116,16,128,204,134,222,6,18,person
54170,10,person,11,1,19117,24,50,218,67,255,17,37,person
54171,7,person,8,0,19119,19,503,527,539,610,36,83,person
54172,9,person,10,0,19119,16,682,647,707,747,25,100,person
54173,10,person,11,0,19119,22,697,646,741,759,44,113,person
54174,12,person,13,0,19119,25,289,628,322,747,33,119,person
54175,13,person,14,0,19119,21,268,599,291,700,23,101,person
54176,17,person,18,0,19119,21,873,642,931,762,58,120,person
54177,18,person,19,1,19119,15,978,692,1023,762,45,70,person
54178,6,person,7,1,19120,16,76,231,91,255,15,24,person
54179,6,person,7,0,19122,28,78,193,96,253,18,60,person
54180,7,person,8,0,19122,18,114,186,127,233,13,47,person
54181,8,person,9,1,19122,16,125,201,146,234,21,33,person
54182,9,person,10,0,19122,32,141,199,166,255,25,56,person
54183,11,car,12,0,19125,21,0,1141,140,1199,140,58,car
54184,13,car,14,1,19125,18,97,1142,226,1186,129,44,car
54185,32,person,33,0,19125,15,287,1127,298,1167,11,40,person
54186,33,person,34,0,19125,15,545,1137,565,1190,20,53,person
54187,34,person,35,0,19125,19,563,1136,593,1192,30,56,person
54188,35,person,36,0,19125,17,599,1130,619,1187,20,57,person
54189,36,person,37,0,19125,15,626,1133,642,1181,16,48,person
54190,37,person,38,0,19125,17,647,1137,667,1184,20,47,person
54191,38,person,39,0,19125,17,892,1130,917,1178,25,48,person
54192,2,window,3,0,19126,17,535,449,701,525,166,76,window
54193,17,person,18,0,19149,38,133,185,188,335,55,150,person
54194,18,person,19,0,19149,26,62,196,118,334,56,138,person
54195,12,car,13,0,19212,15,355,384,384,402,29,18,car
54196,3,door,4,0,19213,17,223,118,275,211,52,93,door
54197,6,truck,7,0,19213,16,115,116,148,159,33,43,truck
54198,5,car,6,0,19214,19,412,309,553,369,141,60,car
54199,6,car,7,1,19214,16,266,285,369,320,103,35,car
54200,8,car,9,0,19214,15,138,287,218,319,80,32,car
54201,4,car,5,0,19215,21,303,205,374,255,71,50,car
54202,9,car,10,0,19215,16,111,211,177,231,66,20,car
54203,15,car,16,0,19216,17,430,200,467,222,37,22,car
54204,17,car,18,0,19216,18,275,228,312,251,37,23,car
54205,21,truck,22,0,19216,23,270,273,387,366,117,93,truck
54206,7,car,8,0,19217,22,94,283,148,310,54,27,car
54207,7,car,8,0,19218,18,229,165,261,189,32,24,car
54208,8,car,9,0,19218,25,277,159,335,200,58,41,car
54209,2,person,3,1,19220,30,197,237,308,354,111,117,person
54210,12,car,13,1,19221,27,205,111,420,217,215,106,car
54211,3,car,4,0,19234,15,489,1015,883,1198,394,183,car
54212,0,person,1,0,19241,21,408,1511,952,2044,544,533,person
54213,1,clock,2,0,19243,18,266,204,973,766,707,562,clock
54214,0,clock,1,0,19251,17,397,573,789,971,392,398,clock
54215,6,clock,7,0,19255,22,495,1052,713,1269,218,217,clock
54216,22,window,23,0,19257,18,1134,1012,1183,1132,49,120,window
54217,23,window,24,0,19257,21,996,1017,1045,1138,49,121,window
54218,25,window,22,0,19264,20,469,1244,568,1378,99,134,window
54219,32,person,29,0,19264,42,253,1698,346,1993,93,295,person
54220,33,person,30,0,19264,28,348,1700,412,1999,64,299,person
54221,34,person,31,0,19264,36,787,1779,860,1942,73,163,person
54222,35,person,32,0,19264,22,964,1747,988,1855,24,108,person
54223,36,person,33,0,19264,23,933,1755,970,1855,37,100,person
54224,37,person,34,0,19264,17,905,1755,934,1853,29,98,person
54225,38,person,35,0,19264,26,1075,1738,1129,1917,54,179,person
54226,39,person,36,0,19264,27,1149,1728,1196,1918,47,190,person
54227,40,person,37,0,19264,25,1195,1755,1230,1863,35,108,person
54228,41,person,38,0,19264,27,1286,1756,1321,1861,35,105,person
54229,50,person,51,1,19265,17,183,1466,275,1594,92,128,person
54230,2,clock,3,0,22253,16,123,327,219,416,96,89,clock
54231,4,car,5,1,24568,21,537,709,767,813,230,104,car
54232,6,car,7,1,24568,35,146,698,263,755,117,57,car
54233,7,car,8,1,24568,17,1,687,123,737,122,50,car
54234,8,person,9,0,24568,26,186,688,215,758,29,70,person
54235,7,car,8,0,24573,42,290,844,540,964,250,120,car
54236,14,chair,15,0,24574,25,107,556,185,668,78,112,chair
54237,15,chair,16,0,24574,33,153,561,231,682,78,121,chair
54238,16,chair,17,0,24574,29,193,572,272,692,79,120,chair
54239,17,chair,18,0,24574,28,226,582,311,711,85,129,chair
54240,18,chair,19,0,24574,25,248,596,348,730,100,134,chair
54241,19,chair,20,0,24574,30,268,605,369,757,101,152,chair
54242,20,chair,21,0,24574,34,288,621,401,790,113,169,chair
54243,21,chair,22,1,24574,21,306,642,428,795,122,153,chair
54244,22,chair,23,1,24574,34,300,677,455,932,155,255,chair
54245,23,chair,24,0,24574,37,306,711,484,1023,178,312,chair
54246,24,chair,25,1,24574,17,430,830,682,1022,252,192,chair
54247,25,chair,26,0,24574,24,347,527,389,592,42,65,chair
54248,26,chair,27,0,24574,25,376,528,420,596,44,68,chair
54249,27,chair,28,0,24574,27,408,530,453,600,45,70,chair
54250,28,chair,29,0,24574,23,440,534,488,604,48,70,chair
54251,29,chair,30,0,24574,26,474,535,524,610,50,75,chair
54252,17,person,18,0,24575,22,283,881,323,942,40,61,person
54253,18,person,19,1,24575,20,254,876,285,941,31,65,person
54254,19,person,20,1,24575,22,174,848,207,974,33,126,person
54255,20,person,21,0,24575,30,141,856,176,978,35,122,person
54256,21,person,22,1,24575,16,73,965,128,1023,55,58,person
54257,22,person,23,0,24575,26,483,918,532,1005,49,87,person
54258,23,person,24,1,24575,16,530,908,550,949,20,41,person
54259,26,person,27,1,24575,17,442,893,469,946,27,53,person
54260,11,person,12,0,24576,20,419,654,437,727,18,73,person
54261,13,person,14,0,24576,29,239,661,261,721,22,60,person
54262,15,person,16,0,24576,28,746,621,764,676,18,55,person
54263,16,person,17,0,24576,30,794,617,818,676,24,59,person
54264,17,person,18,0,24576,52,863,619,914,757,51,138,person
54265,18,person,19,0,24576,28,953,614,1004,767,51,153,person
54266,19,person,20,0,24576,24,709,621,727,680,18,59,person
54267,23,person,24,0,24576,37,443,652,467,728,24,76,person
54268,24,person,25,0,24576,24,488,669,516,723,28,54,person
54269,3,car,4,0,19269,30,371,630,647,770,276,140,car
54270,5,car,6,0,19269,21,47,630,163,702,116,72,car
54271,7,car,8,0,19270,20,164,170,216,205,52,35,car
54272,10,car,11,1,19276,21,0,255,103,300,103,45,car
54273,11,car,12,1,19276,24,310,228,499,321,189,93,car
54274,4,person,5,0,963,45,1389,728,1545,1227,156,499,person
54275,8,person,9,0,963,73,120,521,442,1021,322,500,person
54276,17,person,18,1,963,35,138,407,288,772,150,365,person
54277,18,person,19,1,963,18,289,421,381,533,92,112,person
54278,22,bus,23,1,963,20,2105,626,2198,838,93,212,bus
54279,23,train,24,0,963,172,100,135,1782,1511,1682,1376,train
54280,34,person,35,1,963,19,1827,744,1884,845,57,101,person
54281,35,person,36,1,963,49,1877,748,1972,1153,95,405,person
54282,36,person,37,0,963,62,1739,766,1934,1256,195,490,person
54283,46,person,47,1,963,36,1913,725,2021,973,108,248,person
54284,47,person,48,1,963,48,1930,826,2024,1281,94,455,person
54285,49,person,50,0,963,75,1954,702,2198,1363,244,661,person
54286,57,backpack,58,0,963,28,1897,1063,2015,1253,118,190,backpack
54287,3,train,4,0,19314,15,0,156,339,273,339,117,train
54288,5,train,6,0,19315,28,113,86,256,187,143,101,train
54289,12,train,13,0,19316,27,0,77,239,211,239,134,train
54290,6,train,7,0,19317,31,36,83,254,192,218,109,train
54291,4,train,5,0,19318,26,36,95,243,210,207,115,train
54292,5,train,6,0,19319,32,26,94,155,189,129,95,train
54293,6,train,7,0,19319,19,147,97,256,188,109,91,train
54294,3,train,4,0,19320,22,9,124,185,203,176,79,train
54295,4,train,5,0,19321,22,6,80,176,199,170,119,train
54296,7,person,8,0,19321,18,140,137,154,169,14,32,person
54297,8,person,9,0,19321,22,156,138,169,178,13,40,person
54298,9,person,10,0,19321,20,172,137,182,176,10,39,person
54299,10,person,11,1,19321,16,183,133,191,172,8,39,person
54300,11,person,12,0,19321,27,186,136,205,192,19,56,person
54301,12,person,13,1,19321,16,207,133,213,166,6,33,person
54302,13,person,14,0,19321,26,210,135,225,177,15,42,person
54303,9,motorbike,10,0,19323,24,484,230,528,260,44,30,motorcycle
54304,10,car,11,0,19323,23,391,220,501,257,110,37,car
54305,16,bicycle,17,0,19323,18,249,228,276,247,27,19,bicycle
54306,2,bench,3,0,19324,50,353,303,602,470,249,167,bench
54307,3,bench,4,0,19324,18,161,268,275,343,114,75,bench
54308,7,person,8,0,19325,19,238,211,255,284,17,73,person
54309,8,person,9,0,19325,20,251,220,266,291,15,71,person
54310,9,person,10,0,19325,21,265,215,284,294,19,79,person
54311,10,person,11,0,19325,25,294,212,318,296,24,84,person
54312,11,person,12,0,19325,34,353,214,384,311,31,97,person
54313,5,train,6,0,19326,28,0,76,210,229,210,153,train
54314,5,train,6,0,19327,43,97,39,296,213,199,174,train
54315,9,bench,10,1,19327,18,11,143,43,176,32,33,bench
54316,4,car,5,0,19328,21,587,375,781,452,194,77,car
54317,15,person,16,1,19328,16,470,365,491,453,21,88,person
54318,10,train,11,0,19329,27,109,309,479,638,370,329,train
54319,2,train,3,0,19367,37,2,0,639,146,637,146,train
54320,5,bench,6,1,19379,21,210,175,256,212,46,37,bench
54321,7,bench,8,0,19383,26,0,181,58,213,58,32,bench
54322,8,bench,9,0,19383,19,179,181,218,211,39,30,bench
54323,9,car,10,0,19384,15,121,167,146,189,25,22,car
54324,3,flowerpot,4,1,299,17,849,310,939,467,90,157,potted plant
54325,4,flowerpot,5,1,299,18,793,393,886,475,93,82,potted plant
54326,9,person,10,0,299,108,366,53,762,580,396,527,person
54327,19,person,20,1,299,69,249,1,432,568,183,567,person
54328,28,person,29,1,299,96,1,2,244,572,243,570,person
54329,12,car,13,1,19477,19,144,117,248,201,104,84,car
54330,8,person,9,0,19482,34,92,186,130,301,38,115,person
54331,3,person,4,0,19487,25,13,93,47,167,34,74,person
54332,6,person,6,0,19487,21,173,75,196,144,23,69,person
54333,8,person,8,0,19487,22,234,70,263,128,29,58,person
54334,10,person,9,0,19487,26,290,87,319,163,29,76,person
54335,11,person,10,0,19487,19,78,71,104,152,26,81,person
54336,12,person,11,0,19487,21,270,75,291,138,21,63,person
54337,2,person,3,1,19488,27,710,520,799,662,89,142,person
54338,3,person,4,1,19488,19,788,440,875,582,87,142,person
54339,4,person,5,1,19488,26,1291,482,1356,623,65,141,person
54340,5,person,6,1,19488,28,1424,482,1524,664,100,182,person
54341,27,table,27,1,19488,18,1684,646,1889,725,205,79,dining table
54342,1,person,2,1,24630,59,1,0,466,204,465,204,person
54343,2,plant pot,3,1,24631,25,186,497,468,685,282,188,potted plant
54344,3,plant pot,4,1,24631,25,72,492,222,654,150,162,potted plant
54345,4,plant pot,5,1,24631,19,23,501,83,600,60,99,potted plant
54346,2,bench,3,0,24637,37,18,107,271,241,253,134,bench
54347,3,plant pot,4,0,24637,16,12,193,76,245,64,52,potted plant
54348,10,plant pot,11,0,24637,15,340,161,360,200,20,39,potted plant
54349,14,plant pot,15,0,24637,34,284,384,442,483,158,99,potted plant
54350,16,plant pot,17,0,24637,32,107,351,216,404,109,53,potted plant
54351,15,chair,16,0,19501,20,154,133,202,180,48,47,chair
54352,23,chair,23,1,19502,15,639,475,792,647,153,172,chair
54353,25,chair,25,1,19502,17,707,507,863,667,156,160,chair
54354,32,flowerpot,32,0,19502,20,564,432,631,500,67,68,potted plant
54355,36,flowerpot,36,0,19502,24,523,380,555,403,32,23,potted plant
54356,46,person,46,0,19502,25,467,349,478,390,11,41,person
54357,11,sofa,12,0,19503,25,256,189,349,276,93,87,couch
54358,12,chair,13,0,19503,15,26,206,81,277,55,71,chair
54359,13,chair,14,0,19503,19,2,202,38,268,36,66,chair
54360,18,chair,19,0,19504,26,222,194,316,301,94,107,chair
54361,21,chair,22,0,19504,29,320,205,409,323,89,118,chair
54362,22,chair,23,0,19504,25,406,194,471,292,65,98,chair
54363,8,chair,9,0,19505,22,508,280,630,415,122,135,chair
54364,8,chair,9,0,19506,19,64,183,162,309,98,126,chair
54365,9,chair,10,0,19506,22,127,170,222,259,95,89,chair
54366,11,chair,12,1,19506,32,143,254,269,399,126,145,chair
54367,5,train,6,0,965,21,56,181,168,219,112,38,train
54368,3,train,4,0,966,21,290,285,905,450,615,165,train
54369,12,motorbike,13,0,19521,55,544,328,875,541,331,213,motorcycle
54370,4,train,5,0,19527,15,0,135,475,227,475,92,train
54371,5,cow,3,0,19530,64,1141,936,1384,1095,243,159,cow
54372,6,cow,4,0,19530,41,457,996,693,1095,236,99,cow
54373,7,cow,5,0,19530,59,529,919,780,1098,251,179,cow
54374,2,boat,3,0,24647,71,2,29,708,683,706,654,boat
54375,16,boat,17,0,24654,27,135,322,225,406,90,84,boat
54376,17,boat,18,1,24654,18,221,343,301,387,80,44,boat
54377,22,boat,23,1,24654,15,251,383,425,422,174,39,boat
54378,23,boat,24,1,24654,18,486,395,604,474,118,79,boat
54379,24,boat,25,0,24654,43,43,395,495,521,452,126,boat
54380,2,bench,3,0,24657,43,142,348,364,528,222,180,bench
54381,3,table,4,0,24657,39,298,332,595,525,297,193,dining table
54382,4,bench,5,0,24657,58,536,292,759,513,223,221,bench
54383,5,bench,6,1,24657,40,757,387,845,512,88,125,bench
54384,0,car,1,0,24658,87,49,152,767,627,718,475,car
54385,3,person,4,1,24667,60,239,297,486,654,247,357,person
54386,4,person,5,0,24669,23,596,327,634,401,38,74,person
54387,5,person,6,0,24669,23,624,320,645,395,21,75,person
54388,2,person,3,1,24670,30,800,198,973,432,173,234,person
54389,3,person,4,0,24670,41,867,205,1278,794,411,589,person
54390,4,person,5,0,24670,64,89,88,447,615,358,527,person
54391,1,person,2,0,24673,97,431,3,787,599,356,596,person
54392,2,person,3,0,24673,99,5,2,408,645,403,643,person
54393,3,truck,4,0,19754,38,1238,822,1847,1111,609,289,truck
54394,12,car,13,1,22299,27,364,913,515,997,151,84,car
54395,16,traffic light,17,0,22299,20,101,787,151,922,50,135,traffic light
54396,21,person,22,1,22299,17,303,898,324,929,21,31,person
54397,22,person,23,1,22299,19,257,894,277,930,20,36,person
54398,25,person,26,1,22299,20,219,895,234,931,15,36,person
54399,26,person,27,0,22299,20,136,893,155,931,19,38,person
54400,28,car,29,0,22299,36,96,929,521,1267,425,338,car
54401,29,parking meter,30,0,22299,21,0,827,114,1461,114,634,parking meter
54402,5,sink,6,0,19762,27,0,615,2180,1458,2180,843,sink
54403,4,person,5,0,19774,35,161,118,238,286,77,168,person
54404,9,person,10,0,19778,26,582,317,614,440,32,123,person
54405,2,truck,3,0,19897,58,13,25,277,194,264,169,truck
54406,5,person,6,0,19897,20,276,104,290,143,14,39,person
54407,1,truck,2,0,19898,60,24,17,274,186,250,169,truck
54408,3,truck,4,0,19899,51,15,65,232,159,217,94,truck
54409,5,truck,6,0,19900,57,130,146,476,391,346,245,truck
54410,3,truck,4,0,19901,65,87,34,366,198,279,164,truck
54411,7,truck,8,0,19902,40,42,77,283,228,241,151,truck
54412,3,car,4,1,19903,22,204,121,280,160,76,39,car
54413,5,truck,6,0,19903,17,0,99,47,153,47,54,truck
54414,8,truck,9,0,19903,18,58,77,112,154,54,77,truck
54415,6,truck,7,0,19904,83,52,1,331,202,279,201,truck
54416,3,truck,4,0,19905,81,2,50,448,296,446,246,truck
54417,12,truck,13,0,19906,45,227,275,630,495,403,220,truck
54418,3,truck,4,0,19907,74,19,44,683,217,664,173,truck
54419,3,truck,4,0,19908,40,144,78,418,223,274,145,truck
54420,3,truck,4,0,19909,33,0,0,305,192,305,192,truck
54421,5,person,6,0,19909,62,219,117,265,237,46,120,person
54422,8,truck,9,0,19910,61,30,82,304,195,274,113,truck
54423,6,truck,7,0,19912,64,66,108,402,257,336,149,truck
54424,4,truck,5,0,19913,59,30,12,456,316,426,304,truck
54425,10,mirror,11,0,19913,16,248,117,274,161,26,44,mirror
54426,6,truck,7,0,19914,68,58,0,518,319,460,319,truck
54427,10,boat,11,1,19949,29,1378,291,2198,823,820,532,boat
54428,17,person,17,0,19949,89,577,321,1070,1576,493,1255,person
54429,18,person,18,0,19949,68,993,362,1397,1643,404,1281,person
54430,2,boat,3,1,19951,26,0,0,163,64,163,64,boat
54431,4,boat,5,0,19951,17,160,2,271,36,111,34,boat
54432,5,boat,6,1,19951,41,176,0,320,167,144,167,boat
54433,11,person,12,0,19951,21,205,150,218,185,13,35,person
54434,12,person,13,1,19951,18,103,109,115,136,12,27,person
54435,3,boat,4,1,19952,21,562,137,601,253,39,116,boat
54436,4,boat,5,1,19952,36,405,78,588,273,183,195,boat
54437,5,boat,6,0,19952,29,317,120,449,270,132,150,boat
54438,6,boat,7,1,19952,15,300,152,351,225,51,73,boat
54439,7,boat,8,0,19952,20,204,132,265,248,61,116,boat
54440,8,boat,9,0,19952,25,135,121,207,232,72,111,boat
54441,9,boat,10,1,19952,21,73,127,153,226,80,99,boat
54442,10,boat,11,1,19952,22,6,120,89,226,83,106,boat
54443,13,person,14,0,19954,43,286,940,590,1263,304,323,person
54444,4,table,5,0,19972,22,30,202,115,283,85,81,dining table
54445,8,bench,9,0,19978,22,182,153,411,300,229,147,bench
54446,7,person,8,1,315,105,1,358,1043,1730,1042,1372,person
54447,10,car,11,0,19990,16,405,221,431,250,26,29,car
54448,8,person,8,0,19992,17,383,498,411,557,28,59,person
54449,9,person,9,0,19992,16,426,502,449,557,23,55,person
54450,5,car,6,0,20000,27,109,572,415,699,306,127,car
54451,3,boat,4,0,24772,92,207,326,907,601,700,275,boat
54452,9,flowerpot,10,1,20123,17,245,175,276,206,31,31,potted plant
54453,14,bench,15,0,20128,45,279,102,404,188,125,86,bench
54454,2,door,3,0,20141,15,0,94,131,360,131,266,door
54455,5,car,6,1,20142,17,0,169,120,277,120,108,car
54456,23,plant pot,24,0,24777,35,1,554,98,669,97,115,potted plant
54457,0,person,1,0,24782,59,493,341,1078,1904,585,1563,person
54458,2,car,3,1,24782,15,1319,822,1437,937,118,115,car
54459,20,plant pot,21,0,24784,17,336,321,377,350,41,29,potted plant
54460,21,chair,22,0,24784,67,542,378,662,538,120,160,chair
54461,22,chair,23,0,24784,35,426,357,506,469,80,112,chair
54462,23,chair,24,0,24784,41,340,359,428,487,88,128,chair
54463,24,table,25,1,24784,19,266,362,368,398,102,36,dining table
54464,25,chair,26,1,24784,26,262,343,309,407,47,64,chair
54465,26,chair,27,0,24784,30,241,351,317,466,76,115,chair
54466,27,table,28,0,24784,19,1,442,98,572,97,130,dining table
54467,28,chair,29,1,24784,20,31,383,131,488,100,105,chair
54468,5,person,6,0,24785,56,627,573,790,984,163,411,person
54469,10,person,11,1,20192,40,856,863,1252,1534,396,671,person
54470,26,person,27,1,20196,16,1459,415,1508,474,49,59,person
54471,3,bird,4,0,24787,58,546,311,1004,498,458,187,bird
54472,30,umbrella,31,0,24788,28,271,61,399,134,128,73,umbrella
54473,36,table,37,0,24788,16,308,161,344,204,36,43,dining table
54474,37,bench,38,0,24788,24,252,156,323,194,71,38,bench
54475,38,chair,39,0,24788,18,233,126,273,155,40,29,chair
54476,44,bench,45,0,24788,18,191,143,260,174,69,31,bench
54477,5,car,6,1,24789,28,936,270,1023,363,87,93,car
54478,9,bench,10,0,24789,91,111,130,925,650,814,520,bench
54479,8,person,9,0,20199,27,535,290,579,396,44,106,person
54480,9,person,10,0,20199,24,617,296,647,388,30,92,person
54481,7,person,7,1,20203,15,1115,354,1133,378,18,24,person
54482,8,person,8,1,20203,19,1120,319,1142,367,22,48,person
54483,9,person,9,1,20203,18,1104,323,1118,375,14,52,person
54484,6,person,7,0,1396,50,118,72,183,260,65,188,person
54485,4,person,5,0,1397,68,113,23,229,338,116,315,person
54486,4,person,5,0,1398,40,57,179,104,313,47,134,person
54487,5,person,6,0,1398,31,170,181,223,292,53,111,person
54488,6,person,7,0,1398,33,295,173,341,304,46,131,person
54489,7,person,8,0,1398,43,423,167,479,345,56,178,person
54490,3,person,4,0,1399,47,110,61,153,150,43,89,person
54491,4,person,5,0,1400,31,276,419,338,578,62,159,person
54492,5,person,6,0,1402,37,157,108,215,183,58,75,person
54493,3,car,4,0,1403,41,105,45,296,247,191,202,car
54494,3,tables,4,0,1838,32,0,104,448,334,448,230,dining table
54495,9,person,10,1,1838,29,0,78,75,273,75,195,person
54496,10,person,11,1,1838,52,108,32,212,219,104,187,person
54497,11,person,12,1,1838,36,225,56,327,175,102,119,person
54498,12,person,13,1,1838,25,335,64,372,137,37,73,person
54499,10,person,11,1,1839,20,372,70,399,206,27,136,person
54500,11,person,12,1,1839,35,302,59,374,206,72,147,person
54501,14,person,15,1,1839,15,84,79,127,109,43,30,person
54502,4,person,5,1,1840,37,125,154,191,259,66,105,person
54503,9,person,10,1,1840,27,65,88,118,163,53,75,person
54504,10,person,11,1,1840,19,17,42,48,88,31,46,person
54505,11,person,12,1,1840,23,241,84,288,151,47,67,person
54506,13,person,14,1,1840,27,188,60,237,115,49,55,person
54507,15,person,16,1,1840,33,152,17,207,83,55,66,person
54508,19,person,20,1,1840,27,316,67,358,136,42,69,person
54509,21,person,22,1,1840,32,223,32,260,110,37,78,person
54510,23,person,24,1,1840,16,298,8,324,45,26,37,person
54511,12,person,13,1,1841,24,270,188,333,339,63,151,person
54512,4,person,5,0,1842,29,99,249,156,377,57,128,person
54513,10,person,11,1,1842,23,339,245,378,334,39,89,person
54514,11,person,12,1,1842,16,294,255,330,295,36,40,person
54515,12,person,13,1,1843,36,170,189,259,312,89,123,person
54516,13,person,14,1,1843,27,135,172,185,262,50,90,person
54517,14,person,15,1,1843,27,76,151,134,226,58,75,person
54518,15,person,16,1,1843,20,65,144,98,198,33,54,person
54519,16,person,17,1,1843,18,51,134,79,181,28,47,person
54520,18,person,19,1,1843,16,26,129,47,157,21,28,person
54521,23,person,24,1,1843,17,375,156,398,200,23,44,person
54522,24,person,25,1,1843,16,312,148,337,188,25,40,person
54523,25,person,26,1,1843,15,258,141,285,177,27,36,person
54524,26,person,27,1,1843,17,218,135,241,168,23,33,person
54525,27,person,28,1,1843,15,187,130,210,160,23,30,person
54526,2,person,3,1,1844,42,157,30,256,239,99,209,person
54527,3,person,4,1,1844,35,34,40,97,134,63,94,person
54528,8,table,9,0,1844,22,1,143,87,239,86,96,dining table
54529,1,car,2,1,1845,26,361,1,639,351,278,350,car
54530,2,car,3,0,1845,35,180,90,407,239,227,149,car
54531,3,car,4,0,1845,17,124,142,193,227,69,85,car
54532,4,person,5,0,1845,43,184,191,236,367,52,176,person
54533,10,person,11,1,1845,21,57,200,87,264,30,64,person
54534,14,person,15,1,1845,17,371,231,416,345,45,114,person
54535,15,person,16,0,1845,69,273,193,420,479,147,286,person
54536,2,hat,3,0,1846,29,188,23,276,87,88,64,hat
54537,7,person,8,1,1846,15,2,140,111,524,109,384,person
54538,8,person,9,1,1846,53,185,22,364,418,179,396,person
54539,10,person,11,1,1846,43,326,73,416,350,90,277,person
54540,12,person,13,1,1846,32,387,83,451,314,64,231,person
54541,23,person,24,1,1846,48,583,42,787,388,204,346,person
54542,6,person,7,1,1847,28,304,135,446,227,142,92,person
54543,7,person,8,1,1847,16,208,130,256,183,48,53,person
54544,19,table,20,1,1847,16,199,256,437,373,238,117,dining table
54545,21,person,22,1,1847,33,197,159,339,372,142,213,person
54546,22,person,23,1,1847,28,133,145,213,372,80,227,person
54547,23,person,24,1,1847,15,107,139,167,202,60,63,person
54548,24,person,25,1,1847,16,85,138,129,185,44,47,person
54549,14,person,15,0,1867,23,113,213,140,289,27,76,person
54550,15,person,16,1,1867,15,57,197,72,225,15,28,person
54551,7,table,8,0,1868,15,376,663,484,744,108,81,dining table
54552,9,table,10,0,1868,19,385,774,510,888,125,114,dining table
54553,11,person,12,0,1868,17,424,916,453,990,29,74,person
54554,12,person,13,0,1868,15,482,891,504,950,22,59,person
54555,13,person,14,0,1868,18,532,858,561,922,29,64,person
54556,16,person,17,0,1868,15,369,822,392,883,23,61,person
54557,20,person,21,0,1868,17,550,758,571,814,21,56,person
54558,23,person,24,0,1868,17,465,1031,492,1112,27,81,person
54559,24,person,25,0,1868,19,430,1037,461,1109,31,72,person
54560,25,person,26,0,1868,19,378,1044,403,1115,25,71,person
54561,26,person,27,0,1868,18,350,1044,376,1115,26,71,person
54562,27,person,28,0,1868,17,424,870,445,928,21,58,person
54563,6,person,7,0,1871,16,546,1284,569,1346,23,62,person
54564,8,person,9,0,1871,15,754,1276,766,1333,12,57,person
54565,12,person,13,0,1871,18,215,1284,238,1348,23,64,person
54566,13,person,14,0,1871,17,312,1293,334,1367,22,74,person
54567,14,person,15,0,1871,15,282,1290,306,1355,24,65,person
54568,27,chair,28,0,1872,18,294,265,351,342,57,77,chair
54569,28,chair,29,0,1872,15,356,266,417,347,61,81,chair
54570,29,chair,30,0,1872,15,415,256,458,330,43,74,chair
54571,36,chair,37,0,1872,16,106,265,159,338,53,73,chair
54572,17,person,18,0,1873,17,159,362,169,390,10,28,person
54573,21,person,22,0,1874,20,320,223,373,281,53,58,person
54574,23,vase,24,0,1874,22,368,279,445,341,77,62,vase
54575,25,chair,26,0,1874,36,302,304,465,536,163,232,chair
54576,26,sofa,27,1,1874,23,436,279,618,434,182,155,couch
54577,27,person,28,1,1874,25,455,263,552,379,97,116,person
54578,28,person,29,1,1874,22,532,256,614,375,82,119,person
54579,29,table,30,1,1874,22,479,369,718,516,239,147,dining table
54580,9,person,10,0,1875,17,246,603,266,669,20,66,person
54581,13,person,14,0,1878,21,879,1829,916,1971,37,142,person
54582,14,person,15,0,1878,20,832,1816,875,1941,43,125,person
54583,15,person,16,0,1878,20,772,1831,809,1963,37,132,person
54584,27,bench,28,1,1880,40,1754,867,2070,1049,316,182,bench
54585,28,chair,29,0,1880,37,1850,903,2061,1093,211,190,chair
54586,29,chair,30,0,1880,33,1545,863,1699,1021,154,158,chair
54587,30,desk,31,1,1880,24,1452,811,1583,888,131,77,desk
54588,45,chair,46,0,1880,47,146,965,380,1312,234,347,chair
54589,46,chair,47,1,1880,27,239,916,396,1074,157,158,chair
54590,49,chair,50,1,1880,41,459,886,572,1047,113,161,chair
54591,50,chair,51,0,1880,40,503,1019,778,1354,275,335,chair
54592,8,chair,9,0,24821,21,439,639,537,768,98,129,chair
54593,4,car,5,0,2008,35,33,121,174,234,141,113,car
54594,5,car,6,0,2008,33,171,98,239,154,68,56,car
54595,6,car,7,0,2008,23,234,88,268,121,34,33,car
54596,7,car,8,1,2008,21,266,81,288,104,22,23,car
54597,8,person,9,0,2008,17,258,109,270,122,12,13,person
54598,10,car,11,0,2009,15,177,174,238,228,61,54,car
54599,13,car,14,1,2009,19,16,157,77,200,61,43,car
54600,16,car,17,1,2009,27,300,216,395,296,95,80,car
54601,17,car,18,1,2009,30,192,257,311,340,119,83,car
54602,18,car,19,1,2009,28,320,255,418,344,98,89,car
54603,20,car,21,1,2009,29,91,219,184,295,93,76,car
54604,21,car,22,1,2009,24,48,259,174,343,126,84,car
54605,23,car,24,1,2009,21,0,215,88,289,88,74,car
54606,4,car,5,1,2010,16,2,67,81,134,79,67,car
54607,5,car,6,0,2010,45,80,69,349,230,269,161,car
54608,7,car,8,1,2010,15,326,63,398,104,72,41,car
54609,1,car,2,1,2011,28,0,92,132,273,132,181,car
54610,2,person,3,0,2011,88,224,27,408,289,184,262,person
54611,3,car,4,1,2011,27,350,50,594,327,244,277,car
54612,9,person,10,1,2011,41,227,41,337,222,110,181,person
54613,10,person,11,0,2011,18,314,18,354,78,40,60,person
54614,11,person,12,0,2011,24,383,16,422,98,39,82,person
54615,12,person,13,0,2011,18,418,22,478,86,60,64,person
54616,4,car,5,1,2012,17,186,45,216,68,30,23,car
54617,8,car,9,1,2012,19,138,46,190,72,52,26,car
54618,9,car,10,1,2012,22,97,46,169,81,72,35,car
54619,10,car,11,0,2012,49,14,53,168,146,154,93,car
54620,3,car,4,1,2013,19,185,115,299,197,114,82,car
54621,4,car,5,1,2013,21,96,100,177,141,81,41,car
54622,1,car,2,0,2014,20,110,321,244,458,134,137,car
54623,4,car,5,1,2015,20,1050,45,1522,1093,472,1048,car
54624,5,car,6,1,2015,25,629,272,1101,866,472,594,car
54625,6,car,7,1,2015,20,408,344,639,750,231,406,car
54626,7,car,8,1,2015,16,284,387,440,686,156,299,car
54627,2,car,3,1,2016,21,253,141,350,261,97,120,car
54628,3,car,4,1,2016,22,171,61,245,117,74,56,car
54629,6,car,7,1,2016,18,146,21,185,57,39,36,car
54630,7,car,8,0,2017,22,257,286,337,350,80,64,car
54631,3,car,4,1,2018,30,81,76,274,182,193,106,car
54632,5,person,6,0,2018,37,271,93,317,196,46,103,person
54633,6,person,7,0,2018,27,58,103,83,186,25,83,person
54634,2,car,3,0,2019,44,771,286,1726,921,955,635,car
54635,3,person,4,1,2019,56,0,343,612,1434,612,1091,person
54636,4,person,5,1,2019,29,1522,147,1740,587,218,440,person
54637,5,person,6,1,2019,21,1698,252,1794,743,96,491,person
54638,6,person,7,0,2019,29,1738,176,1922,765,184,589,person
54639,7,person,8,1,2019,24,1911,122,2106,777,195,655,person
54640,2,door,3,0,2020,31,728,7,1342,735,614,728,door
54641,6,truck,6,1,2020,46,0,0,1346,1522,1346,1522,truck
54642,10,person,10,1,2020,17,1158,1054,1259,1172,101,118,person
54643,11,truck,11,1,2020,33,1089,998,1429,1374,340,376,truck
54644,12,truck,12,1,2020,21,1385,1166,1484,1350,99,184,truck
54645,0,car,1,0,22729,25,302,1,799,578,497,577,car
54646,1,person,2,0,22729,90,44,15,326,401,282,386,person
54647,2,car,3,0,22729,29,61,0,344,108,283,108,car
54648,2,person,3,0,22730,30,1,149,32,265,31,116,person
54649,3,person,4,0,22730,38,29,151,66,254,37,103,person
54650,4,car,5,1,22730,38,21,193,123,245,102,52,car
54651,5,car,6,0,22730,107,132,57,651,510,519,453,car
54652,6,car,7,1,22730,15,587,211,615,265,28,54,car
54653,7,car,8,1,22730,26,597,193,800,283,203,90,car
54654,8,car,9,1,22730,28,616,281,800,457,184,176,car
54655,9,person,10,1,22730,38,0,272,103,594,103,322,person
54656,2,car,3,1,2021,16,2,72,193,397,191,325,car
54657,3,person,4,0,2021,58,120,4,271,396,151,392,person
54658,4,person,5,1,2022,50,3,9,233,334,230,325,person
54659,5,person,6,1,2022,45,229,33,405,262,176,229,person
54660,7,window,8,1,2022,17,143,2,382,66,239,64,window
54661,3,car,4,1,2023,15,123,105,320,240,197,135,car
54662,4,car,5,1,2023,25,151,95,293,150,142,55,car
54663,5,car,6,0,2023,22,112,91,206,129,94,38,car
54664,6,car,7,1,2023,20,13,39,117,98,104,59,car
54665,5,person,6,1,2024,37,806,363,1268,1086,462,723,person
54666,6,person,7,1,2024,35,1253,169,1708,1013,455,844,person
54667,7,person,8,1,2024,31,1665,175,2053,994,388,819,person
54668,8,person,9,1,2024,40,612,301,1062,1170,450,869,person
54669,10,person,11,1,2024,52,3,228,877,1641,874,1413,person
54670,2,car,3,1,2026,21,2,73,166,148,164,75,car
54671,3,car,4,1,2026,19,0,0,177,200,177,200,car
54672,4,person,5,1,2026,74,32,12,200,200,168,188,person
54673,5,person,6,1,2027,58,1,21,111,279,110,258,person
54674,2,window,3,1,2028,17,7,34,378,500,371,466,window
54675,4,person,5,1,2028,73,156,118,584,953,428,835,person
54676,5,person,6,1,2028,75,695,125,1179,958,484,833,person
54677,4,car,5,0,2029,23,347,124,589,204,242,80,car
54678,7,car,8,1,2029,20,241,199,377,255,136,56,car
54679,8,car,9,1,2029,21,129,207,304,273,175,66,car
54680,9,car,10,1,2029,27,2,185,285,340,283,155,car
54681,0,car,1,1,2030,20,0,0,340,224,340,224,car
54682,4,person,5,1,2030,49,158,42,320,194,162,152,person
54683,5,person,6,1,2030,58,5,0,165,201,160,201,person
54684,7,person,8,0,2063,19,421,170,438,250,17,80,person
54685,3,person,4,1,2064,29,77,89,223,299,146,210,person
54686,4,person,5,1,2064,33,31,95,92,299,61,204,person
54687,8,person,9,0,2066,43,432,92,505,312,73,220,person
54688,9,bench,10,0,2066,23,244,187,348,275,104,88,bench
54689,4,person,5,0,4255,66,254,34,509,328,255,294,person
54690,2,person,3,1,4256,27,175,0,287,187,112,187,person
54691,3,person,4,1,4256,25,2,2,73,128,71,126,person
54692,4,person,5,1,4256,59,186,126,336,426,150,300,person
54693,5,person,6,1,4256,23,0,212,117,449,117,237,person
54694,6,person,7,1,4256,34,0,10,93,251,93,241,person
54695,4,person,5,1,4257,52,0,56,107,179,107,123,person
54696,7,person,8,1,4259,30,102,74,131,145,29,71,person
54697,10,person,11,0,4259,27,92,44,106,95,14,51,person
54698,3,person,4,0,4261,30,166,84,296,403,130,319,person
54699,4,car,5,1,4262,21,167,45,250,131,83,86,car
54700,5,car,6,1,4262,21,245,0,330,232,85,232,car
54701,16,person,17,1,4292,32,319,79,421,317,102,238,person
54702,7,person,8,1,4293,29,321,220,379,475,58,255,person
54703,8,table,9,0,4293,22,346,315,691,540,345,225,dining table
54704,21,person,22,1,4293,41,83,189,213,540,130,351,person
54705,22,person,23,1,4293,33,581,190,687,443,106,253,person
54706,15,chair,16,0,22895,26,885,478,985,591,100,113,chair
54707,16,chair,17,1,22895,31,868,460,956,562,88,102,chair
54708,42,hair dryer,43,0,22895,17,593,192,619,315,26,123,hair drier
54709,43,hair dryer,44,0,22895,19,550,160,592,322,42,162,hair drier
54710,44,hair dryer,45,0,22895,15,623,222,662,330,39,108,hair drier
54711,45,hair dryer,46,0,22895,16,501,114,525,306,24,192,hair drier
54712,46,hair dryer,47,0,22895,21,404,43,452,296,48,253,hair drier
54713,47,hair dryer,48,0,22895,31,113,2,209,249,96,247,hair drier
54714,48,chair,49,0,22895,39,112,603,391,777,279,174,chair
54715,49,chair,50,0,22895,67,305,530,490,778,185,248,chair
54716,50,chair,51,0,22895,49,419,494,566,707,147,213,chair
54717,51,chair,52,0,22895,35,499,476,624,650,125,174,chair
54718,52,chair,53,0,22895,37,562,459,671,608,109,149,chair
54719,53,chair,54,1,22895,21,622,444,678,516,56,72,chair
54720,54,chair,55,0,22895,41,929,522,1035,669,106,147,chair
54721,55,chair,56,0,22895,18,960,527,1036,719,76,192,chair
54722,16,person,17,1,4374,22,1455,936,1627,1170,172,234,person
54723,19,person,20,1,4374,39,400,1002,841,1611,441,609,person
54724,8,person,9,1,553,17,2,748,86,1586,84,838,person
54725,9,person,10,0,553,77,11,553,390,1798,379,1245,person
54726,19,person,20,1,553,82,589,419,1025,1817,436,1398,person
54727,27,person,28,0,553,75,968,627,1433,1965,465,1338,person
54728,32,person,33,1,553,56,1521,593,1782,2167,261,1574,person
54729,2,person,3,1,4407,23,213,46,261,125,48,79,person
54730,3,person,4,1,4407,27,249,26,319,166,70,140,person
54731,2,person,3,1,4408,24,154,50,191,107,37,57,person
54732,3,person,4,1,4408,35,212,53,250,177,38,124,person
54733,12,person,13,1,4408,29,2,83,39,171,37,88,person
54734,5,person,6,1,4409,34,286,417,378,796,92,379,person
54735,6,person,7,1,4409,31,112,412,242,910,130,498,person
54736,8,person,9,1,4409,30,323,407,541,793,218,386,person
54737,9,person,10,0,4409,25,541,462,675,761,134,299,person
54738,10,person,11,1,4409,31,673,410,920,738,247,328,person
54739,11,person,12,1,4409,31,961,422,1123,909,162,487,person
54740,2,person,3,1,4410,25,273,103,309,209,36,106,person
54741,3,person,4,1,4410,30,73,87,144,239,71,152,person
54742,9,person,10,1,4410,36,137,62,196,172,59,110,person
54743,10,person,11,1,4410,29,204,65,232,161,28,96,person
54744,11,person,12,1,4410,28,150,113,255,239,105,126,person
54745,12,chair,13,1,4410,17,140,156,163,209,23,53,chair
54746,9,chair,10,0,4411,25,253,189,302,262,49,73,chair
54747,9,person,10,1,4412,33,488,222,565,440,77,218,person
54748,10,person,11,0,4412,43,538,209,615,482,77,273,person
54749,11,person,12,0,4412,39,409,226,498,482,89,256,person
54750,12,person,13,0,4412,39,321,217,391,466,70,249,person
54751,13,person,14,0,4412,40,250,206,329,532,79,326,person
54752,15,person,16,0,4412,41,142,208,251,533,109,325,person
54753,16,person,17,1,4412,17,671,247,688,342,17,95,person
54754,17,person,18,0,4412,17,659,258,676,341,17,83,person
54755,18,person,19,0,4412,26,703,255,741,348,38,93,person
54756,19,person,20,1,4412,17,601,241,629,409,28,168,person
54757,37,person,38,1,4412,26,484,240,515,281,31,41,person
54758,38,person,39,1,4412,26,751,256,771,341,20,85,person
54759,39,person,40,1,4412,38,732,255,762,345,30,90,person
54760,3,person,4,1,4413,30,40,77,96,185,56,108,person
54761,10,person,11,0,4413,43,219,92,269,195,50,103,person
54762,8,person,9,1,4414,19,97,109,118,176,21,67,person
54763,9,person,10,0,4414,26,108,113,140,240,32,127,person
54764,10,person,11,0,4414,41,143,104,198,244,55,140,person
54765,11,person,12,0,4414,27,187,112,221,225,34,113,person
54766,12,table,13,0,4414,16,201,161,249,259,48,98,dining table
54767,8,person,9,0,4415,22,148,72,168,135,20,63,person
54768,9,person,10,0,4415,41,175,64,209,151,34,87,person
54769,10,person,11,1,4415,24,2,74,22,151,20,77,person
54770,22,chair,21,1,4416,24,1,1117,504,1551,503,434,chair
54771,7,person,8,0,24853,75,2,104,128,459,126,355,person
54772,8,person,9,1,24853,47,196,96,285,304,89,208,person
54773,9,person,10,0,24853,65,271,95,350,385,79,290,person
54774,10,person,11,0,24853,61,345,91,450,391,105,300,person
54775,11,person,12,0,24853,73,433,86,550,419,117,333,person
54776,12,person,13,0,24853,82,523,81,640,472,117,391,person
54777,2,person,3,0,24854,81,822,156,985,694,163,538,person
54778,3,person,4,0,24854,80,682,200,822,768,140,568,person
54779,4,person,5,0,24854,66,571,236,724,733,153,497,person
54780,5,person,6,1,24854,72,431,385,534,768,103,383,person
54781,6,person,7,1,24854,74,488,305,717,768,229,463,person
54782,7,person,8,1,24854,73,174,243,395,768,221,525,person
54783,8,person,9,1,24854,45,20,293,212,767,192,474,person
54784,10,chair,11,0,24854,18,821,622,1024,768,203,146,chair
54785,13,clock,14,0,24854,16,20,241,60,301,40,60,clock
54786,1,person,2,1,24855,144,135,19,799,532,664,513,person
54787,0,window,1,0,24856,100,75,0,1171,445,1096,445,window
54788,8,person,9,0,24856,74,831,250,1104,866,273,616,person
54789,9,person,10,0,24856,62,638,249,825,861,187,612,person
54790,10,person,11,0,24856,72,398,224,683,920,285,696,person
54791,11,person,12,0,24856,67,178,246,526,928,348,682,person
54792,2,person,3,1,24857,33,939,337,1023,712,84,375,person
54793,3,person,4,1,24857,53,757,361,872,714,115,353,person
54794,4,person,5,1,24857,56,614,347,765,714,151,367,person
54795,5,person,6,1,24857,42,548,375,664,712,116,337,person
54796,6,person,7,1,24857,59,250,340,518,714,268,374,person
54797,7,person,8,1,24857,50,172,403,294,713,122,310,person
54798,8,person,9,1,24857,20,282,410,352,492,70,82,person
54799,9,person,10,1,24857,38,21,359,197,712,176,353,person
54800,10,person,11,1,24857,27,155,371,228,539,73,168,person
54801,8,table,9,1,4527,23,58,143,261,224,203,81,dining table
54802,11,person,12,1,4528,21,293,73,334,120,41,47,person
54803,12,person,13,1,4528,18,340,77,383,117,43,40,person
54804,13,person,14,1,4528,16,330,116,399,209,69,93,person
54805,15,person,16,1,4528,24,203,73,245,131,42,58,person
54806,16,person,17,1,4528,22,138,94,178,159,40,65,person
54807,17,person,18,1,4528,23,59,110,124,184,65,74,person
54808,18,person,19,1,4528,24,2,134,67,219,65,85,person
54809,19,person,20,1,4528,28,167,118,220,203,53,85,person
54810,20,person,21,1,4528,29,197,128,258,232,61,104,person
54811,21,person,22,1,4528,15,139,174,207,232,68,58,person
54812,25,person,26,1,4528,16,32,188,77,231,45,43,person
54813,27,chair,28,0,4528,17,291,124,345,201,54,77,chair
54814,13,person,14,0,4957,25,136,34,150,81,14,47,person
54815,3,chair,4,0,4958,22,104,234,152,293,48,59,chair
54816,15,person,16,1,4958,26,385,212,449,295,64,83,person
54817,19,person,20,1,4958,27,83,215,139,266,56,51,person
54818,25,person,26,1,4958,30,246,215,299,290,53,75,person
54819,26,chair,27,1,4958,24,249,241,318,295,69,54,chair
54820,63,person,64,1,4958,23,27,91,65,141,38,50,person
54821,64,person,65,1,4958,21,142,76,176,131,34,55,person
54822,65,person,66,1,4958,16,231,102,264,160,33,58,person
54823,66,person,67,1,4958,20,255,78,283,135,28,57,person
54824,67,person,68,1,4958,22,364,88,405,153,41,65,person
54825,68,person,69,1,4958,17,350,119,405,163,55,44,person
54826,69,person,70,1,4958,21,86,19,122,54,36,35,person
54827,70,person,71,1,4958,15,172,17,190,42,18,25,person
54828,71,person,72,1,4958,18,250,3,278,53,28,50,person
54829,72,person,73,1,4958,16,265,14,287,47,22,33,person
54830,73,person,74,1,4958,27,350,4,403,56,53,52,person
54831,74,person,75,1,4958,25,419,22,447,110,28,88,person
54832,75,chair,76,1,4958,17,142,101,192,142,50,41,chair
54833,7,person,8,1,4959,25,223,175,298,261,75,86,person
54834,12,person,13,1,4959,28,128,192,206,261,78,69,person
54835,14,person,15,1,4959,30,6,181,102,261,96,80,person
54836,29,person,30,1,4959,16,368,81,399,126,31,45,person
54837,34,person,35,1,4959,18,25,103,62,137,37,34,person
54838,37,person,38,1,4959,18,135,101,175,131,40,30,person
54839,39,person,40,1,4959,15,184,97,215,125,31,28,person
54840,59,person,60,1,4959,28,330,166,394,242,64,76,person
54841,17,person,18,1,4960,32,253,265,516,560,263,295,person
54842,19,person,20,1,4960,23,392,265,512,449,120,184,person
54843,20,person,21,1,4960,43,0,360,423,893,423,533,person
54844,21,person,22,1,4960,29,992,114,1160,381,168,267,person
54845,26,person,27,1,4960,27,797,244,948,443,151,199,person
54846,27,person,28,1,4960,36,820,280,1138,626,318,346,person
54847,28,person,29,1,4960,37,1041,352,1412,896,371,544,person
54848,8,person,9,1,4962,75,75,54,251,204,176,150,person
54849,9,person,10,1,4962,28,52,40,99,130,47,90,person
54850,10,person,11,1,4962,31,9,39,55,122,46,83,person
54851,11,desk,12,0,4963,23,42,135,298,274,256,139,desk
54852,16,person,17,1,4963,32,10,82,95,202,85,120,person
54853,17,person,18,1,4963,47,174,86,269,272,95,186,person
54854,20,person,21,1,4963,23,210,36,253,92,43,56,person
54855,1,desk,2,0,4964,26,139,202,367,351,228,149,desk
54856,11,chair,12,0,4964,24,87,189,153,267,66,78,chair
54857,3,person,4,1,5406,39,145,18,222,191,77,173,person
54858,4,person,5,1,5406,43,230,19,304,276,74,257,person
54859,7,person,8,1,5407,37,388,100,521,283,133,183,person
54860,10,person,11,1,5410,19,0,121,28,237,28,116,person
54861,12,person,13,0,5410,39,143,124,180,234,37,110,person
54862,4,person,5,0,5411,63,147,31,268,206,121,175,person
54863,5,person,6,1,5411,16,198,25,224,56,26,31,person
54864,4,person,5,1,5412,44,77,32,177,154,100,122,person
54865,5,person,6,1,5412,49,259,41,392,188,133,147,person
54866,4,person,5,1,5413,60,178,7,374,177,196,170,person
54867,6,person,7,1,5420,26,15,80,77,200,62,120,person
54868,7,person,8,1,5423,38,2,68,204,198,202,130,person
54869,8,person,9,1,5423,43,160,89,379,178,219,89,person
54870,13,person,14,0,5424,50,302,135,385,351,83,216,person
54871,14,person,15,0,5424,53,82,131,186,393,104,262,person
54872,10,person,10,1,5425,37,589,264,750,767,161,503,person
54873,11,person,11,0,5425,49,759,251,884,659,125,408,person
54874,25,bottle,25,0,5425,19,176,147,304,248,128,101,bottle
54875,32,bottle,32,0,5425,16,327,629,387,749,60,120,bottle
54876,33,bottle,33,1,5425,24,348,580,420,717,72,137,bottle
54877,3,table,4,0,5426,15,400,862,1581,1530,1181,668,dining table
54878,9,person,10,1,5426,45,1056,301,2046,1533,990,1232,person
54879,8,table,9,0,5427,17,88,425,377,673,289,248,dining table
54880,9,table,10,0,5427,32,224,452,1181,793,957,341,dining table
54881,13,table,14,0,5427,21,818,387,1181,543,363,156,dining table
54882,3,refrigerator,4,1,23077,38,1444,49,2017,900,573,851,refrigerator
54883,7,desk,8,0,23077,75,4,561,1337,1198,1333,637,desk
54884,8,person,9,1,23077,111,749,238,1848,1201,1099,963,person
54885,9,chair,10,1,23077,23,1748,816,1971,1200,223,384,chair
54886,14,keyboard,15,0,23077,16,586,654,945,790,359,136,keyboard
54887,6,bird,7,0,5435,36,223,98,274,196,51,98,bird
54888,7,bird,8,0,5435,33,82,136,175,214,93,78,bird
54889,8,bird,9,1,5435,37,150,130,232,205,82,75,bird
54890,9,bird,10,1,5435,16,151,93,184,129,33,36,bird
54891,7,person,8,1,5450,35,153,88,299,159,146,71,person
54892,10,bird,11,0,5452,46,57,157,158,239,101,82,bird
54893,14,bird,15,0,5452,48,200,99,319,183,119,84,bird
54894,15,bird,16,0,5452,34,177,89,233,143,56,54,bird
54895,16,bird,17,0,5452,26,2,104,57,194,55,90,bird
54896,6,bird,7,0,5453,15,209,287,242,314,33,27,bird
54897,7,bird,8,0,5453,15,113,298,157,325,44,27,bird
54898,8,bird,9,0,5453,15,166,278,196,308,30,30,bird
54899,5,person,6,0,5454,45,151,66,275,183,124,117,person
54900,8,bird,9,0,5454,126,55,192,406,312,351,120,bird
54901,8,person,9,1,5646,28,263,112,300,201,37,89,person
54902,9,person,10,1,5646,31,269,71,340,225,71,154,person
54903,10,person,11,1,5646,50,212,128,372,331,160,203,person
54904,11,chair,12,0,5646,23,243,203,389,331,146,128,chair
54905,6,person,7,0,5647,51,207,111,288,208,81,97,person
54906,12,person,13,1,5648,35,212,346,504,605,292,259,person
54907,13,person,14,1,5648,23,0,275,178,605,178,330,person
54908,14,person,15,1,5648,36,0,115,215,604,215,489,person
54909,15,person,16,1,5648,33,141,161,289,466,148,305,person
54910,16,person,17,1,5648,45,255,122,405,511,150,389,person
54911,18,person,19,1,5648,42,389,158,546,522,157,364,person
54912,19,person,20,1,5648,27,494,134,582,367,88,233,person
54913,20,person,21,1,5648,23,540,196,697,406,157,210,person
54914,22,person,23,1,5648,17,91,4,121,71,30,67,person
54915,5,door,6,1,5649,36,573,135,827,579,254,444,door
54916,10,person,11,1,5649,44,521,205,732,618,211,413,person
54917,11,person,12,1,5649,49,728,175,988,614,260,439,person
54918,12,person,13,1,5649,54,235,384,537,954,302,570,person
54919,13,person,14,1,5649,37,515,443,787,1020,272,577,person
54920,14,person,15,1,5649,39,710,449,1024,1022,314,573,person
54921,15,person,16,1,5649,28,107,694,549,1018,442,324,person
54922,17,person,18,1,5649,39,298,233,527,575,229,342,person
54923,5,person,6,1,5650,42,199,349,997,1634,798,1285,person
54924,6,person,7,1,5650,37,833,362,1329,1641,496,1279,person
54925,13,table,14,0,5651,15,225,121,286,185,61,64,dining table
54926,6,person,7,1,5652,47,100,54,270,299,170,245,person
54927,6,person,7,1,5653,51,220,97,437,674,217,577,person
54928,7,person,8,0,5653,46,449,93,597,546,148,453,person
54929,10,person,11,0,5653,70,703,83,954,554,251,471,person
54930,0,person,1,0,5654,70,790,220,1080,1334,290,1114,person
54931,1,person,2,1,5654,55,131,38,703,1291,572,1253,person
54932,5,table,6,0,23086,28,366,1019,1345,1384,979,365,dining table
54933,10,chair,11,0,23086,60,885,967,1134,1398,249,431,chair
54934,11,chair,12,0,23086,53,516,964,777,1373,261,409,chair
54935,12,chair,13,1,23086,16,1729,987,1896,1391,167,404,chair
54936,13,chair,14,1,23086,18,1884,1066,2084,1536,200,470,chair
54937,3,table,4,0,5939,31,4,219,841,640,837,421,dining table
54938,22,table,23,1,5939,16,480,70,821,152,341,82,dining table
54939,38,chair,39,1,5939,18,517,134,577,198,60,64,chair
54940,39,chair,40,1,5939,19,695,139,771,219,76,80,chair
54941,40,chair,41,1,5939,16,604,521,853,638,249,117,chair
54942,41,chair,42,1,5939,15,0,271,66,374,66,103,chair
54943,43,chair,44,1,5939,21,0,502,132,640,132,138,chair
54944,12,desk,13,0,5941,17,100,109,256,197,156,88,desk
54945,13,chair,14,1,5941,29,95,127,176,192,81,65,chair
54946,11,person,12,1,5942,16,115,79,132,105,17,26,person
54947,16,chair,17,1,5942,19,153,113,179,148,26,35,chair
54948,19,chair,20,1,5943,24,171,177,256,255,85,78,chair
54949,17,table,18,1,5944,16,334,384,867,618,533,234,dining table
54950,23,person,24,1,5944,19,571,186,618,248,47,62,person
54951,0,desk,1,0,5945,20,0,23,197,255,197,232,desk
54952,20,chair,21,1,5946,15,976,715,1237,959,261,244,chair
54953,21,chair,22,1,5946,27,703,588,987,958,284,370,chair
54954,22,chair,23,0,5946,33,442,481,764,913,322,432,chair
54955,23,chair,24,1,5946,23,356,417,482,775,126,358,chair
54956,24,chair,25,1,5946,18,230,381,411,670,181,289,chair
54957,25,chair,26,1,5946,15,197,354,279,580,82,226,chair
54958,4,desk,5,0,5947,16,130,111,250,179,120,68,desk
54959,10,chair,11,1,5947,18,150,202,198,256,48,54,chair
54960,11,desk,12,0,5947,27,0,102,121,233,121,131,desk
54961,3,desk,4,0,5948,17,390,622,826,958,436,336,desk
54962,6,desk,7,0,5948,17,810,573,1155,895,345,322,desk
54963,9,desk,10,0,5948,16,144,528,406,780,262,252,desk
54964,10,chair,11,1,5949,18,93,332,234,440,141,108,chair
54965,6,desk,7,0,5950,24,5,350,714,859,709,509,desk
54966,19,chair,19,0,5950,26,770,414,912,689,142,275,chair
54967,20,chair,20,0,5950,23,294,547,477,861,183,314,chair
54968,21,chair,21,1,5950,16,522,442,594,730,72,288,chair
54969,45,chair,45,1,5950,16,636,377,682,602,46,225,chair
54970,15,chair,16,1,5952,22,0,480,128,765,128,285,chair
54971,16,chair,17,1,5952,25,90,434,257,691,167,257,chair
54972,17,chair,18,0,5952,29,247,415,390,616,143,201,chair
54973,18,chair,19,0,5952,24,403,370,545,564,142,194,chair
54974,19,chair,20,0,5952,26,563,364,705,556,142,192,chair
54975,20,chair,21,0,5952,27,682,384,819,591,137,207,chair
54976,21,chair,22,1,5952,27,815,420,1022,626,207,206,chair
54977,17,chair,18,1,5954,22,212,155,255,220,43,65,chair
54978,20,chair,21,1,5954,17,132,158,169,216,37,58,chair
54979,21,table,22,0,5954,15,88,190,158,256,70,66,dining table
54980,22,chair,23,1,5954,22,2,206,60,255,58,49,chair
54981,8,chair,9,0,5955,43,214,1158,662,1642,448,484,chair
54982,9,chair,10,0,5955,30,686,1077,1057,1586,371,509,chair
54983,12,chair,13,1,5955,24,1283,1047,1626,1245,343,198,chair
54984,13,person,14,1,5955,31,1380,744,1724,1160,344,416,person
54985,14,person,15,1,5955,31,1785,700,1991,948,206,248,person
54986,19,person,20,1,5955,43,1709,859,2148,1263,439,404,person
54987,10,table,11,0,5956,16,988,1092,1375,1464,387,372,dining table
54988,37,chair,38,1,5956,18,2023,898,2198,1225,175,327,chair
54989,38,chair,39,0,5956,25,1670,900,1948,1283,278,383,chair
54990,40,chair,41,1,5956,17,1204,921,1424,1259,220,338,chair
54991,45,chair,46,1,5956,31,408,1170,837,1464,429,294,chair
54992,46,chair,47,1,5956,18,2,1135,228,1464,226,329,chair
54993,88,table,89,1,5956,25,1417,752,1994,844,577,92,dining table
54994,10,desk,11,0,5957,23,31,118,255,226,224,108,desk
54995,19,desk,20,1,5957,21,92,104,186,132,94,28,desk
54996,28,table,28,0,5957,17,0,160,103,185,103,25,dining table
54997,13,chair,14,1,5958,24,0,156,75,256,75,100,chair
54998,14,chair,15,1,5958,29,63,167,166,255,103,88,chair
54999,15,chair,16,1,5958,24,158,172,228,256,70,84,chair
55000,7,desk,8,0,23131,21,2,373,1024,767,1022,394,desk
55001,9,keyboard,10,0,23131,22,79,514,712,692,633,178,keyboard
55002,10,mouse,11,0,23131,16,792,650,916,764,124,114,mouse
55003,5,mouse,6,1,23132,18,867,965,983,1039,116,74,mouse
55004,10,person,11,1,23132,103,211,187,957,1199,746,1012,person
55005,11,chair,12,1,23132,32,3,736,730,1200,727,464,chair
55006,12,person,13,1,23132,69,3,156,274,796,271,640,person
55007,32,table,33,1,5972,20,0,128,239,240,239,112,dining table
55008,18,person,19,1,5973,25,484,385,564,489,80,104,person
55009,22,person,23,1,5973,20,143,452,217,556,74,104,person
55010,23,person,24,1,5973,19,93,456,171,577,78,121,person
55011,26,person,27,1,5973,16,853,433,919,503,66,70,person
55012,32,person,33,1,5973,27,1063,417,1203,577,140,160,person
55013,33,person,34,1,5973,19,1207,451,1269,531,62,80,person
55014,35,person,36,1,5973,29,573,476,713,653,140,177,person
55015,37,person,38,1,5973,18,440,475,524,587,84,112,person
55016,39,person,40,1,5973,28,181,476,309,683,128,207,person
55017,41,person,42,1,5973,33,303,496,543,820,240,324,person
55018,42,chair,43,1,5973,18,300,688,563,831,263,143,chair
55019,43,chair,44,1,5973,18,585,617,824,784,239,167,chair
55020,45,person,46,1,5973,22,964,448,1065,611,101,163,person
55021,47,chair,48,1,5973,20,967,579,1155,728,188,149,chair
55022,48,person,49,1,5973,35,1003,528,1273,956,270,428,person
55023,51,desk,52,1,5973,18,309,708,1087,955,778,247,desk
55024,8,table,9,0,5974,15,742,393,1279,554,537,161,dining table
55025,9,table,10,1,5974,16,391,667,1277,954,886,287,dining table
55026,20,person,21,1,5974,20,2,322,71,553,69,231,person
55027,21,person,22,1,5974,24,62,318,151,530,89,212,person
55028,22,person,23,1,5974,27,134,319,229,530,95,211,person
55029,23,person,24,1,5974,29,227,318,315,505,88,187,person
55030,24,person,25,1,5974,25,308,325,382,500,74,175,person
55031,25,person,26,1,5974,23,377,323,458,505,81,182,person
55032,26,person,27,1,5974,34,456,307,532,486,76,179,person
55033,27,person,28,1,5974,24,508,303,597,479,89,176,person
55034,30,person,31,1,5974,32,591,315,726,479,135,164,person
55035,31,person,32,1,5974,27,677,319,773,479,96,160,person
55036,32,person,33,1,5974,31,761,321,848,500,87,179,person
55037,33,person,34,1,5974,15,827,316,868,391,41,75,person
55038,34,person,35,1,5974,36,809,324,932,514,123,190,person
55039,35,person,36,1,5974,36,913,328,1002,524,89,196,person
55040,37,person,38,1,5974,31,994,335,1091,538,97,203,person
55041,38,person,39,1,5974,23,1087,320,1145,421,58,101,person
55042,39,person,40,1,5974,28,1128,335,1230,522,102,187,person
55043,40,person,41,1,5974,16,1233,333,1279,426,46,93,person
55044,8,chair,9,1,5976,22,546,546,727,834,181,288,chair
55045,9,chair,10,1,5976,26,703,561,883,894,180,333,chair
55046,10,chair,11,1,5976,32,824,580,1157,991,333,411,chair
55047,11,chair,12,1,5976,25,1290,636,1591,917,301,281,chair
55048,12,chair,13,1,5976,26,1588,680,1863,1081,275,401,chair
55049,13,chair,14,0,5976,32,1860,720,2183,1327,323,607,chair
55050,14,chair,15,1,5976,42,1461,864,1957,1644,496,780,chair
55051,15,chair,16,0,5976,31,1128,801,1507,1346,379,545,chair
55052,16,chair,17,0,5976,31,840,746,1148,1241,308,495,chair
55053,17,chair,18,1,5976,22,113,589,304,954,191,365,chair
55054,18,chair,19,1,5976,24,256,614,482,1126,226,512,chair
55055,19,chair,20,0,5976,35,420,652,816,1132,396,480,chair
55056,22,chair,23,1,5976,30,149,893,543,1644,394,751,chair
55057,23,chair,24,1,5976,39,482,1033,1053,1645,571,612,chair
55058,24,chair,25,1,5976,21,1013,1194,1748,1647,735,453,chair
55059,4,window,5,0,5977,29,722,181,881,355,159,174,window
55060,11,chair,12,1,5977,24,135,439,249,622,114,183,chair
55061,12,chair,13,1,5977,27,306,423,423,531,117,108,chair
55062,13,chair,14,1,5977,25,463,396,596,493,133,97,chair
55063,14,chair,15,1,5977,30,587,385,694,509,107,124,chair
55064,15,chair,16,1,5977,38,677,361,775,492,98,131,chair
55065,16,chair,17,1,5977,18,726,350,803,447,77,97,chair
55066,18,chair,19,1,5977,17,708,321,782,377,74,56,chair
55067,19,chair,20,1,5977,16,666,313,747,386,81,73,chair
55068,20,chair,21,1,5977,31,626,303,702,390,76,87,chair
55069,23,chair,24,1,5977,24,802,313,891,407,89,94,chair
55070,24,chair,25,1,5977,21,828,326,926,425,98,99,chair
55071,25,chair,26,1,5977,22,846,338,952,437,106,99,chair
55072,28,chair,29,1,5977,23,824,411,947,545,123,134,chair
55073,29,chair,30,1,5977,27,721,433,891,590,170,157,chair
55074,30,chair,31,0,5977,28,537,489,731,692,194,203,chair
55075,31,chair,32,1,5977,30,371,490,543,731,172,241,chair
55076,32,chair,33,0,5977,29,165,513,337,765,172,252,chair
55077,22,sofa,23,0,5978,27,31,635,508,1012,477,377,couch
55078,24,chair,25,1,5978,20,650,602,777,756,127,154,chair
55079,25,table,26,0,5978,25,968,633,1607,731,639,98,dining table
55080,37,chair,38,0,5978,59,26,928,451,1380,425,452,chair
55081,39,chair,40,1,5978,16,1677,604,1737,847,60,243,chair
55082,16,table,16,0,570,30,107,156,450,338,343,182,dining table
55083,14,chair,15,1,5979,15,90,195,161,253,71,58,chair
55084,28,chair,29,1,5979,20,159,169,204,248,45,79,chair
55085,29,chair,30,1,5979,28,131,178,187,253,56,75,chair
55086,12,chair,13,1,5980,15,760,440,1048,864,288,424,chair
55087,30,chair,26,0,5980,15,830,612,1140,899,310,287,chair
55088,7,table,8,0,5982,16,2,200,460,449,458,249,dining table
55089,10,person,11,0,5982,15,102,132,176,210,74,78,person
55090,11,person,12,0,5982,17,186,124,271,207,85,83,person
55091,12,person,13,0,5982,17,390,142,493,219,103,77,person
55092,13,person,14,0,5982,18,504,144,573,285,69,141,person
55093,14,person,15,0,5982,31,394,152,565,339,171,187,person
55094,23,chair,24,0,5983,54,148,214,238,338,90,124,chair
55095,27,chair,26,0,5983,54,238,235,342,373,104,138,chair
55096,28,table,27,0,5983,17,175,196,471,371,296,175,dining table
55097,1,table,2,0,5984,26,1,108,244,239,243,131,dining table
55098,0,table,1,0,5985,17,0,783,2069,1335,2069,552,dining table
55099,25,chair,24,1,5985,48,461,1073,1529,1642,1068,569,chair
55100,0,table,1,0,5986,22,93,126,229,255,136,129,dining table
55101,2,table,3,0,5987,19,85,398,1023,767,938,369,dining table
55102,19,chair,16,1,5987,55,15,434,209,744,194,310,chair
55103,20,chair,17,1,5987,35,86,501,327,767,241,266,chair
55104,21,chair,18,1,5987,21,272,560,604,765,332,205,chair
55105,23,chair,20,1,5987,22,458,326,604,416,146,90,chair
55106,3,chair,4,1,5988,27,77,70,136,112,59,42,chair
55107,5,chair,6,0,5988,44,1,146,129,254,128,108,chair
55108,7,table,8,0,5988,25,31,109,254,250,223,141,dining table
55109,2,table,3,0,5989,20,29,72,214,224,185,152,dining table
55110,9,chair,10,1,5989,19,191,119,255,255,64,136,chair
55111,1,table,1,0,5990,18,73,132,255,254,182,122,dining table
55112,1,chair,2,0,5991,30,123,112,238,255,115,143,chair
55113,3,table,4,0,5991,26,37,85,236,221,199,136,dining table
55114,4,chair,5,1,5991,35,10,91,92,208,82,117,chair
55115,5,sofa,6,0,5992,18,0,97,55,155,55,58,couch
55116,19,chair,20,0,5992,17,56,132,160,255,104,123,chair
55117,10,chair,11,1,5993,15,658,624,819,744,161,120,chair
55118,11,chair,12,1,5993,18,402,632,635,762,233,130,chair
55119,13,chair,14,1,5993,16,1120,614,1318,805,198,191,chair
55120,15,chair,16,1,5993,15,1414,698,1597,875,183,177,chair
55121,21,chair,21,1,5993,16,574,931,809,1190,235,259,chair
55122,7,chair,8,1,5994,18,1,198,116,255,115,57,chair
55123,8,chair,9,1,5994,15,173,192,255,254,82,62,chair
55124,1,chair,2,0,5995,23,154,178,222,255,68,77,chair
55125,2,chair,3,0,5995,17,125,163,157,217,32,54,chair
55126,5,chair,6,0,5995,18,172,150,207,200,35,50,chair
55127,6,chair,7,0,5995,22,203,160,256,241,53,81,chair
55128,12,chair,13,0,5995,16,73,142,109,184,36,42,chair
55129,26,chair,27,1,5995,24,41,168,100,226,59,58,chair
55130,27,chair,28,1,5995,35,55,182,125,254,70,72,chair
55131,14,table,15,0,5996,18,32,142,256,186,224,44,dining table
55132,4,table,5,1,5998,16,28,148,306,251,278,103,dining table
55133,7,chair,8,1,5998,15,140,127,185,174,45,47,chair
55134,8,chair,9,1,5998,17,96,137,143,196,47,59,chair
55135,9,chair,10,1,5998,15,46,154,100,228,54,74,chair
55136,11,chair,12,1,5998,18,303,144,357,199,54,55,chair
55137,12,chair,13,1,5998,17,300,163,371,211,71,48,chair
55138,13,chair,14,1,5998,21,284,186,370,248,86,62,chair
55139,17,chair,18,1,5999,17,95,968,496,1200,401,232,chair
55140,18,table,19,0,5999,20,212,769,1109,1200,897,431,dining table
55141,20,chair,21,1,5999,25,870,924,1017,1198,147,274,chair
55142,21,chair,22,1,5999,25,997,846,1150,1196,153,350,chair
55143,22,chair,23,1,5999,22,1071,766,1190,1079,119,313,chair
55144,23,chair,24,1,5999,26,1114,710,1206,967,92,257,chair
55145,24,chair,25,1,5999,24,1137,675,1236,886,99,211,chair
55146,8,chair,9,0,6000,17,95,124,156,190,61,66,chair
55147,10,chair,11,0,6000,21,35,119,79,177,44,58,chair
55148,11,chair,12,0,6000,22,14,112,41,165,27,53,chair
55149,19,table,20,0,6000,36,34,100,256,133,222,33,dining table
55150,11,desk,12,0,6001,24,609,702,2063,1382,1454,680,desk
55151,13,chair,14,0,6001,22,418,908,951,1570,533,662,chair
55152,14,chair,15,0,6001,40,957,905,1440,1514,483,609,chair
55153,15,chair,16,0,6001,31,1496,791,1918,1317,422,526,chair
55154,24,chair,25,1,6001,46,455,654,732,937,277,283,chair
55155,25,chair,26,1,6001,36,665,762,1032,1197,367,435,chair
55156,28,chair,29,1,6001,51,1849,652,2105,1062,256,410,chair
55157,39,chair,40,1,6001,48,1788,698,1994,1176,206,478,chair
55158,5,table,6,0,6002,34,0,166,414,278,414,112,dining table
55159,3,table,4,0,6003,28,39,111,259,281,220,170,dining table
55160,8,chair,9,0,6003,36,150,151,257,271,107,120,chair
55161,9,chair,10,1,6003,16,248,131,274,187,26,56,chair
55162,16,chair,17,0,6003,30,4,136,93,250,89,114,chair
55163,9,table,9,0,6004,32,80,189,639,414,559,225,dining table
55164,10,chair,10,0,6004,15,19,213,128,358,109,145,chair
55165,11,chair,11,0,6004,17,85,242,216,417,131,175,chair
55166,12,chair,12,0,6004,17,169,288,339,446,170,158,chair
55167,3,door,4,0,6005,16,41,38,69,164,28,126,door
55168,10,chair,11,1,6005,18,16,133,60,171,44,38,chair
55169,12,chair,13,0,6005,36,97,170,217,255,120,85,chair
55170,13,chair,14,1,6005,19,205,162,252,232,47,70,chair
55171,9,chair,10,0,6008,20,47,191,95,254,48,63,chair
55172,10,chair,11,0,6008,22,105,191,149,256,44,65,chair
55173,11,chair,12,0,6008,22,159,191,205,254,46,63,chair
55174,12,chair,13,0,6008,18,216,192,256,253,40,61,chair
55175,13,chair,14,0,6008,20,3,182,44,240,41,58,chair
55176,9,chair,10,1,6009,16,37,120,70,197,33,77,chair
55177,14,person,15,1,6009,20,61,97,95,151,34,54,person
55178,15,person,16,1,6009,33,84,103,157,187,73,84,person
55179,17,person,18,1,6009,19,170,89,197,125,27,36,person
55180,18,person,19,1,6009,20,192,89,224,132,32,43,person
55181,21,person,22,1,6009,28,229,95,291,154,62,59,person
55182,22,chair,23,1,6009,17,272,108,300,163,28,55,chair
55183,20,table,21,0,6010,22,9,224,380,451,371,227,dining table
55184,22,chair,23,0,6010,18,1,331,174,449,173,118,chair
55185,23,chair,24,0,6010,27,162,294,319,448,157,154,chair
55186,30,chair,31,0,6010,17,55,213,136,277,81,64,chair
55187,7,chair,8,1,6011,17,87,135,134,162,47,27,chair
55188,10,chair,11,1,6011,15,124,199,168,255,44,56,chair
55189,11,chair,12,1,6011,26,95,171,126,255,31,84,chair
55190,8,chair,9,1,6012,16,91,176,172,255,81,79,chair
55191,3,chair,4,0,6013,19,137,182,223,254,86,72,chair
55192,15,chair,16,1,6013,16,20,128,57,182,37,54,chair
55193,1,table,2,0,6014,17,0,172,255,255,255,83,dining table
55194,4,table,5,0,6015,16,43,132,300,233,257,101,dining table
55195,14,chair,15,1,6015,17,11,139,155,233,144,94,chair
55196,0,table,1,0,6016,30,67,127,399,299,332,172,dining table
55197,15,chair,16,1,6017,15,540,383,720,540,180,157,chair
55198,16,table,17,0,6017,31,46,292,639,540,593,248,dining table
55199,3,chair,4,1,6018,16,155,153,255,255,100,102,chair
55200,11,table,12,0,6018,32,1,78,255,198,254,120,dining table
55201,18,chair,19,1,6018,18,2,127,151,254,149,127,chair
55202,16,chair,17,1,6019,20,105,157,218,255,113,98,chair
55203,7,table,8,0,6020,29,27,103,233,142,206,39,dining table
55204,0,table,1,0,6021,17,4,161,255,227,251,66,dining table
55205,4,chair,5,0,6021,15,214,169,249,218,35,49,chair
55206,5,chair,6,0,6021,16,45,173,89,231,44,58,chair
55207,24,chair,25,0,6021,23,138,175,179,232,41,57,chair
55208,0,table,1,0,6022,21,16,79,191,192,175,113,dining table
55209,15,window,15,0,6022,27,1,0,135,85,134,85,window
55210,0,table,1,0,6024,21,25,99,194,239,169,140,dining table
55211,2,chair,3,0,6024,20,39,152,106,234,67,82,chair
55212,0,chair,1,0,6026,26,40,139,114,252,74,113,chair
55213,1,table,2,0,6026,17,57,121,255,207,198,86,dining table
55214,10,chair,11,0,6026,26,149,138,212,241,63,103,chair
55215,11,chair,12,0,6026,26,205,129,246,215,41,86,chair
55216,12,chair,13,0,6027,28,119,148,256,254,137,106,chair
55217,14,chair,15,1,6027,20,0,134,119,254,119,120,chair
55218,11,table,12,0,6028,18,29,350,694,588,665,238,dining table
55219,37,chair,38,0,6028,18,473,378,670,590,197,212,chair
55220,38,chair,39,1,6028,29,595,347,733,570,138,223,chair
55221,39,chair,40,1,6028,19,661,333,767,510,106,177,chair
55222,8,chair,8,0,6029,16,2,159,55,249,53,90,chair
55223,8,chair,9,1,6031,16,79,172,108,203,29,31,chair
55224,9,chair,10,1,6031,15,36,178,60,216,24,38,chair
55225,11,chair,12,1,6031,17,290,172,317,207,27,35,chair
55226,12,chair,13,1,6031,16,324,176,353,215,29,39,chair
55227,20,table,21,1,6031,20,52,196,429,286,377,90,dining table
55228,23,chair,24,1,6031,18,405,186,440,254,35,68,chair
55229,21,chair,22,1,6032,15,285,409,338,526,53,117,chair
55230,25,chair,25,0,6032,20,325,422,414,550,89,128,chair
55231,26,chair,26,0,6032,19,404,438,534,550,130,112,chair
55232,4,chair,5,0,6033,32,36,151,98,244,62,93,chair
55233,5,chair,6,0,6033,33,170,151,230,247,60,96,chair
55234,6,table,7,0,6033,68,17,115,246,176,229,61,dining table
55235,17,person,18,0,6033,46,52,141,117,234,65,93,person
55236,18,person,19,0,6033,54,151,144,216,239,65,95,person
55237,19,person,20,1,6033,26,218,175,255,229,37,54,person
55238,20,person,21,1,6033,29,0,169,50,219,50,50,person
55239,21,person,22,1,6033,16,0,127,23,171,23,44,person
55240,22,person,23,1,6033,18,0,121,17,153,17,32,person
55241,23,person,24,1,6033,19,12,117,29,143,17,26,person
55242,24,person,25,1,6033,17,23,110,37,135,14,25,person
55243,25,person,26,1,6033,17,40,109,54,129,14,20,person
55244,26,person,27,1,6033,18,53,108,66,126,13,18,person
55245,27,person,28,1,6033,17,65,107,77,122,12,15,person
55246,29,person,30,1,6033,18,187,104,199,119,12,15,person
55247,30,person,31,1,6033,16,198,106,208,121,10,15,person
55248,32,person,33,1,6033,17,146,103,157,115,11,12,person
55249,34,person,35,1,6033,15,90,106,101,115,11,9,person
55250,36,person,37,1,6033,20,216,108,234,127,18,19,person
55251,37,person,38,1,6033,20,228,110,244,132,16,22,person
55252,6,table,7,0,6034,23,83,101,238,174,155,73,dining table
55253,2,table,3,0,6035,23,50,100,206,146,156,46,dining table
55254,15,window,16,0,6036,15,160,77,238,129,78,52,window
55255,21,table,22,0,6037,24,12,113,247,255,235,142,dining table
55256,0,table,1,0,6038,15,143,119,256,197,113,78,dining table
55257,5,table,6,0,6039,27,3,124,225,219,222,95,dining table
55258,32,chair,30,0,6040,26,384,734,671,1019,287,285,chair
55259,33,chair,31,1,6040,15,614,664,692,891,78,227,chair
55260,34,table,32,0,6040,43,2,469,691,994,689,525,dining table
55261,4,table,5,0,6041,39,0,152,255,216,255,64,dining table
55262,5,table,6,0,6041,15,0,206,217,256,217,50,dining table
55263,66,table,66,0,6043,23,52,522,914,784,862,262,dining table
55264,5,clock,6,0,6044,17,424,39,460,74,36,35,clock
55265,6,table,7,0,6045,23,46,70,256,229,210,159,dining table
55266,7,chair,8,0,6045,31,20,125,117,251,97,126,chair
55267,10,chair,11,0,6045,25,159,120,245,235,86,115,chair
55268,15,chair,16,0,6046,19,65,176,100,216,35,40,chair
55269,16,chair,17,0,6046,19,122,167,150,206,28,39,chair
55270,19,chair,20,1,6047,16,1348,1301,2185,1520,837,219,chair
55271,48,person,48,1,6048,93,1275,562,1798,1347,523,785,person
55272,49,person,49,1,6048,49,1416,502,1590,973,174,471,person
55273,50,person,50,1,6048,50,1267,499,1484,833,217,334,person
55274,51,person,51,0,6048,18,1337,446,1399,543,62,97,person
55275,52,person,52,1,6048,53,1226,489,1417,712,191,223,person
55276,53,person,53,1,6048,41,1148,429,1302,639,154,210,person
55277,54,person,54,1,6048,28,749,444,867,614,118,170,person
55278,55,person,55,1,6048,60,620,441,855,672,235,231,person
55279,56,person,56,1,6048,54,513,444,674,727,161,283,person
55280,57,person,57,1,6048,41,495,487,623,806,128,319,person
55281,58,person,58,1,6048,45,392,494,531,873,139,379,person
55282,59,person,59,1,6048,42,195,527,423,953,228,426,person
55283,60,person,60,1,6048,60,0,598,340,1248,340,650,person
55284,67,table,67,1,6048,132,0,594,1574,1348,1574,754,dining table
55285,5,chair,6,1,6049,15,3,188,63,254,60,66,chair
55286,6,chair,7,1,6049,15,25,172,76,233,51,61,chair
55287,28,chair,29,0,6051,26,100,111,187,244,87,133,chair
55288,29,chair,30,1,6051,21,55,103,106,209,51,106,chair
55289,30,chair,31,1,6051,20,25,97,60,185,35,88,chair
55290,31,chair,32,1,6051,18,2,91,29,169,27,78,chair
55291,9,chair,10,1,6052,17,0,182,101,255,101,73,chair
55292,10,chair,11,1,6052,32,102,160,212,255,110,95,chair
55293,11,table,12,0,6052,38,0,142,223,217,223,75,dining table
55294,17,chair,18,1,6052,38,198,143,255,254,57,111,chair
55295,0,table,1,0,6053,21,20,138,229,239,209,101,dining table
55296,2,chair,3,0,6053,15,136,169,217,248,81,79,chair
55297,3,chair,4,0,6053,16,1,186,97,254,96,68,chair
55298,14,bird,15,0,6054,19,334,174,617,300,283,126,bird
55299,21,chair,20,1,6054,35,1286,531,1486,618,200,87,chair
55300,25,chair,24,1,6054,44,1184,896,1599,1179,415,283,chair
55301,30,chair,29,1,6054,66,1209,769,1597,1067,388,298,chair
55302,35,chair,34,1,6054,51,1237,673,1549,916,312,243,chair
55303,40,chair,39,1,6054,44,1256,611,1521,790,265,179,chair
55304,45,chair,44,1,6054,43,1274,562,1503,705,229,143,chair
55305,4,chair,5,0,6055,15,87,146,149,252,62,106,chair
55306,33,chair,34,1,6055,20,4,139,49,214,45,75,chair
55307,0,table,1,0,6057,20,908,937,1932,1647,1024,710,dining table
55308,9,chair,8,0,6057,24,0,984,346,1476,346,492,chair
55309,16,door,14,0,6057,16,2022,657,2197,1647,175,990,door
55310,28,chair,26,1,6057,29,801,1014,1010,1593,209,579,chair
55311,29,chair,27,1,6057,25,938,860,1146,1097,208,237,chair
55312,30,chair,28,1,6057,33,878,849,1075,1016,197,167,chair
55313,31,chair,29,1,6057,56,1618,1116,2122,1645,504,529,chair
55314,32,chair,30,1,6057,25,1821,1029,2071,1211,250,182,chair
55315,33,chair,31,1,6057,18,1885,975,2105,1060,220,85,chair
55316,34,chair,32,0,6057,44,940,1193,1488,1639,548,446,chair
55317,1,table,2,0,6058,21,12,154,255,256,243,102,dining table
55318,2,chair,3,0,6058,19,119,176,219,255,100,79,chair
55319,5,table,6,0,6059,42,45,585,1727,1150,1682,565,dining table
55320,7,chair,7,0,6059,19,892,500,1030,740,138,240,chair
55321,10,chair,8,0,6059,21,587,809,1032,1150,445,341,chair
55322,5,chair,6,0,6060,16,100,151,212,255,112,104,chair
55323,6,chair,7,0,6060,25,193,134,244,250,51,116,chair
55324,9,table,10,0,6060,15,0,138,219,255,219,117,dining table
55325,2,table,3,0,6061,21,37,379,854,668,817,289,dining table
55326,3,chair,4,0,6061,15,2,612,340,863,338,251,chair
55327,7,chair,8,0,6061,24,434,590,780,863,346,273,chair
55328,13,chair,13,0,6061,19,832,332,962,513,130,181,chair
55329,18,chair,18,0,6061,15,147,335,296,429,149,94,chair
55330,22,chair,22,0,6061,16,422,288,542,374,120,86,chair
55331,25,chair,25,1,6061,60,605,516,854,852,249,336,chair
55332,26,chair,26,1,6061,79,677,476,904,765,227,289,chair
55333,27,chair,27,1,6061,62,748,426,935,680,187,254,chair
55334,9,table,10,0,6062,16,1539,457,1793,617,254,160,dining table
55335,35,table,36,0,6062,20,137,785,1055,1193,918,408,dining table
55336,36,table,37,0,6062,22,981,752,1789,1197,808,445,dining table
55337,37,tables,38,0,6062,28,598,468,1177,628,579,160,dining table
55338,39,tables,40,0,6062,26,1004,493,1647,821,643,328,dining table
55339,2,table,3,0,6063,15,0,110,255,173,255,63,dining table
55340,3,chair,4,0,6063,45,79,156,157,254,78,98,chair
55341,4,chair,5,0,6063,32,141,144,201,227,60,83,chair
55342,15,chair,16,0,6063,21,194,135,228,202,34,67,chair
55343,19,chair,20,0,6063,21,217,125,250,184,33,59,chair
55344,4,table,5,1,6064,16,127,150,182,196,55,46,dining table
55345,7,chair,8,1,6064,19,90,150,140,197,50,47,chair
55346,27,chair,27,1,6064,38,331,201,400,265,69,64,chair
55347,28,chair,28,1,6064,27,322,217,398,265,76,48,chair
55348,1,chair,2,0,6066,21,46,119,137,234,91,115,chair
55349,2,chair,3,0,6066,19,141,117,228,233,87,116,chair
55350,9,chair,10,0,6066,17,9,108,54,203,45,95,chair
55351,10,table,11,0,6067,39,24,81,254,231,230,150,dining table
55352,14,chair,15,0,6068,23,163,156,244,255,81,99,chair
55353,34,chair,34,1,6068,15,195,128,213,144,18,16,chair
55354,0,table,1,0,6069,17,49,93,225,167,176,74,dining table
55355,2,chair,3,0,6069,34,0,146,131,254,131,108,chair
55356,3,chair,4,0,6069,24,156,152,256,256,100,104,chair
55357,16,chair,17,1,6069,24,208,117,255,176,47,59,chair
55358,2,chair,3,0,6071,16,36,166,110,253,74,87,chair
55359,20,table,21,0,6071,27,57,159,201,205,144,46,dining table
55360,1,table,2,0,6072,26,13,89,229,236,216,147,dining table
55361,12,chair,13,1,6073,16,0,155,70,187,70,32,chair
55362,83,chair,78,1,6074,15,627,701,678,764,51,63,chair
55363,105,chair,100,1,6074,20,0,972,80,1283,80,311,chair
55364,107,chair,101,1,6074,52,2,926,182,1260,180,334,chair
55365,108,chair,102,1,6074,67,1,801,255,1177,254,376,chair
55366,109,chair,103,0,6074,76,59,783,310,1103,251,320,chair
55367,110,chair,104,1,6074,72,135,769,355,1035,220,266,chair
55368,111,chair,105,1,6074,69,197,759,384,1007,187,248,chair
55369,112,chair,106,1,6074,74,246,749,418,971,172,222,chair
55370,113,chair,107,1,6074,72,291,742,442,942,151,200,chair
55371,114,chair,108,1,6074,61,325,737,465,915,140,178,chair
55372,115,chair,109,1,6074,61,357,731,485,901,128,170,chair
55373,116,chair,110,1,6074,44,384,727,497,880,113,153,chair
55374,117,chair,111,1,6074,30,406,723,513,866,107,143,chair
55375,118,chair,112,1,6074,27,426,720,520,797,94,77,chair
55376,0,table,1,0,6075,28,41,447,1583,1106,1542,659,dining table
55377,4,person,5,1,6075,19,908,248,1156,482,248,234,person
55378,8,door,9,0,6075,16,56,0,339,585,283,585,door
55379,22,person,23,1,6075,39,679,243,878,468,199,225,person
55380,29,person,30,1,6075,42,425,242,672,483,247,241,person
55381,38,person,39,1,6075,51,1239,259,1463,572,224,313,person
55382,43,person,44,1,6075,55,1276,265,1585,713,309,448,person
55383,48,person,49,1,6075,42,1,390,339,954,338,564,person
55384,54,person,55,1,6075,63,204,280,451,711,247,431,person
55385,18,plate,19,0,6076,18,575,595,683,701,108,106,plate
55386,35,plate,36,0,6076,18,1346,501,1453,608,107,107,plate
55387,50,table,51,1,6076,24,445,774,1140,1350,695,576,dining table
55388,55,bottle,56,0,6076,18,721,850,760,979,39,129,bottle
55389,56,bottle,57,0,6076,17,701,938,750,1092,49,154,bottle
55390,15,door,16,0,6077,16,801,457,975,914,174,457,door
55391,19,window,20,0,6077,59,4,312,801,929,797,617,window
55392,27,table,28,0,6077,135,189,791,1975,1469,1786,678,dining table
55393,3,door,2,0,6078,16,1636,262,2197,940,561,678,door
55394,13,chair,12,0,6078,19,506,1129,1216,1647,710,518,chair
55395,20,table,21,1,6079,25,4,1081,1815,1650,1811,569,dining table
55396,57,chair,58,0,6080,18,1225,712,1418,947,193,235,chair
55397,62,table,63,0,6080,17,245,649,1369,1185,1124,536,dining table
55398,71,book,72,1,6080,19,662,830,717,996,55,166,book
55399,79,chair,79,1,6080,24,327,856,695,1183,368,327,chair
55400,67,table,68,1,6081,34,1377,534,2184,789,807,255,dining table
55401,68,table,69,1,6081,28,1163,528,1820,666,657,138,dining table
55402,69,table,70,1,6081,33,1072,540,1395,622,323,82,dining table
55403,70,table,71,1,6081,17,494,526,972,570,478,44,dining table
55404,71,table,72,1,6081,46,440,553,1036,841,596,288,dining table
55405,72,table,73,1,6081,49,1118,603,1561,784,443,181,dining table
55406,73,table,74,1,6081,27,1166,528,1816,652,650,124,dining table
55407,74,table,75,1,6081,27,138,561,1982,1133,1844,572,dining table
55408,78,clock,79,0,6081,15,695,352,729,388,34,36,clock
55409,85,chair,86,0,6081,67,1286,831,1759,1468,473,637,chair
55410,86,chair,87,0,6081,93,86,801,513,1414,427,613,chair
55411,87,chair,88,0,6081,21,1509,594,1624,706,115,112,chair
55412,88,chair,89,1,6081,26,1404,613,1548,734,144,121,chair
55413,89,chair,90,1,6081,31,1246,629,1432,774,186,145,chair
55414,91,chair,92,1,6081,43,691,620,870,803,179,183,chair
55415,92,chair,93,1,6081,31,610,599,718,757,108,158,chair
55416,93,chair,94,1,6081,25,1005,656,1193,835,188,179,chair
55417,94,chair,95,1,6081,20,875,567,981,642,106,75,chair
55418,95,chair,96,1,6081,55,1688,754,1943,1239,255,485,chair
55419,102,chair,103,1,6081,47,436,1039,1031,1471,595,432,chair
55420,104,chair,105,1,6081,16,809,557,887,623,78,66,chair
55421,105,chair,106,1,6081,17,726,553,822,605,96,52,chair
55422,42,chair,42,1,6082,15,1826,1079,2128,1200,302,121,chair
55423,43,chair,43,1,6082,15,1483,1042,1707,1118,224,76,chair
55424,45,chair,45,1,6082,15,1218,988,1357,1044,139,56,chair
55425,50,chair,50,1,6082,31,497,954,595,1089,98,135,chair
55426,51,chair,51,1,6082,33,377,977,527,1035,150,58,chair
55427,52,chair,52,1,6082,31,394,995,600,1112,206,117,chair
55428,53,chair,53,1,6082,45,347,1020,612,1268,265,248,chair
55429,54,chair,54,1,6082,48,397,1050,679,1219,282,169,chair
55430,55,chair,55,1,6082,54,335,1103,819,1421,484,318,chair
55431,56,chair,56,1,6082,54,371,1187,977,1467,606,280,chair
55432,57,table,57,0,6082,53,511,968,2199,1467,1688,499,dining table
55433,65,door,65,1,6082,15,168,655,278,1132,110,477,door
55434,0,table,1,0,6083,21,44,1490,1400,1972,1356,482,dining table
55435,4,window,5,0,6083,15,492,731,866,1458,374,727,window
55436,17,person,17,1,6083,30,728,1359,845,1499,117,140,person
55437,21,person,21,0,6083,38,857,1351,947,1503,90,152,person
55438,25,person,25,1,6083,36,910,1386,1009,1509,99,123,person
55439,31,chair,31,1,6083,15,427,1422,543,1514,116,92,chair
55440,32,chair,32,1,6083,17,693,1412,763,1489,70,77,chair
55441,35,chair,35,1,6083,15,973,1414,1049,1503,76,89,chair
55442,18,clock,19,0,6084,16,166,232,258,324,92,92,clock
55443,29,table,30,0,6084,19,357,631,1271,1236,914,605,dining table
55444,75,chair,75,1,6085,25,1464,923,1590,1267,126,344,chair
55445,85,chair,85,1,6085,44,638,986,907,1445,269,459,chair
55446,88,chair,88,1,6085,15,674,876,702,922,28,46,chair
55447,95,table,95,1,6085,82,676,798,1717,1354,1041,556,dining table
55448,96,chair,96,0,6085,73,907,1080,1250,1467,343,387,chair
55449,97,chair,97,0,6085,90,1254,1029,1580,1467,326,438,chair
55450,119,chair,119,0,6085,23,443,801,522,908,79,107,chair
55451,50,chair,51,1,6086,42,534,734,696,955,162,221,chair
55452,51,chair,52,1,6086,34,361,748,519,946,158,198,chair
55453,52,chair,53,1,6086,29,650,734,803,970,153,236,chair
55454,53,chair,54,1,6086,31,702,753,870,989,168,236,chair
55455,54,chair,55,1,6086,30,741,764,921,1019,180,255,chair
55456,55,chair,56,1,6086,42,789,779,994,1084,205,305,chair
55457,56,chair,57,1,6086,43,872,795,1083,1094,211,299,chair
55458,57,chair,58,1,6086,25,998,820,1227,1085,229,265,chair
55459,58,chair,59,1,6086,23,1104,844,1366,1071,262,227,chair
55460,61,chair,62,0,6086,91,1639,1129,2137,1636,498,507,chair
55461,62,chair,63,1,6086,42,1072,1264,1590,1648,518,384,chair
55462,63,chair,64,1,6086,50,573,1344,1094,1649,521,305,chair
55463,64,chair,65,1,6086,59,48,1120,499,1649,451,529,chair
55464,65,chair,66,1,6086,39,1,1018,188,1493,187,475,chair
55465,67,chair,68,1,6086,31,6,989,150,1256,144,267,chair
55466,72,table,73,0,6086,42,190,968,2175,1649,1985,681,dining table
55467,73,table,74,0,6086,15,62,882,769,1212,707,330,dining table
55468,75,table,76,0,6086,15,22,731,758,874,736,143,dining table
55469,76,table,77,0,6086,19,561,747,1776,1113,1215,366,dining table
55470,3,table,4,0,6087,16,154,267,704,708,550,441,dining table
55471,12,chair,12,1,6087,16,190,320,345,492,155,172,chair
55472,13,chair,13,1,6087,21,12,384,246,608,234,224,chair
55473,14,chair,14,1,6087,23,2,556,435,766,433,210,chair
55474,15,chair,15,1,6087,22,400,572,786,765,386,193,chair
55475,16,chair,16,1,6087,39,702,377,891,766,189,389,chair
55476,17,chair,17,1,6087,31,705,310,863,562,158,252,chair
55477,18,chair,18,1,6087,22,705,273,867,401,162,128,chair
55478,19,chair,19,1,6087,22,705,244,848,377,143,133,chair
55479,20,chair,20,1,6087,16,705,228,787,337,82,109,chair
55480,67,table,68,0,6088,16,176,764,1776,1505,1600,741,dining table
55481,68,chair,69,1,6088,46,76,1044,418,1531,342,487,chair
55482,69,chair,70,1,6088,39,381,1123,751,1531,370,408,chair
55483,70,chair,71,0,6088,45,1548,1020,1920,1533,372,513,chair
55484,27,door,28,0,6089,27,1612,195,2134,1125,522,930,door
55485,29,door,30,0,6089,21,1273,292,1639,1014,366,722,door
55486,39,table,40,0,6089,92,352,919,2199,1650,1847,731,dining table
55487,19,chair,19,1,6090,28,747,689,941,809,194,120,chair
55488,22,window,23,0,6091,27,584,316,892,916,308,600,window
55489,51,chair,52,1,6091,28,766,853,895,1030,129,177,chair
55490,52,chair,53,1,6091,34,624,862,835,1046,211,184,chair
55491,53,chair,54,1,6091,21,411,891,558,1081,147,190,chair
55492,55,chair,56,1,6091,17,1371,885,1569,973,198,88,chair
55493,56,chair,57,1,6091,16,1097,892,1253,997,156,105,chair
55494,58,chair,59,1,6091,15,489,928,719,1078,230,150,chair
55495,59,chair,60,1,6091,15,148,956,440,1126,292,170,chair
55496,60,chair,61,1,6091,22,1,1251,494,1535,493,284,chair
55497,61,chair,62,1,6091,28,645,1143,1158,1536,513,393,chair
55498,62,chair,63,1,6091,44,1091,1087,1434,1535,343,448,chair
55499,63,chair,64,1,6091,52,1374,1014,1663,1533,289,519,chair
55500,64,chair,65,1,6091,61,1444,977,1816,1479,372,502,chair
55501,65,chair,66,1,6091,54,1650,923,1886,1351,236,428,chair
55502,66,chair,67,1,6091,19,1895,931,2046,1240,151,309,chair
55503,68,table,69,0,6091,59,1,960,1725,1535,1724,575,dining table
55504,0,table,1,0,6093,16,307,369,1119,1065,812,696,dining table
55505,31,chair,30,1,6093,78,951,557,1384,1093,433,536,chair
55506,51,chair,50,1,6093,25,1027,484,1247,815,220,331,chair
55507,64,chair,63,1,6093,24,973,427,1137,701,164,274,chair
55508,76,chair,75,1,6093,18,933,386,1074,609,141,223,chair
55509,79,chair,78,1,6093,15,903,351,1035,535,132,184,chair
55510,81,chair,80,1,6093,21,393,364,512,566,119,202,chair
55511,85,chair,84,1,6093,20,342,403,481,641,139,238,chair
55512,90,chair,89,1,6093,26,256,451,441,737,185,286,chair
55513,95,chair,94,1,6093,28,163,511,375,877,212,366,chair
55514,113,chair,112,1,6093,68,17,597,497,1092,480,495,chair
55515,68,table,69,0,6094,19,2,471,1163,1064,1161,593,dining table
55516,72,chair,73,1,6094,15,894,423,941,471,47,48,chair
55517,73,person,74,1,6094,28,840,418,934,475,94,57,person
55518,75,person,76,1,6094,29,691,409,775,475,84,66,person
55519,76,person,77,1,6094,27,1011,415,1113,488,102,73,person
55520,77,person,78,1,6094,26,563,406,639,482,76,76,person
55521,78,person,79,1,6094,30,1143,437,1259,553,116,116,person
55522,79,person,80,1,6094,19,424,419,489,497,65,78,person
55523,80,person,81,1,6094,18,371,434,438,509,67,75,person
55524,81,person,82,1,6094,33,222,433,292,536,70,103,person
55525,82,person,83,1,6094,23,118,441,219,549,101,108,person
55526,84,person,85,1,6094,35,1253,625,1529,1063,276,438,person
55527,85,person,86,1,6094,20,1192,789,1424,1061,232,272,person
55528,86,person,87,1,6094,44,1129,493,1386,794,257,301,person
55529,87,person,88,1,6094,42,1153,449,1339,609,186,160,person
55530,91,bottle,92,1,6094,18,635,842,692,1007,57,165,bottle
55531,93,plate,94,0,6094,23,644,995,773,1057,129,62,plate
55532,0,table,1,0,6095,23,311,586,1060,1198,749,612,dining table
55533,13,chair,12,1,6095,21,1058,598,1162,740,104,142,chair
55534,14,chair,13,1,6095,32,270,662,511,1078,241,416,chair
55535,15,chair,14,0,6095,60,114,721,485,1197,371,476,chair
55536,16,chair,15,1,6095,20,1048,628,1214,783,166,155,chair
55537,17,chair,16,1,6095,24,1025,656,1258,858,233,202,chair
55538,18,chair,17,1,6095,28,971,710,1273,954,302,244,chair
55539,19,chair,18,0,6095,38,899,781,1298,1196,399,415,chair
55540,12,door,13,0,6096,16,484,211,513,617,29,406,door
55541,49,table,50,1,6096,35,582,553,1084,816,502,263,dining table
55542,41,window,42,0,6097,16,1738,119,2080,643,342,524,window
55543,45,window,46,0,6097,15,1350,204,1547,612,197,408,window
55544,57,chair,58,1,6097,24,694,564,803,691,109,127,chair
55545,58,table,59,0,6097,111,799,586,1482,928,683,342,dining table
55546,59,chair,60,1,6097,23,974,561,1032,593,58,32,chair
55547,60,chair,61,1,6097,48,1468,613,1603,854,135,241,chair
55548,61,chair,62,0,6097,40,1562,655,1755,946,193,291,chair
55549,62,chair,63,1,6097,26,1424,604,1510,721,86,117,chair
55550,63,chair,64,1,6097,22,1354,594,1426,688,72,94,chair
55551,68,chair,69,1,6097,29,1283,586,1351,666,68,80,chair
55552,69,plate,70,0,6097,17,1354,700,1447,720,93,20,plate
55553,71,plate,72,0,6097,16,1198,726,1303,748,105,22,plate
55554,73,chair,74,1,6097,29,1230,581,1288,651,58,70,chair
55555,74,chair,75,1,6097,25,1185,576,1236,648,51,72,chair
55556,75,chair,76,0,6097,22,1138,571,1188,634,50,63,chair
55557,82,chair,83,0,6097,68,721,671,947,946,226,275,chair
55558,83,chair,84,1,6097,67,703,657,882,918,179,261,chair
55559,84,chair,85,1,6097,68,693,638,838,865,145,227,chair
55560,85,chair,86,1,6097,80,678,619,808,823,130,204,chair
55561,86,chair,87,1,6097,79,670,606,786,789,116,183,chair
55562,87,chair,88,1,6097,76,664,599,766,760,102,161,chair
55563,88,chair,89,1,6097,66,652,583,752,738,100,155,chair
55564,89,chair,90,1,6097,38,1089,773,1374,946,285,173,chair
55565,100,clock,101,0,6097,15,2128,512,2200,644,72,132,clock
55566,105,fork,106,0,6097,17,1181,727,1197,751,16,24,fork
55567,30,window,31,0,6098,16,1550,329,1829,740,279,411,window
55568,35,table,36,0,6098,211,549,761,2199,1442,1650,681,dining table
55569,36,table,37,0,6098,25,1091,725,1530,861,439,136,dining table
55570,40,bottle,41,0,6098,19,1013,767,1048,893,35,126,bottle
55571,43,bottle,44,0,6098,20,1318,796,1371,955,53,159,bottle
55572,45,bottle,46,0,6098,21,1663,797,1711,951,48,154,bottle
55573,47,bottle,48,0,6098,19,1840,779,1883,915,43,136,bottle
55574,48,bowl,49,1,6098,15,1882,829,1957,873,75,44,bowl
55575,50,bottle,51,1,6098,20,2052,759,2090,877,38,118,bottle
55576,53,bottle,54,0,6098,20,2002,725,2030,811,28,86,bottle
55577,63,chair,64,1,6098,52,1068,707,1225,860,157,153,chair
55578,64,chair,65,1,6098,50,1229,704,1379,877,150,173,chair
55579,65,chair,66,1,6098,26,1906,745,2070,794,164,49,chair
55580,66,chair,67,1,6098,43,1698,735,1838,868,140,133,chair
55581,67,chair,68,1,6098,53,1962,1068,2199,1466,237,398,chair
55582,68,chair,69,0,6098,79,1332,996,2004,1466,672,470,chair
55583,69,chair,70,1,6098,78,343,801,689,1301,346,500,chair
55584,70,chair,71,1,6098,96,444,830,865,1465,421,635,chair
55585,71,chair,72,1,6098,117,622,898,1212,1461,590,563,chair
55586,32,table,33,0,6099,51,1,648,994,1199,993,551,dining table
55587,42,chair,43,1,6099,17,812,698,958,835,146,137,chair
55588,54,window,55,0,6099,52,3,191,491,844,488,653,window
55589,42,table,36,1,6100,21,0,904,509,1217,509,313,dining table
55590,43,table,37,0,6100,61,345,857,967,1163,622,306,dining table
55591,44,table,38,0,6100,34,895,868,1667,1112,772,244,dining table
55592,45,table,39,0,6100,37,439,932,1925,1536,1486,604,dining table
55593,46,chair,40,1,6100,16,486,1351,835,1536,349,185,chair
55594,47,chair,41,1,6100,19,1842,962,1932,1269,90,307,chair
55595,48,chair,42,1,6100,23,1785,991,1886,1323,101,332,chair
55596,49,chair,43,1,6100,25,1724,1021,1836,1383,112,362,chair
55597,50,chair,44,1,6100,24,1647,1052,1783,1402,136,350,chair
55598,51,chair,45,1,6100,22,1560,1081,1719,1534,159,453,chair
55599,52,chair,46,1,6100,27,1438,1126,1634,1536,196,410,chair
55600,53,chair,47,1,6100,28,1233,1181,1508,1536,275,355,chair
55601,54,chair,48,1,6100,26,918,1252,1355,1536,437,284,chair
55602,51,chair,52,0,6101,25,1043,566,1173,759,130,193,chair
55603,57,table,58,0,6101,147,0,642,2055,1347,2055,705,dining table
55604,58,bottle,59,0,6101,23,1195,888,1239,1035,44,147,bottle
55605,59,chair,60,1,6101,36,1,856,362,1179,361,323,chair
55606,60,bottle,61,0,6101,22,1867,690,1893,770,26,80,bottle
55607,63,chair,64,1,6101,23,216,1155,467,1346,251,191,chair
55608,68,chair,69,1,6101,29,1174,1010,1631,1344,457,334,chair
55609,69,bottle,70,0,6101,26,1066,909,1111,1065,45,156,bottle
55610,70,bottle,71,0,6101,26,1397,818,1437,937,40,119,bottle
55611,74,bottle,75,0,6101,22,308,628,330,703,22,75,bottle
55612,76,chair,77,1,6101,18,1603,922,1786,1340,183,418,chair
55613,77,chair,78,1,6101,17,1735,872,1895,1338,160,466,chair
55614,78,chair,79,1,6101,17,1851,836,1967,1252,116,416,chair
55615,79,chair,80,1,6101,16,1926,806,2040,1180,114,374,chair
55616,81,bottle,82,0,6101,18,365,784,399,901,34,117,bottle
55617,82,bottle,83,0,6101,15,776,859,818,1001,42,142,bottle
55618,1,table,2,0,6102,21,149,370,849,686,700,316,dining table
55619,22,chair,18,1,6102,21,595,493,721,756,126,263,chair
55620,23,chair,19,1,6102,20,713,451,760,670,47,219,chair
55621,24,chair,20,1,6102,18,753,436,785,616,32,180,chair
55622,25,chair,21,1,6102,20,781,411,824,590,43,179,chair
55623,26,chair,22,1,6102,19,820,388,858,544,38,156,chair
55624,37,chair,38,1,6103,23,7,879,155,1036,148,157,chair
55625,38,chair,39,1,6103,61,8,743,246,1012,238,269,chair
55626,39,chair,40,1,6103,41,169,737,295,982,126,245,chair
55627,40,chair,41,1,6103,15,475,742,600,810,125,68,chair
55628,44,chair,45,1,6103,21,982,737,1011,787,29,50,chair
55629,48,chair,49,1,6103,15,1348,752,1474,854,126,102,chair
55630,49,chair,50,1,6103,20,1592,762,1763,879,171,117,chair
55631,50,chair,51,1,6103,62,1564,807,2068,1461,504,654,chair
55632,51,chair,52,1,6103,78,1251,833,1854,1462,603,629,chair
55633,52,chair,53,0,6103,74,493,827,1055,1462,562,635,chair
55634,53,chair,54,1,6103,60,399,789,782,1447,383,658,chair
55635,54,chair,55,1,6103,47,336,783,529,1323,193,540,chair
55636,55,chair,56,1,6103,50,274,767,515,1235,241,468,chair
55637,56,chair,57,0,6103,43,221,757,383,1142,162,385,chair
55638,58,table,59,0,6103,34,467,789,1425,1143,958,354,dining table
55639,59,table,60,0,6103,50,776,854,1670,1451,894,597,dining table
55640,60,flowerpot,61,0,6103,18,893,805,989,852,96,47,potted plant
55641,73,table,74,0,6104,16,992,716,1407,814,415,98,dining table
55642,74,table,75,0,6104,136,211,775,2026,1578,1815,803,dining table
55643,84,chair,85,1,6104,32,75,1020,233,1257,158,237,chair
55644,85,chair,86,1,6104,42,58,1251,414,1581,356,330,chair
55645,86,chair,87,1,6104,43,405,1259,745,1581,340,322,chair
55646,87,chair,88,0,6104,40,754,1273,1052,1580,298,307,chair
55647,88,chair,89,1,6104,24,1109,1290,1374,1580,265,290,chair
55648,89,chair,90,1,6104,37,1416,1302,1729,1580,313,278,chair
55649,90,chair,91,1,6104,36,1734,1314,2126,1581,392,267,chair
55650,91,chair,92,1,6104,39,2013,1094,2199,1461,186,367,chair
55651,92,chair,93,1,6104,35,1936,1020,2092,1248,156,228,chair
55652,93,chair,94,1,6104,30,1840,957,1975,1148,135,191,chair
55653,94,chair,95,1,6104,24,1766,912,1889,1076,123,164,chair
55654,95,chair,96,1,6104,24,1706,870,1809,1012,103,142,chair
55655,96,chair,97,1,6104,22,1671,844,1754,963,83,119,chair
55656,97,chair,98,1,6104,24,1636,821,1715,929,79,108,chair
55657,98,chair,99,1,6104,23,1612,803,1681,901,69,98,chair
55658,36,table,37,0,6105,33,1576,466,2009,640,433,174,dining table
55659,38,table,39,1,6105,23,1613,520,1765,638,152,118,dining table
55660,40,person,41,1,6105,22,1540,457,1650,643,110,186,person
55661,42,chair,43,1,6105,21,1655,612,1781,946,126,334,chair
55662,43,chair,44,1,6105,32,1410,638,1705,1051,295,413,chair
55663,44,person,45,0,6105,90,1288,463,1573,1014,285,551,person
55664,45,person,46,0,6105,33,1471,432,1629,759,158,327,person
55665,46,table,47,0,6105,72,1,528,1415,852,1414,324,dining table
55666,47,person,48,1,6105,24,0,503,119,668,119,165,person
55667,48,person,49,1,6105,87,288,640,930,1483,642,843,person
55668,49,table,50,1,6105,81,2,837,1349,1536,1347,699,dining table
55669,50,table,51,1,6105,44,1044,585,1437,1048,393,463,dining table
55670,51,chair,52,1,6105,35,748,620,940,871,192,251,chair
55671,52,chair,53,1,6105,21,921,678,1191,886,270,208,chair
55672,54,chair,55,1,6105,28,141,1061,849,1533,708,472,chair
55673,56,chair,57,1,6105,26,1860,634,2026,811,166,177,chair
55674,59,person,60,1,6105,35,309,475,494,612,185,137,person
55675,60,person,61,1,6105,21,482,470,561,582,79,112,person
55676,61,person,62,1,6105,22,880,449,965,517,85,68,person
55677,62,person,63,1,6105,29,923,441,1042,534,119,93,person
55678,63,person,64,1,6105,24,1048,441,1136,533,88,92,person
55679,24,table,25,1,6106,34,792,985,1665,1312,873,327,dining table
55680,0,table,1,0,6107,32,275,489,1396,1062,1121,573,dining table
55681,5,chair,6,1,6107,20,721,387,911,534,190,147,chair
55682,6,chair,7,1,6107,21,904,404,1169,586,265,182,chair
55683,7,chair,8,1,6107,40,1141,445,1450,766,309,321,chair
55684,8,chair,9,1,6107,49,1264,496,1599,906,335,410,chair
55685,9,chair,10,1,6107,54,1086,709,1599,1197,513,488,chair
55686,15,chair,16,1,6107,68,114,686,1023,1197,909,511,chair
55687,16,chair,17,1,6107,55,11,586,460,1078,449,492,chair
55688,17,chair,18,1,6107,43,1,501,381,882,380,381,chair
55689,19,chair,20,1,6108,36,1563,755,1854,1195,291,440,chair
55690,21,chair,21,1,6108,34,1055,851,1808,1331,753,480,chair
55691,22,chair,22,1,6108,39,1400,787,1843,1330,443,543,chair
55692,28,bottle,28,0,6108,18,1078,666,1162,941,84,275,bottle
55693,29,chair,29,1,6108,15,1041,692,1158,822,117,130,chair
55694,60,chair,61,1,6109,15,1962,655,2086,1041,124,386,chair
55695,62,chair,63,1,6109,18,1798,826,1965,1328,167,502,chair
55696,63,chair,64,1,6109,15,1646,973,1900,1465,254,492,chair
55697,34,book,35,0,6110,17,889,749,1004,790,115,41,book
55698,35,table,36,1,6110,20,989,907,1524,1188,535,281,dining table
55699,36,table,37,1,6110,19,451,902,996,1187,545,285,dining table
55700,37,table,38,1,6110,25,303,930,719,1186,416,256,dining table
55701,39,table,40,0,6110,42,1,1175,1113,1522,1112,347,dining table
55702,40,table,41,1,6110,57,1077,1170,2031,1522,954,352,dining table
55703,41,table,42,1,6110,32,1272,932,2031,1183,759,251,dining table
55704,46,chair,47,1,6110,28,581,866,745,1151,164,285,chair
55705,47,chair,48,1,6110,44,755,868,938,1154,183,286,chair
55706,48,chair,49,1,6110,37,1046,871,1237,1154,191,283,chair
55707,49,chair,50,1,6110,26,1232,870,1388,1151,156,281,chair
55708,53,chair,54,1,6110,15,1341,1343,1864,1523,523,180,chair
55709,54,chair,55,1,6110,17,430,1353,982,1523,552,170,chair
55710,59,door,60,0,6110,17,1704,515,1806,963,102,448,door
55711,33,chair,33,1,6111,24,1761,701,1852,917,91,216,chair
55712,40,chair,40,1,6111,15,1080,692,1138,798,58,106,chair
55713,41,chair,41,1,6111,20,978,684,1061,803,83,119,chair
55714,43,chair,43,1,6111,17,824,694,899,796,75,102,chair
55715,44,chair,44,0,6111,35,640,710,793,934,153,224,chair
55716,45,chair,45,0,6111,32,740,716,886,938,146,222,chair
55717,46,chair,46,0,6111,34,834,715,991,943,157,228,chair
55718,47,chair,47,1,6111,18,868,696,985,821,117,125,chair
55719,48,chair,48,1,6111,18,974,697,1082,832,108,135,chair
55720,49,chair,49,1,6111,20,1074,704,1174,836,100,132,chair
55721,50,chair,50,1,6111,21,1178,707,1272,834,94,127,chair
55722,51,chair,51,1,6111,20,1290,708,1370,837,80,129,chair
55723,52,chair,52,1,6111,23,1392,710,1476,842,84,132,chair
55724,53,chair,53,1,6111,24,1500,710,1591,853,91,143,chair
55725,54,chair,54,1,6111,25,1618,713,1708,858,90,145,chair
55726,55,chair,55,1,6111,32,1738,718,1835,953,97,235,chair
55727,56,chair,56,0,6111,40,1647,732,1796,999,149,267,chair
55728,57,chair,57,1,6111,39,1543,729,1666,994,123,265,chair
55729,58,chair,58,0,6111,24,1431,726,1539,876,108,150,chair
55730,59,chair,59,1,6111,23,1279,724,1418,872,139,148,chair
55731,60,chair,60,1,6111,42,1159,726,1306,915,147,189,chair
55732,62,chair,62,1,6111,36,1043,721,1194,956,151,235,chair
55733,63,chair,63,1,6111,39,936,720,1089,957,153,237,chair
55734,71,table,71,0,6111,105,1,819,508,1180,507,361,dining table
55735,77,table,77,1,6111,99,2,866,1458,1650,1456,784,dining table
55736,20,chair,21,1,6113,15,596,561,663,660,67,99,chair
55737,21,chair,22,1,6113,16,513,569,586,677,73,108,chair
55738,24,chair,25,1,6113,20,188,637,315,857,127,220,chair
55739,25,chair,26,1,6113,43,23,652,222,1043,199,391,chair
55740,26,table,27,1,6113,56,1,630,906,1086,905,456,dining table
55741,27,table,28,1,6113,35,884,616,1303,813,419,197,dining table
55742,28,table,29,1,6113,18,1267,643,1788,709,521,66,dining table
55743,29,table,30,0,6113,69,899,691,1760,1450,861,759,dining table
55744,30,table,31,1,6113,38,1483,593,1877,794,394,201,dining table
55745,31,table,32,1,6113,35,1014,570,1370,642,356,72,dining table
55746,35,chair,36,0,6113,34,191,696,458,1106,267,410,chair
55747,36,chair,37,1,6113,26,421,668,598,1044,177,376,chair
55748,37,chair,38,1,6113,25,562,651,711,995,149,344,chair
55749,38,chair,39,1,6113,34,692,623,886,925,194,302,chair
55750,39,chair,40,1,6113,22,862,610,973,889,111,279,chair
55751,40,chair,41,1,6113,20,953,599,1044,840,91,241,chair
55752,41,chair,42,1,6113,28,1032,567,1116,733,84,166,chair
55753,44,chair,45,1,6113,16,1414,587,1501,652,87,65,chair
55754,47,chair,48,1,6113,66,881,769,1221,1371,340,602,chair
55755,49,chair,50,1,6113,28,1087,598,1233,761,146,163,chair
55756,50,chair,51,1,6113,20,1337,616,1438,675,101,59,chair
55757,55,chair,56,1,6113,62,1190,850,1594,1459,404,609,chair
55758,56,chair,57,1,6113,34,1360,796,1660,1244,300,448,chair
55759,57,chair,58,1,6113,28,1561,758,1711,1225,150,467,chair
55760,58,chair,59,1,6113,24,1648,698,1780,1094,132,396,chair
55761,59,chair,60,1,6113,15,1722,674,1802,998,80,324,chair
55762,60,chair,61,1,6113,20,1733,655,1831,984,98,329,chair
55763,61,chair,62,1,6113,32,2014,675,2196,946,182,271,chair
55764,62,chair,63,1,6113,20,2011,635,2198,786,187,151,chair
55765,63,chair,64,1,6113,21,2014,617,2196,762,182,145,chair
55766,64,chair,65,1,6113,21,2019,606,2190,742,171,136,chair
55767,49,sofa,50,1,6114,41,1036,345,1213,428,177,83,couch
55768,51,door,52,1,6114,15,1211,193,1350,455,139,262,door
55769,62,table,63,0,6114,36,471,400,1180,842,709,442,dining table
55770,74,bottle,75,0,6114,22,780,624,814,719,34,95,bottle
55771,77,bottle,78,0,6114,21,599,552,633,635,34,83,bottle
55772,81,bottle,82,0,6114,20,917,529,945,600,28,71,bottle
55773,82,bottle,83,0,6114,19,777,477,799,533,22,56,bottle
55774,19,table,20,1,6115,47,306,679,2028,1648,1722,969,dining table
55775,20,vase,21,0,6115,19,967,660,1127,918,160,258,vase
55776,73,chair,73,0,6116,46,816,671,1036,967,220,296,chair
55777,74,chair,74,0,6116,38,1414,551,1548,717,134,166,chair
55778,75,chair,75,1,6116,57,454,712,714,1053,260,341,chair
55779,77,table,77,0,6116,77,158,504,1478,1070,1320,566,dining table
55780,78,chair,78,1,6116,21,1404,538,1505,606,101,68,chair
55781,79,chair,79,1,6116,27,1025,628,1136,878,111,250,chair
55782,80,chair,80,1,6116,33,869,508,972,625,103,117,chair
55783,81,chair,81,1,6116,29,1111,609,1215,832,104,223,chair
55784,82,chair,82,1,6116,30,1204,579,1317,776,113,197,chair
55785,83,chair,83,1,6116,35,1271,560,1405,741,134,181,chair
55786,84,chair,84,1,6116,33,321,657,458,938,137,281,chair
55787,85,chair,85,1,6116,32,257,631,389,845,132,214,chair
55788,99,chair,100,1,6117,54,1909,1049,2199,1463,290,414,chair
55789,100,chair,101,1,6117,72,1890,885,2199,1133,309,248,chair
55790,101,chair,102,1,6117,37,1883,848,2137,1022,254,174,chair
55791,102,chair,103,1,6117,33,1880,824,2090,964,210,140,chair
55792,103,chair,104,1,6117,32,1881,805,2054,927,173,122,chair
55793,107,table,108,1,6117,92,866,813,1453,1047,587,234,dining table
55794,41,chair,42,1,6118,16,1445,561,1573,658,128,97,chair
55795,42,chair,43,1,6118,15,1380,550,1469,634,89,84,chair
55796,55,table,56,0,6118,31,306,505,1598,1199,1292,694,dining table
55797,61,chair,62,1,6118,32,499,955,839,1199,340,244,chair
55798,62,chair,63,1,6118,25,386,707,569,885,183,178,chair
55799,36,window,37,0,6119,15,384,442,441,601,57,159,window
55800,37,door,38,0,6119,23,438,441,531,604,93,163,door
55801,42,table,43,1,6119,30,997,576,1199,703,202,127,dining table
55802,43,table,44,1,6119,16,738,594,1107,659,369,65,dining table
55803,44,table,45,0,6119,35,277,637,881,949,604,312,dining table
55804,43,table,44,0,6120,67,470,921,1865,1462,1395,541,dining table
55805,60,chair,61,1,6121,23,298,499,472,603,174,104,chair
55806,61,chair,62,1,6121,23,151,522,338,649,187,127,chair
55807,62,chair,63,1,6121,20,1,561,147,719,146,158,chair
55808,67,chair,68,1,6121,39,1287,905,1781,1176,494,271,chair
55809,68,chair,69,1,6121,61,1355,751,1709,1046,354,295,chair
55810,76,chair,77,1,6121,15,100,629,305,710,205,81,chair
55811,78,chair,79,1,6121,21,406,865,810,1179,404,314,chair
55812,79,chair,80,1,6121,44,964,642,1083,931,119,289,chair
55813,80,chair,81,1,6121,50,1045,582,1152,813,107,231,chair
55814,81,chair,82,1,6121,43,1093,547,1186,732,93,185,chair
55815,82,chair,83,1,6121,36,1146,506,1225,688,79,182,chair
55816,83,chair,84,1,6121,44,1175,485,1251,645,76,160,chair
55817,84,chair,85,1,6121,76,1418,543,1607,658,189,115,chair
55818,85,chair,86,1,6121,37,1399,592,1617,744,218,152,chair
55819,86,chair,87,1,6121,50,1377,654,1650,861,273,207,chair
55820,67,mirror,68,0,6122,15,1315,606,1404,767,89,161,mirror
55821,74,chair,75,1,6122,30,99,1049,612,1497,513,448,chair
55822,78,chair,79,1,6122,19,1242,870,1372,1013,130,143,chair
55823,79,chair,80,1,6122,20,1271,891,1434,1083,163,192,chair
55824,80,chair,81,1,6122,21,1320,915,1534,1182,214,267,chair
55825,81,chair,82,1,6122,32,1378,964,1697,1336,319,372,chair
55826,82,chair,83,1,6122,27,1483,1041,2021,1497,538,456,chair
55827,86,chair,87,1,6122,17,733,867,880,1019,147,152,chair
55828,87,chair,88,1,6122,27,671,890,850,1085,179,195,chair
55829,88,chair,89,1,6122,31,569,924,802,1184,233,260,chair
55830,89,chair,90,1,6122,34,412,967,736,1342,324,375,chair
55831,90,chair,91,1,6122,30,100,1045,619,1499,519,454,chair
55832,0,table,1,0,6123,51,221,419,1416,762,1195,343,dining table
55833,29,chair,30,1,6123,15,1414,466,1455,528,41,62,chair
55834,30,chair,31,1,6123,16,1416,474,1472,540,56,66,chair
55835,31,chair,32,1,6123,19,1417,484,1507,557,90,73,chair
55836,32,chair,33,1,6123,22,1416,496,1531,581,115,85,chair
55837,33,chair,34,1,6123,31,1412,510,1537,605,125,95,chair
55838,34,chair,35,1,6123,39,1387,531,1532,693,145,162,chair
55839,35,chair,36,1,6123,42,1361,560,1531,779,170,219,chair
55840,36,chair,37,1,6123,37,1338,582,1472,833,134,251,chair
55841,37,chair,38,1,6123,43,1171,610,1362,887,191,277,chair
55842,38,chair,39,0,6123,40,989,634,1193,918,204,284,chair
55843,39,chair,40,0,6123,34,811,652,988,953,177,301,chair
55844,40,chair,41,0,6123,39,601,657,789,948,188,291,chair
55845,41,chair,42,0,6123,38,408,644,615,939,207,295,chair
55846,42,chair,43,1,6123,39,237,614,432,895,195,281,chair
55847,43,chair,44,1,6123,26,120,599,269,851,149,252,chair
55848,44,chair,45,0,6123,33,76,577,242,803,166,226,chair
55849,45,chair,46,1,6123,29,74,552,231,650,157,98,chair
55850,46,chair,47,1,6123,24,95,529,226,625,131,96,chair
55851,47,chair,48,1,6123,16,131,513,223,597,92,84,chair
55852,48,chair,49,1,6123,17,164,496,226,575,62,79,chair
55853,49,chair,50,1,6123,15,212,482,252,553,40,71,chair
55854,38,table,39,0,6124,63,660,611,1538,1193,878,582,dining table
55855,23,table,24,0,6125,84,366,791,2199,1467,1833,676,dining table
55856,11,table,12,0,6126,24,558,788,1688,1517,1130,729,dining table
55857,19,chair,20,1,6126,18,600,764,831,998,231,234,chair
55858,22,chair,23,1,6126,59,307,827,780,1494,473,667,chair
55859,33,chair,34,1,6126,65,1588,775,1928,1273,340,498,chair
55860,40,chair,41,0,6126,60,1471,818,1892,1394,421,576,chair
55861,30,desk,31,1,6127,18,1422,660,1957,762,535,102,desk
55862,39,table,40,0,6127,109,161,707,2108,1463,1947,756,dining table
55863,61,window,62,0,6128,20,582,319,892,916,310,597,window
55864,62,chair,63,0,6128,20,766,851,890,1029,124,178,chair
55865,63,chair,64,1,6128,26,619,862,831,1051,212,189,chair
55866,64,chair,65,1,6128,21,413,890,557,1084,144,194,chair
55867,67,chair,68,1,6128,15,1368,881,1568,970,200,89,chair
55868,69,chair,70,1,6128,15,870,907,1055,1029,185,122,chair
55869,72,table,73,0,6128,59,3,960,1733,1523,1730,563,dining table
55870,95,chair,96,1,6128,30,1763,922,1887,1180,124,258,chair
55871,96,chair,97,1,6128,54,1364,1018,1659,1534,295,516,chair
55872,97,chair,98,1,6128,62,1442,975,1814,1481,372,506,chair
55873,98,chair,99,1,6128,43,1082,1089,1433,1535,351,446,chair
55874,99,chair,100,1,6128,32,645,1143,1155,1535,510,392,chair
55875,100,chair,101,1,6128,24,2,1253,497,1535,495,282,chair
55876,7,table,8,0,6129,15,135,632,1080,860,945,228,dining table
55877,36,table,37,1,6130,39,136,1128,1518,2190,1382,1062,dining table
55878,37,chair,38,1,6130,87,731,1258,1309,2063,578,805,chair
55879,38,chair,39,1,6130,56,1022,1182,1408,1807,386,625,chair
55880,39,chair,40,1,6130,54,1242,1113,1529,1611,287,498,chair
55881,40,chair,41,1,6130,46,1376,1090,1573,1508,197,418,chair
55882,43,chair,44,1,6130,82,259,1211,830,1975,571,764,chair
55883,35,table,36,1,6131,24,472,922,950,1012,478,90,dining table
55884,36,table,37,1,6131,15,1358,956,1682,1020,324,64,dining table
55885,51,table,51,1,6131,47,909,987,2099,1149,1190,162,dining table
55886,58,chair,58,1,6131,19,1250,1005,1449,1108,199,103,chair
55887,60,plate,60,1,6131,15,1129,1068,1288,1099,159,31,plate
55888,63,chair,63,1,6131,20,968,989,1157,1076,189,87,chair
55889,66,chair,66,1,6131,16,573,926,669,1033,96,107,chair
55890,78,table,78,1,6131,38,119,929,640,1032,521,103,dining table
55891,85,chair,85,1,6131,24,205,936,307,1195,102,259,chair
55892,86,table,86,1,6131,37,1,958,220,1269,219,311,dining table
55893,88,table,88,1,6131,98,318,1018,2099,1522,1781,504,dining table
55894,91,chair,91,1,6131,27,90,1016,310,1569,220,553,chair
55895,92,chair,92,1,6131,26,270,1036,532,1600,262,564,chair
55896,93,chair,93,1,6131,26,493,1065,839,1600,346,535,chair
55897,94,chair,94,1,6131,23,799,1100,1249,1600,450,500,chair
55898,95,chair,95,1,6131,16,1214,1146,1918,1600,704,454,chair
55899,98,person,98,1,6131,54,1304,698,1448,954,144,256,person
55900,34,window,35,0,6132,75,430,209,1627,932,1197,723,window
55901,38,chair,39,1,6132,23,504,826,635,903,131,77,chair
55902,42,chair,43,1,6132,28,752,825,862,893,110,68,chair
55903,53,chair,54,1,6132,23,975,826,1087,896,112,70,chair
55904,59,chair,60,1,6132,30,1226,836,1351,913,125,77,chair
55905,64,chair,65,1,6132,23,1545,858,1705,963,160,105,chair
55906,66,chair,67,1,6132,46,1720,946,1982,1414,262,468,chair
55907,68,table,69,0,6132,168,356,889,1763,1167,1407,278,dining table
55908,69,chair,70,0,6132,62,1364,1018,1821,1595,457,577,chair
55909,70,chair,71,0,6132,43,905,1024,1217,1590,312,566,chair
55910,73,chair,72,0,6132,58,280,969,693,1511,413,542,chair
55911,74,chair,73,1,6132,47,135,884,351,1302,216,418,chair
55912,35,table,36,0,6133,51,96,753,976,973,880,220,dining table
55913,40,table,41,0,6133,82,1,943,742,1463,741,520,dining table
55914,48,table,49,0,6133,64,1071,840,1553,1259,482,419,dining table
55915,0,table,1,0,6134,16,0,433,777,668,777,235,dining table
55916,26,chair,22,1,6134,16,358,394,411,432,53,38,chair
55917,27,chair,23,1,6134,16,281,403,353,461,72,58,chair
55918,28,chair,24,1,6134,16,172,411,289,480,117,69,chair
55919,29,chair,25,1,6134,20,57,419,197,505,140,86,chair
55920,32,chair,28,1,6134,21,768,407,840,465,72,58,chair
55921,33,chair,29,1,6134,21,800,420,870,560,70,140,chair
55922,34,chair,30,1,6134,22,763,440,835,589,72,149,chair
55923,35,chair,31,1,6134,29,717,454,800,631,83,177,chair
55924,36,chair,32,1,6134,32,622,478,761,698,139,220,chair
55925,37,chair,33,1,6134,35,339,523,672,767,333,244,chair
55926,38,chair,34,1,6134,17,0,628,340,767,340,139,chair
55927,43,table,44,0,6135,35,333,744,1175,1124,842,380,dining table
55928,44,chair,45,1,6135,18,461,681,563,781,102,100,chair
55929,45,chair,46,1,6135,18,970,680,1075,783,105,103,chair
55930,46,chair,47,1,6135,23,1050,695,1194,839,144,144,chair
55931,47,chair,48,1,6135,23,1139,712,1296,863,157,151,chair
55932,48,chair,49,1,6135,26,1155,746,1392,934,237,188,chair
55933,49,chair,50,1,6135,30,1065,795,1428,1124,363,329,chair
55934,50,chair,51,1,6135,19,326,694,463,835,137,141,chair
55935,51,chair,52,1,6135,19,213,716,377,859,164,143,chair
55936,52,chair,53,1,6135,23,125,745,361,924,236,179,chair
55937,53,chair,54,1,6135,25,73,783,518,1125,445,342,chair
55938,55,pot,56,0,6135,16,617,614,664,696,47,82,potted plant
55939,48,table,49,0,6136,48,48,608,1423,1198,1375,590,dining table
55940,29,table,30,0,6137,47,307,555,1745,1535,1438,980,dining table
55941,35,chair,36,1,6137,16,146,899,460,1267,314,368,chair
55942,36,chair,37,1,6137,17,336,784,574,1044,238,260,chair
55943,56,table,57,0,6139,25,491,551,1301,847,810,296,dining table
55944,0,table,1,0,6140,18,365,422,1240,904,875,482,dining table
55945,1,laptop,2,0,6140,15,453,416,625,489,172,73,laptop
55946,10,chair,11,1,6141,15,1305,581,1507,782,202,201,chair
55947,11,chair,12,1,6141,16,1502,593,1705,798,203,205,chair
55948,15,chair,16,1,6141,28,714,893,1080,1518,366,625,chair
55949,31,chair,32,1,6141,26,465,1233,1157,1650,692,417,chair
55950,32,chair,33,1,6141,44,1112,1122,1781,1650,669,528,chair
55951,33,chair,34,1,6141,31,1684,967,1962,1648,278,681,chair
55952,34,chair,35,1,6141,28,1773,866,2118,1519,345,653,chair
55953,35,table,36,0,6141,42,597,773,2011,1650,1414,877,dining table
55954,38,flowerpot,39,0,6141,21,1316,918,1465,996,149,78,potted plant
55955,42,table,43,0,6142,29,148,640,1255,1127,1107,487,dining table
55956,21,chair,22,1,6143,25,151,871,454,1156,303,285,chair
55957,24,chair,25,1,6143,25,2,1045,399,1588,397,543,chair
55958,30,chair,31,1,6143,41,28,999,602,1649,574,650,chair
55959,38,chair,39,1,6143,32,311,1164,816,1649,505,485,chair
55960,44,chair,45,1,6143,24,659,1292,1360,1648,701,356,chair
55961,30,table,31,0,6144,83,393,685,1937,1569,1544,884,dining table
55962,48,chair,49,1,6144,19,957,624,1085,698,128,74,chair
55963,49,chair,50,0,6144,36,1062,642,1207,793,145,151,chair
55964,51,chair,52,1,6144,22,1386,695,1497,845,111,150,chair
55965,52,chair,53,1,6144,39,1458,729,1674,934,216,205,chair
55966,53,bench,54,1,6144,21,1,1256,456,1645,455,389,bench
55967,55,bench,56,1,6144,18,1,951,119,1200,118,249,bench
55968,2,door,3,0,20521,22,515,25,620,275,105,250,door
55969,6,person,7,1,20521,44,13,125,160,327,147,202,person
55970,7,person,8,1,20521,35,100,131,188,309,88,178,person
55971,8,person,9,1,20521,35,184,123,267,206,83,83,person
55972,9,person,10,1,20521,32,389,139,492,219,103,80,person
55973,10,person,11,1,20521,50,410,144,570,270,160,126,person
55974,11,person,12,1,20521,52,390,149,568,339,178,190,person
55975,12,chair,13,0,20521,80,470,230,619,435,149,205,chair
55976,16,chair,15,1,20521,40,368,265,497,412,129,147,chair
55977,17,chair,16,1,20521,26,314,301,485,424,171,123,chair
55978,18,chair,17,1,20521,23,297,395,454,449,157,54,chair
55979,19,table,18,0,20521,72,0,201,475,449,475,248,dining table
55980,10,chair,11,1,20522,29,0,804,193,1204,193,400,chair
55981,11,chair,12,0,20522,42,63,789,301,1143,238,354,chair
55982,16,table,17,0,20522,38,303,798,1753,1270,1450,472,dining table
55983,20,chair,21,1,20522,32,243,883,462,1454,219,571,chair
55984,21,chair,22,1,20522,35,429,1042,890,1650,461,608,chair
55985,22,chair,23,0,20522,42,851,1128,1449,1650,598,522,chair
55986,23,chair,24,1,20522,67,1328,957,1729,1547,401,590,chair
55987,25,chair,25,1,20522,62,1454,900,1799,1412,345,512,chair
55988,26,chair,26,1,20522,52,1616,854,1849,1265,233,411,chair
55989,27,chair,27,1,20522,53,1690,810,1890,1167,200,357,chair
55990,32,chair,32,1,20522,15,2061,784,2197,1096,136,312,chair
55991,33,chair,33,1,20522,24,787,728,963,859,176,131,chair
55992,10,table,11,1,20523,16,506,843,991,1244,485,401,dining table
55993,20,table,21,0,20524,17,611,1080,1380,1536,769,456,dining table
55994,22,chair,23,1,20524,25,502,1041,837,1316,335,275,chair
55995,23,chair,24,1,20524,32,336,1099,749,1536,413,437,chair
55996,24,chair,25,1,20524,39,1332,1055,1614,1381,282,326,chair
55997,25,chair,26,1,20524,29,1244,1163,1634,1536,390,373,chair
55998,27,chair,28,1,20524,17,555,1378,1119,1533,564,155,chair
55999,17,table,18,0,20525,104,377,580,1565,1089,1188,509,dining table
56000,18,chair,19,1,20525,15,1104,535,1180,589,76,54,chair
56001,20,chair,21,1,20525,15,863,545,972,624,109,79,chair
56002,21,chair,22,1,20525,17,472,562,634,676,162,114,chair
56003,23,chair,24,0,20525,77,116,626,628,1089,512,463,chair
56004,47,chair,43,1,20525,15,1433,530,1542,587,109,57,chair
56005,56,chair,52,0,20525,28,935,619,1389,1088,454,469,chair
56006,57,chair,53,1,20525,37,1207,585,1545,1085,338,500,chair
56007,58,chair,54,1,20525,34,1351,575,1637,972,286,397,chair
56008,59,chair,55,1,20525,29,1485,555,1707,887,222,332,chair
56009,60,chair,56,1,20525,29,1552,539,1746,829,194,290,chair
56010,21,table,22,0,20526,42,379,545,1193,953,814,408,dining table
56011,31,chair,31,1,20526,24,278,549,515,757,237,208,chair
56012,32,chair,32,0,20526,125,211,614,574,1108,363,494,chair
56013,33,chair,33,0,20526,109,672,613,1015,1139,343,526,chair
56014,34,chair,34,1,20526,73,931,573,1176,954,245,381,chair
56015,35,chair,35,1,20526,57,1067,555,1249,865,182,310,chair
56016,36,chair,36,1,20526,42,1159,541,1302,790,143,249,chair
56017,37,chair,37,1,20526,33,1237,529,1315,741,78,212,chair
56018,39,window,39,0,20526,20,477,316,676,618,199,302,window
56019,7,window,8,1,20527,38,1089,230,1997,544,908,314,window
56020,8,person,9,1,20527,43,1670,383,1997,973,327,590,person
56021,9,person,10,1,20527,63,1381,433,1865,1207,484,774,person
56022,10,person,11,1,20527,41,691,400,996,724,305,324,person
56023,11,person,12,1,20527,37,296,430,578,796,282,366,person
56024,12,person,13,1,20527,55,22,436,428,1067,406,631,person
56025,14,chair,15,1,20527,21,1028,484,1146,641,118,157,chair
56026,15,chair,16,1,20527,15,1075,531,1189,628,114,97,chair
56027,16,chair,17,1,20527,16,963,551,1077,664,114,113,chair
56028,18,chair,19,1,20527,30,468,523,621,713,153,190,chair
56029,23,chair,24,1,20527,23,731,1021,1680,1305,949,284,chair
56030,25,table,26,0,20527,60,30,570,1493,1277,1463,707,dining table
56031,33,glasses,34,0,20527,17,1014,703,1107,736,93,33,eye glasses
56032,37,glasses,38,0,20527,20,663,745,763,779,100,34,eye glasses
56033,44,clock,45,0,20527,16,306,108,392,212,86,104,clock
56034,8,window,9,0,20528,21,1033,366,1182,781,149,415,window
56035,14,table,15,0,20528,31,257,672,1176,1046,919,374,dining table
56036,15,chair,16,1,20528,16,1225,619,1333,728,108,109,chair
56037,16,chair,17,0,20528,46,630,746,1004,1228,374,482,chair
56038,17,chair,18,0,20528,42,1063,705,1347,1126,284,421,chair
56039,18,chair,19,0,20528,58,1150,680,1391,1038,241,358,chair
56040,19,chair,20,1,20528,42,307,740,629,1203,322,463,chair
56041,20,chair,21,1,20528,27,117,733,367,1143,250,410,chair
56042,22,chair,23,1,20528,42,1031,658,1263,940,232,282,chair
56043,24,chair,25,1,20528,30,667,654,863,906,196,252,chair
56044,5,table,6,0,20529,69,36,281,941,787,905,506,dining table
56045,18,chair,19,1,20529,26,754,174,876,270,122,96,chair
56046,19,person,20,1,20529,22,725,179,870,303,145,124,person
56047,20,person,21,1,20529,31,865,173,971,322,106,149,person
56048,21,chair,22,1,20529,25,1036,200,1129,315,93,115,chair
56049,22,person,23,1,20529,40,896,190,1025,425,129,235,person
56050,23,person,24,1,20529,49,834,224,1089,583,255,359,person
56051,24,person,25,1,20529,37,773,235,1155,786,382,551,person
56052,25,chair,26,1,20529,61,877,501,1154,787,277,286,chair
56053,27,chair,28,1,20529,39,378,157,531,280,153,123,chair
56054,28,chair,29,1,20529,21,230,179,310,296,80,117,chair
56055,29,chair,30,1,20529,20,92,206,195,270,103,64,chair
56056,30,person,31,1,20529,27,396,161,522,291,126,130,person
56057,31,person,32,1,20529,29,281,171,407,329,126,158,person
56058,32,person,33,1,20529,35,161,192,320,395,159,203,person
56059,33,person,34,1,20529,33,56,218,218,443,162,225,person
56060,34,person,35,1,20529,59,1,235,228,787,227,552,person
56061,4,window,5,0,20530,83,1517,0,2200,513,683,513,window
56062,10,table,11,1,20530,16,0,457,281,604,281,147,dining table
56063,12,chair,13,1,20530,24,45,585,337,847,292,262,chair
56064,14,person,15,1,20530,57,240,242,466,811,226,569,person
56065,15,person,16,1,20530,42,404,372,593,598,189,226,person
56066,16,person,17,1,20530,52,433,178,615,551,182,373,person
56067,18,laptop,19,0,20530,15,518,462,682,579,164,117,laptop
56068,19,person,20,1,20530,69,679,333,911,734,232,401,person
56069,21,table,22,0,20530,19,2,667,398,880,396,213,dining table
56070,22,table,23,0,20530,54,104,535,959,847,855,312,dining table
56071,23,table,24,0,20530,32,679,474,1176,708,497,234,dining table
56072,24,table,25,0,20530,20,1099,478,1806,665,707,187,dining table
56073,25,table,26,1,20530,17,1666,509,2085,634,419,125,dining table
56074,28,table,29,1,20530,18,0,825,1121,1110,1121,285,dining table
56075,29,laptop,30,0,20530,16,247,770,679,1100,432,330,laptop
56076,36,laptop,37,0,20530,17,1643,657,1815,769,172,112,laptop
56077,42,plate,43,0,20530,15,40,681,115,703,75,22,plate
56078,50,person,51,1,20530,59,951,336,1280,676,329,340,person
56079,56,person,57,1,20530,36,1372,320,1505,491,133,171,person
56080,57,person,58,1,20530,58,1473,322,1693,717,220,395,person
56081,58,person,59,1,20530,35,1713,329,1922,513,209,184,person
56082,59,person,60,1,20530,54,1957,343,2128,533,171,190,person
56083,60,person,61,1,20530,43,2011,366,2198,796,187,430,person
56084,61,chair,62,1,20530,25,1947,711,2166,987,219,276,chair
56085,62,person,63,1,20530,20,1917,872,2199,1087,282,215,person
56086,67,plate,68,0,20530,17,1706,761,1799,793,93,32,plate
56087,80,plant pot,81,0,20530,24,952,890,1140,980,188,90,potted plant
56088,82,plant pot,83,0,20530,24,1258,740,1408,875,150,135,potted plant
56089,9,table,10,0,20531,63,340,831,1704,1536,1364,705,dining table
56090,11,chair,12,0,20531,40,865,832,1373,1536,508,704,chair
56091,12,chair,13,1,20531,38,33,893,700,1533,667,640,chair
56092,15,table,16,0,20532,15,84,692,1189,1033,1105,341,dining table
56093,17,chair,18,1,20532,23,601,601,727,746,126,145,chair
56094,19,chair,20,1,20532,29,83,681,321,1012,238,331,chair
56095,20,chair,21,1,20532,33,89,842,366,1196,277,354,chair
56096,21,chair,22,1,20532,53,1136,663,1420,1149,284,486,chair
56097,22,chair,23,1,20532,52,990,710,1295,1200,305,490,chair
56098,23,chair,24,1,20532,37,720,766,1124,1200,404,434,chair
56099,8,table,9,0,20533,15,620,819,2198,1372,1578,553,dining table
56100,10,person,11,1,20533,55,1189,441,1458,877,269,436,person
56101,13,person,14,1,20533,27,412,669,645,1066,233,397,person
56102,14,person,15,1,20533,43,323,686,637,1205,314,519,person
56103,15,person,16,1,20533,60,166,736,627,1372,461,636,person
56104,16,person,17,1,20533,34,42,844,572,1372,530,528,person
56105,18,person,19,1,20533,42,1452,569,1698,929,246,360,person
56106,19,person,20,1,20533,33,1602,604,1819,1046,217,442,person
56107,21,person,22,1,20533,35,1770,637,2110,1154,340,517,person
56108,13,window,13,0,20534,17,232,115,394,857,162,742,window
56109,14,chair,14,0,20534,34,1583,689,1828,997,245,308,chair
56110,15,chair,15,1,20534,24,1169,678,1361,915,192,237,chair
56111,17,chair,17,1,20534,28,675,678,912,931,237,253,chair
56112,18,chair,18,1,20534,21,658,784,830,977,172,193,chair
56113,19,chair,19,1,20534,26,581,824,806,1094,225,270,chair
56114,20,chair,20,0,20534,18,435,937,744,1299,309,362,chair
56115,21,chair,21,1,20534,24,62,1086,603,1467,541,381,chair
56116,22,chair,22,1,20534,25,1358,789,1583,988,225,199,chair
56117,23,chair,23,1,20534,21,1396,843,1649,1098,253,255,chair
56118,24,chair,24,1,20534,23,1452,918,1810,1334,358,416,chair
56119,25,chair,25,1,20534,25,1568,1111,2145,1462,577,351,chair
56120,26,chair,26,1,20534,27,269,728,581,974,312,246,chair
56121,27,chair,27,1,20534,29,116,765,496,1078,380,313,chair
56122,28,chair,28,1,20534,31,5,813,423,1209,418,396,chair
56123,29,chair,29,1,20534,16,6,1057,160,1400,154,343,chair
56124,7,window,8,0,20535,35,0,0,324,342,324,342,window
56125,8,window,9,0,20535,15,707,0,901,287,194,287,window
56126,13,chair,14,1,20535,22,1471,375,1544,586,73,211,chair
56127,15,person,16,1,20535,42,1528,207,1762,566,234,359,person
56128,16,person,17,1,20535,39,1758,231,2025,475,267,244,person
56129,17,person,18,1,20535,91,1725,274,2200,1187,475,913,person
56130,20,person,21,1,20535,55,1243,199,1499,641,256,442,person
56131,21,person,22,1,20535,61,1128,181,1343,609,215,428,person
56132,23,person,24,1,20535,39,940,214,1117,498,177,284,person
56133,24,person,25,1,20535,47,578,183,830,560,252,377,person
56134,25,person,26,1,20535,37,351,204,578,434,227,230,person
56135,26,person,27,1,20535,36,130,193,325,452,195,259,person
56136,27,person,28,0,20535,35,4,308,256,551,252,243,person
56137,28,person,29,1,20535,46,0,312,340,934,340,622,person
56138,29,person,30,1,20535,84,373,307,861,1265,488,958,person
56139,30,person,31,1,20535,73,802,371,1320,1318,518,947,person
56140,31,chair,32,0,20535,52,739,795,1322,1320,583,525,chair
56141,32,chair,33,0,20535,41,1551,715,2095,1320,544,605,chair
56142,33,chair,34,1,20535,38,305,694,789,1320,484,626,chair
56143,34,chair,35,1,20535,32,1,652,316,1166,315,514,chair
56144,36,table,37,0,20535,33,1233,627,1827,1320,594,693,dining table
56145,37,table,38,0,20535,32,1351,490,2031,813,680,323,dining table
56146,39,table,40,0,20535,21,1018,384,1363,627,345,243,dining table
56147,50,table,51,1,20535,18,139,487,435,675,296,188,dining table
56148,51,table,52,0,20535,15,233,417,575,508,342,91,dining table
56149,52,table,53,0,20535,18,737,375,917,476,180,101,dining table
56150,53,chair,54,1,20535,16,887,284,956,377,69,93,chair
56151,54,chair,55,1,20535,21,802,291,880,386,78,95,chair
56152,62,glasses,63,0,20535,15,1828,555,1898,581,70,26,eye glasses
56153,7,table,8,0,20536,51,1,842,1792,1649,1791,807,dining table
56154,11,chair,12,1,20536,24,441,845,793,1064,352,219,chair
56155,12,chair,13,1,20536,18,240,864,494,1124,254,260,chair
56156,14,chair,15,1,20536,15,224,1465,696,1650,472,185,chair
56157,15,chair,16,1,20536,38,609,1097,1274,1650,665,553,chair
56158,16,chair,17,0,20536,62,1422,987,1976,1650,554,663,chair
56159,17,chair,18,1,20536,28,1626,915,1937,1218,311,303,chair
56160,18,chair,19,1,20536,45,1756,812,2053,1061,297,249,chair
56161,19,chair,20,1,20536,53,1895,877,2198,1437,303,560,chair
56162,7,table,8,0,20537,47,3,620,1555,1218,1552,598,dining table
56163,13,chair,14,1,20537,17,1409,695,1568,1057,159,362,chair
56164,14,chair,15,0,20537,27,1223,730,1465,1143,242,413,chair
56165,15,chair,16,1,20537,20,852,825,1165,1219,313,394,chair
56166,17,chair,18,1,20537,20,19,873,397,1219,378,346,chair
56167,7,person,8,1,20538,24,1362,445,1556,640,194,195,person
56168,8,person,9,0,20538,35,1023,404,1223,629,200,225,person
56169,9,person,10,0,20538,25,798,429,988,638,190,209,person
56170,10,person,11,0,20538,29,352,430,506,656,154,226,person
56171,11,person,12,1,20538,41,225,420,351,697,126,277,person
56172,12,person,13,0,20538,52,27,427,323,1000,296,573,person
56173,13,person,14,1,20538,82,251,503,724,1367,473,864,person
56174,14,person,15,1,20538,94,675,576,1229,1535,554,959,person
56175,16,person,17,1,20538,28,1691,447,1915,693,224,246,person
56176,17,person,18,1,20538,31,1852,505,2048,738,196,233,person
56177,21,bottle,22,0,20538,16,1703,608,1737,718,34,110,bottle
56178,24,bottle,25,0,20538,16,1944,703,1984,847,40,144,bottle
56179,38,chair,39,1,20538,25,47,786,224,1278,177,492,chair
56180,39,chair,40,1,20538,42,182,847,604,1468,422,621,chair
56181,40,chair,41,0,20538,54,525,1001,1104,1535,579,534,chair
56182,41,chair,42,0,20538,60,1501,958,2048,1535,547,577,chair
56183,42,table,43,0,20538,146,506,622,2048,1487,1542,865,dining table
56184,44,chair,45,1,20538,18,1,1219,216,1535,215,316,chair
56185,21,table,22,0,20539,51,557,672,1600,1200,1043,528,dining table
56186,22,table,23,0,20539,18,925,723,1332,854,407,131,dining table
56187,23,table,24,0,20539,27,966,578,1205,673,239,95,dining table
56188,24,chair,25,1,20539,20,1091,554,1189,669,98,115,chair
56189,25,chair,26,1,20539,17,985,571,1075,672,90,101,chair
56190,29,chair,30,0,20539,16,1154,970,1500,1200,346,230,chair
56191,30,chair,31,1,20539,22,742,939,1092,1200,350,261,chair
56192,31,chair,32,1,20539,23,594,798,752,1200,158,402,chair
56193,32,chair,33,0,20539,28,484,748,635,1140,151,392,chair
56194,33,chair,34,1,20539,20,514,697,629,896,115,199,chair
56195,35,table,36,0,20539,18,227,621,604,831,377,210,dining table
56196,36,chair,37,1,20539,44,331,566,477,788,146,222,chair
56197,38,chair,39,0,20539,47,87,585,238,844,151,259,chair
56198,23,table,24,0,20540,69,300,739,2200,1473,1900,734,dining table
56199,94,chair,95,1,20540,20,1936,895,2085,965,149,70,chair
56200,95,chair,96,1,20540,26,1747,868,1869,926,122,58,chair
56201,96,chair,97,1,20540,26,1582,839,1682,886,100,47,chair
56202,104,chair,105,1,20540,15,364,742,431,768,67,26,chair
56203,105,chair,106,1,20540,21,255,772,343,1001,88,229,chair
56204,106,chair,107,1,20540,25,313,799,397,1057,84,258,chair
56205,107,chair,108,1,20540,32,361,832,528,1123,167,291,chair
56206,108,chair,109,1,20540,29,404,874,550,1218,146,344,chair
56207,109,chair,110,1,20540,32,505,920,755,1322,250,402,chair
56208,110,chair,111,1,20540,37,592,991,886,1376,294,385,chair
56209,111,chair,112,1,20540,45,653,1084,1010,1471,357,387,chair
56210,112,chair,113,1,20540,20,1202,1230,1681,1472,479,242,chair
56211,113,chair,114,1,20540,40,1613,1100,1974,1472,361,372,chair
56212,114,chair,115,1,20540,34,1915,1065,2200,1472,285,407,chair
56213,116,spoon,117,0,20540,15,949,1110,1049,1143,100,33,spoon
56214,118,fork,119,0,20540,17,1165,1134,1252,1192,87,58,fork
56215,127,fork,128,0,20540,19,1534,1064,1623,1110,89,46,fork
56216,128,spoon,129,0,20540,16,1665,1053,1745,1087,80,34,spoon
56217,144,fork,145,0,20540,16,731,983,819,1003,88,20,fork
56218,148,spoon,149,0,20540,16,2069,973,2143,999,74,26,spoon
56219,3,window,4,0,20541,26,598,1,1024,314,426,313,window
56220,4,chair,5,1,20541,23,775,332,904,471,129,139,chair
56221,6,chair,7,1,20541,28,0,434,248,766,248,332,chair
56222,10,person,11,1,20541,63,364,257,1024,768,660,511,person
56223,11,person,12,1,20541,70,524,214,851,451,327,237,person
56224,12,table,13,0,20541,88,132,245,809,767,677,522,dining table
56225,21,person,22,1,20541,42,487,163,652,358,165,195,person
56226,22,person,23,1,20541,44,369,159,533,307,164,148,person
56227,23,person,24,1,20541,40,315,130,426,265,111,135,person
56228,24,person,25,1,20541,44,181,126,318,259,137,133,person
56229,25,person,26,1,20541,37,2,152,115,313,113,161,person
56230,26,person,27,1,20541,73,1,218,294,712,293,494,person
56231,18,chair,19,1,20542,41,632,1096,1070,1535,438,439,chair
56232,19,chair,20,1,20542,47,1011,1012,1329,1533,318,521,chair
56233,20,chair,21,1,20542,50,1265,956,1516,1457,251,501,chair
56234,21,chair,22,1,20542,40,1451,904,1611,1334,160,430,chair
56235,22,chair,23,1,20542,40,1565,866,1700,1254,135,388,chair
56236,23,chair,24,1,20542,42,1658,841,1811,1191,153,350,chair
56237,24,chair,25,1,20542,27,1766,817,1828,1096,62,279,chair
56238,34,table,35,0,20542,79,1,829,1746,1535,1745,706,dining table
56239,10,chair,11,1,20543,17,571,639,709,788,138,149,chair
56240,11,chair,12,1,20543,19,397,625,603,836,206,211,chair
56241,13,chair,14,1,20543,70,0,557,431,1462,431,905,chair
56242,17,chair,18,1,20543,26,1449,500,2200,1463,751,963,chair
56243,18,chair,19,1,20543,40,1607,528,2169,1263,562,735,chair
56244,19,table,20,0,20543,45,109,734,2144,1462,2035,728,dining table
56245,3,window,4,0,20544,41,380,217,897,600,517,383,window
56246,7,chair,7,0,20544,93,59,760,757,1434,698,674,chair
56247,8,chair,8,1,20544,45,31,581,307,1297,276,716,chair
56248,9,chair,9,1,20544,17,489,572,629,750,140,178,chair
56249,12,chair,12,1,20544,16,1152,568,1297,727,145,159,chair
56250,13,chair,13,1,20544,20,1625,600,1803,768,178,168,chair
56251,14,chair,14,1,20544,72,1724,643,2198,1368,474,725,chair
56252,15,person,15,0,20544,101,1569,499,2110,1390,541,891,person
56253,17,person,16,1,20544,36,1319,486,1470,769,151,283,person
56254,18,person,17,1,20544,37,977,488,1192,727,215,239,person
56255,19,person,18,0,20544,39,704,491,892,712,188,221,person
56256,20,person,19,1,20544,31,437,567,720,895,283,328,person
56257,21,person,20,1,20544,48,363,407,600,867,237,460,person
56258,22,person,21,0,20544,115,161,453,936,1431,775,978,person
56259,23,person,22,0,20544,71,1227,450,1645,1184,418,734,person
56260,24,table,23,0,20544,79,592,671,1996,1434,1404,763,dining table
56261,34,book,33,0,20544,15,763,815,1049,886,286,71,book
56262,40,window,39,0,20544,17,1662,1,1891,689,229,688,window
56263,0,bottle,1,0,20545,18,1172,793,1264,1141,92,348,bottle
56264,1,table,2,0,20545,21,217,734,2199,1471,1982,737,dining table
56265,4,chair,5,1,20545,16,1980,814,2197,1201,217,387,chair
56266,6,person,7,1,20545,48,1593,536,2113,1218,520,682,person
56267,7,chair,8,1,20545,32,1470,692,1815,1087,345,395,chair
56268,8,person,9,1,20545,58,1256,484,1746,1037,490,553,person
56269,9,chair,10,1,20545,24,1137,630,1327,897,190,267,chair
56270,11,person,12,1,20545,53,790,484,1254,893,464,409,person
56271,13,chair,14,1,20545,33,690,519,1056,787,366,268,chair
56272,19,person,20,1,20545,80,72,192,465,1134,393,942,person
56273,23,door,24,0,20545,16,1843,130,2128,736,285,606,door
56274,26,chair,27,1,20545,19,1729,681,1873,897,144,216,chair
56275,15,table,16,0,20546,90,201,812,1708,1561,1507,749,dining table
56276,18,table,19,0,20546,18,1988,887,2199,1201,211,314,dining table
56277,19,table,20,0,20546,30,1557,812,1989,1143,432,331,dining table
56278,21,chair,22,1,20546,21,1748,828,1915,958,167,130,chair
56279,22,chair,23,1,20546,57,1518,926,1913,1463,395,537,chair
56280,23,chair,24,1,20546,20,1491,866,1662,996,171,130,chair
56281,30,chair,31,1,20546,24,1134,791,1262,996,128,205,chair
56282,31,chair,32,1,20546,19,1022,771,1123,938,101,167,chair
56283,32,chair,33,1,20546,29,935,788,1074,999,139,211,chair
56284,34,chair,35,1,20546,52,150,935,544,1436,394,501,chair
56285,37,chair,38,1,20546,16,575,791,682,887,107,96,chair
56286,17,mirror,18,0,20547,24,1057,301,1228,513,171,212,mirror
56287,21,bottle,22,1,20547,18,1194,485,1228,567,34,82,bottle
56288,25,chair,26,1,20547,15,537,505,641,594,104,89,chair
56289,26,chair,27,1,20547,32,652,526,767,643,115,117,chair
56290,27,chair,28,1,20547,29,774,548,918,689,144,141,chair
56291,28,chair,29,1,20547,53,176,520,282,794,106,274,chair
56292,29,chair,30,1,20547,59,241,551,357,873,116,322,chair
56293,30,chair,31,1,20547,66,330,589,507,1010,177,421,chair
56294,31,chair,32,0,20547,65,476,645,822,1104,346,459,chair
56295,32,chair,33,0,20547,36,1017,716,1474,1103,457,387,chair
56296,33,chair,34,1,20547,20,942,578,1106,749,164,171,chair
56297,34,table,35,0,20547,69,338,543,1246,1079,908,536,dining table
56298,36,bottle,37,0,20547,20,1086,721,1130,828,44,107,bottle
56299,37,bottle,38,0,20547,20,869,645,903,729,34,84,bottle
56300,38,bottle,39,1,20547,19,784,662,819,750,35,88,bottle
56301,42,bottle,43,1,20547,15,632,615,662,689,30,74,bottle
56302,46,bottle,47,0,20547,15,511,578,538,640,27,62,bottle
56303,21,chair,22,0,20548,34,354,750,657,1217,303,467,chair
56304,22,chair,23,0,20548,39,713,746,950,1202,237,456,chair
56305,23,chair,24,0,20548,43,1112,717,1398,1149,286,432,chair
56306,24,chair,25,1,20548,23,1368,696,1531,1093,163,397,chair
56307,25,chair,26,1,20548,19,1494,667,1592,1020,98,353,chair
56308,26,chair,27,1,20548,27,1379,657,1638,974,259,317,chair
56309,28,chair,29,1,20548,25,1576,633,1717,901,141,268,chair
56310,29,chair,30,1,20548,28,1636,617,1764,859,128,242,chair
56311,30,chair,31,1,20548,23,244,724,392,1149,148,425,chair
56312,31,chair,32,1,20548,19,204,675,297,1093,93,418,chair
56313,35,chair,36,1,20548,16,633,613,785,755,152,142,chair
56314,36,chair,37,1,20548,22,753,604,909,749,156,145,chair
56315,37,chair,38,1,20548,22,855,591,1005,770,150,179,chair
56316,38,chair,39,1,20548,29,982,590,1115,759,133,169,chair
56317,39,chair,40,1,20548,29,1122,582,1233,750,111,168,chair
56318,40,chair,41,1,20548,18,1308,587,1412,710,104,123,chair
56319,43,table,44,0,20548,89,321,624,1625,1151,1304,527,dining table
56320,18,table,19,0,20549,40,412,860,1495,1432,1083,572,dining table
56321,19,chair,20,1,20549,17,791,805,890,872,99,67,chair
56322,23,chair,24,1,20549,15,984,817,1056,899,72,82,chair
56323,28,chair,29,0,20549,20,1501,913,1639,1090,138,177,chair
56324,29,chair,30,0,20549,54,1242,984,1601,1446,359,462,chair
56325,30,chair,31,0,20549,59,874,1008,1249,1523,375,515,chair
56326,31,chair,32,0,20549,52,406,974,753,1444,347,470,chair
56327,32,chair,33,0,20549,70,373,954,666,1340,293,386,chair
56328,33,chair,34,1,20549,56,315,913,563,1251,248,338,chair
56329,34,chair,35,1,20549,50,300,899,484,1194,184,295,chair
56330,35,chair,36,1,20549,49,273,879,444,1138,171,259,chair
56331,36,chair,37,1,20549,41,258,865,420,1103,162,238,chair
56332,11,chair,12,1,20550,20,388,287,534,396,146,109,chair
56333,13,chair,13,1,20550,28,905,299,1077,460,172,161,chair
56334,14,chair,14,1,20550,79,202,320,420,761,218,441,chair
56335,15,chair,15,0,20550,104,359,349,783,916,424,567,chair
56336,16,chair,16,0,20550,105,855,373,1314,977,459,604,chair
56337,17,chair,17,1,20550,56,683,288,861,617,178,329,chair
56338,18,table,18,0,20550,54,320,386,1101,813,781,427,dining table
56339,19,bottle,19,1,20550,17,971,396,1002,487,31,91,bottle
56340,8,person,8,1,20551,54,1025,295,1260,796,235,501,person
56341,15,chair,14,1,20551,30,323,967,884,1462,561,495,chair
56342,16,chair,15,1,20551,49,236,897,772,1462,536,565,chair
56343,18,chair,17,1,20551,16,802,1096,1239,1459,437,363,chair
56344,19,person,18,1,20551,32,1265,483,1474,866,209,383,person
56345,20,person,19,1,20551,29,1510,478,1787,940,277,462,person
56346,21,person,20,1,20551,36,525,501,734,851,209,350,person
56347,22,person,21,1,20551,65,237,403,822,1229,585,826,person
56348,23,chair,22,1,20551,17,2027,835,2199,1462,172,627,chair
56349,24,table,23,0,20551,27,570,766,2197,1462,1627,696,dining table
56350,34,plate,33,0,20551,19,1028,843,1171,898,143,55,plate
56351,16,table,17,0,20552,55,0,795,1309,1492,1309,697,dining table
56352,20,chair,21,1,20552,21,276,741,553,958,277,217,chair
56353,23,chair,23,1,20552,34,1,852,81,1492,80,640,chair
56354,24,chair,24,1,20552,86,3,991,448,1646,445,655,chair
56355,25,chair,25,0,20552,101,590,913,1027,1615,437,702,chair
56356,26,chair,26,1,20552,71,846,835,1221,1476,375,641,chair
56357,27,chair,27,1,20552,36,982,820,1159,1297,177,477,chair
56358,28,chair,28,1,20552,65,1156,749,1399,1231,243,482,chair
56359,29,chair,29,1,20552,40,1289,747,1444,1132,155,385,chair
56360,19,table,20,0,20553,33,2,553,1983,1487,1981,934,dining table
56361,21,chair,22,1,20553,31,1142,642,1325,987,183,345,chair
56362,24,chair,25,1,20553,33,189,950,692,1483,503,533,chair
56363,25,chair,26,1,20553,47,80,889,511,1411,431,522,chair
56364,26,chair,27,1,20553,36,20,797,365,1260,345,463,chair
56365,29,chair,30,1,20553,19,614,536,741,657,127,121,chair
56366,30,chair,31,1,20553,31,476,542,603,746,127,204,chair
56367,31,chair,32,1,20553,23,325,550,468,709,143,159,chair
56368,32,chair,33,1,20553,32,2,741,256,1265,254,524,chair
56369,33,chair,34,1,20553,20,0,708,183,1121,183,413,chair
56370,14,table,15,0,20554,27,295,781,2191,1650,1896,869,dining table
56371,15,person,16,1,20554,46,2,1029,1024,1650,1022,621,person
56372,23,chair,24,1,20554,19,2,1308,820,1650,818,342,chair
56373,29,chair,30,1,20554,18,1929,912,2134,1353,205,441,chair
56374,31,chair,32,1,20554,21,1121,1265,1661,1650,540,385,chair
56375,11,table,12,0,20555,17,1139,660,1736,851,597,191,dining table
56376,12,table,13,0,20555,25,662,677,998,907,336,230,dining table
56377,13,table,14,0,20555,28,201,721,745,1020,544,299,dining table
56378,20,table,21,0,20555,15,927,1064,2094,1256,1167,192,dining table
56379,25,chair,26,1,20555,20,1947,1201,2196,1498,249,297,chair
56380,26,chair,27,1,20555,16,1946,1206,2194,1611,248,405,chair
56381,27,chair,28,1,20555,17,1378,1239,1951,1645,573,406,chair
56382,28,chair,29,1,20555,33,779,1181,1396,1650,617,469,chair
56383,29,chair,30,1,20555,24,241,1141,802,1648,561,507,chair
56384,30,chair,31,1,20555,22,2,1121,311,1645,309,524,chair
56385,31,chair,32,1,20555,22,779,663,934,841,155,178,chair
56386,32,chair,33,1,20555,24,711,667,882,866,171,199,chair
56387,33,chair,34,1,20555,18,639,679,796,882,157,203,chair
56388,34,chair,35,1,20555,21,565,688,758,892,193,204,chair
56389,35,chair,36,1,20555,20,456,706,665,939,209,233,chair
56390,36,chair,37,1,20555,19,370,714,588,959,218,245,chair
56391,37,chair,38,1,20555,19,257,728,488,975,231,247,chair
56392,38,chair,39,1,20555,24,140,749,387,1006,247,257,chair
56393,39,chair,40,1,20555,16,5,773,172,1005,167,232,chair
56394,42,bench,43,0,20556,31,93,974,357,1446,264,472,bench
56395,49,chair,50,0,20556,35,1084,1013,1535,1464,451,451,chair
56396,50,chair,51,0,20556,36,742,925,1101,1457,359,532,chair
56397,51,chair,52,1,20556,37,659,849,840,1260,181,411,chair
56398,52,chair,53,1,20556,26,614,808,696,1070,82,262,chair
56399,53,chair,54,1,20556,28,549,761,645,1060,96,299,chair
56400,55,table,56,0,20556,29,639,737,1525,1328,886,591,dining table
56401,18,chair,19,1,20557,25,0,1644,779,2198,779,554,chair
56402,24,chair,25,1,20557,19,1295,1177,1381,1610,86,433,chair
56403,25,chair,26,1,20557,24,1232,1235,1325,1780,93,545,chair
56404,26,chair,27,1,20557,19,1155,1304,1261,1802,106,498,chair
56405,27,chair,28,1,20557,23,803,1410,1201,2195,398,785,chair
56406,21,chair,22,1,20558,15,861,546,973,631,112,85,chair
56407,24,chair,25,1,20558,65,117,628,625,1091,508,463,chair
56408,25,chair,26,1,20558,38,1556,541,1747,828,191,287,chair
56409,26,chair,27,1,20558,36,1479,548,1702,889,223,341,chair
56410,27,chair,28,1,20558,39,1346,570,1638,975,292,405,chair
56411,28,chair,29,1,20558,43,1210,588,1549,1084,339,496,chair
56412,29,chair,30,1,20558,50,920,614,1391,1091,471,477,chair
56413,30,table,31,0,20558,70,374,582,1524,1091,1150,509,dining table
56414,1,table,2,0,20559,45,1,682,1500,1125,1499,443,dining table
56415,6,person,7,1,20559,29,354,439,632,839,278,400,person
56416,7,person,8,1,20559,31,2,478,320,933,318,455,person
56417,8,person,9,1,20559,45,824,462,1098,740,274,278,person
56418,9,person,10,1,20559,40,1064,309,1272,786,208,477,person
56419,10,person,11,1,20559,26,1101,808,1500,1125,399,317,person
56420,19,chair,20,1,20559,19,279,538,446,845,167,307,chair
56421,2,table,3,0,23140,26,205,378,800,608,595,230,dining table
56422,14,person,15,1,23140,30,365,238,508,391,143,153,person
56423,15,person,16,1,23140,35,112,254,254,521,142,267,person
56424,16,person,17,1,23140,56,687,230,928,608,241,378,person
56425,17,person,18,1,23140,52,617,375,1023,753,406,378,person
56426,18,person,19,0,23140,48,2,277,573,766,571,489,person
56427,19,chair,20,1,23140,24,0,517,486,766,486,249,chair
56428,21,chair,22,1,23140,26,596,640,1023,766,427,126,chair
56429,13,table,14,0,23141,47,468,443,1023,606,555,163,dining table
56430,14,chair,15,1,23141,21,918,362,1007,446,89,84,chair
56431,19,chair,20,0,23141,76,394,505,595,766,201,261,chair
56432,20,chair,21,0,23141,46,593,506,773,764,180,258,chair
56433,21,chair,22,0,23141,64,747,479,937,766,190,287,chair
56434,22,chair,23,1,23141,40,923,470,1023,701,100,231,chair
56435,5,table,6,0,23142,60,129,204,403,336,274,132,dining table
56436,7,person,8,0,23142,77,226,131,378,362,152,231,person
56437,8,table,9,0,23142,44,1,239,303,354,302,115,dining table
56438,9,person,10,1,23142,73,462,127,566,289,104,162,person
56439,10,table,11,0,23142,53,522,267,1024,378,502,111,dining table
56440,12,chair,13,1,23142,28,770,302,905,398,135,96,chair
56441,13,chair,14,1,23142,21,584,293,693,386,109,93,chair
56442,15,chair,16,1,23142,20,742,436,970,604,228,168,chair
56443,16,table,17,0,23142,74,0,330,1024,556,1024,226,dining table
56444,18,chair,19,1,23142,23,129,458,354,604,225,146,chair
56445,19,person,20,1,23142,57,50,187,205,347,155,160,person
56446,20,chair,21,1,23142,15,50,278,136,343,86,65,chair
56447,21,chair,22,1,23142,16,1,453,146,605,145,152,chair
56448,22,chair,23,1,23142,24,127,457,352,605,225,148,chair
56449,23,chair,24,0,23142,17,350,532,538,605,188,73,chair
56450,24,person,25,1,23142,71,339,280,734,605,395,325,person
56451,4,table,5,0,23143,53,99,972,1196,1598,1097,626,dining table
56452,8,chair,9,0,23143,23,877,1281,1196,1598,319,317,chair
56453,10,chair,11,1,23143,35,242,1088,662,1597,420,509,chair
56454,11,chair,12,1,23143,53,90,996,329,1545,239,549,chair
56455,12,chair,13,1,23143,44,31,938,177,1366,146,428,chair
56456,16,person,17,1,6172,25,356,288,435,502,79,214,person
56457,20,person,21,1,6172,32,49,394,209,665,160,271,person
56458,15,person,16,0,6173,34,78,236,170,354,92,118,person
56459,19,person,20,0,6173,30,175,231,270,375,95,144,person
56460,21,person,22,0,6173,39,329,223,439,407,110,184,person
56461,0,person,1,1,6174,48,458,382,674,767,216,385,person
56462,1,person,2,1,6174,32,678,374,839,633,161,259,person
56463,3,chair,3,1,6174,33,496,547,714,765,218,218,chair
56464,4,chair,4,1,6174,27,705,483,897,763,192,280,chair
56465,7,chair,6,1,6174,22,895,366,989,511,94,145,chair
56466,45,chair,39,1,6174,16,638,632,907,767,269,135,chair
56467,3,person,4,1,6176,40,1296,404,1400,600,104,196,person
56468,21,chair,22,1,6176,23,854,512,955,634,101,122,chair
56469,26,person,27,1,6176,58,864,344,1063,807,199,463,person
56470,28,person,29,1,6176,68,793,297,1349,922,556,625,person
56471,15,chair,16,1,6177,40,235,231,399,398,164,167,chair
56472,16,person,17,1,6177,80,196,143,388,399,192,256,person
56473,12,person,13,1,6178,54,235,119,359,249,124,130,person
56474,13,chair,14,1,6178,16,327,209,370,250,43,41,chair
56475,8,desk,9,0,6179,20,120,219,531,339,411,120,desk
56476,10,person,11,1,6179,37,383,165,475,300,92,135,person
56477,11,person,12,0,6179,54,493,108,599,378,106,270,person
56478,12,person,13,1,6179,47,19,96,173,393,154,297,person
56479,4,person,5,1,6180,17,88,121,107,146,19,25,person
56480,5,person,6,1,6180,18,220,114,249,137,29,23,person
56481,9,person,10,1,6180,17,325,107,360,145,35,38,person
56482,15,chair,16,1,6180,21,180,188,317,262,137,74,chair
56483,6,person,7,1,6181,50,0,45,147,148,147,103,person
56484,7,person,8,0,6181,70,10,86,130,337,120,251,person
56485,5,person,6,1,6182,60,329,61,583,534,254,473,person
56486,7,person,8,0,6182,55,571,212,654,491,83,279,person
56487,4,person,5,1,6183,23,2,85,151,268,149,183,person
56488,5,person,6,1,6183,48,193,76,369,269,176,193,person
56489,5,person,6,0,6184,15,334,110,357,143,23,33,person
56490,6,person,7,1,6184,33,288,122,346,234,58,112,person
56491,7,person,8,1,6184,75,175,133,312,334,137,201,person
56492,8,chair,9,1,6184,22,213,243,329,334,116,91,chair
56493,9,person,10,1,6184,43,325,69,404,329,79,260,person
56494,10,person,11,1,6184,47,298,31,494,335,196,304,person
56495,8,chair,9,1,6185,20,596,392,765,557,169,165,chair
56496,9,person,10,1,6185,73,425,160,711,556,286,396,person
56497,3,chair,4,1,6186,24,246,78,346,178,100,100,chair
56498,4,chair,5,1,6186,19,452,82,545,194,93,112,chair
56499,5,chair,6,0,6186,35,633,95,723,199,90,104,chair
56500,6,person,7,0,6187,53,114,45,169,201,55,156,person
56501,7,person,8,1,6187,50,48,44,103,202,55,158,person
56502,8,person,9,1,6187,39,164,39,204,200,40,161,person
56503,11,chair,12,0,6261,15,17,147,49,195,32,48,chair
56504,12,chair,13,0,6266,16,965,1255,1231,1719,266,464,chair
56505,13,chair,14,1,6266,18,1043,1211,1273,1588,230,377,chair
56506,14,chair,15,1,6266,19,1121,1180,1330,1496,209,316,chair
56507,15,chair,16,1,6266,19,1215,1160,1411,1438,196,278,chair
56508,14,person,15,0,6284,26,263,516,312,685,49,169,person
56509,15,person,16,0,6284,52,309,528,394,682,85,154,person
56510,16,chair,17,0,6288,15,140,138,145,156,5,18,chair
56511,10,chair,11,0,6292,16,153,137,184,174,31,37,chair
56512,17,person,18,0,6295,42,96,117,130,232,34,115,person
56513,25,person,26,0,6304,39,407,838,481,1015,74,177,person
56514,1,bench,2,0,6305,22,189,171,255,210,66,39,bench
56515,2,door,3,0,6312,15,390,305,404,527,14,222,door
56516,2,person,3,0,6324,20,160,68,187,131,27,63,person
56517,3,person,4,0,6324,28,113,72,147,173,34,101,person
56518,12,person,13,0,6324,30,147,72,164,117,17,45,person
56519,15,person,15,0,6327,20,95,121,116,178,21,57,person
56520,16,door,16,0,6327,18,94,96,120,145,26,49,door
56521,27,bench,28,0,6334,22,179,129,248,205,69,76,bench
56522,21,person,22,0,6351,28,122,113,136,142,14,29,person
56523,36,person,37,0,20572,15,509,398,525,410,16,12,person
56524,37,person,38,0,20572,15,505,394,522,410,17,16,person
56525,25,person,26,0,20574,23,597,228,648,520,51,292,person
56526,27,person,28,0,20574,39,946,218,1009,371,63,153,person
56527,28,person,29,1,20574,21,866,232,899,320,33,88,person
56528,23,person,24,0,20575,15,424,305,433,335,9,30,person
56529,24,person,25,0,20575,17,409,304,419,336,10,32,person
56530,18,chair,19,1,20577,20,0,1015,183,1337,183,322,chair
56531,8,chair,8,0,20585,45,82,154,114,211,32,57,chair
56532,5,window,6,0,23171,31,737,35,1024,451,287,416,window
56533,6,window,7,0,23171,18,559,166,601,375,42,209,window
56534,3,bicycle,4,0,23174,95,66,506,365,687,299,181,bicycle
56535,10,person,11,0,23175,26,329,180,356,280,27,100,person
56536,11,person,12,0,23175,17,408,188,426,240,18,52,person
56537,11,glasses,12,0,23176,18,337,352,386,370,49,18,eye glasses
56538,12,shoe,13,0,23176,16,200,545,274,583,74,38,shoe
56539,13,shoe,14,0,23176,17,217,578,296,618,79,40,shoe
56540,8,chair,9,1,23177,20,707,369,754,461,47,92,chair
56541,9,chair,10,1,23177,25,618,337,682,432,64,95,chair
56542,10,chair,11,0,23177,18,621,374,679,443,58,69,chair
56543,23,person,24,1,23177,15,947,589,1024,767,77,178,person
56544,6,person,7,0,23179,19,307,479,320,528,13,49,person
56545,7,person,8,1,23179,18,319,474,332,524,13,50,person
56546,9,person,10,0,23179,19,334,476,350,538,16,62,person
56547,13,person,14,1,23179,17,341,474,352,535,11,61,person
56548,17,person,18,0,23180,31,437,581,455,640,18,59,person
56549,18,person,19,1,23180,18,357,586,370,635,13,49,person
56550,19,person,20,1,23180,20,335,585,351,645,16,60,person
56551,3,person,4,1,23181,30,590,430,689,893,99,463,person
56552,5,bed,6,0,23181,22,203,606,532,724,329,118,bed
56553,11,door,12,0,23185,19,480,188,578,888,98,700,door
56554,6,chair,7,1,6530,20,182,355,485,522,303,167,chair
56555,12,person,13,0,6531,59,199,36,311,229,112,193,person
56556,2,table,3,1,6532,33,68,134,347,319,279,185,dining table
56557,4,chair,5,1,6532,23,14,150,162,320,148,170,chair
56558,5,chair,6,1,6532,20,297,102,396,288,99,186,chair
56559,6,person,7,1,6532,34,265,37,368,273,103,236,person
56560,7,person,8,1,6532,39,20,91,163,302,143,211,person
56561,14,chair,15,0,6533,18,167,159,224,236,57,77,chair
56562,19,chair,20,1,6533,17,435,184,499,281,64,97,chair
56563,2,person,3,0,6536,59,21,70,200,300,179,230,person
56564,3,person,4,1,6537,69,73,23,241,297,168,274,person
56565,4,chair,5,1,6537,38,93,157,277,297,184,140,chair
56566,8,chair,9,1,6538,18,256,533,362,639,106,106,chair
56567,4,chair,5,1,6540,16,19,187,165,268,146,81,chair
56568,11,person,12,0,6541,55,110,73,216,253,106,180,person
56569,13,person,14,0,6541,43,9,15,85,254,76,239,person
56570,13,backpack,14,1,6542,19,54,140,89,194,35,54,backpack
56571,10,desk,11,1,6543,31,2,780,1598,1198,1596,418,desk
56572,8,desk,9,0,6546,24,101,88,279,174,178,86,desk
56573,11,desk,12,0,6546,23,198,99,360,199,162,100,desk
56574,17,desk,17,0,6547,24,59,129,287,209,228,80,desk
56575,18,chair,18,1,6547,31,113,144,182,209,69,65,chair
56576,4,desk,5,0,6549,24,59,123,275,208,216,85,desk
56577,4,desk,5,0,6550,22,0,322,1278,750,1278,428,desk
56578,5,chair,6,1,6550,23,2,452,649,848,647,396,chair
56579,7,keyboard,8,0,6550,16,520,363,955,482,435,119,keyboard
56580,13,chair,14,1,6551,15,285,459,659,765,374,306,chair
56581,4,desk,5,0,6552,25,14,98,311,168,297,70,desk
56582,10,desk,11,0,6553,17,425,1638,1101,2031,676,393,desk
56583,11,desk,12,0,6558,20,2,894,1734,1642,1732,748,desk
56584,6,person,7,1,6579,18,940,271,994,376,54,105,person
56585,8,cow,9,1,6579,41,0,451,567,763,567,312,cow
56586,3,cow,4,1,6581,29,0,3,439,474,439,471,cow
56587,4,cow,5,1,6581,22,0,77,179,529,179,452,cow
56588,5,cow,6,1,6581,17,0,500,289,1025,289,525,cow
56589,7,cow,8,1,6581,18,547,195,711,298,164,103,cow
56590,8,cow,9,1,6581,20,673,170,958,285,285,115,cow
56591,9,cow,10,1,6581,19,1147,186,1515,343,368,157,cow
56592,10,cow,11,1,6581,35,394,179,1195,554,801,375,cow
56593,11,cow,12,1,6581,23,1522,205,1999,401,477,196,cow
56594,12,cow,13,1,6581,23,1977,166,2197,628,220,462,cow
56595,13,cow,14,1,6581,38,1464,269,2102,715,638,446,cow
56596,14,cow,15,1,6581,40,673,250,1682,644,1009,394,cow
56597,15,cow,16,0,6581,70,272,493,2015,1330,1743,837,cow
56598,0,person,1,0,6582,25,505,114,581,417,76,303,person
56599,4,person,5,1,6604,44,0,106,187,224,187,118,person
56600,4,person,5,1,6607,43,85,80,203,347,118,267,person
56601,10,person,11,1,6608,24,199,153,338,343,139,190,person
56602,11,person,12,1,6608,15,385,230,410,272,25,42,person
56603,10,person,11,1,6644,18,509,157,638,426,129,269,person
56604,8,chair,9,1,6645,15,16,208,106,255,90,47,chair
56605,1,chair,2,1,6646,28,50,146,149,256,99,110,chair
56606,9,chair,10,0,6647,32,248,232,390,383,142,151,chair
56607,14,chair,15,1,6647,17,0,224,62,380,62,156,chair
56608,7,person,8,1,6649,45,0,41,134,344,134,303,person
56609,8,person,9,1,6649,65,313,53,497,343,184,290,person
56610,10,person,11,1,6649,58,112,209,403,338,291,129,person
56611,3,bottle,4,0,6656,17,84,283,128,326,44,43,bottle
56612,7,table,8,1,6656,15,232,136,398,269,166,133,dining table
56613,9,person,10,1,6656,65,117,69,266,371,149,302,person
56614,10,person,11,1,6656,51,205,153,482,373,277,220,person
56615,7,person,8,1,6657,63,87,28,200,221,113,193,person
56616,4,chair,5,1,6659,28,177,151,242,242,65,91,chair
56617,5,person,6,1,6659,33,193,135,243,198,50,63,person
56618,6,person,7,1,6660,79,14,79,362,498,348,419,person
56619,6,sink,7,0,6661,31,54,124,93,201,39,77,sink
56620,12,table,13,0,6662,28,423,211,498,337,75,126,dining table
56621,18,door,19,0,6662,19,272,55,342,236,70,181,door
56622,3,person,4,1,6664,54,203,23,371,297,168,274,person
56623,4,person,5,1,6664,36,19,104,58,237,39,133,person
56624,7,person,8,1,6664,21,140,175,206,216,66,41,person
56625,14,person,15,1,7272,22,375,164,399,293,24,129,person
56626,15,person,16,1,7272,21,286,169,322,311,36,142,person
56627,16,person,17,0,7272,36,191,147,237,345,46,198,person
56628,17,person,18,1,7272,19,157,140,194,248,37,108,person
56629,18,person,19,1,7272,33,85,139,135,346,50,207,person
56630,20,person,21,0,7272,22,2,164,51,348,49,184,person
56631,21,person,22,0,7272,39,36,137,99,361,63,224,person
56632,22,person,23,0,7272,53,110,123,201,391,91,268,person
56633,23,person,24,0,7272,47,228,155,304,369,76,214,person
56634,24,person,25,0,7272,36,292,167,349,356,57,189,person
56635,25,person,26,0,7272,38,338,161,383,345,45,184,person
56636,26,person,27,0,7272,38,375,149,440,360,65,211,person
56637,2,person,3,1,7444,26,878,688,1133,1147,255,459,person
56638,3,person,4,1,7444,29,586,584,1047,1094,461,510,person
56639,5,person,6,1,7444,67,467,1064,1481,2192,1014,1128,person
56640,7,person,8,1,7444,65,0,279,724,2186,724,1907,person
56641,1,person,2,1,7445,58,31,194,325,773,294,579,person
56642,2,mirror,3,0,7445,119,453,30,849,583,396,553,mirror
56643,4,person,5,1,7445,29,792,362,1022,750,230,388,person
56644,5,person,6,1,7445,28,729,513,1014,771,285,258,person
56645,2,person,3,1,7446,21,1220,327,2196,1750,976,1423,person
56646,4,mirror,5,1,7446,20,900,548,1785,1233,885,685,mirror
56647,9,eyeglasses,10,0,7446,15,1473,938,1546,1082,73,144,eye glasses
56648,10,person,11,1,7446,58,243,239,1233,1736,990,1497,person
56649,11,person,12,1,7446,41,186,274,833,1739,647,1465,person
56650,12,person,13,1,7446,21,123,1065,345,1750,222,685,person
56651,13,person,14,1,7446,17,190,714,334,1226,144,512,person
56652,19,eyeglasses,20,0,7446,23,1572,924,1654,1071,82,147,eye glasses
56653,4,person,5,1,7447,21,688,365,797,590,109,225,person
56654,5,chair,6,1,7447,20,620,367,756,613,136,246,chair
56655,7,person,8,1,7447,42,419,551,739,1064,320,513,person
56656,8,person,9,1,7447,26,491,585,797,1064,306,479,person
56657,10,person,11,1,7447,25,2,553,231,983,229,430,person
56658,6,person,7,1,7448,45,29,556,226,1597,197,1041,person
56659,7,person,8,1,7448,36,52,549,352,1657,300,1108,person
56660,8,person,9,1,7448,31,449,612,730,1193,281,581,person
56661,9,person,10,0,7448,49,193,552,556,1835,363,1283,person
56662,10,person,11,1,7448,67,660,511,1138,1827,478,1316,person
56663,11,person,12,1,7448,34,915,645,1216,1149,301,504,person
56664,12,person,13,1,7448,27,504,1156,1005,1842,501,686,person
56665,26,bottle,27,1,7448,16,983,1192,1036,1365,53,173,bottle
56666,6,person,7,1,7449,16,835,546,952,926,117,380,person
56667,7,person,8,1,7449,37,1070,703,1489,1476,419,773,person
56668,8,person,9,1,7449,32,538,533,891,1402,353,869,person
56669,9,person,10,1,7449,58,730,511,1507,2175,777,1664,person
56670,10,person,11,1,7449,34,437,1275,983,2175,546,900,person
56671,11,person,12,1,7449,15,0,1642,655,2175,655,533,person
56672,70,glasses,71,0,7449,27,690,1504,933,1611,243,107,eye glasses
56673,8,person,9,1,7520,26,175,106,298,294,123,188,person
56674,26,person,27,1,7521,61,35,29,228,313,193,284,person
56675,27,chair,28,1,7521,16,0,151,59,313,59,162,chair
56676,26,person,27,1,7522,20,444,244,489,319,45,75,person
56677,27,person,28,1,7522,20,560,231,606,317,46,86,person
56678,9,person,10,1,7524,18,314,205,352,309,38,104,person
56679,10,person,11,1,7524,27,350,200,417,321,67,121,person
56680,11,person,12,1,7524,38,419,181,503,328,84,147,person
56681,13,person,14,1,7524,17,470,242,535,333,65,91,person
56682,12,person,13,1,7525,17,0,130,107,222,107,92,person
56683,16,person,17,1,7525,59,170,89,294,222,124,133,person
56684,5,dog,6,0,7533,43,578,1190,876,1594,298,404,dog
56685,3,person,4,0,7540,54,20,91,86,325,66,234,person
56686,4,person,5,0,7540,52,162,81,234,326,72,245,person
56687,16,person,17,1,7560,34,625,663,888,1641,263,978,person
56688,6,person,7,0,7562,59,114,95,168,301,54,206,person
56689,7,person,8,1,7562,37,82,85,128,257,46,172,person
56690,8,person,9,0,7562,52,17,79,93,323,76,244,person
56691,5,person,6,0,7563,51,250,151,458,721,208,570,person
56692,5,person,6,1,7564,15,151,38,190,95,39,57,person
56693,6,person,7,1,7564,17,255,9,303,83,48,74,person
56694,7,person,8,1,7564,21,288,14,348,117,60,103,person
56695,8,person,9,1,7564,20,372,18,420,113,48,95,person
56696,9,person,10,1,7564,20,446,14,489,112,43,98,person
56697,10,person,11,1,7564,41,382,30,476,274,94,244,person
56698,11,person,12,1,7564,27,435,33,530,274,95,241,person
56699,12,person,13,1,7564,34,277,35,434,274,157,239,person
56700,13,person,14,1,7564,19,119,38,163,133,44,95,person
56701,14,person,15,1,7564,20,96,53,180,275,84,222,person
56702,15,person,16,1,7564,43,160,8,312,274,152,266,person
56703,2,person,3,0,20715,64,26,48,165,432,139,384,person
56704,4,person,5,1,7606,52,161,48,317,630,156,582,person
56705,5,person,6,1,7606,46,293,149,478,636,185,487,person
56706,6,person,7,1,7606,33,19,245,281,633,262,388,person
56707,7,person,8,1,7606,32,473,125,612,633,139,508,person
56708,2,person,3,1,7607,97,85,32,212,199,127,167,person
56709,9,person,10,0,8254,31,501,207,539,309,38,102,person
56710,10,person,11,0,8254,25,374,207,413,284,39,77,person
56711,0,person,1,0,8255,42,41,16,112,230,71,214,person
56712,1,person,2,0,8255,37,159,98,231,233,72,135,person
56713,2,person,3,1,8255,22,253,48,306,181,53,133,person
56714,3,person,4,0,8255,34,340,36,419,271,79,235,person
56715,6,person,7,0,8256,49,2,67,68,329,66,262,person
56716,7,person,8,0,8256,34,181,129,236,247,55,118,person
56717,8,person,9,1,8256,24,302,125,343,185,41,60,person
56718,2,car,3,1,8600,36,995,744,2057,1285,1062,541,car
56719,4,person,5,0,8600,36,246,579,341,866,95,287,person
56720,7,person,8,1,8600,37,1071,552,1153,852,82,300,person
56721,8,person,9,1,8600,50,1134,549,1234,861,100,312,person
56722,9,person,10,1,8600,42,1248,560,1332,823,84,263,person
56723,10,person,11,1,8600,36,1226,584,1313,847,87,263,person
56724,15,person,16,1,8600,34,775,575,850,839,75,264,person
56725,16,person,17,1,8600,23,672,563,747,861,75,298,person
56726,17,person,18,0,8600,32,135,577,213,850,78,273,person
56727,18,person,19,1,8600,31,69,582,147,873,78,291,person
56728,19,person,20,1,8600,40,2,581,121,866,119,285,person
56729,1,truck,2,1,8601,16,465,466,536,556,71,90,truck
56730,16,chair,17,0,8602,23,515,632,725,939,210,307,chair
56731,17,flowerpot,18,0,8602,15,808,741,891,861,83,120,potted plant
56732,1,table,2,0,8603,38,356,709,1219,1078,863,369,dining table
56733,10,chair,11,1,8604,18,246,981,375,1279,129,298,chair
56734,11,chair,12,0,8604,32,340,980,598,1279,258,299,chair
56735,13,chair,14,0,8604,35,595,988,845,1278,250,290,chair
56736,10,chair,11,0,8605,20,408,1209,526,1432,118,223,chair
56737,12,chair,13,0,8605,18,742,1240,879,1471,137,231,chair
56738,14,sofa,15,0,8605,39,6,1335,514,1760,508,425,couch
56739,15,chair,16,0,8605,22,2,1755,464,2198,462,443,chair
56740,2,window,3,0,8607,16,0,671,211,923,211,252,window
56741,4,person,5,0,8607,58,353,687,610,973,257,286,person
56742,5,person,6,0,8607,51,350,464,625,755,275,291,person
56743,0,bench,1,0,8723,21,0,108,255,256,255,148,bench
56744,5,flowerpot,6,0,8723,16,115,181,169,217,54,36,potted plant
56745,6,flowerpot,7,0,8723,15,174,214,242,254,68,40,potted plant
56746,11,flowerpot,12,1,8736,16,478,269,544,315,66,46,potted plant
56747,15,flowerpot,16,0,8736,16,295,415,398,478,103,63,potted plant
56748,26,flowerpot,27,1,8736,19,405,280,458,342,53,62,potted plant
56749,30,flowerpot,31,1,8736,15,353,293,396,336,43,43,potted plant
56750,1,flowerpot,2,0,8737,16,39,0,70,110,31,110,potted plant
56751,2,person,3,0,8740,15,79,93,84,116,5,23,person
56752,19,plant pots,20,0,8740,18,133,88,181,101,48,13,potted plant
56753,2,plant pots,3,0,8744,16,74,167,101,197,27,30,potted plant
56754,1,flowerpot,2,0,8745,16,93,162,198,255,105,93,potted plant
56755,16,plant pots,17,0,8745,19,87,136,117,156,30,20,potted plant
56756,0,bench,1,0,8746,26,0,129,208,255,208,126,bench
56757,4,flowerpot,5,0,8746,31,11,26,50,109,39,83,potted plant
56758,5,flowerpot,6,1,8746,22,38,34,64,111,26,77,potted plant
56759,6,flowerpot,7,0,8746,23,54,41,80,114,26,73,potted plant
56760,7,flowerpot,8,0,8746,20,66,46,90,115,24,69,potted plant
56761,8,flowerpot,9,1,8746,23,77,51,100,114,23,63,potted plant
56762,9,plant pots,10,0,8746,40,92,60,132,115,40,55,potted plant
56763,3,table,4,1,8747,59,247,716,1961,1099,1714,383,dining table
56764,3,person,4,1,25044,21,394,145,436,293,42,148,person
56765,11,person,12,1,8917,21,696,68,726,193,30,125,person
56766,12,person,13,0,8917,22,664,61,705,193,41,132,person
56767,13,person,14,1,8917,22,764,68,806,198,42,130,person
56768,14,person,15,1,8917,23,782,81,832,217,50,136,person
56769,15,person,16,1,8917,39,798,57,913,296,115,239,person
56770,16,person,17,1,8917,33,943,108,1022,374,79,266,person
56771,6,person,7,1,8919,17,460,34,499,99,39,65,person
56772,7,person,8,1,8919,16,448,46,477,91,29,45,person
56773,8,person,9,1,8919,38,400,67,499,374,99,307,person
56774,10,person,11,0,8919,23,338,71,363,139,25,68,person
56775,11,person,12,0,8919,22,372,76,396,141,24,65,person
56776,12,person,13,1,8919,24,395,74,413,136,18,62,person
56777,5,person,6,1,8920,22,172,38,191,103,19,65,person
56778,6,person,7,1,8920,18,150,31,171,98,21,67,person
56779,5,person,6,1,8922,36,364,16,519,408,155,392,person
56780,8,person,9,0,8938,22,137,103,181,156,44,53,person
56781,9,person,10,1,8938,17,320,91,344,126,24,35,person
56782,0,window,1,0,181,42,1,1,808,313,807,312,window
56783,9,laptop,10,0,181,33,42,255,294,390,252,135,laptop
56784,13,person,14,1,181,75,134,13,425,599,291,586,person
56785,25,person,26,1,181,75,423,130,772,599,349,469,person
56786,19,door,20,0,182,21,53,46,190,198,137,152,door
56787,24,person,25,1,182,17,84,162,121,195,37,33,person
56788,25,person,26,0,182,98,278,71,460,258,182,187,person
56789,4,bed,5,1,9453,19,63,346,893,737,830,391,bed
56790,5,bed,6,1,9453,17,140,450,1441,1007,1301,557,bed
56791,7,person,8,1,9453,21,273,201,385,423,112,222,person
56792,8,person,9,0,9453,29,236,234,482,600,246,366,person
56793,9,person,10,0,9453,25,197,407,519,529,322,122,person
56794,10,person,11,0,9453,36,832,307,1131,733,299,426,person
56795,11,person,12,0,9453,56,497,313,1068,899,571,586,person
56796,12,person,13,0,9453,34,352,667,643,942,291,275,person
56797,13,person,14,1,9453,32,1113,476,1435,1007,322,531,person
56798,14,person,15,1,9453,21,1034,743,1221,1007,187,264,person
56799,1,person,2,0,9454,40,48,215,353,333,305,118,person
56800,2,person,3,1,9454,49,128,60,317,252,189,192,person
56801,3,person,4,1,9454,27,215,67,306,244,91,177,person
56802,4,person,5,1,9454,21,289,81,327,197,38,116,person
56803,5,person,6,1,9454,23,291,147,411,223,120,76,person
56804,6,person,7,1,9454,40,379,74,491,334,112,260,person
56805,7,person,8,1,9454,33,103,51,178,230,75,179,person
56806,8,person,9,1,9454,41,0,75,169,335,169,260,person
56807,8,person,9,1,9455,20,142,105,156,124,14,19,person
56808,11,person,12,0,9455,30,230,96,248,159,18,63,person
56809,0,bed,1,0,9456,31,49,81,229,167,180,86,bed
56810,9,table,10,0,9457,23,241,176,359,328,118,152,dining table
56811,12,chair,13,0,9458,22,169,147,189,194,20,47,chair
56812,1,chair,2,0,9459,28,35,82,89,162,54,80,chair
56813,5,person,6,0,9460,68,61,85,246,136,185,51,person
56814,6,person,7,0,9460,43,91,33,163,103,72,70,person
56815,5,person,6,1,9462,22,89,118,177,164,88,46,person
56816,6,person,7,1,9462,37,106,63,176,134,70,71,person
56817,7,person,8,1,9462,54,67,60,147,164,80,104,person
56818,8,person,9,1,9462,30,0,50,95,164,95,114,person
56819,10,person,11,1,9462,30,148,52,249,163,101,111,person
56820,5,person,6,1,9467,55,214,131,562,287,348,156,person
56821,8,person,9,1,9467,50,87,64,245,279,158,215,person
56822,1,bed,2,0,9468,43,26,111,252,243,226,132,bed
56823,6,person,7,1,9469,32,155,56,219,129,64,73,person
56824,7,person,8,0,9469,52,53,63,118,225,65,162,person
56825,0,person,1,1,23550,20,0,133,174,374,174,241,person
56826,1,person,2,1,23550,53,1,83,879,682,878,599,person
56827,1,person,2,1,23551,89,120,43,1023,661,903,618,person
56828,5,person,6,0,9841,30,16,94,35,152,19,58,person
56829,6,person,7,1,9841,15,46,103,58,153,12,50,person
56830,9,dog,10,0,10083,52,59,133,110,260,51,127,dog
56831,8,dog,9,1,10086,16,16,136,41,165,25,29,dog
56832,11,dog,12,0,10088,25,111,166,142,217,31,51,dog
56833,11,dog,12,1,10091,25,34,675,356,954,322,279,dog
56834,12,dog,13,1,10091,17,1145,555,1256,688,111,133,dog
56835,15,dog,16,1,10091,16,356,483,488,569,132,86,dog
56836,25,door,26,0,10887,18,549,586,716,836,167,250,door
56837,30,door,31,0,10887,20,798,601,1005,884,207,283,door
56838,31,window,32,0,10887,19,867,659,973,829,106,170,window
56839,35,door,36,0,10887,20,1118,624,1388,951,270,327,door
56840,36,window,37,0,10887,20,1193,685,1344,879,151,194,window
56841,44,door,45,0,10887,21,1544,654,1897,1037,353,383,door
56842,45,window,46,0,10887,16,1621,725,1839,962,218,237,window
56843,18,table,19,1,10889,19,359,295,500,372,141,77,dining table
56844,6,table,7,0,10893,21,0,265,187,384,187,119,dining table
56845,4,person,5,1,10894,23,264,132,292,214,28,82,person
56846,5,person,6,1,10894,15,321,135,341,183,20,48,person
56847,6,person,7,0,10894,42,403,135,445,236,42,101,person
56848,7,person,8,1,10894,22,435,137,456,207,21,70,person
56849,3,table,4,0,10896,36,72,188,387,332,315,144,dining table
56850,8,table,9,0,10898,26,99,114,496,369,397,255,dining table
56851,9,chair,10,1,10898,26,110,154,230,286,120,132,chair
56852,10,chair,11,0,10898,36,226,167,361,373,135,206,chair
56853,11,chair,12,1,10898,25,391,220,500,339,109,119,chair
56854,13,door,14,0,10898,23,288,30,383,122,95,92,door
56855,14,window,15,0,10898,16,299,41,372,116,73,75,window
56856,7,table,8,0,10899,16,368,160,452,288,84,128,dining table
56857,8,person,9,1,10899,23,435,112,478,202,43,90,person
56858,26,door,27,0,10899,16,280,48,316,142,36,94,door
56859,28,door,29,0,10899,16,217,29,271,148,54,119,door
56860,8,table,9,0,10900,15,6,328,116,496,110,168,dining table
56861,16,door,17,0,10900,16,898,383,1019,612,121,229,door
56862,18,window,19,0,10900,15,931,429,1001,562,70,133,window
56863,20,door,21,0,10900,16,750,365,846,554,96,189,door
56864,22,window,23,0,10900,16,775,401,825,513,50,112,window
56865,25,door,26,0,10900,15,640,351,714,514,74,163,door
56866,27,window,28,0,10900,17,662,385,698,480,36,95,window
56867,30,door,31,0,10900,17,556,345,619,486,63,141,door
56868,32,window,33,0,10900,16,573,373,605,456,32,83,window
56869,34,door,35,0,10900,15,494,334,539,463,45,129,door
56870,36,window,37,0,10900,16,506,359,533,444,27,85,window
56871,13,door,14,0,10901,18,134,153,173,206,39,53,door
56872,17,door,18,0,10901,15,197,161,249,224,52,63,door
56873,18,window,19,0,10901,18,205,172,238,214,33,42,window
56874,16,door,17,0,10902,23,247,173,299,241,52,68,door
56875,17,window,18,0,10902,20,256,182,292,235,36,53,window
56876,6,person,7,0,10903,26,225,201,267,281,42,80,person
56877,4,person,5,0,10904,37,218,179,263,354,45,175,person
56878,5,person,6,1,10904,27,343,195,396,301,53,106,person
56879,6,person,7,1,10904,43,514,141,640,479,126,338,person
56880,35,door,36,0,10904,19,37,310,75,408,38,98,door
56881,36,window,37,0,10904,19,51,323,67,388,16,65,window
56882,2,person,3,1,10908,45,201,196,284,325,83,129,person
56883,3,person,4,1,10908,60,217,132,469,364,252,232,person
56884,4,person,5,1,10908,30,347,72,406,195,59,123,person
56885,18,door,19,0,10908,18,93,141,145,236,52,95,door
56886,19,window,20,0,10908,15,99,149,136,228,37,79,window
56887,14,person,15,0,10909,75,67,36,177,255,110,219,person
56888,15,person,16,1,10909,26,197,57,254,107,57,50,person
56889,16,person,17,0,10909,69,155,72,266,261,111,189,person
56890,6,person,7,0,10910,79,247,46,373,360,126,314,person
56891,7,dog,8,0,10910,45,241,290,303,374,62,84,dog
56892,9,person,10,1,10910,18,324,85,356,226,32,141,person
56893,26,window,27,0,10911,15,222,235,292,291,70,56,window
56894,12,person,12,0,10912,51,148,87,232,213,84,126,person
56895,14,person,14,1,10912,22,376,77,500,374,124,297,person
56896,15,person,15,1,10912,24,0,168,22,365,22,197,person
56897,4,person,5,1,23722,91,683,40,927,632,244,592,person
56898,5,person,6,1,23722,94,402,9,684,631,282,622,person
56899,6,person,7,1,23722,85,182,80,435,632,253,552,person
56900,7,person,8,1,23722,65,1,53,198,632,197,579,person
56901,29,bottle,30,0,23723,15,171,191,212,256,41,65,bottle
56902,31,bottle,32,0,23723,15,280,186,306,248,26,62,bottle
56903,3,mirror,4,0,10916,15,0,0,157,185,157,185,mirror
56904,4,window,5,0,10916,15,461,77,625,381,164,304,window
56905,3,toilet,4,0,10917,32,429,324,641,767,212,443,toilet
56906,2,sink,3,0,10918,18,386,472,1008,830,622,358,sink
56907,12,flowerpot,13,0,11520,23,203,155,232,189,29,34,potted plant
56908,14,sofa,15,0,11520,40,106,169,199,224,93,55,couch
56909,17,chair,18,0,11520,21,47,157,98,220,51,63,chair
56910,16,chair,17,0,11521,28,172,358,221,436,49,78,chair
56911,18,chair,19,0,11521,40,66,390,154,513,88,123,chair
56912,29,table,30,0,11521,18,323,377,389,458,66,81,dining table
56913,5,person,6,1,11529,15,191,97,209,121,18,24,person
56914,4,table,5,0,11532,23,121,142,179,179,58,37,dining table
56915,6,vase,7,0,11532,18,94,130,111,155,17,25,vase
56916,8,vase,9,0,11532,15,209,132,225,157,16,25,vase
56917,14,chair,15,0,11532,21,15,136,47,176,32,40,chair
56918,36,table,37,1,11534,15,540,370,575,414,35,44,dining table
56919,12,person,13,0,11535,31,116,129,132,182,16,53,person
56920,14,person,15,1,11535,15,142,145,154,172,12,27,person
56921,16,person,17,1,11535,16,171,147,191,175,20,28,person
56922,14,table,15,0,11536,16,34,454,217,538,183,84,dining table
56923,15,vase,16,0,11536,27,101,357,150,475,49,118,vase
56924,7,person,8,0,11540,26,308,206,319,246,11,40,person
56925,17,table,18,0,11540,18,22,245,54,271,32,26,dining table
56926,10,sofa,11,1,11542,42,920,673,1080,809,160,136,couch
56927,11,sofa,12,1,11542,40,1005,662,1190,855,185,193,couch
56928,13,chair,14,1,11542,19,1495,682,1623,817,128,135,chair
56929,17,table,18,1,11542,60,1097,907,1351,1316,254,409,dining table
56930,52,window,53,0,11543,40,823,267,1843,536,1020,269,window
56931,61,flowerpot,62,0,11543,22,901,1071,1017,1209,116,138,potted plant
56932,65,table,66,0,11543,34,1319,1216,1586,1461,267,245,dining table
56933,66,table,67,1,11543,19,1477,1142,1675,1170,198,28,dining table
56934,67,chair,68,0,11543,33,1520,1196,1719,1461,199,265,chair
56935,68,chair,69,1,11543,40,1180,1174,1374,1314,194,140,chair
56936,69,chair,70,1,11543,32,1384,1162,1555,1415,171,253,chair
56937,70,chair,71,1,11543,19,1513,1147,1646,1265,133,118,chair
56938,71,chair,72,1,11543,49,1646,1119,1760,1308,114,189,chair
56939,125,flowerpot,126,1,11543,15,711,1320,884,1435,173,115,potted plant
56940,127,flowerpot,128,1,11543,18,1168,1175,1258,1249,90,74,potted plant
56941,130,chair,131,0,11543,18,1,1012,64,1088,63,76,chair
56942,14,vase,15,0,11545,19,1223,855,1307,952,84,97,vase
56943,15,vase,16,0,11545,17,887,854,977,952,90,98,vase
56944,22,table,23,0,11545,77,888,1016,1282,1300,394,284,dining table
56945,39,door,40,1,11545,17,502,662,607,864,105,202,door
56946,42,door,43,0,11545,21,1595,724,1664,867,69,143,door
56947,50,desk,51,0,11545,17,1542,866,1865,984,323,118,desk
56948,51,chair,52,0,11545,26,1744,889,1830,1000,86,111,chair
56949,52,chair,53,0,11545,24,1649,892,1750,1000,101,108,chair
56950,53,person,54,1,11545,28,1630,815,1715,875,85,60,person
56951,64,desk,65,0,11545,25,292,856,629,975,337,119,desk
56952,65,chair,66,0,11545,25,325,876,420,992,95,116,chair
56953,66,chair,67,0,11545,25,426,872,515,989,89,117,chair
56954,67,person,68,1,11545,30,430,813,507,866,77,53,person
56955,71,vase,72,0,11545,44,1012,933,1150,1062,138,129,vase
56956,55,sofa,56,1,11546,40,999,1568,1330,1730,331,162,couch
56957,73,flowerpot,74,0,11546,28,951,1756,1047,1843,96,87,potted plant
56958,75,sofa,76,1,11546,134,593,1595,1122,1809,529,214,couch
56959,59,chair,60,1,11547,15,1903,832,1999,926,96,94,chair
56960,60,chair,61,1,11547,17,1682,800,1792,847,110,47,chair
56961,65,chair,66,1,11547,35,1754,840,1986,1000,232,160,chair
56962,70,table,71,1,11547,46,1317,951,1994,1264,677,313,dining table
56963,71,chair,72,0,11547,51,1352,990,1530,1333,178,343,chair
56964,72,chair,73,0,11547,35,1527,1020,1723,1333,196,313,chair
56965,73,chair,74,1,11547,22,1743,1059,1969,1333,226,274,chair
56966,81,sofa,82,1,11547,52,1031,852,1345,1050,314,198,couch
56967,83,chair,84,0,11547,36,929,856,1143,1121,214,265,chair
56968,35,person,36,1,11549,24,1872,689,1948,796,76,107,person
56969,42,sofa,43,0,11549,65,382,800,1380,960,998,160,couch
56970,44,chair,45,1,11549,34,913,874,1071,1039,158,165,chair
56971,45,chair,46,1,11549,37,969,894,1176,1106,207,212,chair
56972,46,chair,47,1,11549,20,734,913,955,1044,221,131,chair
56973,59,chair,60,0,11549,38,449,916,685,1168,236,252,chair
56974,63,chair,64,1,11549,22,212,972,484,1164,272,192,chair
56975,64,chair,65,0,11549,43,1,936,212,1205,211,269,chair
56976,65,chair,66,1,11549,26,172,1017,369,1337,197,320,chair
56977,66,chair,67,1,11549,46,667,992,944,1394,277,402,chair
56978,67,chair,68,1,11549,42,1075,960,1221,1245,146,285,chair
56979,68,chair,69,1,11549,42,801,1063,1205,1449,404,386,chair
56980,69,chair,70,1,11549,24,193,1174,698,1448,505,274,chair
56981,77,chair,78,1,11549,43,1472,940,1699,1240,227,300,chair
56982,78,chair,79,0,11549,41,1588,998,1934,1368,346,370,chair
56983,79,chair,80,0,11549,37,1194,1033,1591,1415,397,382,chair
56984,61,window,61,0,11550,15,1356,928,1690,1184,334,256,window
56985,66,flowerpot,66,0,11550,16,171,1314,320,1460,149,146,potted plant
56986,69,chair,69,1,11550,15,530,1130,641,1216,111,86,chair
56987,78,sofa,78,1,11550,85,496,1195,1735,1504,1239,309,couch
56988,79,vase,79,0,11550,19,820,1350,959,1529,139,179,vase
56989,81,table,81,1,11550,36,604,1428,1623,1608,1019,180,dining table
56990,41,chair,42,1,11551,19,721,817,773,886,52,69,chair
56991,44,chair,45,1,11551,19,774,821,862,895,88,74,chair
56992,53,window,54,0,11551,20,1358,489,1532,677,174,188,window
56993,87,window,88,0,11551,17,1570,438,1822,664,252,226,window
56994,101,table,100,1,11551,37,876,870,960,947,84,77,dining table
56995,102,chair,101,0,11551,88,720,869,883,1017,163,148,chair
56996,104,sofa,103,1,11551,86,529,864,791,963,262,99,couch
56997,105,vase,104,0,11551,24,619,791,682,887,63,96,vase
56998,112,chair,111,0,11551,28,360,827,438,908,78,81,chair
56999,113,chair,112,1,11551,15,276,831,350,884,74,53,chair
57000,115,chair,114,1,11551,17,246,852,305,891,59,39,chair
57001,131,table,130,0,11551,276,776,922,1500,1355,724,433,dining table
57002,134,person,133,1,11551,17,236,794,257,817,21,23,person
57003,42,sofa,43,1,11552,56,389,769,933,1019,544,250,couch
57004,64,sofa,65,1,11552,51,871,854,1829,1434,958,580,couch
57005,55,bench,56,1,11553,18,374,992,489,1058,115,66,bench
57006,38,door,39,1,11554,15,1910,873,2052,1124,142,251,door
57007,40,door,41,0,11554,15,1774,877,1913,1185,139,308,door
57008,49,bowl,50,0,11554,21,1555,1051,1608,1106,53,55,bowl
57009,68,chair,69,1,11555,21,1949,836,2113,986,164,150,chair
57010,69,chair,70,0,11555,30,1915,849,2116,1108,201,259,chair
57011,73,sofa,74,1,11555,36,943,933,1695,1429,752,496,couch
57012,86,vase,87,0,11555,18,1692,863,1764,985,72,122,vase
57013,92,vase,93,0,11555,15,192,526,272,665,80,139,vase
57014,94,vase,95,0,11555,15,188,769,268,868,80,99,vase
57015,95,vase,96,0,11555,15,97,956,158,1083,61,127,vase
57016,46,chair,47,0,11556,25,1772,745,1820,821,48,76,chair
57017,48,table,49,1,11556,25,1906,805,2055,960,149,155,dining table
57018,50,flowerpot,51,0,11556,34,1963,893,2098,1050,135,157,potted plant
57019,54,chair,55,0,11556,38,1839,779,1973,947,134,168,chair
57020,60,door,61,0,11556,33,570,596,674,979,104,383,door
57021,64,table,65,0,11556,86,740,867,1415,1435,675,568,dining table
57022,65,vase,66,0,11556,22,1011,547,1126,913,115,366,vase
57023,67,sofa,68,1,11556,28,1250,785,1377,883,127,98,couch
57024,82,person,83,1,11556,29,86,597,255,789,169,192,person
57025,53,sofa,54,1,11557,70,24,1064,523,1347,499,283,couch
57026,60,chair,61,1,11557,15,54,1247,104,1353,50,106,chair
57027,77,flowerpot,78,0,11557,23,1210,1261,1288,1341,78,80,potted plant
57028,66,table,67,1,11558,22,266,453,515,506,249,53,dining table
57029,84,vase,85,1,11559,18,1030,1076,1081,1173,51,97,vase
57030,87,table,88,0,11559,44,729,1161,1092,1347,363,186,dining table
57031,93,sofa,94,1,11559,88,278,1268,822,1526,544,258,couch
57032,66,sofa,67,1,11560,23,1732,1193,2199,1496,467,303,couch
57033,76,vase,77,0,11560,21,1205,1378,1275,1468,70,90,vase
57034,85,clock,86,0,11560,38,668,898,748,1039,80,141,clock
57035,45,window,46,0,11561,34,145,569,611,756,466,187,window
57036,21,person,22,0,11562,43,1,331,74,588,73,257,person
57037,24,person,25,1,11562,42,256,342,381,565,125,223,person
57038,30,person,31,0,11562,66,418,487,660,743,242,256,person
57039,32,cup,33,0,11562,15,532,718,570,754,38,36,cup
57040,34,sofa,35,1,11562,23,740,597,848,663,108,66,couch
57041,35,person,36,1,11562,61,744,459,960,715,216,256,person
57042,36,sofa,37,1,11562,62,933,559,1331,690,398,131,couch
57043,38,person,39,1,11562,90,918,452,1136,725,218,273,person
57044,40,person,41,1,11562,83,923,523,1419,766,496,243,person
57045,43,person,44,1,11562,82,771,572,1224,860,453,288,person
57046,45,laptop,46,0,11562,26,831,651,948,820,117,169,laptop
57047,49,person,50,1,11562,75,199,482,522,749,323,267,person
57048,50,backpack,51,0,11562,31,390,797,552,981,162,184,backpack
57049,53,person,54,1,11562,90,85,466,414,971,329,505,person
57050,54,chair,55,1,11562,52,70,652,379,1022,309,370,chair
57051,55,person,56,0,11562,23,1511,541,1599,797,88,256,person
57052,56,person,57,1,11562,50,1256,599,1599,1014,343,415,person
57053,31,sofa,32,1,11564,16,1735,703,1869,914,134,211,couch
57054,49,table,50,0,11564,16,8,823,197,976,189,153,dining table
57055,51,chair,52,1,11564,15,228,798,298,962,70,164,chair
57056,52,chair,53,0,11564,28,109,803,239,976,130,173,chair
57057,58,sofa,59,0,11564,26,1618,911,2015,1503,397,592,couch
57058,14,chair,15,1,11566,19,1104,594,1182,671,78,77,chair
57059,16,sofa,17,1,11566,88,827,598,1146,764,319,166,couch
57060,18,table,19,0,11566,78,618,680,940,909,322,229,dining table
57061,19,vase,20,0,11566,15,752,687,818,716,66,29,vase
57062,24,sofa,25,1,11566,38,534,546,694,651,160,105,couch
57063,28,chair,29,0,11566,22,376,517,424,610,48,93,chair
57064,31,mirror,32,0,11566,57,835,307,967,532,132,225,mirror
57065,34,sofa,35,1,11566,90,1,832,818,1201,817,369,couch
57066,38,table,39,1,11566,40,1,997,658,1200,657,203,dining table
57067,33,window,34,0,11568,50,832,315,1210,908,378,593,window
57068,42,window,43,0,11568,27,1,109,246,1019,245,910,window
57069,43,window,44,0,11568,29,1415,591,1549,818,134,227,window
57070,45,door,46,1,11568,17,1331,592,1412,848,81,256,door
57071,57,chair,58,0,11568,50,490,883,741,1268,251,385,chair
57072,68,chair,68,0,11568,42,1,956,375,1396,374,440,chair
57073,78,chair,78,1,11568,24,1203,828,1283,891,80,63,chair
57074,79,chair,79,1,11568,20,1330,811,1418,873,88,62,chair
57075,80,chair,80,1,11568,48,1511,748,1664,879,153,131,chair
57076,84,sofa,84,1,11568,37,1282,859,1506,906,224,47,couch
57077,85,sofa,85,1,11568,77,1569,886,2067,1195,498,309,couch
57078,86,chair,86,1,11568,66,2025,765,2199,967,174,202,chair
57079,89,sofa,89,1,11568,158,915,860,1940,1390,1025,530,couch
57080,94,vase,94,0,11568,16,1659,846,1707,889,48,43,vase
57081,119,vase,119,0,11568,23,1042,1087,1123,1170,81,83,vase
57082,121,bowl,121,0,11568,31,876,1140,985,1207,109,67,bowl
57083,36,person,37,1,11569,38,545,418,670,576,125,158,person
57084,48,mirror,49,0,11569,34,1567,218,1766,585,199,367,mirror
57085,50,sofa,51,1,11569,55,1506,605,1799,780,293,175,couch
57086,55,bowl,56,0,11569,17,1598,669,1657,709,59,40,bowl
57087,60,book,61,0,11569,16,234,523,438,586,204,63,book
57088,36,sofa,37,0,11570,54,1308,710,1843,864,535,154,couch
57089,38,sofa,39,1,11570,64,1687,704,2199,995,512,291,couch
57090,41,sofa,42,1,11570,47,2,710,1012,1006,1010,296,couch
57091,53,vase,54,0,11570,24,686,639,844,852,158,213,vase
57092,30,person,31,1,11571,15,650,1074,692,1121,42,47,person
57093,31,person,32,1,11571,16,737,1074,780,1121,43,47,person
57094,60,chair,61,1,11571,17,988,1168,1057,1253,69,85,chair
57095,62,chair,63,1,11571,15,1029,1186,1125,1275,96,89,chair
57096,63,chair,64,1,11571,17,1085,1191,1181,1306,96,115,chair
57097,65,chair,66,0,11571,19,1177,1222,1357,1359,180,137,chair
57098,48,sofa,49,1,11572,29,1488,793,1746,954,258,161,couch
57099,53,table,54,1,11572,39,1713,976,2099,1396,386,420,dining table
57100,37,door,38,0,11574,23,829,446,921,613,92,167,door
57101,44,chair,45,0,11574,22,1057,665,1148,777,91,112,chair
57102,45,chair,46,0,11574,24,1155,664,1250,777,95,113,chair
57103,46,chair,47,1,11574,17,1111,691,1199,726,88,35,chair
57104,47,chair,48,1,11574,26,635,667,723,774,88,107,chair
57105,48,chair,49,0,11574,22,518,665,605,775,87,110,chair
57106,49,chair,50,1,11574,17,580,662,656,739,76,77,chair
57107,51,table,52,0,11574,28,797,776,949,891,152,115,dining table
57108,52,vase,53,0,11574,22,842,704,900,777,58,73,vase
57109,62,chair,63,0,11574,22,428,673,526,802,98,129,chair
57110,45,person,46,1,11575,18,350,1052,459,1104,109,52,person
57111,43,person,44,1,11576,31,1467,952,1644,1096,177,144,person
57112,47,person,48,1,11576,23,382,987,484,1122,102,135,person
57113,49,person,50,0,11576,39,1161,975,1315,1435,154,460,person
57114,49,chair,50,1,11577,20,2116,912,2199,1445,83,533,chair
57115,50,chair,51,1,11577,22,2003,941,2171,1293,168,352,chair
57116,57,sofa,58,1,11577,44,52,732,391,865,339,133,couch
57117,58,chair,59,1,11577,16,245,758,326,787,81,29,chair
57118,59,table,60,0,11577,15,177,759,245,844,68,85,dining table
57119,60,chair,61,0,11577,20,122,747,203,872,81,125,chair
57120,61,chair,62,1,11577,26,241,772,338,943,97,171,chair
57121,74,table,75,1,11577,87,865,878,1330,1149,465,271,dining table
57122,42,table,43,0,21465,95,970,766,1209,1014,239,248,dining table
57123,47,window,48,0,21465,46,759,538,964,761,205,223,window
57124,50,window,51,0,21465,30,1365,557,1571,765,206,208,window
57125,58,sofa,59,0,21465,42,1457,742,1665,815,208,73,couch
57126,23,chair,24,0,21466,18,1295,844,1350,916,55,72,chair
57127,24,chair,25,0,21466,19,1224,843,1279,932,55,89,chair
57128,25,chair,26,0,21466,19,1163,842,1212,932,49,90,chair
57129,36,sofa,36,0,21466,70,591,859,1026,1004,435,145,couch
57130,49,sofa,49,1,21466,32,0,962,265,1186,265,224,couch
57131,55,plate,55,0,21466,18,778,1352,867,1385,89,33,plate
57132,57,plate,57,0,21466,15,1366,1181,1427,1199,61,18,plate
57133,62,ball,62,0,21466,15,1170,1137,1235,1203,65,66,sports ball
57134,64,vase,64,0,21466,16,1695,983,1763,1083,68,100,vase
57135,65,vase,65,0,21466,15,1752,976,1823,1080,71,104,vase
57136,71,sofa,71,0,21466,29,1664,1000,2199,1649,535,649,couch
57137,34,sofa,35,0,21467,29,194,896,501,1165,307,269,couch
57138,59,clock,60,0,21467,15,1820,470,1897,567,77,97,clock
57139,60,clock,61,1,21467,21,1707,499,1767,584,60,85,clock
57140,70,clock,71,1,21467,25,1623,522,1667,584,44,62,clock
57141,5,window,6,0,21468,16,587,37,920,767,333,730,window
57142,11,chair,12,0,21468,43,0,858,262,1096,262,238,chair
57143,12,chair,13,0,21468,57,164,944,586,1197,422,253,chair
57144,15,sofa,16,0,21468,29,529,748,908,1021,379,273,couch
57145,45,sofa,45,1,21469,44,112,601,336,716,224,115,couch
57146,52,vase,52,0,21469,23,605,557,691,641,86,84,vase
57147,58,vase,58,0,21469,28,741,1126,804,1186,63,60,vase
57148,61,sofa,61,0,21469,55,691,735,1328,1252,637,517,couch
57149,74,door,74,0,21469,19,863,479,921,549,58,70,door
57150,78,person,78,1,21469,30,1239,488,1283,550,44,62,person
57151,79,person,79,1,21469,29,1033,493,1069,548,36,55,person
57152,81,person,81,1,21469,24,896,513,927,549,31,36,person
57153,93,plant pot,93,1,21469,34,1736,675,1841,780,105,105,potted plant
57154,97,sofa,97,1,21469,41,1196,674,1410,906,214,232,couch
57155,105,bowl,105,0,21469,18,1080,698,1169,738,89,40,bowl
57156,13,chair,13,0,21470,23,1684,698,1810,925,126,227,chair
57157,35,table,33,0,21470,27,1234,745,1359,857,125,112,dining table
57158,39,chair,37,1,21470,15,2166,841,2198,1074,32,233,chair
57159,41,chair,39,1,21470,16,2081,1238,2198,1591,117,353,chair
57160,47,bowl,45,0,21470,17,1098,884,1218,959,120,75,bowl
57161,24,person,24,1,21471,31,753,712,802,786,49,74,person
57162,27,person,27,0,21471,194,232,904,746,1359,514,455,person
57163,28,chair,28,0,21471,127,233,1043,571,1417,338,374,chair
57164,30,person,30,1,21471,89,657,852,921,1260,264,408,person
57165,31,chair,31,1,21471,83,697,954,915,1157,218,203,chair
57166,32,chair,32,0,21471,43,861,1021,1168,1359,307,338,chair
57167,33,chair,33,0,21471,36,1275,981,1523,1282,248,301,chair
57168,34,chair,34,0,21471,69,1603,978,1891,1196,288,218,chair
57169,35,chair,35,0,21471,39,1619,1092,2085,1466,466,374,chair
57170,37,bottle,37,0,21471,22,1666,1032,1695,1128,29,96,bottle
57171,41,plate,41,0,21471,20,802,1074,859,1093,57,19,plate
57172,45,chair,45,1,21471,21,796,1317,1428,1466,632,149,chair
57173,28,chair,29,1,21473,32,771,473,828,605,57,132,chair
57174,43,sofa,44,0,21473,155,807,604,1202,834,395,230,couch
57175,28,window,29,0,21474,19,792,496,891,767,99,271,window
57176,57,plant pot,58,0,21474,20,345,884,439,932,94,48,potted plant
57177,60,plant pot,61,0,21474,23,1,1491,165,1648,164,157,potted plant
57178,13,person,14,1,21475,48,581,532,699,812,118,280,person
57179,19,person,20,1,21475,31,1579,625,1661,745,82,120,person
57180,24,clock,25,0,21475,15,22,399,103,531,81,132,clock
57181,36,plant pot,37,0,21475,22,1073,876,1129,933,56,57,potted plant
57182,24,window,25,0,21476,32,1,247,551,770,550,523,window
57183,34,window,35,0,21477,31,194,164,403,783,209,619,window
57184,38,person,39,0,21477,57,1613,610,1710,956,97,346,person
57185,39,person,40,0,21477,69,1519,663,1611,920,92,257,person
57186,40,person,41,1,21477,71,1446,670,1517,930,71,260,person
57187,41,person,42,1,21477,59,1390,699,1458,931,68,232,person
57188,42,person,43,1,21477,37,1381,703,1416,939,35,236,person
57189,43,person,44,1,21477,50,1274,720,1313,957,39,237,person
57190,44,person,45,1,21477,78,1206,670,1281,958,75,288,person
57191,45,person,46,0,21477,75,1123,660,1213,950,90,290,person
57192,46,person,47,0,21477,66,1092,682,1150,962,58,280,person
57193,47,person,48,0,21477,67,1046,674,1103,979,57,305,person
57194,48,person,49,0,21477,83,1003,697,1076,1001,73,304,person
57195,49,person,50,1,21477,61,936,699,1033,1030,97,331,person
57196,50,person,51,1,21477,70,1011,621,1105,927,94,306,person
57197,51,person,52,0,21477,36,778,707,960,842,182,135,person
57198,52,person,53,1,21477,27,899,681,943,782,44,101,person
57199,53,person,54,0,21477,39,832,707,941,785,109,78,person
57200,54,person,55,1,21477,36,781,681,841,823,60,142,person
57201,55,person,56,1,21477,85,686,627,785,927,99,300,person
57202,56,person,57,0,21477,85,681,673,778,1036,97,363,person
57203,57,person,58,1,21477,61,473,645,555,949,82,304,person
57204,58,person,59,0,21477,150,395,668,662,1223,267,555,person
57205,60,person,61,0,21477,113,291,603,461,1159,170,556,person
57206,64,person,65,0,21477,146,1230,583,1488,1065,258,482,person
57207,14,door,15,0,21478,17,783,251,853,500,70,249,door
57208,17,sofa,18,1,21478,39,909,479,1200,704,291,225,couch
57209,26,person,27,1,21478,26,653,361,675,405,22,44,person
57210,27,person,28,1,21478,21,617,360,646,399,29,39,person
57211,54,plant pot,55,0,21478,45,80,511,162,594,82,83,potted plant
57212,56,person,57,0,21478,159,196,309,327,744,131,435,person
57213,57,suitcase,58,0,21478,44,27,534,230,768,203,234,suitcase
57214,82,person,83,1,21478,17,301,367,313,390,12,23,person
57215,83,door,84,0,21478,19,191,307,227,466,36,159,door
57216,17,window,18,0,21479,77,1,1,510,1466,509,1465,window
57217,18,table,19,0,21479,43,240,1125,695,1466,455,341,dining table
57218,25,chair,26,1,21479,59,795,843,988,1073,193,230,chair
57219,27,sofa,28,0,21479,49,886,819,1181,990,295,171,couch
57220,30,chair,31,0,21479,38,1240,828,1422,1020,182,192,chair
57221,32,mirror,33,0,21479,95,587,560,917,860,330,300,mirror
57222,38,door,39,0,21479,42,1449,644,1553,870,104,226,door
57223,43,vase,44,0,21479,24,1967,820,2030,861,63,41,vase
57224,46,table,47,1,21479,35,1647,959,1885,1153,238,194,dining table
57225,52,sofa,53,0,21479,17,1819,925,2199,1466,380,541,couch
57226,18,person,19,1,21481,60,1608,375,1851,726,243,351,person
57227,22,plant pot,23,0,21481,19,1141,558,1241,642,100,84,potted plant
57228,27,suitcase,28,0,21481,58,1020,695,1298,1217,278,522,suitcase
57229,28,person,29,0,21481,141,1258,348,1631,1281,373,933,person
57230,34,sofa,35,0,21482,24,1901,747,2086,955,185,208,couch
57231,40,chair,41,1,21482,60,245,1098,1030,1466,785,368,chair
57232,42,mirror,43,1,21482,33,204,446,767,784,563,338,mirror
57233,59,sofa,60,0,21483,42,725,917,968,1107,243,190,couch
57234,30,window,31,0,21484,44,0,573,74,1104,74,531,window
57235,41,sofa,42,0,21484,40,330,1049,865,1501,535,452,couch
57236,46,plant pot,47,0,21484,20,752,984,996,1097,244,113,potted plant
57237,63,sofa,64,1,21484,63,1608,855,1969,964,361,109,couch
57238,11,door,12,0,21485,34,279,399,362,536,83,137,door
57239,14,person,15,1,21485,44,577,435,622,537,45,102,person
57240,15,person,16,1,21485,32,609,441,649,611,40,170,person
57241,17,person,18,1,21485,42,493,516,579,579,86,63,person
57242,18,person,19,1,21485,58,707,436,801,698,94,262,person
57243,19,backpack,20,0,21485,32,709,471,777,553,68,82,backpack
57244,20,person,21,1,21485,66,831,424,911,667,80,243,person
57245,21,person,22,1,21485,69,829,441,922,722,93,281,person
57246,22,person,23,1,21485,34,415,498,498,558,83,60,person
57247,23,person,24,1,21485,28,394,516,435,604,41,88,person
57248,24,sofa,25,1,21485,38,392,550,468,606,76,56,couch
57249,26,person,27,1,21485,29,279,505,334,581,55,76,person
57250,31,person,32,0,21485,72,323,417,418,689,95,272,person
57251,32,person,33,1,21485,67,449,596,725,768,276,172,person
57252,33,person,34,1,21485,51,435,652,675,768,240,116,person
57253,36,person,37,1,21485,47,612,423,692,623,80,200,person
57254,43,person,44,0,21485,52,106,438,171,637,65,199,person
57255,53,door,54,0,21485,19,18,398,91,561,73,163,door
57256,60,person,61,1,21485,27,0,441,65,768,65,327,person
57257,61,backpack,62,0,21485,18,26,588,77,661,51,73,backpack
57258,65,table,66,1,21485,20,672,536,718,598,46,62,dining table
57259,24,door,25,0,21486,15,1142,481,1245,770,103,289,door
57260,36,window,37,0,21486,16,584,580,861,796,277,216,window
57261,57,chair,58,0,21486,47,853,829,1082,1150,229,321,chair
57262,58,chair,59,0,21486,44,1076,832,1290,1161,214,329,chair
57263,59,chair,60,1,21486,63,1175,820,1389,1137,214,317,chair
57264,60,table,61,1,21486,48,930,853,1335,1143,405,290,dining table
57265,61,chair,62,0,21486,31,957,813,1112,997,155,184,chair
57266,63,chair,64,1,21486,28,895,806,1029,931,134,125,chair
57267,64,table,65,1,21486,37,753,825,894,1069,141,244,dining table
57268,66,chair,67,1,21486,27,740,794,867,951,127,157,chair
57269,67,chair,68,1,21486,36,706,891,840,1154,134,263,chair
57270,70,chair,71,0,21486,17,620,779,721,825,101,46,chair
57271,57,table,58,1,21487,38,468,745,553,848,85,103,dining table
57272,58,chair,59,1,21487,31,803,757,922,892,119,135,chair
57273,62,sofa,63,1,21487,26,949,751,1137,801,188,50,couch
57274,63,chair,64,1,21487,63,930,791,1101,966,171,175,chair
57275,65,chair,66,1,21487,23,75,847,165,1057,90,210,chair
57276,66,chair,67,1,21487,25,368,799,461,960,93,161,chair
57277,67,chair,68,0,21487,30,338,830,452,1033,114,203,chair
57278,69,table,70,1,21487,23,306,874,332,970,26,96,dining table
57279,70,chair,71,0,21487,27,396,722,445,818,49,96,chair
57280,71,chair,72,1,21487,28,438,735,512,855,74,120,chair
57281,72,chair,73,0,21487,32,519,733,594,856,75,123,chair
57282,73,chair,74,0,21487,23,578,726,608,835,30,109,chair
57283,74,chair,75,1,21487,19,461,728,512,787,51,59,chair
57284,75,chair,76,1,21487,16,613,715,637,806,24,91,chair
57285,76,chair,77,0,21487,30,626,719,675,812,49,93,chair
57286,77,plant pot,78,0,21487,21,690,875,758,948,68,73,potted plant
57287,15,plant pot,16,0,21488,17,800,498,849,541,49,43,potted plant
57288,17,plant pot,18,0,21488,19,535,570,622,664,87,94,potted plant
57289,20,person,21,1,21488,75,0,176,152,778,152,602,person
57290,21,person,22,1,21488,37,117,260,247,425,130,165,person
57291,22,person,23,1,21488,42,240,301,319,416,79,115,person
57292,23,person,24,0,21488,111,276,219,485,744,209,525,person
57293,31,chair,32,1,21488,24,969,446,1097,586,128,140,chair
57294,10,sofa,11,0,21489,53,1596,862,1946,1047,350,185,couch
57295,16,pot,17,0,21489,27,1557,762,1579,820,22,58,potted plant
57296,18,pot,19,0,21489,22,1438,761,1458,813,20,52,potted plant
57297,21,table,22,0,21489,80,355,922,653,1129,298,207,dining table
57298,22,chair,23,1,21489,61,364,879,462,1089,98,210,chair
57299,17,window,18,0,21490,16,350,512,383,904,33,392,window
57300,35,plant pot,36,0,21490,33,587,806,649,844,62,38,potted plant
57301,39,plant pot,40,0,21490,30,101,1008,246,1134,145,126,potted plant
57302,41,plant pot,42,0,21490,15,0,1063,128,1218,128,155,potted plant
57303,43,plant pot,44,0,21490,20,709,1094,828,1192,119,98,potted plant
57304,51,chair,52,1,21490,41,1508,963,1816,1046,308,83,chair
57305,54,table,55,0,21490,92,1273,1083,2200,1475,927,392,dining table
57306,56,chair,57,1,21490,133,1480,1018,2088,1475,608,457,chair
57307,57,bowl,58,0,21490,33,1954,1029,2170,1135,216,106,bowl
57308,67,vase,68,0,21490,17,1270,972,1330,1017,60,45,vase
57309,19,car,20,0,23795,29,665,564,866,677,201,113,car
57310,21,person,22,0,23796,41,624,412,676,536,52,124,person
57311,22,person,23,0,23796,41,577,405,620,546,43,141,person
57312,1,sofa,2,0,23797,135,183,400,1322,1065,1139,665,couch
57313,2,person,3,0,23797,65,716,245,1191,1063,475,818,person
57314,3,person,4,1,23797,63,295,300,870,1064,575,764,person
57315,4,window,5,0,23797,42,0,0,1190,494,1190,494,window
57316,10,suitcase,11,0,23798,21,128,327,184,458,56,131,suitcase
57317,11,person,12,1,23798,19,35,259,74,320,39,61,person
57318,12,person,13,0,23798,80,57,243,137,457,80,214,person
57319,13,person,14,1,23798,47,1,245,48,482,47,237,person
57320,19,clock,20,0,23798,27,321,268,346,302,25,34,clock
57321,20,mirror,21,0,23798,33,316,171,340,271,24,100,mirror
57322,21,chair,22,1,23798,21,604,372,631,462,27,90,chair
57323,22,person,23,0,23798,49,612,330,657,476,45,146,person
57324,24,sofa,25,0,23798,43,398,322,539,387,141,65,couch
57325,25,person,26,0,23798,45,504,313,554,381,50,68,person
57326,32,person,33,1,23798,20,580,310,612,380,32,70,person
57327,33,person,34,0,23798,58,559,276,603,389,44,113,person
57328,34,person,35,1,23798,17,555,281,569,328,14,47,person
57329,8,chair,9,0,23799,26,439,327,551,472,112,145,chair
57330,12,chair,13,0,23799,23,170,322,292,463,122,141,chair
57331,13,chair,14,0,23799,26,281,348,423,512,142,164,chair
57332,38,person,39,0,23801,40,375,327,431,547,56,220,person
57333,39,person,40,0,23801,27,736,312,765,422,29,110,person
57334,40,person,41,0,23801,26,700,318,726,422,26,104,person
57335,41,person,42,0,23801,30,478,286,497,362,19,76,person
57336,42,person,43,0,23801,29,454,289,473,363,19,74,person
57337,24,person,25,0,23804,36,534,230,561,292,27,62,person
57338,25,person,26,0,23804,36,561,231,589,290,28,59,person
57339,26,person,27,0,23804,33,578,229,614,287,36,58,person
57340,27,person,28,0,23804,20,490,227,503,277,13,50,person
57341,28,person,29,0,23804,15,519,233,527,259,8,26,person
57342,4,sofa,5,0,23805,32,250,277,871,613,621,336,couch
57343,5,table,6,0,23805,38,1,387,728,767,727,380,dining table
57344,4,chair,5,1,23806,27,512,534,916,768,404,234,chair
57345,5,chair,6,1,23806,23,606,445,820,631,214,186,chair
57346,6,chair,7,1,23806,22,625,417,799,517,174,100,chair
57347,7,chair,8,1,23806,31,667,397,793,470,126,73,chair
57348,8,chair,9,1,23806,27,673,389,781,443,108,54,chair
57349,9,sofa,10,1,23806,25,149,486,328,748,179,262,couch
57350,10,sofa,11,0,23806,45,217,403,498,610,281,207,couch
57351,11,sofa,12,0,23806,45,404,376,590,498,186,122,couch
57352,14,table,15,0,23806,16,581,431,657,460,76,29,dining table
57353,16,table,17,1,23806,35,512,467,619,560,107,93,dining table
57354,17,table,18,0,23806,30,463,495,590,559,127,64,dining table
57355,19,table,20,0,23806,39,235,612,458,757,223,145,dining table
57356,21,table,22,0,23806,16,643,351,755,416,112,65,dining table
57357,22,chair,23,0,23806,15,677,360,722,421,45,61,chair
57358,24,chair,25,1,23806,16,720,353,764,418,44,65,chair
57359,8,plant pot,9,0,23807,17,533,401,608,457,75,56,potted plant
57360,14,sofa,15,1,23807,65,14,387,447,565,433,178,couch
57361,11,bench,12,0,23808,42,647,485,866,551,219,66,bench
57362,26,sofa,27,0,23811,29,1,312,376,683,375,371,couch
57363,40,shoe,41,0,23811,16,194,293,248,319,54,26,shoe
57364,42,chair,43,0,23811,15,470,153,505,213,35,60,chair
57365,44,chair,45,1,23811,18,299,153,336,207,37,54,chair
57366,54,chair,55,1,23811,15,328,172,377,237,49,65,chair
57367,61,chair,62,1,23811,23,493,228,581,392,88,164,chair
57368,62,chair,63,0,23811,21,416,233,513,403,97,170,chair
57369,63,chair,64,0,23811,20,337,237,438,421,101,184,chair
57370,64,window,65,0,23811,22,1,0,217,368,216,368,window
57371,21,vase,22,0,23812,57,893,50,1024,581,131,531,vase
57372,28,vase,29,0,23812,18,406,324,431,397,25,73,vase
57373,29,vase,30,0,23812,16,613,326,631,396,18,70,vase
57374,30,person,31,0,23812,22,641,369,660,443,19,74,person
57375,33,vase,34,0,23812,55,1,66,126,565,125,499,vase
57376,81,person,82,0,23812,35,131,317,155,392,24,75,person
57377,85,vase,86,0,23812,31,99,357,130,411,31,54,vase
57378,104,vase,105,0,23812,30,904,358,936,412,32,54,vase
57379,4,bed,5,0,11606,23,278,227,598,510,320,283,bed
57380,11,bed,12,1,11607,17,516,400,799,597,283,197,bed
57381,14,chair,15,1,11607,19,522,378,636,519,114,141,chair
57382,9,person,10,1,11608,54,301,52,402,274,101,222,person
57383,11,desk,12,1,11608,21,191,173,401,279,210,106,desk
57384,12,table,13,0,11608,21,180,230,387,381,207,151,dining table
57385,14,bed,15,1,11608,23,405,170,599,395,194,225,bed
57386,1,person,2,1,11617,28,348,46,419,192,71,146,person
57387,2,person,3,1,11617,31,321,50,375,186,54,136,person
57388,3,person,4,1,11617,35,207,39,311,182,104,143,person
57389,4,person,5,1,11617,35,101,38,188,186,87,148,person
57390,3,person,4,1,11620,61,429,339,908,958,479,619,person
57391,4,person,5,1,11620,32,1124,358,1279,958,155,600,person
57392,9,person,10,0,11625,54,469,222,721,708,252,486,person
57393,5,table,6,0,11732,15,217,68,314,134,97,66,dining table
57394,17,person,18,1,11732,36,177,168,264,276,87,108,person
57395,18,person,19,1,11732,34,325,62,381,135,56,73,person
57396,19,person,20,0,11732,22,327,108,395,158,68,50,person
57397,20,person,21,0,11732,15,54,129,119,151,65,22,person
57398,21,person,22,1,11732,16,183,40,207,94,24,54,person
57399,22,person,23,1,11732,22,150,52,190,101,40,49,person
57400,23,person,24,0,11732,34,19,63,52,153,33,90,person
57401,4,person,5,1,11733,49,224,28,415,335,191,307,person
57402,18,table,19,0,11773,17,95,181,146,222,51,41,dining table
57403,19,chair,20,1,11773,18,76,168,121,222,45,54,chair
57404,10,person,11,0,11776,45,41,38,114,228,73,190,person
57405,32,chair,31,1,23879,23,15,416,100,534,85,118,chair
57406,35,bench,34,1,23879,19,407,407,559,508,152,101,bench
57407,39,bench,38,0,23879,22,54,422,205,540,151,118,bench
57408,40,bench,39,0,23879,28,170,427,398,561,228,134,bench
57409,41,bench,40,0,23879,29,575,454,880,668,305,214,bench
57410,42,bench,41,0,23879,17,816,496,1024,682,208,186,bench
57411,2,person,3,1,11777,35,235,96,317,261,82,165,person
57412,3,person,4,1,11777,31,195,126,272,262,77,136,person
57413,4,person,5,1,11777,34,152,139,256,262,104,123,person
57414,5,person,6,1,11777,38,79,108,156,223,77,115,person
57415,6,person,7,1,11777,28,26,112,79,226,53,114,person
57416,7,person,8,1,11777,25,3,132,55,230,52,98,person
57417,8,person,9,1,11777,16,0,157,82,262,82,105,person
57418,9,person,10,1,11777,25,42,175,172,262,130,87,person
57419,14,person,15,1,11777,17,129,103,153,148,24,45,person
57420,3,door,4,0,11778,29,143,18,429,107,286,89,door
57421,10,person,11,1,11778,15,379,225,403,260,24,35,person
57422,6,sofa,7,0,11779,20,3,240,451,430,448,190,couch
57423,7,person,8,1,11779,33,219,102,359,291,140,189,person
57424,8,person,9,1,11779,16,139,308,196,347,57,39,person
57425,9,person,10,1,11779,37,10,129,186,429,176,300,person
57426,1,truck,2,0,11797,30,2,116,267,229,265,113,truck
57427,2,person,3,0,11797,30,302,120,334,191,32,71,person
57428,3,person,4,0,11797,39,2,86,60,210,58,124,person
57429,7,person,8,1,11799,21,233,73,257,129,24,56,person
57430,8,person,9,0,11799,21,187,79,212,139,25,60,person
57431,9,person,10,0,11799,20,162,54,186,119,24,65,person
57432,4,person,5,0,11800,18,81,145,94,171,13,26,person
57433,3,door,3,0,11801,26,58,33,177,267,119,234,door
57434,5,person,6,0,11804,38,750,362,980,1189,230,827,person
57435,6,person,7,0,11804,48,917,435,1166,1189,249,754,person
57436,0,person,1,0,13821,30,0,50,36,184,36,134,person
57437,1,person,2,1,13821,32,44,65,94,182,50,117,person
57438,2,person,3,1,13821,17,101,50,119,79,18,29,person
57439,3,person,4,1,13821,25,80,58,108,98,28,40,person
57440,4,person,5,1,13821,18,70,60,86,94,16,34,person
57441,5,person,6,1,13821,36,135,52,189,135,54,83,person
57442,6,person,7,1,13821,26,205,68,244,116,39,48,person
57443,7,person,8,1,13821,21,237,71,261,113,24,42,person
57444,8,person,9,1,13821,21,272,64,299,116,27,52,person
57445,9,person,10,1,13821,20,292,67,319,125,27,58,person
57446,10,person,11,1,13821,23,204,137,305,209,101,72,person
57447,30,table,31,0,13822,25,570,393,703,546,133,153,dining table
57448,2,desk,2,0,13823,31,0,96,299,200,299,104,desk
57449,4,chair,4,1,13823,16,221,138,287,200,66,62,chair
57450,5,person,5,1,13823,51,183,94,272,200,89,106,person
57451,11,person,11,1,13823,18,42,54,65,83,23,29,person
57452,13,person,13,1,13823,17,101,64,125,87,24,23,person
57453,14,person,14,1,13823,17,184,66,215,101,31,35,person
57454,2,desk,3,0,13824,43,276,302,560,479,284,177,desk
57455,8,person,9,0,13824,38,430,269,516,438,86,169,person
57456,9,person,10,1,13824,28,534,246,599,384,65,138,person
57457,8,person,9,1,13825,23,114,56,141,105,27,49,person
57458,12,person,12,1,13825,15,31,79,44,103,13,24,person
57459,25,person,25,1,13825,37,15,120,166,222,151,102,person
57460,33,person,33,1,13825,18,282,50,319,102,37,52,person
57461,5,desk,6,1,13826,26,2,88,68,129,66,41,desk
57462,6,desk,7,1,13826,19,86,86,144,110,58,24,desk
57463,7,desk,8,1,13826,48,180,86,359,166,179,80,desk
57464,8,person,9,1,13826,22,163,66,208,107,45,41,person
57465,9,person,10,1,13826,34,239,45,281,130,42,85,person
57466,10,person,11,0,13826,44,283,36,339,194,56,158,person
57467,11,person,12,0,13826,31,8,52,55,138,47,86,person
57468,12,person,13,0,13826,40,50,78,108,197,58,119,person
57469,13,person,14,1,13826,22,93,82,138,120,45,38,person
57470,14,person,15,1,13826,41,128,76,180,182,52,106,person
57471,16,table,17,1,13826,21,100,116,164,181,64,65,dining table
57472,17,chair,18,1,13826,18,157,103,192,150,35,47,chair
57473,18,table,19,0,13826,26,129,142,263,238,134,96,dining table
57474,19,person,20,0,13826,45,199,105,270,238,71,133,person
57475,13,desk,14,0,13827,28,105,174,299,250,194,76,desk
57476,2,desk,3,0,13847,15,23,371,146,455,123,84,desk
57477,6,person,7,0,13847,33,654,302,705,489,51,187,person
57478,7,person,8,0,13847,40,610,297,658,481,48,184,person
57479,8,person,9,1,13847,23,543,305,569,467,26,162,person
57480,9,person,10,0,13847,39,561,302,611,474,50,172,person
57481,10,person,11,0,13847,30,502,294,554,476,52,182,person
57482,11,person,12,1,13847,39,463,286,515,492,52,206,person
57483,12,person,13,0,13847,31,422,297,484,503,62,206,person
57484,13,person,14,0,13847,37,365,304,429,514,64,210,person
57485,14,person,15,0,13847,40,256,290,352,543,96,253,person
57486,2,person,3,1,13957,79,169,160,513,765,344,605,person
57487,18,door,19,1,228,24,514,404,882,1045,368,641,door
57488,19,window,20,0,228,49,137,395,522,1006,385,611,window
57489,30,door,31,0,228,26,1698,486,1926,985,228,499,door
57490,32,table,33,0,228,18,1393,865,1494,991,101,126,dining table
57491,33,table,34,0,228,32,1084,983,2199,1526,1115,543,dining table
57492,38,person,39,0,228,88,5,350,738,1648,733,1298,person
57493,48,chair,49,1,228,20,1053,760,1149,996,96,236,chair
57494,50,person,51,1,228,19,1205,728,1298,814,93,86,person
57495,51,person,52,1,228,44,1426,745,1587,988,161,243,person
57496,66,person,67,0,228,75,1202,745,1413,1022,211,277,person
57497,78,bottle,79,0,228,26,1357,924,1394,1032,37,108,bottle
57498,82,bottle,83,0,228,21,1426,935,1460,1037,34,102,bottle
57499,86,chair,87,1,228,19,1527,838,1626,942,99,104,chair
57500,87,person,88,0,228,48,1533,758,1799,986,266,228,person
57501,100,glasses,101,0,228,28,1641,849,1691,919,50,70,eye glasses
57502,101,bottle,102,0,228,22,1840,931,1878,1029,38,98,bottle
57503,106,person,107,1,228,40,1974,752,2200,994,226,242,person
57504,129,person,129,1,228,18,0,1465,57,1566,57,101,person
57505,1,table,2,1,229,36,1,95,852,479,851,384,dining table
57506,2,mouse,3,0,229,17,53,166,207,226,154,60,mouse
57507,3,keyboard,4,0,229,39,90,205,758,415,668,210,keyboard
57508,4,person,5,1,229,76,335,1,852,371,517,370,person
57509,13,window,14,0,933,27,326,113,486,380,160,267,window
57510,15,chair,16,1,933,17,717,345,754,447,37,102,chair
57511,16,person,17,1,933,52,566,290,749,491,183,201,person
57512,50,chair,51,1,933,48,330,592,698,863,368,271,chair
57513,3,keyboard,4,0,14000,21,676,809,1081,900,405,91,keyboard
57514,18,desk,18,0,14000,26,480,727,1231,1355,751,628,desk
57515,6,desk,7,0,14001,38,3,66,1091,816,1088,750,desk
57516,7,mouse,7,0,14002,15,1319,735,1438,779,119,44,mouse
57517,15,person,15,0,14002,71,440,85,1396,1290,956,1205,person
57518,3,mouse,4,0,14004,16,1368,929,1436,992,68,63,mouse
57519,4,bottle,5,0,14004,22,375,705,468,964,93,259,bottle
57520,16,chair,17,1,14004,22,623,1091,1344,1533,721,442,chair
57521,22,desk,23,1,14004,25,3,771,1947,1533,1944,762,desk
57522,25,bottle,26,1,14004,24,698,647,771,888,73,241,bottle
57523,16,person,16,1,14005,36,3,806,544,1533,541,727,person
57524,18,chair,18,1,14005,24,899,1103,1681,1533,782,430,chair
57525,19,chair,19,1,14005,19,384,1027,634,1533,250,506,chair
57526,20,desk,20,1,14005,35,323,806,1908,1533,1585,727,desk
57527,4,table,2,0,14006,35,674,597,1809,1470,1135,873,dining table
57528,15,chair,8,1,14006,76,576,550,1134,1382,558,832,chair
57529,16,chair,9,0,14006,80,200,557,935,1459,735,902,chair
57530,19,window,12,0,14006,17,1264,159,1700,561,436,402,window
57531,23,person,16,1,14006,30,1571,351,1841,619,270,268,person
57532,26,chair,19,0,14006,21,1377,652,2198,1470,821,818,chair
57533,8,chair,8,0,14007,39,1581,501,1926,894,345,393,chair
57534,5,bottle,6,0,14008,18,1204,781,1281,1033,77,252,bottle
57535,6,desk,7,0,14009,31,425,669,1542,1533,1117,864,desk
57536,7,chair,8,1,14009,25,858,980,1434,1530,576,550,chair
57537,13,book,14,0,14009,15,1123,977,1536,1108,413,131,book
57538,16,chair,17,0,14010,40,24,203,137,342,113,139,chair
57539,35,desk,33,0,14010,19,140,200,375,400,235,200,desk
57540,2,mouse,3,0,14011,16,478,994,572,1083,94,89,mouse
57541,4,mouse,5,0,14011,20,1205,1139,1314,1252,109,113,mouse
57542,9,bottle,10,0,14011,24,361,672,463,957,102,285,bottle
57543,21,desk,22,0,14011,28,0,774,2045,1533,2045,759,desk
57544,5,chair,6,0,14013,20,259,252,515,480,256,228,chair
57545,3,chair,4,0,14014,25,480,196,638,385,158,189,chair
57546,14,desk,15,0,14014,18,141,224,504,479,363,255,desk
57547,3,bottle,4,0,14015,22,1699,984,1808,1264,109,280,bottle
57548,20,bottle,21,1,14015,19,1630,967,1729,1218,99,251,bottle
57549,22,bottle,23,0,14015,15,465,822,582,1035,117,213,bottle
57550,29,scissors,30,0,14015,33,1636,1198,1733,1306,97,108,scissors
57551,7,keyboard,7,0,14016,18,817,736,1079,809,262,73,keyboard
57552,10,chair,10,0,14016,19,0,664,127,1213,127,549,chair
57553,15,chair,16,1,14017,40,3,855,631,1524,628,669,chair
57554,26,desk,27,0,14017,46,250,852,1620,1531,1370,679,desk
57555,15,person,16,1,14018,32,9,797,800,1527,791,730,person
57556,1,bottle,2,0,14019,15,1393,328,1449,516,56,188,bottle
57557,14,book,15,1,14019,16,841,1292,1521,1530,680,238,book
57558,2,bottle,3,0,14021,17,1266,814,1331,995,65,181,bottle
57559,5,mouse,6,0,14021,15,1199,1009,1264,1065,65,56,mouse
57560,22,chair,23,1,14021,34,1050,1044,1868,1533,818,489,chair
57561,5,mouse,6,0,14025,16,1285,914,1342,966,57,52,mouse
57562,17,desk,18,0,14025,24,9,657,1841,1385,1832,728,desk
57563,27,desk,25,0,14026,23,364,272,609,423,245,151,desk
57564,28,desk,29,0,14027,18,299,915,1578,1531,1279,616,desk
57565,13,door,11,0,14028,29,1354,647,1907,1098,553,451,door
57566,13,desk,14,0,14029,17,432,788,1470,1418,1038,630,desk
57567,10,chair,11,1,14030,16,3,1123,698,1530,695,407,chair
57568,29,desk,29,0,14031,33,681,762,1695,1382,1014,620,desk
57569,30,desk,30,1,14031,17,163,799,733,1026,570,227,desk
57570,0,table,1,0,14032,36,481,359,1632,1244,1151,885,dining table
57571,8,chair,7,0,14032,36,878,820,1759,1468,881,648,chair
57572,19,desk,13,0,14032,45,943,43,2093,854,1150,811,desk
57573,24,person,17,1,14032,27,1367,6,1630,297,263,291,person
57574,34,chair,27,1,14032,35,1423,396,1902,1004,479,608,chair
57575,35,chair,28,1,14032,37,384,274,777,776,393,502,chair
57576,36,chair,29,0,14032,49,39,529,721,1436,682,907,chair
57577,3,bottle,4,0,14033,23,1019,857,1091,1046,72,189,bottle
57578,12,chair,13,1,14033,17,41,1146,800,1533,759,387,chair
57579,13,person,14,1,14033,44,323,652,940,1533,617,881,person
57580,23,desk,24,0,14033,21,92,946,1378,1531,1286,585,desk
57581,6,chair,7,1,14034,17,3,287,191,478,188,191,chair
57582,9,desk,10,0,14035,22,349,759,1405,1353,1056,594,desk
57583,11,desk,12,0,14035,27,1489,748,2046,1268,557,520,desk
57584,31,keyboard,32,0,14038,20,1693,876,1933,1050,240,174,keyboard
57585,1,bottle,2,0,14039,19,560,640,611,785,51,145,bottle
57586,12,scissors,13,0,14040,20,597,346,639,377,42,31,scissors
57587,10,chair,11,1,14041,23,1178,436,1402,663,224,227,chair
57588,16,chair,17,1,14041,24,3,1137,858,1533,855,396,chair
57589,12,desk,13,0,14044,30,45,111,256,229,211,118,desk
57590,3,chair,4,0,14045,17,173,157,254,254,81,97,chair
57591,16,chair,17,1,14047,15,335,732,850,997,515,265,chair
57592,14,desk,15,0,14048,21,0,105,205,232,205,127,desk
57593,9,desk,10,0,14049,17,1,102,155,246,154,144,desk
57594,11,desk,12,0,14049,15,133,98,226,188,93,90,desk
57595,19,chair,20,0,14049,17,240,84,256,146,16,62,chair
57596,20,chair,21,1,14049,19,1,167,39,239,38,72,chair
57597,4,desk,5,0,14050,17,0,97,81,195,81,98,desk
57598,54,desk,55,0,14051,16,113,183,320,289,207,106,desk
57599,55,chair,56,0,14051,16,128,166,198,221,70,55,chair
57600,3,chair,4,0,14053,22,6,141,87,254,81,113,chair
57601,4,desk,5,0,14053,17,54,149,168,247,114,98,desk
57602,11,desk,7,0,14054,18,41,138,198,239,157,101,desk
57603,25,desk,10,0,14054,16,196,59,320,229,124,170,desk
57604,11,desk,12,0,14055,53,0,798,1945,1643,1945,845,desk
57605,28,glasses,28,1,14055,16,549,1043,659,1085,110,42,eye glasses
57606,53,bowl,53,0,14055,19,923,1419,1058,1625,135,206,bowl
57607,3,chair,4,0,14056,28,22,134,173,226,151,92,chair
57608,31,chair,32,1,14056,15,85,122,133,143,48,21,chair
57609,23,chair,24,1,14057,17,0,131,14,207,14,76,chair
57610,3,chair,4,0,14058,38,101,131,160,233,59,102,chair
57611,8,desk,9,0,14058,26,24,120,210,229,186,109,desk
57612,5,chair,6,0,14059,19,189,91,225,135,36,44,chair
57613,14,desk,15,0,14059,18,65,86,138,108,73,22,desk
57614,3,desk,4,0,14060,24,46,154,255,255,209,101,desk
57615,24,desk,24,0,14061,34,31,115,238,248,207,133,desk
57616,5,chair,6,0,14062,31,118,157,252,255,134,98,chair
57617,21,desk,22,0,14063,15,118,112,342,249,224,137,desk
57618,13,chair,14,0,14065,20,126,827,788,1222,662,395,chair
57619,1,desk,2,0,14067,34,52,135,225,240,173,105,desk
57620,5,desk,6,0,14068,16,0,115,255,240,255,125,desk
57621,3,person,4,1,14069,36,115,109,294,353,179,244,person
57622,4,desk,5,0,14072,23,108,129,250,230,142,101,desk
57623,4,desk,5,0,14075,16,110,130,243,239,133,109,desk
57624,18,window,19,0,14075,28,111,31,168,130,57,99,window
57625,20,chair,21,0,14076,19,169,407,321,612,152,205,chair
57626,5,chair,6,0,14077,23,94,98,128,165,34,67,chair
57627,6,chair,7,0,14077,27,186,109,248,192,62,83,chair
57628,10,chair,11,0,14077,20,208,102,251,132,43,30,chair
57629,7,desk,8,0,14078,23,0,164,131,233,131,69,desk
57630,12,chair,13,0,14078,21,77,162,132,243,55,81,chair
57631,13,chair,14,0,14078,15,37,168,81,210,44,42,chair
57632,4,chair,5,0,14079,15,181,185,235,230,54,45,chair
57633,17,chair,18,0,14080,16,897,584,1038,819,141,235,chair
57634,19,person,20,0,14080,18,943,467,1091,701,148,234,person
57635,37,person,38,0,14080,16,477,426,611,607,134,181,person
57636,20,desk,20,0,14081,17,34,60,316,218,282,158,desk
57637,0,chair,1,0,14082,33,43,111,97,200,54,89,chair
57638,6,desk,7,0,14082,32,83,117,246,235,163,118,desk
57639,4,desk,5,0,14083,26,31,131,324,273,293,142,desk
57640,1,desk,2,0,14085,16,1,137,204,254,203,117,desk
57641,8,desk,9,0,14087,29,79,857,1906,1650,1827,793,desk
57642,7,chair,8,0,14088,23,93,149,167,255,74,106,chair
57643,0,chair,1,0,14090,39,177,141,236,233,59,92,chair
57644,3,desk,4,0,14090,24,61,135,256,224,195,89,desk
57645,5,chair,6,0,14091,15,0,109,23,144,23,35,chair
57646,29,desk,27,0,14092,15,132,312,509,399,377,87,desk
57647,17,desk,18,0,14094,23,175,132,256,256,81,124,desk
57648,2,desk,3,0,14096,26,0,118,197,236,197,118,desk
57649,9,chair,10,0,14097,16,527,356,636,481,109,125,chair
57650,11,desk,12,0,14097,27,14,281,611,481,597,200,desk
57651,32,chair,31,1,14098,16,2,449,68,572,66,123,chair
57652,36,desk,35,0,14098,15,0,351,266,590,266,239,desk
57653,66,chair,64,0,14098,19,617,311,690,402,73,91,chair
57654,13,desk,14,0,14099,63,49,112,316,240,267,128,desk
57655,4,desk,5,0,14100,17,48,146,255,254,207,108,desk
57656,3,person,4,1,14101,29,2,64,43,250,41,186,person
57657,7,person,8,1,14101,23,162,96,220,152,58,56,person
57658,8,person,9,1,14101,44,215,75,285,250,70,175,person
57659,9,person,10,1,14101,40,285,71,362,250,77,179,person
57660,12,person,13,1,14101,50,93,147,199,249,106,102,person
57661,2,desk,3,0,14102,24,0,26,255,255,255,229,desk
57662,6,desk,7,0,14103,16,67,104,255,255,188,151,desk
57663,11,chair,12,0,14103,34,92,119,161,216,69,97,chair
57664,1,keyboard,2,0,14104,21,37,115,98,139,61,24,keyboard
57665,8,desk,9,0,14104,42,0,95,250,234,250,139,desk
57666,2,desk,2,0,14105,28,0,115,173,228,173,113,desk
57667,3,desk,3,0,14105,53,156,100,251,202,95,102,desk
57668,0,car,1,0,14106,27,35,59,115,103,80,44,car
57669,24,chair,23,0,14106,23,136,195,237,240,101,45,chair
57670,25,chair,24,0,14106,49,50,166,141,240,91,74,chair
57671,28,desk,27,0,14106,46,106,129,300,240,194,111,desk
57672,38,table,37,0,14106,17,146,117,200,138,54,21,dining table
57673,0,chair,1,1,14107,28,2,502,488,1571,486,1069,chair
57674,9,desk,10,0,14107,20,503,368,1239,743,736,375,desk
57675,19,glasses,20,0,14107,22,687,272,750,298,63,26,eye glasses
57676,2,chair,3,0,14108,17,129,67,186,136,57,69,chair
57677,13,desk,14,0,14108,40,78,101,256,245,178,144,desk
57678,0,desk,1,0,14109,17,1,144,142,255,141,111,desk
57679,4,chair,5,0,14109,15,174,122,208,159,34,37,chair
57680,6,chair,7,0,14109,16,129,120,159,160,30,40,chair
57681,6,chair,7,0,14110,34,74,134,179,254,105,120,chair
57682,1,chair,2,0,23962,63,612,199,987,576,375,377,chair
57683,2,desk,3,0,23962,53,70,352,833,576,763,224,desk
57684,4,desk,5,0,23963,15,349,585,767,1022,418,437,desk
57685,10,chair,11,0,23963,53,134,528,290,794,156,266,chair
57686,11,chair,12,0,23963,75,3,626,224,973,221,347,chair
57687,4,chair,5,0,23964,35,1214,869,1521,1307,307,438,chair
57688,5,chair,6,0,23964,51,73,1112,623,1649,550,537,chair
57689,9,vase,10,0,23964,17,487,945,568,1069,81,124,vase
57690,4,desk,5,0,23965,38,66,253,800,532,734,279,desk
57691,18,chair,19,0,23965,149,296,137,488,510,192,373,chair
57692,19,chair,20,1,23965,28,704,320,799,415,95,95,chair
57693,20,chair,21,1,23965,46,524,350,799,533,275,183,chair
57694,11,laptop,12,0,23966,16,638,159,768,261,130,102,laptop
57695,18,person,19,1,23966,50,532,70,683,256,151,186,person
57696,19,person,20,1,23966,52,425,103,629,327,204,224,person
57697,20,person,21,1,23966,77,317,157,637,548,320,391,person
57698,21,person,22,1,23966,44,100,216,438,550,338,334,person
57699,22,chair,23,1,23966,25,307,172,366,287,59,115,chair
57700,23,chair,24,1,23966,19,0,337,146,545,146,208,chair
57701,13,person,14,1,23967,105,475,49,869,550,394,501,person
57702,14,laptop,15,0,23967,18,390,476,780,682,390,206,laptop
57703,15,person,16,1,23967,87,56,67,497,683,441,616,person
57704,16,table,17,0,23967,30,2,108,484,307,482,199,dining table
57705,2,window,3,0,23968,58,161,0,634,466,473,466,window
57706,5,person,6,1,23968,78,107,1,505,478,398,477,person
57707,1,table,2,1,23969,68,329,431,730,683,401,252,dining table
57708,2,person,3,1,23969,57,129,197,383,681,254,484,person
57709,3,person,4,1,23969,100,417,96,700,682,283,586,person
57710,4,person,5,0,23969,91,704,170,851,682,147,512,person
57711,8,person,9,1,23969,45,874,171,960,531,86,360,person
57712,9,person,10,0,23969,31,895,206,1018,588,123,382,person
57713,3,person,4,0,23970,83,206,89,594,488,388,399,person
57714,3,table,4,0,23971,28,15,685,675,1000,660,315,dining table
57715,5,chair,6,1,23971,54,2,665,238,999,236,334,chair
57716,19,bottle,20,0,23971,19,478,588,523,721,45,133,bottle
57717,3,laptop,4,0,23972,26,3,424,685,781,682,357,laptop
57718,4,chair,5,1,23972,17,246,447,550,621,304,174,chair
57719,6,person,7,1,23972,77,345,17,1153,741,808,724,person
57720,2,desk,3,0,23973,20,132,100,848,572,716,472,desk
57721,7,desk,8,0,23974,35,57,222,771,519,714,297,desk
57722,10,chair,11,1,23974,20,537,247,617,396,80,149,chair
57723,11,chair,12,0,23974,33,400,305,562,522,162,217,chair
57724,12,chair,13,0,23974,27,184,305,340,522,156,217,chair
57725,13,chair,14,1,23974,23,158,246,238,400,80,154,chair
57726,4,table,5,0,23975,17,156,239,567,491,411,252,dining table
57727,5,chair,6,0,23975,95,51,182,269,491,218,309,chair
57728,4,toilet,5,0,23976,16,1545,531,1599,719,54,188,toilet
57729,12,television,13,0,23976,20,643,366,1112,751,469,385,tv
57730,8,person,9,1,14135,36,171,67,228,177,57,110,person
57731,11,person,12,1,14135,29,345,62,392,142,47,80,person
57732,20,person,21,0,14135,29,32,13,46,54,14,41,person
57733,26,person,27,1,14135,29,234,56,277,167,43,111,person
57734,0,window,1,0,14137,23,0,0,299,56,299,56,window
57735,5,desk,6,0,14137,17,235,39,299,151,64,112,desk
57736,6,desk,7,0,14137,19,117,112,299,292,182,180,desk
57737,7,desk,8,0,14137,20,2,107,157,293,155,186,desk
57738,18,chair,19,1,14137,17,134,65,177,104,43,39,chair
57739,15,chair,16,0,23992,56,691,705,827,899,136,194,chair
57740,16,chair,17,0,23992,44,432,685,551,851,119,166,chair
57741,22,chair,22,0,23992,24,1102,571,1151,621,49,50,chair
57742,26,chair,26,0,23992,20,1016,557,1058,631,42,74,chair
57743,11,person,12,1,23993,21,515,260,542,340,27,80,person
57744,23,desk,24,0,23993,15,0,340,255,493,255,153,desk
57745,25,chair,26,1,23993,31,242,326,302,453,60,127,chair
57746,26,person,27,1,23993,22,209,291,254,367,45,76,person
57747,1,desk,2,0,23994,20,883,312,1023,611,140,299,desk
57748,2,chair,3,1,23994,79,883,212,1023,611,140,399,chair
57749,4,desk,5,0,23994,56,290,314,848,612,558,298,desk
57750,5,chair,6,1,23994,68,92,359,431,611,339,252,chair
57751,5,table,6,0,14147,18,108,135,194,212,86,77,dining table
57752,2,chair,3,1,14149,19,202,100,231,144,29,44,chair
57753,3,sink,4,0,14150,18,246,53,420,133,174,80,sink
57754,4,person,5,1,14151,70,148,138,307,335,159,197,person
57755,5,person,6,1,14151,36,247,131,329,310,82,179,person
57756,0,person,1,1,14152,44,289,95,415,245,126,150,person
57757,1,dog,2,0,14152,35,270,180,411,280,141,100,dog
57758,3,person,4,0,14152,56,30,246,169,393,139,147,person
57759,6,person,7,1,14154,26,254,169,336,201,82,32,person
57760,7,person,8,0,14155,52,15,59,61,199,46,140,person
57761,8,person,9,1,14155,21,38,65,55,131,17,66,person
57762,9,person,10,1,14155,29,60,71,93,146,33,75,person
57763,10,person,11,1,14155,26,82,73,96,138,14,65,person
57764,11,person,12,1,14155,26,90,76,106,141,16,65,person
57765,12,person,13,1,14155,27,104,81,126,142,22,61,person
57766,13,person,14,1,14155,29,132,78,156,143,24,65,person
57767,14,person,15,0,14155,28,154,76,172,143,18,67,person
57768,15,person,16,0,14155,27,175,74,196,138,21,64,person
57769,16,person,17,1,14155,31,196,67,222,143,26,76,person
57770,17,person,18,1,14155,27,215,76,243,147,28,71,person
57771,18,person,19,0,14155,42,239,79,275,187,36,108,person
57772,19,person,20,1,14155,45,264,73,294,171,30,98,person
57773,7,table,6,0,14159,31,1332,849,2094,1557,762,708,dining table
57774,27,bed,26,0,14159,15,1030,745,1300,851,270,106,bed
57775,34,bowl,33,1,14159,16,1595,856,1713,912,118,56,bowl
57776,17,chair,18,1,23996,37,0,889,94,1097,94,208,chair
57777,5,person,6,1,14941,17,101,152,150,208,49,56,person
57778,14,person,15,1,14941,37,348,121,445,266,97,145,person
57779,15,bench,16,0,14941,17,287,289,471,366,184,77,bench
57780,18,person,19,1,14941,45,8,168,130,383,122,215,person
57781,4,person,5,0,14942,42,8,103,65,253,57,150,person
57782,9,person,10,0,14942,24,171,102,202,210,31,108,person
57783,10,person,11,0,14942,50,113,108,187,257,74,149,person
57784,4,person,5,0,14965,16,459,272,471,292,12,20,person
57785,19,chair,20,0,14965,15,117,262,135,289,18,27,chair
57786,11,person,12,1,14996,22,76,257,105,339,29,82,person
57787,15,car,16,0,15082,29,82,234,278,327,196,93,car
57788,9,car,10,0,15084,24,192,205,351,258,159,53,car
57789,10,car,11,0,15084,16,578,189,616,220,38,31,car
57790,4,car,5,0,15085,18,216,158,266,177,50,19,car
57791,11,car,12,1,15085,20,0,192,111,310,111,118,car
57792,4,car,5,0,15088,30,295,178,503,266,208,88,car
57793,5,car,6,1,15088,18,493,179,599,251,106,72,car
57794,9,car,10,1,15089,28,314,242,512,334,198,92,car
57795,10,car,11,0,15089,24,618,249,717,320,99,71,car
57796,12,car,13,1,15089,29,125,232,293,341,168,109,car
57797,13,car,14,1,15089,22,32,230,168,354,136,124,car
57798,6,car,7,0,15090,21,330,191,396,221,66,30,car
57799,7,car,8,0,15092,39,410,672,815,954,405,282,car
57800,10,car,11,1,15094,16,56,135,107,166,51,31,car
57801,12,car,13,1,15094,20,95,134,154,174,59,40,car
57802,13,car,14,1,15094,22,123,137,193,176,70,39,car
57803,14,car,15,0,15094,33,155,132,306,188,151,56,car
57804,21,car,22,1,15094,24,307,132,383,176,76,44,car
57805,22,car,23,1,15094,24,376,134,481,181,105,47,car
57806,4,car,5,1,15095,19,309,213,439,263,130,50,car
57807,5,car,6,1,15095,17,299,222,394,276,95,54,car
57808,6,car,7,1,15095,24,175,212,365,295,190,83,car
57809,7,car,8,0,15095,31,0,221,301,347,301,126,car
57810,4,car,5,0,15096,32,202,133,295,186,93,53,car
57811,5,car,6,0,15096,43,111,132,197,193,86,61,car
57812,6,car,7,0,15096,31,7,132,101,187,94,55,car
57813,8,car,9,1,15097,18,274,192,330,222,56,30,car
57814,10,car,11,1,15097,17,283,199,328,241,45,42,car
57815,11,car,12,1,15097,23,320,170,386,252,66,82,car
57816,12,car,13,1,15097,39,346,162,550,286,204,124,car
57817,13,car,14,1,15097,18,380,201,550,364,170,163,car
57818,16,car,17,1,15097,17,114,187,159,213,45,26,car
57819,18,car,19,1,15097,20,21,187,118,228,97,41,car
57820,7,car,8,0,15098,20,24,205,103,258,79,53,car
57821,8,car,9,1,15098,30,430,212,639,340,209,128,car
57822,4,car,5,1,15099,25,72,93,237,172,165,79,car
57823,9,car,10,1,15099,16,0,112,61,157,61,45,car
57824,13,person,14,0,15099,30,342,103,367,177,25,74,person
57825,6,car,7,1,15100,27,447,124,571,200,124,76,car
57826,7,car,8,1,15100,25,373,140,495,200,122,60,car
57827,8,car,9,0,15100,32,257,134,385,203,128,69,car
57828,9,car,10,0,15100,24,169,122,259,202,90,80,car
57829,10,car,11,0,15100,24,50,132,143,202,93,70,car
57830,5,car,6,1,15101,23,162,104,231,147,69,43,car
57831,6,car,7,1,15101,32,215,119,284,188,69,69,car
57832,9,car,10,1,15101,35,270,107,479,209,209,102,car
57833,1,person,2,0,25165,58,968,172,1376,958,408,786,person
57834,2,person,3,1,25165,38,1,134,335,474,334,340,person
57835,2,car,3,0,25166,58,164,268,694,519,530,251,car
57836,6,person,7,0,15223,29,278,64,307,164,29,100,person
57837,9,person,10,1,15223,21,350,233,390,362,40,129,person
57838,10,person,11,0,15223,33,422,209,485,376,63,167,person
57839,0,window,1,0,15694,16,10,0,333,138,323,138,window
57840,3,table,4,1,15694,20,195,104,280,139,85,35,dining table
57841,4,chair,5,0,15694,16,201,99,228,134,27,35,chair
57842,5,chair,6,1,15694,17,232,102,262,145,30,43,chair
57843,9,chair,10,1,15694,18,165,114,213,179,48,65,chair
57844,10,chair,11,1,15694,19,129,111,169,179,40,68,chair
57845,11,table,12,1,15694,16,124,111,213,178,89,67,dining table
57846,23,chair,24,1,15694,26,105,128,142,232,37,104,chair
57847,24,chair,25,1,15694,39,31,136,112,255,81,119,chair
57848,25,chair,26,1,15694,17,0,122,40,253,40,131,chair
57849,2,chair,3,1,15695,19,94,80,140,139,46,59,chair
57850,7,table,8,1,15695,25,184,66,269,132,85,66,dining table
57851,10,chair,11,1,15695,22,173,64,206,122,33,58,chair
57852,12,chair,13,1,15695,26,199,72,252,128,53,56,chair
57853,2,window,3,0,15696,18,0,2,242,118,242,116,window
57854,7,desk,8,1,15696,15,240,80,310,124,70,44,desk
57855,8,desk,9,1,15696,18,200,84,293,145,93,61,desk
57856,10,desk,11,0,15696,16,117,89,251,209,134,120,desk
57857,11,chair,12,1,15696,17,157,139,193,193,36,54,chair
57858,12,chair,13,0,15696,17,89,101,111,126,22,25,chair
57859,10,table,11,0,15697,20,41,136,89,195,48,59,dining table
57860,11,table,12,0,15697,23,70,135,120,191,50,56,dining table
57861,17,chair,18,0,15697,34,14,139,50,190,36,51,chair
57862,18,chair,19,1,15697,21,103,133,127,183,24,50,chair
57863,19,chair,20,1,15697,21,122,129,152,169,30,40,chair
57864,20,chair,21,0,15697,26,143,127,174,173,31,46,chair
57865,21,chair,22,0,15697,24,187,130,221,173,34,43,chair
57866,22,chair,23,0,15697,26,205,160,275,239,70,79,chair
57867,6,table,7,1,15698,34,93,112,300,200,207,88,dining table
57868,7,chair,8,0,15698,24,75,135,123,200,48,65,chair
57869,8,chair,9,1,15698,15,116,150,162,200,46,50,chair
57870,38,table,39,1,15698,16,232,103,300,123,68,20,dining table
57871,6,table,7,1,15699,31,671,415,1259,702,588,287,dining table
57872,9,chair,10,0,15699,37,916,432,1097,690,181,258,chair
57873,11,chair,12,1,15699,22,684,478,850,866,166,388,chair
57874,13,chair,14,0,15699,43,12,492,283,877,271,385,chair
57875,14,chair,15,0,15699,44,343,548,665,983,322,435,chair
57876,15,table,16,1,15699,27,101,476,933,985,832,509,dining table
57877,15,chair,16,0,15700,17,126,261,154,296,28,35,chair
57878,16,chair,17,0,15700,19,160,263,190,296,30,33,chair
57879,1,person,2,1,15701,29,123,87,236,249,113,162,person
57880,5,person,6,1,15701,19,200,103,263,216,63,113,person
57881,6,person,7,1,15701,28,209,48,280,125,71,77,person
57882,9,chair,10,1,15701,20,230,117,284,206,54,89,chair
57883,11,person,12,1,15701,36,78,49,162,156,84,107,person
57884,15,desk,16,1,15701,25,16,154,173,267,157,113,desk
57885,4,table,5,1,15702,35,198,393,831,767,633,374,dining table
57886,5,person,6,1,15702,87,592,186,967,758,375,572,person
57887,6,chair,7,1,15702,21,531,525,638,736,107,211,chair
57888,8,chair,9,1,15702,43,622,418,968,767,346,349,chair
57889,10,person,11,1,15702,91,37,132,562,767,525,635,person
57890,11,book,12,0,15702,16,262,406,433,456,171,50,book
57891,12,backpack,13,0,15702,31,299,334,633,410,334,76,backpack
57892,16,chair,17,1,15702,50,2,399,297,767,295,368,chair
57893,5,desk,6,1,15703,27,0,146,274,279,274,133,desk
57894,10,table,11,1,15704,39,2,124,301,240,299,116,dining table
57895,12,chair,13,1,15704,22,67,135,151,240,84,105,chair
57896,13,chair,14,1,15704,22,151,124,228,240,77,116,chair
57897,8,table,9,1,15705,18,153,116,230,156,77,40,dining table
57898,10,chair,11,1,15705,16,169,119,199,159,30,40,chair
57899,3,table,4,1,15706,19,134,135,300,151,166,16,dining table
57900,5,table,6,1,15706,27,15,130,137,162,122,32,dining table
57901,6,table,7,1,15706,22,0,155,299,225,299,70,dining table
57902,38,table,39,1,15708,19,173,101,226,122,53,21,dining table
57903,39,person,40,1,15708,19,196,98,215,114,19,16,person
57904,47,table,48,0,15708,15,295,103,379,152,84,49,dining table
57905,48,chair,49,1,15708,17,290,109,302,136,12,27,chair
57906,49,person,50,1,15708,21,295,103,316,126,21,23,person
57907,53,person,54,0,15708,28,340,109,367,150,27,41,person
57908,54,chair,55,0,15708,28,346,119,376,157,30,38,chair
57909,57,table,58,1,15708,47,0,133,280,214,280,81,dining table
57910,60,person,61,1,15708,30,177,112,217,147,40,35,person
57911,65,person,66,1,15708,30,3,137,57,183,54,46,person
57912,71,chair,72,0,15708,35,245,144,292,214,47,70,chair
57913,72,chair,73,1,15708,19,192,160,247,215,55,55,chair
57914,73,person,74,1,15708,35,113,146,177,215,64,69,person
57915,23,chair,24,1,15709,20,6,995,267,1171,261,176,chair
57916,11,person,12,1,15710,25,179,112,214,146,35,34,person
57917,12,person,13,1,15710,21,5,139,56,180,51,41,person
57918,41,chair,42,0,15710,19,245,145,290,213,45,68,chair
57919,42,chair,43,1,15710,22,194,159,247,213,53,54,chair
57920,44,person,45,1,15710,28,112,147,177,213,65,66,person
57921,47,person,48,1,15710,16,296,104,316,125,20,21,person
57922,48,person,49,0,15710,20,341,111,365,149,24,38,person
57923,50,chair,51,0,15710,15,345,120,375,156,30,36,chair
57924,58,person,59,1,15710,21,318,98,332,113,14,15,person
57925,50,chair,51,0,15711,46,76,137,152,225,76,88,chair
57926,52,table,53,0,15711,23,138,114,269,224,131,110,dining table
57927,53,table,54,0,15711,40,88,120,226,225,138,105,dining table
57928,32,door,33,1,244,17,159,452,267,629,108,177,door
57929,35,vase,36,0,244,60,100,508,201,694,101,186,vase
57930,37,flowerpot,38,0,244,23,471,566,512,627,41,61,potted plant
57931,39,flowerpot,40,0,244,23,519,581,571,648,52,67,potted plant
57932,54,flowerpot,55,0,244,23,1236,519,1370,598,134,79,potted plant
57933,63,flowerpot,64,0,244,21,0,568,70,723,70,155,potted plant
57934,66,person,67,1,244,47,752,473,920,566,168,93,person
57935,73,person,74,0,244,98,571,435,726,775,155,340,person
57936,86,door,87,0,244,16,544,433,560,583,16,150,door
57937,91,suitcase,92,0,244,39,535,588,612,828,77,240,suitcase
57938,97,door,98,0,244,18,1346,251,1410,594,64,343,door
57939,7,person,8,1,15713,24,188,146,249,226,61,80,person
57940,9,person,10,1,15713,47,2,140,97,314,95,174,person
57941,4,person,5,1,15715,21,187,105,211,136,24,31,person
57942,26,chair,27,0,15715,19,22,139,46,171,24,32,chair
57943,3,person,4,1,15716,19,437,640,598,856,161,216,person
57944,4,person,5,1,15716,18,594,627,753,866,159,239,person
57945,14,person,15,1,15716,46,1128,548,1422,1471,294,923,person
57946,15,person,16,1,15716,46,736,541,1109,1471,373,930,person
57947,15,person,16,0,15717,27,119,109,143,172,24,63,person
57948,16,person,17,0,15717,27,105,111,127,172,22,61,person
57949,3,window,4,1,15718,32,69,434,481,737,412,303,window
57950,4,person,5,1,15718,19,372,654,476,735,104,81,person
57951,15,person,16,1,15718,16,989,658,1119,746,130,88,person
57952,20,sofa,21,1,15719,20,129,219,311,264,182,45,couch
57953,7,table,8,0,15720,28,0,443,409,766,409,323,dining table
57954,10,bottle,11,0,15720,21,169,557,264,730,95,173,bottle
57955,11,chair,12,1,15720,32,670,550,1022,766,352,216,chair
57956,8,desk,9,0,15721,18,19,569,544,867,525,298,desk
57957,27,person,28,1,15721,17,649,504,722,564,73,60,person
57958,28,person,29,1,15721,31,636,470,854,629,218,159,person
57959,30,person,31,1,15721,47,1034,459,1249,712,215,253,person
57960,41,sofa,42,1,15721,19,0,714,346,959,346,245,couch
57961,23,person,24,1,15722,30,1151,651,1382,874,231,223,person
57962,22,chair,23,1,15724,38,3,661,338,957,335,296,chair
57963,16,sofa,17,1,15725,24,1684,731,2197,1035,513,304,couch
57964,20,sofa,21,0,15725,19,910,742,1219,926,309,184,couch
57965,22,chair,23,1,15726,27,1059,800,1239,1016,180,216,chair
57966,27,door,28,0,15726,16,1159,790,1343,1005,184,215,door
57967,29,door,30,0,15726,18,995,780,1165,1013,170,233,door
57968,31,door,32,0,15726,15,848,773,1001,1013,153,240,door
57969,12,chair,13,1,15727,19,3,160,71,239,68,79,chair
57970,14,person,15,1,15728,30,120,189,172,242,52,53,person
57971,17,person,18,0,15728,34,304,199,338,285,34,86,person
57972,17,vase,18,0,15729,17,776,686,866,850,90,164,vase
57973,3,clock,4,0,15730,15,329,27,378,99,49,72,clock
57974,7,person,8,1,15731,17,59,75,86,98,27,23,person
57975,8,person,9,1,15731,17,121,72,147,96,26,24,person
57976,9,person,10,1,15732,30,235,50,300,110,65,60,person
57977,11,person,12,0,15732,60,163,61,212,215,49,154,person
57978,8,person,9,1,15733,21,303,111,339,157,36,46,person
57979,13,window,14,0,15733,15,3,77,257,139,254,62,window
57980,15,chair,16,0,15734,24,320,97,389,209,69,112,chair
57981,16,chair,17,1,15734,16,457,99,499,212,42,113,chair
57982,17,desk,18,0,15734,31,401,56,457,149,56,93,desk
57983,4,door,5,0,15737,15,729,315,849,567,120,252,door
57984,20,person,21,1,15737,24,714,383,766,608,52,225,person
57985,21,person,22,0,15737,34,668,397,754,621,86,224,person
57986,8,chair,9,1,15738,28,0,132,42,228,42,96,chair
57987,5,person,6,1,15739,32,193,42,249,123,56,81,person
57988,6,person,7,1,15739,25,273,49,331,123,58,74,person
57989,8,person,9,0,15739,57,71,50,132,253,61,203,person
57990,9,person,10,0,15739,59,2,58,52,232,50,174,person
57991,4,window,5,0,15740,18,1650,119,2197,1065,547,946,window
57992,8,person,9,1,15741,18,177,118,208,164,31,46,person
57993,9,person,10,0,15741,47,103,128,147,258,44,130,person
57994,10,sofa,11,0,15741,24,38,185,84,224,46,39,couch
57995,12,chair,13,1,15741,20,0,210,40,286,40,76,chair
57996,7,chair,8,1,15742,25,511,233,619,354,108,121,chair
57997,12,chair,13,0,15742,53,85,357,235,591,150,234,chair
57998,6,chair,7,0,15743,15,830,687,1239,1068,409,381,chair
57999,4,window,5,0,15744,16,182,37,286,194,104,157,window
58000,14,person,15,1,15744,25,260,128,327,196,67,68,person
58001,15,person,16,1,15744,20,389,141,457,206,68,65,person
58002,8,person,9,1,15745,21,187,103,223,137,36,34,person
58003,9,chair,10,1,15745,15,213,153,282,217,69,64,chair
58004,7,person,8,1,15747,26,552,225,663,366,111,141,person
58005,8,person,9,1,15747,39,356,213,477,572,121,359,person
58006,9,person,10,0,15747,69,627,231,768,663,141,432,person
58007,24,suitcase,25,0,15747,17,493,621,599,768,106,147,suitcase
58008,2,door,3,1,15748,19,129,70,161,123,32,53,door
58009,8,person,9,1,15748,19,195,95,216,124,21,29,person
58010,9,person,10,1,15748,29,83,98,119,133,36,35,person
58011,10,person,11,0,15748,47,116,94,156,205,40,111,person
58012,11,person,12,0,15748,42,224,87,250,185,26,98,person
58013,15,suitcase,16,0,15748,22,166,148,191,203,25,55,suitcase
58014,9,person,10,1,15749,17,182,128,210,169,28,41,person
58015,4,vase,5,0,15750,18,287,72,329,152,42,80,vase
58016,4,desk,5,0,15751,16,239,311,501,476,262,165,desk
58017,10,chair,11,1,15751,32,443,281,594,467,151,186,chair
58018,3,person,4,1,15752,52,204,65,289,145,85,80,person
58019,4,person,5,1,15752,17,156,100,183,136,27,36,person
58020,5,person,6,1,15752,27,120,80,152,167,32,87,person
58021,6,person,7,1,15752,39,208,86,283,200,75,114,person
58022,28,sofa,29,1,15753,43,356,321,767,541,411,220,couch
58023,6,person,7,1,15754,33,244,85,310,208,66,123,person
58024,7,person,8,1,15754,44,120,98,220,172,100,74,person
58025,8,person,9,1,15754,64,2,54,122,252,120,198,person
58026,2,person,3,1,15759,27,0,51,35,173,35,122,person
58027,5,door,6,1,15759,22,65,22,103,65,38,43,door
58028,6,person,7,1,15759,41,35,34,105,115,70,81,person
58029,11,chair,12,1,15759,30,164,132,250,233,86,101,chair
58030,8,sofa,9,1,15760,26,220,152,342,205,122,53,couch
58031,15,person,16,1,15760,19,86,105,110,144,24,39,person
58032,12,chair,13,0,15761,15,276,110,307,150,31,40,chair
58033,13,chair,14,0,15761,35,302,165,397,252,95,87,chair
58034,20,person,21,1,15761,23,0,109,41,180,41,71,person
58035,3,door,4,1,15762,20,1267,398,1505,668,238,270,door
58036,4,window,5,1,15762,28,719,381,1002,768,283,387,window
58037,7,person,8,1,15762,21,927,592,1132,769,205,177,person
58038,8,person,9,1,15762,22,1538,592,1735,752,197,160,person
58039,10,person,11,0,15762,38,1745,597,1950,1286,205,689,person
58040,11,person,12,1,15762,77,1182,465,1667,1427,485,962,person
58041,12,person,13,0,15762,58,599,517,851,1405,252,888,person
58042,13,person,14,0,15762,85,80,481,472,1423,392,942,person
58043,4,person,5,0,15763,65,24,358,208,824,184,466,person
58044,7,window,8,0,15763,17,986,90,1205,785,219,695,window
58045,9,flowerpot,10,0,15763,18,1008,127,1119,491,111,364,potted plant
58046,27,chair,28,1,15763,18,920,674,1276,959,356,285,chair
58047,11,sofa,12,0,15764,20,74,435,312,588,238,153,couch
58048,10,person,11,1,15765,79,1022,112,1402,1212,380,1100,person
58049,17,chair,18,0,15765,85,268,644,806,1223,538,579,chair
58050,10,table,11,0,15766,17,5,221,48,277,43,56,dining table
58051,11,person,12,1,15767,18,803,705,935,858,132,153,person
58052,17,person,18,1,15767,25,327,704,502,950,175,246,person
58053,5,person,6,1,15768,21,106,99,134,134,28,35,person
58054,6,person,7,1,15768,17,202,100,226,130,24,30,person
58055,8,person,9,0,15768,45,128,86,171,227,43,141,person
58056,9,person,10,0,15768,36,235,96,261,193,26,97,person
58057,10,person,11,0,15768,41,303,96,336,203,33,107,person
58058,13,suitcase,14,0,15768,21,285,151,312,197,27,46,suitcase
58059,14,vase,15,0,15768,15,177,108,193,132,16,24,vase
58060,27,chair,28,0,24249,22,641,336,713,420,72,84,chair
58061,32,vase,33,0,24249,24,878,313,920,408,42,95,vase
58062,34,vase,35,0,24249,17,849,381,870,405,21,24,vase
58063,36,chair,37,1,24249,34,197,355,288,435,91,80,chair
58064,37,chair,38,0,24249,34,240,364,353,460,113,96,chair
58065,9,door,10,0,24250,17,82,122,204,342,122,220,door
58066,5,window,6,0,24251,15,71,262,266,444,195,182,window
58067,10,sofa,11,1,24251,36,88,432,278,524,190,92,couch
58068,28,sofa,29,0,24251,31,198,560,710,735,512,175,couch
58069,6,sink,7,0,15837,20,290,264,412,335,122,71,sink
58070,9,toilet,10,0,15837,19,78,363,144,457,66,94,toilet
58071,6,mirror,7,0,15840,15,200,79,225,121,25,42,mirror
58072,10,sink,11,0,15841,16,833,992,1241,1101,408,109,sink
58073,11,sink,12,0,15841,18,346,1143,914,1344,568,201,sink
58074,3,sink,4,0,15842,16,97,181,179,207,82,26,sink
58075,3,person,4,0,16128,47,224,81,287,211,63,130,person
58076,6,person,7,0,16133,69,320,141,488,402,168,261,person
58077,1,door,2,1,24364,24,287,0,467,289,180,289,door
58078,6,desk,7,0,24364,71,195,234,790,532,595,298,desk
58079,7,chair,8,0,24364,103,295,213,494,532,199,319,chair
58080,8,person,9,1,24364,104,355,206,502,468,147,262,person
58081,5,bowl,6,0,24365,15,912,707,979,755,67,48,bowl
58082,6,chair,7,0,24365,16,880,486,956,626,76,140,chair
58083,9,chair,10,0,24365,45,461,556,628,767,167,211,chair
58084,10,chair,11,1,24365,16,577,531,645,651,68,120,chair
58085,12,chair,13,1,24365,29,696,434,796,605,100,171,chair
58086,10,person,11,0,16171,36,527,101,591,274,64,173,person
58087,9,person,10,0,16172,16,165,192,174,223,9,31,person
58088,3,person,4,0,16173,22,242,221,277,302,35,81,person
58089,4,person,5,0,16173,29,298,219,333,310,35,91,person
58090,0,person,1,0,16174,38,251,171,298,306,47,135,person
58091,3,person,4,0,16177,28,331,181,374,252,43,71,person
58092,1,person,2,0,22105,25,283,139,303,228,20,89,person
58093,4,person,5,1,16179,26,265,48,327,110,62,62,person
58094,5,person,6,1,16179,16,225,64,255,110,30,46,person
58095,6,person,7,1,16179,21,138,51,188,114,50,63,person
58096,9,person,10,1,16179,24,48,56,103,111,55,55,person
58097,11,table,12,0,16179,17,2,157,350,246,348,89,dining table
58098,12,person,13,1,16179,28,105,90,180,166,75,76,person
58099,13,person,14,1,16179,32,255,82,348,179,93,97,person
58100,11,chair,12,0,16180,21,220,382,332,556,112,174,chair
58101,12,chair,13,0,16180,22,103,353,227,541,124,188,chair
58102,3,desk,4,0,16181,15,73,159,153,220,80,61,desk
58103,6,chair,7,0,16182,43,119,187,196,318,77,131,chair
58104,5,table,6,0,16183,26,68,172,304,299,236,127,dining table
58105,13,desk,14,0,16183,17,18,188,127,298,109,110,desk
58106,10,chair,11,0,16184,51,20,138,146,299,126,161,chair
58107,18,chair,19,1,16185,16,162,94,201,142,39,48,chair
58108,7,chair,8,1,16186,15,92,141,153,195,61,54,chair
58109,8,person,9,0,270,93,480,48,962,720,482,672,person
58110,1,person,2,1,271,23,0,153,44,318,44,165,person
58111,4,person,5,1,271,90,135,1,336,318,201,317,person
58112,4,horse,5,1,16734,25,54,373,308,611,254,238,horse
58113,8,horse,9,1,16734,29,1110,347,1279,645,169,298,horse
58114,10,person,11,0,16734,17,682,530,711,661,29,131,person
58115,9,horse,10,1,16735,16,466,332,514,390,48,58,horse
58116,10,person,11,0,16735,21,393,353,433,447,40,94,person
58117,11,person,12,0,16735,19,57,361,100,495,43,134,person
58118,7,horse,8,1,16737,25,74,99,135,164,61,65,horse
58119,8,horse,9,1,16737,26,148,92,201,146,53,54,horse
58120,10,horse,11,1,16737,17,264,83,298,122,34,39,horse
58121,1,horse,2,1,22221,55,26,23,197,189,171,166,horse
58122,5,horse,6,0,24484,147,296,627,1535,1648,1239,1021,horse
58123,6,person,7,0,24484,77,848,423,1150,1254,302,831,person
58124,9,flowerpot,10,0,16780,15,105,216,141,241,36,25,potted plant
58125,8,table,9,0,16783,25,66,117,145,202,79,85,dining table
58126,9,vase,10,0,16783,21,195,141,238,254,43,113,vase
58127,9,window,10,1,16786,15,2,153,64,298,62,145,window
58128,23,door,24,0,16788,17,224,15,256,147,32,132,door
58129,5,flowerpot,6,0,16791,15,49,150,91,202,42,52,potted plant
58130,5,mirror,6,0,16797,20,110,24,162,109,52,85,mirror
58131,6,bicycle,7,0,16800,61,155,196,298,287,143,91,bicycle
58132,10,chair,11,1,16808,21,225,110,255,185,30,75,chair
58133,2,window,3,0,16809,15,199,0,229,63,30,63,window
58134,11,sofa,12,0,16810,18,64,118,99,144,35,26,couch
58135,18,table,19,0,16834,35,4,163,63,216,59,53,dining table
58136,7,person,8,0,16836,18,679,430,725,492,46,62,person
58137,8,person,9,1,16836,16,661,204,707,282,46,78,person
58138,12,person,13,1,16836,20,752,395,790,465,38,70,person
58139,6,person,7,1,24491,22,97,540,128,647,31,107,person
58140,7,person,8,1,24491,18,356,564,378,649,22,85,person
58141,8,person,9,1,24491,18,408,547,418,646,10,99,person
58142,9,person,10,0,24491,33,411,532,456,648,45,116,person
58143,7,mirror,8,0,24492,17,1,361,99,467,98,106,mirror
58144,26,person,26,0,24494,40,260,568,303,691,43,123,person
58145,3,person,4,1,16846,31,183,59,239,130,56,71,person
58146,4,person,5,1,16846,27,248,51,284,138,36,87,person
58147,5,person,6,1,16846,38,33,40,100,163,67,123,person
58148,15,person,16,1,16855,30,475,156,589,426,114,270,person
58149,16,person,17,1,16855,39,287,184,430,462,143,278,person
58150,17,person,18,1,16855,22,89,182,202,291,113,109,person
58151,12,person,13,0,19305,27,263,238,304,317,41,79,person
58152,13,person,14,0,19305,26,300,211,338,300,38,89,person
58153,15,person,16,0,19305,20,390,262,419,349,29,87,person
58154,16,person,17,1,19305,15,453,324,497,382,44,58,person
58155,20,person,21,1,19305,22,355,205,389,281,34,76,person
58156,39,person,40,0,19305,20,334,135,357,194,23,59,person
58157,40,person,41,0,19305,19,398,199,419,262,21,63,person
58158,41,person,42,1,19305,15,269,333,304,380,35,47,person
58159,43,person,44,1,19305,17,297,175,332,216,35,41,person
58160,32,person,30,1,19306,32,140,232,265,385,125,153,person
58161,33,person,31,1,19306,23,451,220,557,294,106,74,person
58162,34,chair,32,1,19306,17,430,286,560,413,130,127,chair
58163,57,person,55,1,19306,17,182,114,209,138,27,24,person
58164,4,desk,5,0,19307,18,70,123,323,240,253,117,desk
58165,6,person,7,1,19307,35,39,82,111,201,72,119,person
58166,12,person,13,1,19307,44,226,105,320,259,94,154,person
58167,9,person,10,1,19308,27,163,12,228,120,65,108,person
58168,10,person,11,1,19308,24,216,26,285,106,69,80,person
58169,11,person,12,1,19308,45,225,38,358,171,133,133,person
58170,12,person,13,1,19308,24,323,85,360,244,37,159,person
58171,20,person,21,1,19308,40,235,124,352,304,117,180,person
58172,23,person,24,1,19308,27,119,164,244,304,125,140,person
58173,15,person,16,0,19309,16,167,175,178,196,11,21,person
58174,16,person,17,1,19309,16,96,183,108,208,12,25,person
58175,5,person,6,1,19498,30,66,248,224,404,158,156,person
58176,2,person,3,1,19515,36,0,12,172,247,172,235,person
58177,3,cat,4,0,19515,48,60,79,189,246,129,167,cat
58178,3,horse,4,1,19516,43,2,75,164,283,162,208,horse
58179,4,person,5,1,19516,37,5,39,62,163,57,124,person
58180,5,horse,6,1,19516,47,47,1,359,283,312,282,horse
58181,6,person,7,1,19516,56,236,51,354,281,118,230,person
58182,16,person,17,1,19517,54,295,3,551,370,256,367,person
58183,17,dog,18,0,19517,80,112,105,449,424,337,319,dog
58184,2,person,3,1,19518,70,33,0,239,248,206,248,person
58185,4,dog,5,0,19518,52,131,137,236,225,105,88,dog
58186,4,person,5,1,19519,56,1028,70,1490,1038,462,968,person
58187,5,person,6,1,19519,85,261,22,1115,1198,854,1176,person
58188,7,dog,8,0,19519,71,798,467,1195,1171,397,704,dog
58189,1,person,2,1,22282,117,150,0,459,288,309,288,person
58190,2,dog,3,1,22282,61,0,47,292,287,292,240,dog
58191,3,clock,4,1,22282,20,99,0,189,79,90,79,clock
58192,1,person,2,1,22283,60,39,7,218,195,179,188,person
58193,2,person,3,1,22284,73,6,1,205,184,199,183,person
58194,3,dog,4,0,22284,61,185,38,249,177,64,139,dog
58195,1,person,2,1,22285,54,2,1,245,386,243,385,person
58196,2,dog,3,0,22285,42,77,276,249,412,172,136,dog
58197,3,person,4,1,24638,61,1565,446,2011,1362,446,916,person
58198,4,person,5,1,24638,100,1065,244,1632,1394,567,1150,person
58199,5,person,6,0,24638,116,665,2,1178,1483,513,1481,person
58200,6,person,7,1,24638,51,4,4,771,1648,767,1644,person
58201,10,person,11,1,24639,24,1504,760,1655,1241,151,481,person
58202,12,dog,13,1,24639,72,702,696,861,919,159,223,dog
58203,13,person,14,1,24639,111,376,168,953,868,577,700,person
58204,15,bottle,16,0,24639,20,513,812,595,1019,82,207,bottle
58205,3,cat,4,1,24641,53,96,244,505,598,409,354,cat
58206,6,dog,7,1,24642,47,136,322,372,936,236,614,dog
58207,7,dog,8,0,24642,100,292,207,764,751,472,544,dog
58208,1,cat,2,0,24643,57,4,1,459,636,455,635,cat
58209,3,person,4,0,301,31,11,97,68,230,57,133,person
58210,5,window,6,0,301,25,306,0,540,110,234,110,window
58211,7,person,8,1,301,109,71,53,320,319,249,266,person
58212,16,person,17,1,301,69,205,6,511,319,306,313,person
58213,8,chair,9,1,19605,28,139,121,202,195,63,74,chair
58214,9,chair,10,1,19605,23,202,133,255,223,53,90,chair
58215,11,chair,12,1,19605,30,77,118,132,185,55,67,chair
58216,13,chair,14,0,19605,24,0,122,52,198,52,76,chair
58217,17,chair,18,0,19606,27,48,263,149,380,101,117,chair
58218,18,chair,19,1,19606,28,85,255,169,361,84,106,chair
58219,19,chair,20,1,19606,28,113,250,189,344,76,94,chair
58220,21,chair,22,1,19606,16,250,232,293,281,43,49,chair
58221,22,chair,23,1,19606,17,289,231,332,294,43,63,chair
58222,25,chair,26,1,19606,26,363,241,434,318,71,77,chair
58223,26,chair,27,0,19606,30,377,245,455,342,78,97,chair
58224,2,table,3,0,19607,17,42,159,191,225,149,66,dining table
58225,3,window,4,0,19607,20,177,0,263,134,86,134,window
58226,4,chair,5,1,19607,21,125,130,165,177,40,47,chair
58227,5,chair,6,1,19607,32,167,135,217,211,50,76,chair
58228,7,person,8,0,19607,48,189,109,269,224,80,115,person
58229,12,chair,13,1,19607,24,10,140,58,217,48,77,chair
58230,13,chair,14,1,19607,23,257,158,299,225,42,67,chair
58231,7,chair,8,1,19608,15,227,188,253,243,26,55,chair
58232,8,chair,9,0,19608,18,181,184,219,239,38,55,chair
58233,11,chair,12,1,19608,33,284,161,346,234,62,73,chair
58234,12,chair,13,1,19608,24,334,165,403,235,69,70,chair
58235,13,chair,14,1,19608,19,387,172,449,280,62,108,chair
58236,3,chair,4,0,19609,18,459,482,524,570,65,88,chair
58237,4,chair,5,0,19609,17,405,489,474,593,69,104,chair
58238,5,chair,6,0,19609,21,294,506,379,628,85,122,chair
58239,6,chair,7,0,19609,24,207,519,307,658,100,139,chair
58240,7,chair,8,0,19609,25,80,595,229,767,149,172,chair
58241,4,chair,5,1,19610,44,1159,879,1555,1397,396,518,chair
58242,9,clock,10,0,19610,16,1198,391,1341,548,143,157,clock
58243,13,chair,14,0,19610,50,1493,985,2048,1646,555,661,chair
58244,14,mirror,15,0,19610,27,255,316,504,645,249,329,mirror
58245,17,chair,18,0,19611,23,138,185,244,306,106,121,chair
58246,18,chair,19,0,19611,21,188,171,283,284,95,113,chair
58247,19,chair,20,0,19611,22,234,159,317,261,83,102,chair
58248,20,chair,21,0,19611,21,269,148,346,239,77,91,chair
58249,21,chair,22,0,19611,20,301,138,369,224,68,86,chair
58250,22,chair,23,0,19611,19,326,132,392,210,66,78,chair
58251,3,window,4,0,19612,19,170,56,255,135,85,79,window
58252,9,chair,10,1,19612,21,118,115,156,141,38,26,chair
58253,10,sofa,11,0,19612,34,145,115,203,159,58,44,couch
58254,12,chair,13,1,19612,17,225,118,255,161,30,43,chair
58255,13,sofa,14,1,19612,36,38,124,140,163,102,39,couch
58256,3,chair,4,0,19613,18,389,222,462,367,73,145,chair
58257,4,chair,5,0,19613,17,474,223,546,370,72,147,chair
58258,26,chair,26,1,19613,21,574,232,696,375,122,143,chair
58259,27,chair,27,1,19613,26,585,242,725,398,140,156,chair
58260,28,chair,28,1,19613,27,605,252,760,400,155,148,chair
58261,14,chair,15,0,19614,21,337,833,768,1152,431,319,chair
58262,15,chair,16,1,19614,25,331,931,869,1449,538,518,chair
58263,9,person,10,0,19616,16,134,59,153,88,19,29,person
58264,15,sofa,16,1,19617,31,251,217,424,317,173,100,couch
58265,16,sofa,17,1,19617,36,327,250,579,401,252,151,couch
58266,6,chair,7,1,19618,15,2,126,24,184,22,58,chair
58267,7,chair,8,1,19618,21,30,125,74,176,44,51,chair
58268,8,chair,9,0,19618,27,78,126,122,186,44,60,chair
58269,9,chair,10,0,19618,27,130,126,173,186,43,60,chair
58270,10,chair,11,1,19618,18,190,143,245,210,55,67,chair
58271,11,chair,12,1,19618,15,204,159,255,236,51,77,chair
58272,14,window,15,0,19619,17,356,212,497,418,141,206,window
58273,15,window,16,1,19619,20,560,209,707,395,147,186,window
58274,17,person,18,0,19620,43,707,349,797,559,90,210,person
58275,24,table,25,0,19621,17,118,224,176,264,58,40,dining table
58276,39,chair,40,1,19621,20,296,252,343,295,47,43,chair
58277,40,chair,41,1,19621,20,272,239,310,275,38,36,chair
58278,5,sofa,6,0,19622,29,74,233,266,406,192,173,couch
58279,6,sofa,7,1,19622,19,190,202,344,301,154,99,couch
58280,4,chair,5,0,19623,31,27,74,113,155,86,81,chair
58281,5,chair,6,1,19623,16,2,85,39,161,37,76,chair
58282,6,chair,7,1,19623,32,188,67,272,178,84,111,chair
58283,7,chair,8,0,19623,40,246,66,349,199,103,133,chair
58284,3,bench,4,0,19624,25,60,135,255,238,195,103,bench
58285,13,sofa,14,1,19626,20,13,189,94,255,81,66,couch
58286,14,sofa,15,1,19626,17,178,183,255,255,77,72,couch
58287,3,table,4,1,19629,16,21,225,115,305,94,80,dining table
58288,6,person,7,1,19629,39,114,126,258,305,144,179,person
58289,7,person,8,1,19629,32,226,134,369,306,143,172,person
58290,13,table,14,0,19630,33,161,192,247,269,86,77,dining table
58291,9,chair,10,0,19631,20,275,112,298,151,23,39,chair
58292,10,chair,11,0,19631,20,254,110,277,149,23,39,chair
58293,15,chair,16,0,19631,22,202,124,239,188,37,64,chair
58294,16,chair,17,0,19631,24,237,129,271,186,34,57,chair
58295,19,chair,20,0,19631,19,9,180,118,299,109,119,chair
58296,21,chair,22,0,19631,16,298,134,350,218,52,84,chair
58297,23,chair,24,0,19631,19,337,148,399,250,62,102,chair
58298,10,chair,11,0,19632,25,100,136,181,219,81,83,chair
58299,11,chair,12,0,19632,20,21,140,80,225,59,85,chair
58300,13,chair,14,1,19632,19,140,144,224,208,84,64,chair
58301,14,chair,15,1,19632,35,118,177,225,256,107,79,chair
58302,6,chair,7,1,19634,15,3,301,106,491,103,190,chair
58303,7,chair,8,0,19634,19,71,284,223,486,152,202,chair
58304,8,chair,9,1,19634,22,192,275,325,455,133,180,chair
58305,9,chair,10,0,19634,15,368,272,499,438,131,166,chair
58306,10,chair,11,0,19634,21,446,286,600,492,154,206,chair
58307,11,chair,12,0,19634,23,559,304,730,533,171,229,chair
58308,2,sofa,3,0,19635,27,136,122,256,216,120,94,couch
58309,7,sofa,8,0,19636,31,284,229,516,348,232,119,couch
58310,16,chair,17,1,19636,15,420,321,612,477,192,156,chair
58311,17,chair,18,1,19636,18,460,294,604,402,144,108,chair
58312,18,chair,19,1,19636,17,482,262,614,363,132,101,chair
58313,4,chair,5,0,19637,21,2,161,65,255,63,94,chair
58314,5,chair,6,0,19637,15,37,157,100,255,63,98,chair
58315,6,chair,7,0,19637,19,120,156,177,249,57,93,chair
58316,7,chair,8,0,19637,19,153,159,212,250,59,91,chair
58317,6,sofa,7,0,19639,26,85,134,255,222,170,88,couch
58318,7,chair,8,0,19640,15,478,260,618,466,140,206,chair
58319,8,chair,9,0,19640,19,500,271,674,509,174,238,chair
58320,9,chair,10,0,19640,18,534,291,742,521,208,230,chair
58321,10,chair,11,0,19640,21,564,318,773,599,209,281,chair
58322,10,window,11,0,19641,27,203,0,382,293,179,293,window
58323,13,person,14,1,19641,18,2,150,25,350,23,200,person
58324,5,person,6,0,19642,30,139,65,154,127,15,62,person
58325,6,person,7,0,19642,29,114,66,141,132,27,66,person
58326,7,chair,8,0,19642,21,52,127,122,214,70,87,chair
58327,8,chair,9,0,19642,19,18,119,83,197,65,78,chair
58328,9,chair,10,1,19642,25,60,119,153,196,93,77,chair
58329,10,person,11,1,19642,20,68,96,115,127,47,31,person
58330,20,chair,21,0,19642,17,194,97,226,131,32,34,chair
58331,21,chair,22,1,19642,17,216,99,248,131,32,32,chair
58332,1,window,2,0,19643,19,1041,0,1278,957,237,957,window
58333,3,table,4,0,19643,21,172,527,317,679,145,152,dining table
58334,1,chair,2,0,19646,42,0,420,438,931,438,511,chair
58335,3,chair,4,0,19646,43,253,404,642,832,389,428,chair
58336,4,vase,5,0,19646,26,568,379,761,714,193,335,vase
58337,8,chair,9,0,19646,32,779,389,1089,748,310,359,chair
58338,9,chair,10,0,19646,37,994,393,1313,781,319,388,chair
58339,7,table,8,0,19647,17,46,138,120,196,74,58,dining table
58340,7,table,8,0,19648,17,26,180,143,255,117,75,dining table
58341,8,vase,9,0,19648,15,31,118,48,144,17,26,vase
58342,11,sofa,12,0,19649,19,65,142,146,189,81,47,couch
58343,12,sofa,13,0,19649,22,0,149,59,215,59,66,couch
58344,13,sofa,14,0,19649,28,167,148,251,208,84,60,couch
58345,9,sofa,10,0,19651,21,0,828,925,1648,925,820,couch
58346,11,sofa,12,0,19651,50,953,797,2196,1468,1243,671,couch
58347,2,window,3,0,19652,16,1700,0,1873,617,173,617,window
58348,5,sofa,6,0,19652,50,529,534,1281,1022,752,488,couch
58349,10,clock,11,0,19652,31,1340,498,1444,627,104,129,clock
58350,11,flowerpot,12,0,19652,20,1432,502,1526,611,94,109,potted plant
58351,54,sofa,55,0,19652,80,1,777,1157,1464,1156,687,couch
58352,6,chair,7,0,19653,15,37,126,85,193,48,67,chair
58353,7,chair,8,0,19653,15,67,129,118,205,51,76,chair
58354,9,chair,10,0,19653,21,155,136,211,217,56,81,chair
58355,4,chair,5,1,19654,33,306,121,358,232,52,111,chair
58356,11,window,12,0,19654,15,17,1,165,162,148,161,window
58357,20,chair,21,0,19656,41,918,728,1184,1080,266,352,chair
58358,21,chair,22,0,19656,40,712,724,975,1066,263,342,chair
58359,22,chair,23,0,19656,38,506,716,769,1049,263,333,chair
58360,23,chair,24,1,19656,16,943,863,1171,898,228,35,chair
58361,24,chair,25,1,19656,20,62,747,438,1161,376,414,chair
58362,25,chair,26,1,19656,19,0,777,275,1163,275,386,chair
58363,26,chair,27,1,19656,31,0,1102,393,1566,393,464,chair
58364,9,sofa,10,0,19657,31,5,126,110,184,105,58,couch
58365,11,chair,12,1,19657,28,130,127,169,177,39,50,chair
58366,12,chair,13,1,19657,23,157,127,200,176,43,49,chair
58367,13,chair,14,1,19657,25,174,130,221,189,47,59,chair
58368,14,sofa,15,1,19657,36,195,132,313,195,118,63,couch
58369,6,sofa,7,1,19658,39,450,229,784,397,334,168,couch
58370,5,person,6,0,19659,44,471,345,600,531,129,186,person
58371,2,bench,3,1,19661,15,453,506,668,664,215,158,bench
58372,5,bench,6,1,19661,15,570,533,889,695,319,162,bench
58373,6,person,7,1,19661,24,703,407,914,539,211,132,person
58374,8,bench,9,0,19661,34,640,528,1279,793,639,265,bench
58375,11,backpack,12,0,19661,20,141,637,332,853,191,216,backpack
58376,12,person,13,1,19661,46,79,444,425,867,346,423,person
58377,8,chair,9,0,19662,50,149,518,378,825,229,307,chair
58378,9,chair,10,0,19662,51,297,531,534,858,237,327,chair
58379,10,chair,11,0,19662,48,479,543,724,900,245,357,chair
58380,11,chair,12,0,19662,50,682,559,936,942,254,383,chair
58381,12,chair,13,0,19662,50,920,571,1191,991,271,420,chair
58382,13,chair,14,0,19662,53,1184,591,1488,1023,304,432,chair
58383,14,flowerpot,15,1,19662,27,57,635,182,760,125,125,potted plant
58384,6,dog,7,0,19663,35,191,122,228,177,37,55,dog
58385,13,chair,14,0,19663,27,136,99,170,146,34,47,chair
58386,14,chair,15,0,19663,24,83,101,117,149,34,48,chair
58387,18,chair,19,1,19663,23,17,114,65,156,48,42,chair
58388,19,chair,20,1,19663,24,0,124,61,175,61,51,chair
58389,20,chair,21,1,19663,17,0,148,49,213,49,65,chair
58390,10,sofa,11,1,19665,31,0,394,302,738,302,344,couch
58391,20,chair,21,0,19666,34,749,944,1135,1443,386,499,chair
58392,21,chair,22,0,19666,35,952,983,1393,1548,441,565,chair
58393,22,chair,23,0,19666,33,1221,1035,1726,1647,505,612,chair
58394,23,chair,24,0,19666,34,1562,1101,2160,1649,598,548,chair
58395,7,chair,8,1,19670,25,2,157,71,239,69,82,chair
58396,8,chair,9,0,19670,32,67,143,134,239,67,96,chair
58397,9,chair,10,1,19670,25,119,134,176,217,57,83,chair
58398,10,chair,11,0,19670,29,186,132,243,215,57,83,chair
58399,11,chair,12,0,19670,31,252,137,315,228,63,91,chair
58400,12,chair,13,0,19670,23,316,144,370,238,54,94,chair
58401,7,sofa,8,0,19671,40,1408,789,1999,1169,591,380,couch
58402,9,chair,10,1,19671,15,1052,778,1240,1024,188,246,chair
58403,11,sofa,12,0,19671,55,46,807,1057,1360,1011,553,couch
58404,16,sofa,17,1,19671,40,0,1092,2197,1649,2197,557,couch
58405,4,clock,5,0,19672,20,441,324,477,424,36,100,clock
58406,5,sofa,6,0,19672,50,5,374,504,765,499,391,couch
58407,7,sofa,8,0,19672,33,496,343,1023,727,527,384,couch
58408,4,sofa,5,0,19673,26,95,91,251,143,156,52,couch
58409,5,sofa,6,0,19673,18,0,109,113,202,113,93,couch
58410,6,sofa,7,0,19673,15,228,109,332,202,104,93,couch
58411,35,sofa,36,0,19674,57,149,752,1438,1267,1289,515,couch
58412,2,sofa,3,0,19676,34,2,90,121,176,119,86,couch
58413,3,sofa,4,0,19676,25,135,99,320,229,185,130,couch
58414,4,sofa,5,0,19679,29,445,336,822,594,377,258,couch
58415,2,sofa,3,1,19680,31,1027,573,1598,1180,571,607,couch
58416,10,mirror,11,0,19680,38,327,34,542,433,215,399,mirror
58417,6,sofa,7,1,19681,54,296,507,1507,998,1211,491,couch
58418,10,window,11,0,19682,20,1178,235,1723,861,545,626,window
58419,3,sofa,4,0,19683,17,337,520,931,845,594,325,couch
58420,5,chair,6,1,19683,20,1159,722,1279,959,120,237,chair
58421,4,sofa,5,0,19685,37,0,796,1017,1649,1017,853,couch
58422,14,sofa,15,0,19686,26,969,904,1539,1342,570,438,couch
58423,6,window,7,0,19688,15,0,0,66,260,66,260,window
58424,8,sofa,9,1,19688,28,23,151,84,237,61,86,couch
58425,12,sofa,13,1,19688,27,121,134,264,192,143,58,couch
58426,1,sofa,2,0,19689,38,0,70,149,222,149,152,couch
58427,4,window,5,0,19689,17,168,1,299,65,131,64,window
58428,9,sofa,10,0,19689,34,146,57,300,152,154,95,couch
58429,12,chair,13,0,19690,15,477,740,621,948,144,208,chair
58430,13,chair,14,0,19690,15,100,737,252,950,152,213,chair
58431,11,chair,12,1,19691,16,187,179,256,215,69,36,chair
58432,13,chair,14,1,19691,22,201,162,257,210,56,48,chair
58433,14,chair,15,1,19691,20,204,151,256,188,52,37,chair
58434,15,chair,16,1,19691,18,209,136,255,170,46,34,chair
58435,16,sofa,17,0,19692,17,1732,818,2039,936,307,118,couch
58436,19,window,20,0,19692,27,0,414,1322,981,1322,567,window
58437,1,chair,2,0,19693,48,65,101,148,210,83,109,chair
58438,2,chair,3,0,19693,32,89,112,188,205,99,93,chair
58439,4,chair,5,0,19693,38,119,130,244,255,125,125,chair
58440,5,person,6,0,19694,97,1015,61,1510,920,495,859,person
58441,10,window,11,0,19694,38,68,1,802,354,734,353,window
58442,13,person,14,0,19694,96,44,95,688,1064,644,969,person
58443,9,television,10,0,19695,33,187,17,262,90,75,73,tv
58444,2,window,3,0,19697,17,863,0,1317,490,454,490,window
58445,5,flowerpot,6,1,19697,18,952,546,1071,673,119,127,potted plant
58446,8,sofa,9,0,19698,45,27,136,249,231,222,95,couch
58447,5,mirror,6,0,19699,15,24,32,102,147,78,115,mirror
58448,3,chair,4,0,24678,42,1330,466,1584,889,254,423,chair
58449,4,chair,5,0,24678,38,1102,465,1342,885,240,420,chair
58450,5,chair,6,0,24678,36,876,448,1095,883,219,435,chair
58451,6,chair,7,0,24678,38,660,425,884,877,224,452,chair
58452,7,chair,8,0,24678,40,444,426,685,873,241,447,chair
58453,8,chair,9,0,24678,39,230,425,479,868,249,443,chair
58454,9,chair,10,0,24678,45,28,426,279,864,251,438,chair
58455,7,sofa,8,0,24679,29,280,286,606,523,326,237,couch
58456,8,sofa,9,0,24679,22,1,417,478,749,477,332,couch
58457,15,chair,16,1,24679,27,761,416,923,750,162,334,chair
58458,9,table,10,0,24680,32,402,437,558,719,156,282,dining table
58459,10,chair,11,0,24680,60,468,400,738,694,270,294,chair
58460,11,chair,12,1,24680,41,600,405,778,610,178,205,chair
58461,12,chair,13,1,24680,39,658,393,833,608,175,215,chair
58462,13,person,14,0,24680,56,723,307,893,606,170,299,person
58463,14,person,15,1,24680,15,974,512,1023,666,49,154,person
58464,17,person,18,0,24680,55,37,228,170,556,133,328,person
58465,22,window,23,0,24680,18,34,150,115,303,81,153,window
58466,3,window,4,0,24681,16,97,52,369,451,272,399,window
58467,4,window,5,0,24681,20,590,52,993,469,403,417,window
58468,12,sofa,13,0,24681,56,526,397,929,631,403,234,couch
58469,14,sofa,15,0,24681,31,305,339,544,502,239,163,couch
58470,4,sofa,5,0,24682,39,0,301,481,653,481,352,couch
58471,6,vase,7,0,24682,23,458,407,504,494,46,87,vase
58472,12,chair,13,1,24682,19,885,387,1023,517,138,130,chair
58473,2,chair,3,0,24683,32,434,500,646,801,212,301,chair
58474,3,chair,4,0,24683,19,437,489,617,604,180,115,chair
58475,4,person,5,0,24683,73,276,348,604,684,328,336,person
58476,5,plant pot,6,0,24683,54,268,445,488,622,220,177,potted plant
58477,7,chair,8,0,24683,20,1,470,123,760,122,290,chair
58478,8,chair,9,1,24683,36,58,474,148,730,90,256,chair
58479,9,chair,10,1,24683,35,62,458,197,664,135,206,chair
58480,10,chair,11,0,24683,29,119,445,225,617,106,172,chair
58481,14,window,15,0,24684,22,480,102,584,298,104,196,window
58482,15,window,16,0,24684,16,279,114,349,284,70,170,window
58483,22,sofa,23,0,24684,31,1,356,245,499,244,143,couch
58484,5,chair,6,0,24685,53,65,172,306,403,241,231,chair
58485,9,sofa,10,0,24685,54,440,160,909,371,469,211,couch
58486,10,chair,11,0,24685,75,644,243,965,580,321,337,chair
58487,11,sofa,12,1,24685,39,613,153,1016,357,403,204,couch
58488,17,chair,18,1,24685,23,1054,132,1177,195,123,63,chair
58489,21,chair,22,1,24685,21,778,95,851,167,73,72,chair
58490,22,chair,23,1,24685,19,718,92,779,162,61,70,chair
58491,24,chair,25,1,24685,15,839,85,884,168,45,83,chair
58492,35,plant pot,36,0,24685,15,450,196,521,228,71,32,potted plant
58493,43,chair,44,1,24685,21,0,396,263,693,263,297,chair
58494,13,table,14,0,24686,44,77,450,388,681,311,231,dining table
58495,20,chair,21,1,24686,22,102,476,149,541,47,65,chair
58496,21,chair,22,1,24686,36,114,498,261,682,147,184,chair
58497,22,chair,23,1,24686,29,284,478,330,682,46,204,chair
58498,23,chair,24,1,24686,20,326,466,350,657,24,191,chair
58499,24,chair,25,1,24686,24,344,453,369,618,25,165,chair
58500,25,chair,26,1,24686,18,363,445,381,591,18,146,chair
58501,27,chair,28,1,24686,16,379,438,400,566,21,128,chair
58502,28,chair,29,1,24686,15,395,434,406,551,11,117,chair
58503,31,table,32,0,24686,36,602,449,762,620,160,171,dining table
58504,32,chair,33,1,24686,30,596,477,678,614,82,137,chair
58505,33,sofa,34,0,24686,34,732,438,834,574,102,136,couch
58506,35,chair,36,1,24686,21,672,456,743,612,71,156,chair
58507,37,backpack,38,0,24686,19,604,417,640,479,36,62,backpack
58508,40,person,41,0,24686,78,504,333,598,600,94,267,person
58509,41,backpack,42,1,24686,27,513,489,556,541,43,52,backpack
58510,1,person,2,0,19706,28,313,97,356,156,43,59,person
58511,11,person,12,1,19711,16,182,181,199,207,17,26,person
58512,13,person,14,0,19711,22,153,278,181,356,28,78,person
58513,14,person,15,0,19711,35,235,281,285,381,50,100,person
58514,15,person,16,0,19711,41,283,284,331,406,48,122,person
58515,17,person,18,0,19711,22,104,284,119,338,15,54,person
58516,7,person,8,0,19712,35,956,346,1352,844,396,498,person
58517,33,person,32,1,19714,17,96,132,108,153,12,21,person
58518,6,person,7,0,19715,63,373,622,668,1307,295,685,person
58519,3,person,4,0,19725,23,417,121,432,190,15,69,person
58520,4,person,5,0,19725,30,435,125,467,192,32,67,person
58521,1,person,2,0,19726,33,148,192,196,264,48,72,person
58522,19,table,20,0,19732,17,257,332,322,378,65,46,dining table
58523,0,person,1,0,19733,49,8,154,64,290,56,136,person
58524,1,person,2,0,19733,55,53,164,117,317,64,153,person
58525,2,person,3,1,19733,41,303,140,362,282,59,142,person
58526,3,person,4,1,19733,32,448,145,486,305,38,160,person
58527,5,person,6,0,19734,26,252,175,300,246,48,71,person
58528,10,table,11,0,19735,18,220,203,374,315,154,112,dining table
58529,0,person,1,0,19739,30,180,221,259,278,79,57,person
58530,1,person,2,1,19739,19,124,162,148,267,24,105,person
58531,2,person,3,0,19739,39,92,154,151,316,59,162,person
58532,5,backpack,6,0,19739,21,253,288,311,331,58,43,backpack
58533,0,toilet,1,0,19744,32,138,283,253,420,115,137,toilet
58534,1,toilet,2,1,19744,26,221,259,327,343,106,84,toilet
58535,2,toilet,3,1,19744,27,240,331,374,419,134,88,toilet
58536,3,toilet,4,1,19744,27,321,304,446,419,125,115,toilet
58537,4,toilet,5,1,19744,19,461,359,559,420,98,61,toilet
58538,10,sink,11,0,19744,18,425,277,544,354,119,77,sink
58539,13,toilet,14,1,19744,16,15,225,102,348,87,123,toilet
58540,15,sink,16,1,19744,15,270,200,358,263,88,63,sink
58541,27,toilet,28,1,19744,17,80,202,169,239,89,37,toilet
58542,31,sink,32,1,19744,15,242,222,333,277,91,55,sink
58543,13,person,14,0,19746,22,175,173,193,216,18,43,person
58544,14,person,15,1,19746,25,196,157,213,184,17,27,person
58545,16,person,17,0,19746,30,197,168,212,229,15,61,person
58546,1,person,2,0,19748,38,160,146,205,205,45,59,person
58547,15,person,16,1,19750,18,61,94,75,131,14,37,person
58548,7,person,8,0,22298,22,199,303,210,335,11,32,person
58549,5,person,6,1,20072,24,72,1221,362,1703,290,482,person
58550,6,person,7,1,20072,70,260,407,1050,1703,790,1296,person
58551,5,person,6,1,20074,39,364,774,665,1647,301,873,person
58552,5,person,6,0,20076,39,157,119,189,274,32,155,person
58553,6,person,7,0,20076,48,120,118,160,272,40,154,person
58554,21,chair,22,1,20077,15,1180,559,1220,645,40,86,chair
58555,4,person,5,1,20078,58,666,356,1041,952,375,596,person
58556,2,door,3,0,20100,25,196,1,299,222,103,221,door
58557,11,chair,12,1,20100,19,65,193,227,382,162,189,chair
58558,4,table,5,0,20101,25,244,514,697,831,453,317,dining table
58559,9,cat,10,0,20104,23,97,124,133,195,36,71,cat
58560,6,person,7,1,20105,58,153,1,420,328,267,327,person
58561,12,person,13,1,20107,27,458,16,530,186,72,170,person
